prompt,title,essay,c1,c2,c3,c4,c5,score
128,O papel do meio ambiente na riqueza de um país,"['Para ser ter um bom desenvolvimento econômico deve-se não apenas criar leis rígidas de proteção ao meio         ambiente deve-se         haver uma cobrança do cumprimento dessas leis.', 'Os incentivos                também contribuem para que se proteja o ambiente                 e seus componentes.', 'O ser humano deve aprender a respeitar o meio em que vive. O desenvolvimento econômico só será atingido                 se esse respeito for feito                . Nada adiantara morar em um país de primeiro mundo com um alto poder econômico se         o mesmo         passa por uma destruição crucial,                 afinal, o desenvolvimento de um país não pode ser medido por apenas um fator.', 'Para que o Brasil possa ser reconhecido como uma         super potencia         todo o seu meio ambiente deve ser valorizado, pois é nele em que         se está         a sua maior riqueza.']",120,80,80,80,80,440
93,,"['EM CONSONÂNCIA COM A DECLARAÇÃO UNIVERSAL DOS DIREITOS HUMANOS (DUDH), A CONSTITUIÇÃO FEDERAL POSTULA A IMPORTÂNCIA DO ACESSO À SAÚDE PARA TODO CIDADÃO. TODAVIA, NOTA-SE UMA DIVERGÊNCIA ENTRE GARANTIA E DIREITO, POSTO QUE NÃO HÁ CASAS DE PARTO SUFICIENTES NO SUS . NESSE CONTEXTO, SEJA PELA FALTA DE INFRAESTRUTURA, SEJA PELO DESPREZO COM A MULHER E A MATERNIDADE, O PARTO HUMANIZADO TORNOU-SE UM GRANDE DESAFIO NO PAÍS E MERECE UM OLHAR MAIS CRÍTICO DE ENFRENTAMENTO.', 'CONSTATA-SE QUE 75% DOS BRASILEIROS UTILIZAM O SISTEMA ÚNICO DE SAÚDE (SUS) DE ACORDO COM A POLITIZE,  SENDO ASSIM 3 DE CADA 4 BRASILEIROS UTILIZAM O SUS. POR OUTRO LADO, TEMOS A VISÃO DA ESCASSEZ DE ÁREAS COMPETENTES DE ATENDIMENTOS PARA O PÚBLICO EM GERAL, PRINCIPALMENTE PARA GESTANTES.', 'DO MESMO MODO, TORNA-SE INACEITÁVEL E INCABÍVEL A INTERVENÇÃO CONTÍNUA DE MÉDICOS, OBSTETRAS E ENFERMEIROS DURANTE A HORA DO PARTO, SEM COM QUE HAJA RESPEITO PARA COM A MULHER E O BEBÊ NO MOMENTO DO NASCIMENTO DA CRIANÇA. ATENTA-SE PARA O FATO DE QUE CESARIANAS POSSUEM UM AUMENTO CRESCENTE ENQUANTO O PARTO HUMANIZADO É POUCO CONHECIDO PELA POPULAÇÃO.', 'EFETIVAMENTE, O PARTO HUMANIZADO É UM DIREITO DA MÃE E DO FILHO TENDO AINDA QUE RESPEITAR AMBOS OS LADOS, SABENDO QUE, O NASCIMENTO É UMA VIA DE MÃO DUPLA E TAMBÉM NATURAL.', 'EM SUMA, O GOVERNO BRASILEIRO DEVERÁ INVESTIR NA INFRAESTRUTURA E NO AUMENTO DE MATERNIDADES E CASAS DE PARTOS ALÉM DE TORNAR ACESSÍVEL GESTANTE AS INFORMAÇÕES SOBRE TODO E QUALQUER TIPO DE PARTO, DANDO ASSIM O DIREITO DE ESCOLHA, DA MESMA FORMA OS AGENTES DA SAÚDE ESPECIALIZADOS NESTA ÁREA DEVERÃO TER, TAMBÉM, UM TREINAMENTO SOBRE COMO ATUAR NA HORA DO PARTO HUMANIZADO PROPRIAMENTE DITO.']",120,120,120,160,120,640
92,Não ao preconceito amarelo,"['A Declaração Universal de Direitos Humanos , de 1948, defende a manutenção do respeito entre povos. Entretanto, tal prerrogativa não tem se reverberado com enfâse na prática, quando se observa a o preconceito amarelo que invade o mundo contemporâneo, principalmente diante da pandemia vivenciada, dificultando, deste modo, a universalização deste direito tão importante. Diante dessa perspectiva, faz-se imperiosa a análise dos fatores que favorecem este quadro.', 'Em primeira análise, deve-se ressaltar que a ausência de medidas da Organização das Nações Unidas- ONU para combater o estigma s pessoas asiáticas . Segundo a filósofa Hannah Arandt - A essência dos direitos humanos é o direito a ter direito. Porém, percebe-se que a ONU não cumpre sua função de garantir que os cidadãos desfrutem de seus direitos indispensáveis quando grande número de asiáticos de pele amarela sofre um aumento dos preconceitos que já vivenciavam, devido ao surgimento do surto do novo coronavírus, sendo este racismo muitas vezes banalizados, situação que infelizmente é evidente no mundo.', 'Ademais, é preciso salientar que a falta de conhecimento colabora para a permanência do problema. Segundo o filósofo Schopenhauer, os limites do campo de visão de uma pessoa determinam seu entendimento a respeito do mundo. Diante disso, verifica-se uma lacuna em torno dos debates sobre o preconceito amarelo, que muitas vezes está enraizada na população e é alimentado por notícias falsas e pessoas importantes no mundo. Assim, o silenciamento do tema contribui para desinformação e padronização da população, inviabilizando a construção da criticidade coletiva da sociedade e um melhor entendimento do mundo. Logo, é inadmissível que este cenário continue a perdurar.', 'Depreende-se, portanto, a necessidade de se combater esses obstáculos. Para isso, torna-se imprescindível que a ONU, juntamente com os governantes dos países, probam as práticas de preconceito racial, através de leis e medidas punitivas aos praticantes, a fim de buscar respeito e segurança para as pessoas de pele amarela. Nessa ação, seria importante que as mídias abordassem mais temas que valorizassem o ser humano, a formação educacional, a cidadania, a igualdade, a liberdade e a segurança da sociedade. Somente assim, será possível garantir os direitos previstos na Declaração Universal dos Direitos Humanos.']",160,160,160,200,160,840
71,"Suicidío, problema ou solução?","['O suicidío depende do ponto de vista de cada um, nós que estamos por fora da situação, sabemos que é um grande problema, mas e a pessoa que passa pelo momento? concorda conosco?, com certeza não! os suicidas veem isso como uma nica sada, para uma vida inteira de sofrimento e feridas sem fim.', 'O suicdio vem acompanhado da depressão, ambos mal compreendidos por pessoas preconceituosas que não entendem a necessidade do próximo, oque leva alguém a ter o desejo de tirar a própria vida? uma magoa? uma ferida? o passado? seus proprios pensamentos? são inumeros os questionamentos para tentar entender oque essas pessoas sentem, nós deveriamos tentar ajudar mais o nosso proximo, olhar com empatia.', 'Deveramos investir mais, cobrar mais para que houvesse profissionais capacidados nas escolas desde os 10 anos de uma criança, para que desde muito jovem ela entenda a importncia de não guardar tudo para sí mesmo, e que a solução não é a morte, que há uma saída, investir em um novo jeito de pensar, um novo modo de enfrentar as coisas, e acima de tudo, ensinar desde cedo que a dor do outro, possa sim, ser nossa responsabilidade!']",120,80,80,80,80,440
66,,"['Dos anos noventa até os dias atuais a tecnologia evoluiu de maneira rápida, já se encontra acessível a qualquer pessoa, mesmo sendo analfabeto . Acompanhando essa evolução e a necessidade de se reinventar o comércio, que passou das trocas às grandes navegações, passa a comprar dados de navegação onde passa a ser possível vender produtos específicos para cada usuário com base no seu comportamento virtual.', 'Esses dados são coletados após uma simples navegação na internet  seja ela uma simples busca, uma visita no perfil de rede social até mesmo em aplicativos usados nos smartphones. Estes dados são vendidos para grandes empresas e elas repassam para o usuário produtos que ele procura, utilizando linguagens apelativas e promoções falsas.', 'A atual geração é a mais consumista de todas e que passa por problemas psicológicos, desencadeado pelo mecanismo onde se tem um gatilho, necessidade de algo, aquisição, quando compra o que queria, e recompensa, quando recebe o pedido. Tal processo é explicado no livro O Poder do Hábito de Chales Duhigg.', 'Portanto como tecnologia e comércio continuar de mãos dadas, o internauta pode utilizar bloqueadores de anúncios durante a navegação, prevenindo anúncios, e buscar ler mais sobre o assunto. Nas escolas esse tema precisa ser debatido para prevenir que a próxima geração não sofra com problemas psicológicos e evite consumo desnecessário.']",120,80,80,80,80,440
115,Adaptações não são validas ,"['Em 2014 Patrícia Secco publicou uma adaptação da obra “O Alienista” de Machado de Assis, alegando que os jovens não têm interesse por clássicos da literatura brasileira,         pois         não compreendem a                 linguagem textual                .', 'A linguagem de um texto faz parte de sua essência expressiva e principalmente                 temporal                . Os textos machadianos, por exemplo, possuem um beleza linguística única, pelas palavras e expressões utilizadas por Machado de Assis. Textos         Clássicos          também                retratam                 frequentemente                a época em que foram         escritos         principalmente         através         da linguagem. A         Adaptação         inevitavelmente destrói essa essência que é primordial aos clássicos.', 'É fato que muitos jovens não têm interesse por clássicos, no entanto         simplifica-los         não seria a solução. A maioria deles         continuariam         sem         interesses         , pois não         possuem hábitos         de leitura e ainda haveria os que não leriam mesmo com a adaptação em mãos.         Por tanto          entregar a esses jovens obras de linguagem facilitada tiraria deles a oportunidade de esforçarem-se mais e verem que são capazes de compreender a linguagem original de um clássico.', 'Logo         simplificações de livros clássicos não são         validas         , porque além de empobrecer a obra e esvaecer sua essência, também prejudica o que poderia ser um ótimo aprendizado e desafio aos jovens e igualmente para as pessoas mais velhas.']",120,120,120,120,120,600
54,CRISE DA VACINA,"['A humanidade ao longo de sua história tem sido assolada por diversas doenças que matam milhões anualmente, como a peste negra, que dizimou 1/3 da Europa no século XIV. No entanto, com o passar dos anos, o avanço da tecnologia e da medicina possibilitaram a criação de mecanismos de defesa, como vacinas e antibióticos, os quais possibilitaram a prevenção e a erradicação de algumas dessas doenças. Entretanto, tem sido noticiado atualmente no Brasil, que a vacinação de pessoas vem diminuindo ao longo dos anos, o que vem preocupando as autoridades, principalmente no que tange a volta de certas doenças que até então estavam controladas. Tais resultados podem ter como causa, dois fatores: a autoconfiança das pessoas, que pelo fato da doença está controlada acreditarem que não voltará mais, e pelas informações falsas divulgadas a respeito da vacinação.', 'As campanhas de vacinação no Brasil, iniciaram-se em 1904 com a vacinação contra  varíola, e à medida que os anos passavam-se novas vacinas iam sendo incorporadas ao calendário de vacinação, os resultados foram muito positivos e diversas doenças foram erradicadas ao longo dos anos, bem como, houve uma grande redução na taxa de mortalidade. Todavia, como evidenciado na história de São Tomé, que precisava ver para acreditar, as novas gerações de pessoas vivenciam uma situação análoga, onde, por não verem e/ou ouvirem relatos sobre casos de certas doenças acabam por acreditarem que as mesmas não mais existem, e isso vem contribuindo com a diminuição do índice de vacinação, o que deveria ser o contrário, pois, a não frequência de casos deixa evidente o quão eficaz tem sido essas campanhas ao longo dos anos.', 'Outro fator tem sido as notícias falsas divulgadas, as campanhas antivacinação, as quais não são algo novo na história da vacinação brasileira. No ano de 1904, início da vacinação, iniciou-se juntamente a esta uma revolta, ao qual ficou conhecida como revolta da vacina, na época, a principal causa desta foi a desinformação da população, o que não é diferente nos dias de hoje, onde a falta de conhecimento faz com que as pessoas fiquem vulneráveis e acreditem na falácia formal(conceito abordado por Aristóteles) , ou seja, informações erradas que tentam se passar por verdadeiras, informações essas muitas vezes com referências científicas, porém abordadas erroneamente, como no caso da vacina tríplice viral, que foi acusada de causar autismo.', 'Assim, faz-se necessário combater esses fatores evidenciando a importância da vacinação e seus resultados obtidos ao longo de sua história. Para isso, o governo, por meio do ministério da saúde juntamente com a mídia devem realizar campanhas publicitárias a fim de informar a população sobre os resultados obtidos ao longo dos anos com as campanhas, evidenciando com mais afinco as doenças que foram erradicadas, assim como,  mostrar os riscos da volta dessas doenças, principalmente para pessoas que as desconhecem e consequentemente não sabem a gravidade de seus efeitos. Ainda, se faz necessário maior combate as notícias falsas, que influenciam as massas contra a vacinação, para isso o governo precisa criar um canal em parceria com especialistas da área, com a finalidade de captarem essas notícias, analisarem seu conteúdo e as refutarem, mostrando a população os erros abordados, bem como os responsáveis pela elaboração do mesmo.']",120,160,80,120,80,560
84,,"['Segundo o FBI nos EUA, para cada caso de sucesso no uso defensivo com armas de fogo, houve centenas de casos de mortes com armas em homicídios, suicídios ou acidentes. Já no Brasil, a posse de arma pelos cidadãos tem sido pauta nas discussões no Congresso e nas ruas. Podemos perceber que, casos as legislações sobre esse tema se tornem parecidas com as norte-americanas , à realidade sobre o número de mortes também se tornará, visto que a quantidade de homicídios aumentará significativamente no país e facilitará o comércio de armas para os criminosos.', 'Jean Paul Sartre disse que a violência é sempre uma derrota. Nesse sentido, nota-se a fragilidade da mente humana em regredir ao seu estado selvagem e brutal em certas ocasiões, por exemplo, em brigas de trânsito no qual em um momento de fúria com a presença de uma arma se torna um ato letal, tal fato poderá se repetir em brigas nos bares, discussões cotidianas, ou seja, por motivos fúteis uma vida é tirada violentamente.', 'Além disso, em uma disputa contra o criminoso a principal orientação é não reagir, uma pesquisa realizada no RJ constou que a chance de morrer em uma reação armada é muito maior do que quando não há reação, caso a vítima esteja armada em duelo contra um delinquente que já tem experiência no manuseio, as chances de sucesso para o cidadão de bem são mínimas.', 'Somado a isso, o arsenal criminoso irá aumentar, já que atualmente mesmo com os obstáculos e leis, segundo uma pesquisa feita pelo Sou da Paz com mais de 14 mil armas apreendidas, 80% têm origem nacional e entrou legalmente no mercado sendo desviado em algum momento. Com o comércio de armas livre na sociedade o acesso será facilitado para os bandidos.', 'O porte de armas, portanto, não deve ser livre para a população, muito pelo contrário, o Congresso deve elaborar leis mais rígidas e restringir o uso e comércio apenas para profissionais da segurança, assim facilitará também o controle por parte da polícia sobre a venda ilegal de armas.']",120,200,200,160,200,880
63,Grandes,"['Desde a Primeira Revolução Industrial, ocorrida na Inglaterra, o mundo viu o desenvolvimento do setor fabril causar grandes impactos ambientais, geralmente através da ação de grandes corporações. Por isso, faz-se necessário que o Poder Público tome medidas que evitem a ocorrência desses danos, tão prejudiciais ao planeta.', 'Em primeira análise, é importante destacar que, além do impacto diário causado ao meio ambiente, tragédias ambientais causadas por grandes empresas também são bastante frequentes. Nesse contexto, há casos de ampla repercussão, como os derramamentos de rejeitos em Mariana e Brumadinho, ambos em Minas Gerais, e os vazamentos de petróleo no mar. Desse modo, vê-se como grandes corporações - tais como a Vale e a Petrobras - causam graves transtornos.', 'Em segunda análise, é fundamental reconhecer que a fiscalização atual sobre a atividade das empresas não é eficiente. A título de exemplo, barragens a montante - como as que se romperam em Minas Gerais - são bastante inseguras, porém são muito comuns em várias regiões do país. Por conseguinte, o meio ambiente e a população são postos em risco pela atuação industrial inadequada.', 'Diante do exposto, é mister que o Poder Público aja para mitigar os impactos supracitados . Com esse fito, o Ministério do Meio Ambiente deve ampliar a fiscalização sobre a destinação dos resíduos,  por meio de visitas periódicas às indústrias, avaliando a situação destas e, quando necessário, aplicando as punições já previstas em lei, até que a empresa se adeque ás normas de segurança. Complementarmente, o órgão deve criar um canal de denúncias anônimas a condições de risco e/ou contaminação ambiental - a ser divulgado por meio da mídia - garantindo, assim, que os impactos ambientais sejam reduzidos.']",160,160,120,160,120,720
62,A ira presente nas redes sociais,"['Os avanços tecnológicos proporcionam grande disponibilidade de informações, atraindo usuários de todas as partes do mundo para o uso das redes sociais. Entretanto, discussões em comunidades existentes nessas redes podem obter como consequência possíveis discursos de ódio trocados entre usuários, deixando muitos em estado de desconforto.', 'A presença de discursos de ódio se dá em proveniência de opiniões divergentes apresentadas na comunicação entre os usuários, sendo que alguns tendem a manter suas contas anônimas a fim de não serem reconhecidos. Logo, esses usuários por não disporem de divulgação de dados pessoais, hão de ter o sentimento de segurança ao expressar opiniões online, sendo tais positivas ou negativas, como os discursos de ódio.', 'A internet possui uma plataforma ampla, na qual há a possibilidade de comunicação e discussão sobre tópicos diversos, como étnicos e ambientais, como também gostos individuais. Porém a web se torna cúmplice dos vilões por proporcionar ferramentas que os usuários irados podem utilizar, podendo provocar até comentários xenofóbicos. Uma dessas ferramentas é a possível manutenção do anonimato nas redes sociais, que apesar de ser favorável para o indivíduo que deseja ter sua privacidade zelada também pode facilitar a ação de haters (expressão inglesa utilizada para denominar o sujeito que propaga ódio online), que circulam sem medo pela internet.', 'Ao expor ideias nas redes sociais, um leque de novidades se abre e proporciona melhor compreensão da diversidade, tal como é possível encontrar similaridades de ideais, por isso é saudável a abordagem dessas discussões em ambientes sociáveis. Como o escritor Buckminster Fuller cita  ""A humanidade está adquirindo toda a tecnologia certa por toda as razões erradas"", isso necessita mudança.', 'Portanto medidas devem ser tomadas, como maior inspeção por parte dos programadores dessas redes a partir de um sistema de análise de dados e de IP, a fim de que os comentários e compartilhamentos sejam monitorados de acordo com as normas de direitos humanos. Isso ajudaria a diminuir e até extinguir o ódio propagado na internet.']",120,120,120,120,120,600
51,Um processo,"['Desde muitas décadas o analfabetismo funcional brasileiro é uma problemática na história do país. Isso,  dá-se devido ao tipo de método de aprendizagem e a falta de investimentos na área de educação.', 'O método de aprendizagem brasileiro apresenta-se cheio de falhas, já que não excita os jovem a pensar e refletir . Além do mais, as escolas não ensinam aos adolescentes a estudar de forma aguardar o conteúdo, pois muitas das vezes o conhecimento é armazenado até o dia da prova após isso, conhecimento se perde. Ademais, ausência de aplicar o conhecimento no cotidiano causa desinteresse aos adolescentes uma vez que, segundo Perpétuo e Gonçalves, aulas dinâmicas otimizam aprendizado.', 'Vale destacar, também, que a falta de investimentos na Educação Básica faz aumentar as taxas de analfabetismo. Isso,  pode ser relacionado à falta de investimentos e planejamento de incentivo à leitura, porque, de acordo com a Unesco , Organização das Nações Unidas para a educação ciência e cultura, no Brasil, os brasileiros leem pouco. Isto é, cerca de 1,8 livros por ano enquanto outros países como Alemanha a população e cerca de 7 livros.', 'A partir dessas considerações, fica evidente que essa tribulação sobre o analfabetismo ainda persiste devido aos métodos ineficazes de educação. Afinal as ações governamentais, a exemplo, o Ministério da Educação deve estudar meios e formas a fim de instruir as escolas para formar cidadãos que assimilam e compreendem o conteúdo de forma eficaz.']",120,80,80,120,80,480
74,A morte da própria mãe?,"['A violência contra a mulher é uma questão que merece atenção no país, visto que é um fator preocupante, que está alinhado à uma política ainda muito fraca em relação à este grupo que têm conquistado expressivo espaço nas últimas décadas, em todos os aspectos. O sentimento, muitas vezes de posse, que o homem apresenta à respeito das mulheres, é um fator negativo de extrema força quando se trata do feminicídio. Conivente com isso, encontra-se a legislação com leis brandas e muito mansas com aqueles que atentam contra as mulheres.', 'É notório que o sentimento de posse é um dos principais causadores do problema, levando em consideração que até meados do século XX, a mulher era submissa ao homem. No entanto, a ideia de controlá-las - um mal da sociedade moderna, herdado de muito tempo  - tem que ser combatido com veemência, pois esse mal hábito leva à concessão dessas práticas, que consequentemente resultam em trágicas consequências.', 'Na mesma direção, encontrase a legislação brasileira, contendo uma margem de penalização pouco efetiva para tais crimes relativos, com penas alternativas que muitas vezes tornam o cometimento do ato um tanto confortável, o que gera a reincidência por ter consciência da tranquilidade da lei.', 'Portanto, o combate começa pela educação familiar, onde os genitores têm a obrigação de moldar a educação, logo o devido respeito . Em paralelo à isso, a intensificação da legislação é um ponto crucial e de suma importância para a diminuição dos casos, aliados com uma política de combate conscientizadora, como também explanadora da severidade de tais incrementações, afinal o referido são as genitoras da nação brasileira']",120,120,120,120,120,600
76,A luta contínua,"['A desigualdade de gênero ainda é um desafio para a mulher brasileira, embora tenha conseguido alguns avanços na luta por igualdade, há, ainda, uma disparidade em muitos setores como: mercado de trabalho, desigualdade salarial, ocupação em cargos de liderança e política partidários, por exemplo.', 'No mercado de trabalho, a inserção para as mulheres ainda apresenta resistência no momento da contratação, pois, culturalmente, há uma visão estereotipada sobre os cargos os quais elas devem ocupar. No momento da entrevista, por exemplo, alguns entrevistadores, fundamentados em um ponto de vista sexista, veem as mulheres como pouco capazes de exercer certos cargos e ,principalmente, de liderança. Pois, acreditam que as mesmas  têm mais facilidade de demonstrar comportamentos instáveis e que irá dedicar mais tempo a família e filhos, logo não contratá-las representaria um ganho a empresa. Assim como, alicerçado em uma visão preconceituosa, acreditam que cargos de liderança devem ser ocupados por homens, que são vistos como emocionalmente estáveis.', 'Do mesmo, segundo PNAD (Pesquisa Nacional por Amostra de Domicílios, do IBGE), há diferença salarial, entre homens brancos e mulheres brancas com nível superior que chega a ser de 40% e 43% entre o homem branco e a mulher negra, visto que esta além de ser vítima do machismo na hora da contratação, ainda sofre o racismo. Tal fator torna a mulher negra duplamente injustiçada, o que a distância, ainda mais, do padrão de vida de uma pessoa que ocupe o mesmo cargo que um homem branco. Em vista disso, além dela, a sociedade tem perdas financeiras, já que deixa de ter ganhos que esta mulher poderia repassar , através de compras, por exemplo.', 'Essa desigualdade, também, atinge espaços de decisão como a política partidária que ,segundo o levantamento da Secretaria de Políticas para Mulheres ( SPM) ,  as mulheres na eleição de 2016, ocuparam apenas 13,5% dos cargos na câmaras municipais e 12% das prefeituras de todo país. Já no Congresso Nacional, atualmente , 15% do Senado tem representação feminina e na Câmara elas ocupam 10% das cadeiras. Quando um recorte racial é feito, segundo o INESC 0,13% de mulheres que se declaram negras concorreram ao cargo de prefeita, 0,03% vice prefeita e 2,64% ao de vereador, portanto a representação seria muito menor. Com isso a pouca representação de mulheres ocorre,  devido ao pouco patrocínio e visibilidade durante uma campanha partidária, e muitas mulheres sabendo dessa situação sentem-se compelidas a nem tentarem.', 'Assim sendo  a população como um todo, assim como as mulheres negras, perdem já que não há uma representação e projetos que tragam perspectiva de todos os grupos sendo apresentados.', 'Logo, apesar de existir políticas afirmativas que tenham como bojo promover mais participação feminina em espaços de poder e diversificar os pontos de vistas , opiniões e ideias , como a cota de filiadas de 30% decidida pelo Tribunal Superior Eleitoral (TSE) , ainda há muitos desafios a vencer . Esta empreitada perpassam pela luta contra o machismo , o sexismo e o racismo – para as mulheres negras. Tais pontos dificultam, diariamente, o ingresso de mulheres nos espaços de labor e decisões. Portanto, é preciso além de reforçar as políticas já existentes, criar e fiscalizar os espaços para que as eles sejam ocupados em números iguais por mulheres e homens.']",120,120,80,120,80,520
78,Faça-se a luz!,"['Reformar o ensino médio no Brasil é necessário, mas não do jeito que o governo quer impor, sem discutir com os mais interessados, docentes e discentes. A proposta não agrega nada de interessante que possa transformar o atual sistema educacional em melhor. Pelo contrario  estar direcionando os estudantes de escola publica para o ensino técnico e não para a universidade.', 'Retirar os direitos e incentivos dos professores também não ajuda nessa reforma , assim os melhores professores irão embora para o sistema privado, deixando as instituições publicas cada vez mais defasadas . Não é assim que se faz uma mudança tão importante na educação . Ela é o pilar mais importante de toda as sociedades no mundo. Educação primeiro! Educação não é despesa é investimento. E o retorno é impagável! Só quem investe nela tem um país mais justo, prospero e soberano.', 'Quem deve ficar a frente desse projeto de transformação é um educador, e não um politico . Os professores devem ser incentivados, valorizados e respeitados. Sem eles não existe educação. Quem tem que ser Ministro da educação é um professor e nunca um politico. É preciso pensar juntos para que essa reforma seja boa para todos. Assim, ganha a sociedade os educandos, os educadores, o governo e o país.', 'Logo, se essa reforma imposta pelos políticos será problema ou solução. Só quem pode dar essa resposta são os educadores! Por que não chamaram eles para desenvolver o projeto? O que dará certo na reforma é se os professores forem bem pagos, incentivados e valorizados. Pelo governo, pelos alunos e pela sociedade. Porque ensinar hoje em uma escola publica brasileira é um ato de coragem e de amo. Sem professor não há educação, civilização nem nação . Invistam no professor que a educação muda pra melhor. A grandeza não consiste em receber honras, mas em merecê-las. Aos corajosos professores brasileiros que mesmo diante das grandes dificuldades  nunca desistiram de ensinar toda honra e toda glria.']",80,120,80,80,80,440
50,ciência e o investimento,"['investimento na ciência e fundamental no combate de vírus e bactéria, sendo uma fonte de resposta do mundo . forma vale salientar que a ciência esta contida no âmbito social, no entanto o Brasil não procura investir em pesquisa ciando um ponto negativo frente ao surgimento de uma pandemia.', 'trabalho dos cientistas é grande e detalhado, o qual consiste em várias etapas do método cientifico . o brasil existem grandes pesquisadores, porém falta a iniciativa e o investimento por parte do governo federal , exemplo disso está sendo a luta frequente para enfrentar o covd19, no entanto,vale destacar a efetividade e rapidez em que um cientista brasileiro conseguiu sequenciar o vírus em apenas dois dias , contudo muita das vezes os trabalhos dos mesmos não são reconhecidos.', 'Além disso , vale salientar que o Brasil possui uma imensa biodiversidade em toda sua extensão sendo uma das mais importante do mundo, que é a Amazônia,  Alguns cientista prediz que ela contém a resposta para todos os problemas,', 'Portanto para enfrentar uma pandemia deve-se investir em pesquisa, está preparado e desenvolvido para que o tempo de resposta possa ser rápido  resultando  a cura. Primeiramente o governo federal deve investir financeiramente , gerando  estrutura adequada para o fundo de pesquisa brasileira, as escolas como fonte de inspiração devem incentivarem os alunos e mostrar como é um trabalho cientifico , alem disso as mídias  com o apoio do governo  devem divulgar o trabalho realizado para o conhecimento de toda a população.']",160,160,120,160,120,720
76,,"['Em meados do século XVI, imperava-se no seio social brasileiro o modelo patriarcal de família, no qual integra-se nesse meio o homem e a mulher como gestores do ente familiar. Todavia, a relação existente entre estes era de plena desigualdade, sobretudo nos afazeres de casa e no mercado de trabalho, tendo ainda o fator violência atrelado a submissão desta. Em vista disso,ao longo que a sociedade avançou, essencialmente,  com a Constituição Federal de 1988, buscou-se que a igualdade entre estes dois seres fosse respeitada, mas, ainda, faz-se necessário políticas públicas que garantam isto, tendo em vista o descaso com os direitos conquistados pelas feministas. Assim, uma análise do exposto será fomentada.', 'Em primeiro lugar, evidencia-se o descaso no mercado de trabalho, em que homens e mulheres que exercem a mesma profissão e função recebem salários distintos; elas bem abaixo do deles. Isso pode ser denotado no que foi notificado pelo UOL: “ várias celebridades da Industria Cinematográfica dos Estados Unidos, em primazia, mulheres, vieram a público questionar a desigualdade salarial que estavam sendo submetidas em pleno século XXI “. Já no Brasil este disparate é vislumbrado no meio político, uma vez que,  a maioria dos representantes do povo, ou seja, Deputados e Senadores, são homens, dado este que expõe a fragilidade, desigualdade e injustiça externada na sociedade, contra as mulheres; esta informação foi divulgada pelo Jornal da Rede Globo.', 'Realizando outra análise, é importante ressaltar a inversão de papeis ocorrida na sociedade, no paralelo homem e mulher. Hoje, elas saem de casa em busca de emprego, têm oportunidade de argui de um estudo equivalente; enquanto eles ficam em casa cuidando dos filhos, além de realizarem afazeres, tal como: cozinhar e lavar a casa . Embora isso, estas ainda são vistas como inferiores, como exemplo, tem-se o elevado número de ocorrências sinalizadas pelas instituições policiais, que alertam sobre a violência doméstica que elas estão sofrendo, fato que infringe e ataca drasticamente o princípio isonômico defendido pelo Estado de Direito, essa situação põe em cheque a busca de alternativas para conter esse cenário estarrecedor.', 'Urge, portanto, a necessidade de contornar-se essa situação. Para tanto, o poder judiciário deverá ser mais ativista de maneira a fazer valer o que é explicito na Carta Magna brasileira, e garantir a igualdade entre o homem e a mulher, com o fim específico de agir no mercado de trabalho punindo os que forem contra aos preceitos da equidade. Ademais, o Ministério da Justiça fomentará um projeto para que seja criado em zonas com mais de 50 mil habitantes delegacias especializadas que tenham a finalidade de atender mulheres acometidas por violência doméstica. E, por fim, a mídia disseminará essas ações de forma a endoculturar a sociedade,  para ela ser mais tolerante e harmônica.']",120,160,120,160,160,720
50,Faz mais medos para os idosos,"['Atualmente, o mundo está sofrendo com o surto do novo coronavírus. Isso está causando grandes problemas para muitas pessoas, entre eles a preocupação na busca de uma cura e o medo de uma crise global.', 'A priori, o rápido avanço desse coronavírus chamado ""covid 19"", está deixando todo mundo em alerta. Ademais , o pouco conhecimento sobre ele provoca uma grave dificuldade de criar um medicamento capaz de combate-lo, levando  muitos indivíduos óbito. Tal situação pode ser comparada com a do livro de Albert Camus "" A peste"" onde  segundo conto , provocou a morte de várias pessoas. Nesse sentido, cientistas do mundo inteiro estão correndo contra o tempo em busca de um remédio capaz de combater a covid 19.', 'Assim sendo, se faz necessário que a OMS (Organização da Saúde Mundial)  juntamente com os governantes de cada país, a criação de campanhas de orientação a população sobre os riscos e os cuidados que deve ser tomados, como lava bem as mãos, usar álcool em gel, evitar lugares com grande quantidade de pessoas etc. Isso deve ser feito sobretudo em lugares onde tem idosos que tem os organismos mais frágeis no contágio do coronavírus, além de orientar a população sem risco sobre a importância de terem que trabalhar, pois sem o trabalho de mais da metade da população mundial o planeta encarará uma nova crise. Caso contrário,o planeta não terá óbitos apenas pelo coronavírus mais por fome também.']",120,160,120,120,120,640
79,,"['Não há como negar que o sistema carcerário brasileiro vem sofrendo de diversos problemas há muito tempo. Além da quantidade de presidiários ser exorbitante, a problemática passa também pelo modo de atuação do Poder Judiciário e pelos servidores que atuam diretamente nesse sistema .', 'Primeiramente, precisamos analisar como ocorre a permanência do presidiário no sistema e porque  eles permanecem lá. O Poder Judiciário é lento e comprovamos isso com o grande número de presidiários que já cumprem pena sem nem ao menos terem sido julgados e também os que já cumpriram suas penas e continuam encarcerados. Isso resulta em outros problemas  como a superlotação e as condições subumanas em que essas pessoas vivem.', 'Do mesmo modo, o trabalho de policiais e agentes penitenciários torna-se cada vez mais inviável. A cadeia tornou-se uma verdadeira “escola do crime”, fazendo o sistema entrar num círculo vicioso de violência. Nas atuais condições, a violência tem sido o único meio de comunicação entre presidiários, agentes e governantes, gerando rebeliões e piorando ainda mais as condições.', 'Posteriormente, mostra-se como um grande paradoxo o fato de haver tanta gente encarcerada e ainda assim vivermos com a contínua sensação de impunidade. Esse sentimento é reflexo da ineficácia do sistema, que foca apenas em punir.', 'Finalmente, se faz  necessário enxergar que o objetivo do encarceramento não se restringe a punir o indivíduo, mas objetiva também ressocializar o indivíduo para que seja capaz de viver em sociedade no futuro.']",160,120,160,160,160,760
2,A lacuna entre sociedade e o governo,"['A principal função do Supremo Tribunal Federal é preservar e garantir a aplicação da Constituição Federal em decisões na qual há controversas controvérsias entre os poderes Legislativo e Executivo. Uma vez que a sociedade reflete diretamente nas leis e consequentemente na formação da Constituição, as opiniões e decisões públicas devem condizer com as do Supremo. Com isso, há razões quando isso não acontece e pode distanciar cada vez mais o povo da sua lei.', 'Com dados oferecidos pelo Datafolha, aproximadamente metade da população brasileira discorda das decisões e posições tomadas pelo STF. Isso pode corresponder a várias razões, entre elas a corrupção consolidada na esfera pública brasileira. Sabe-se que no histórico da política do país encontra-se encontram-se vários escândalos de desvio de verba e envolvimento com empreiteiras por parte dos políticos do país.', 'Isso refletiu drasticamente na sociedade e da na sua percepção sobre o envolvimento na vida pública e decisões políticas. Hoje o cenário político no país está separado da participação popular, pois vê-se que os interesses da população brasileira não são considerados em decisões cruciais quando tomadas pelo STF. Pode-se concluir que os interesses sociais estão dissociados dos interesses do STF devido a à massiva e constante onda de corrupção.', 'Dessa forma, se há desinteresse público, não há envolvimento da população na política e consequentemente maior espaço e oportunidades de executar e aplicar desvios de conduta ética e moral nas esferas políticas. Esse abismo entre sociedade e o governo faz com que o país retroceda cada vez mais e estagne em muitas áreas, como educação e saúde, que são as mais gritantes em necessidades e investimentos.', 'Em suma, a divergência entre o STF e a opinião pública reflete a inabilidade da sociedade em lidar com seu papel ligado a cidadania e a irresponsabilidade do governo em cumprir fielmente o que o STF deve fazer primordialmente. Mesmo sendo uma medida paliativa, uma sugestão a fim de minimizar esse abismo entre sociedade e governo é de erradicar todos os privilégios da classe de políticos e diminuir três vezes mais o salário exorbitante deles.']",40,80,80,40,80,320
82,Por uma sociedade mais consciente,"['Influenciadas pelo senso comum, costumes e tradições, as pessoas tomam decisões muitas vezes baseadas nesses fatores do que naquelas providas  de estudos científicos. Exemplo disso é o hábito de ingerir medicamentos para um alívio breve de uma determinada doença,  sem qualquer ordem médica. Nesse contexto, é preciso que a sociedade tenha consciência das diversas consequências atreladas à atitude de se automedicar, pois, do contrário, intoxicações e a intensificação de doenças serão cada vez mais recorrentes.', 'Em primeiro lugar, a ingestão de medicamentos sem qualquer tipo de prescrição médica pode levar a  intoxicação do organismo. Isso se dá, na maioria das vezes, por costumes ou indicações de familiares e amigos, levando em consideração apenas as experiências, bem como a justificativa de que tal doença não necessite de um tratamento mais complexo e aprofundado. Dessa forma, corre-se o risco de total desconhecimento da real doença, além de que,  ao fazer uso de medicamentos aleatórios, pode-se estar  consumindo de forma inadequada , causando sintomas adversos, já que seu uso se deu de forma totalmente desprovido  de qualquer indicação médica.', 'Em segundo lugar, é possível que tal medicamento realizado  de forma inadequada possa agravar o problema de saúde do indivíduo. O consumo de remédios feito para aliviar, na maioria das vezes, de forma imediata, os sintomas,  pode, ao contrário do esperado, intensificar a doença, uma vez que a tendência do paciente é de se acomodar assim que se obtém uma breve melhora e, desse modo, descarta uma visita ao médico. Sendo assim, iludido pelo breve alívio, o problema vai piorando e, consequentemente, fica cada vez mais tarde  de tratar o problema.', 'Dado o exposto, é necessária a compreensão da população quanto aos malefícios da automedicação e, portanto, evitá-la. Não obstante, para tornar tal processo mais eficiente, é preciso  a participação de órgãos da saúde e da mídia. A OMS- Organização Mundial da Saúde- deve investir em políticas públicas para o sistema de saúde de forma a torná-la mais viável e ampla para atender toda a demanda, descartando assim a necessidade de o paciente se automedicar. Além disso, o quarto setor, isto é, a mídia, deve estimular, por meio da publicidade e propagandas, o hábito de visitar os profissionais da saúde e fazer toda uma avaliação mais precisa sobre o estado de saúde. Feito isso, a sociedade estará mais saudável e consciente.']",160,160,160,160,160,800
50,...,"['A ciência é um meio inovador e eficaz para descobrir novas doenças, (como o coronavírus que prejudica milhões de pessoas), e deter para preservar a qualidade de vida dos indivíduos . Em 1928,  foi descoberta a penicilina, pelo médico escocês Alexander Fleming. Entretanto, somente durante a Segunda Guerra Mundial, esta substância foi produzida em larga escala, salvando milhares de vidas. De forma análoga, no Brasil, a propagação de novos métodos é escassa, a falta de investimentos em pesquisas compromete o avanço científico no país . É necessário destacar os benefícios e o impacto da ciência na sociedade.', 'Inicialmente, é importante ressaltar o papel da ciência como difusora de novas descobertas que favorecem a população. Atualmente, o coronavírus é uma doença que ainda não existe vacina , com base nisso, cientistas do mundo inteiro entram em uma corrida para descobrir uma cura e controlar o número de casos e mortes , por isso, é essencial o uso de técnicas científicas para deter o vírus e proteger os cidadãos.', 'Contudo, no contexto social brasileiro, as instituições de pesquisa e universidades estão com pouco recursos e há poucos investimentos, fruto da gestão irregular e vulnerabilidade governamental .. Segundo o Filósofo Thomas Hobbes, o Estado deveria ser a instituição fundamental para regular as relações humanas, tendo como responsabilidade oferecer serviços sociais para as pessoas. Portanto, é dever do estado se comprometer e assumir as despesas,  para garantir uma democratização do acesso a novos insumos na área da saúde, a ponto de propor investimentos de inovação tecnológica que beneficiam os institutos e universidades a frente dessas pesquisas e beneficiar a população.', 'Por conseguinte, para que haja uma maior disponibilidade de recursos à saúde e impulsionar o desenvolvimento científico, o ministério da economia  juntamente com o ministério da ciência, tecnologia, novações e comunicação, deve implementar novos investimentos  em polos de pesquisa, a fim de potencializar o país. Ademais o governo juntamente com as secretarias estaduais, aumentar a renda dos bolsistas das universidades para produzir novos insumos e disponibilizar a projetos sociais como o SUS , com o intuito de elevar a qualidade de vida e bemestar de todos.']",160,160,160,160,160,800
59,Famintos por proteção,"['A fome é um adjetivo persistente em nossa sociedade desde séculos passados, e com o avanço do homem, em questões intelectuais e progressistas, era de se acreditar que um dia todos teriam acesso comida. Porém, a realidade é outra.', 'Sempre houve uma produção maior do que o consumo, mas por que as pessoas continuam passando fome aqui no Brasil? Talvez porque não se trata apenas da produção, mas da obtenção também. Há sempre um acréscimo constante no preço dos alimentos e nem todos conseguem acompanhar. Aqueles que possuem uma renda baixa ou que não possuem nada acabam por não ter acesso a um bom alimento.', 'Apesar da decadência nesse quesito desde o início do século, no ano 2000, até os dias de hoje ainda há a existência predominante da fome. E para que haja uma solução a perspectiva do homem, da burguesia, deverá se recatar . Necessitam de mais empatia. O governo precisa deixar que o véu caia por completo para que essas pessoas possam ser ajudadas. Que elas recebam o necessário para que possam viver estavelmente. No artigo 6, dos direitos constitucionais brasileiros, foi implantado o seguinte “toda pessoa humana tem direito à moradia e um padrão de vida capaz de assegurar a si e sua família saúde e bem-estar, inclusive alimentação” mas a realidade consta o contrário.', 'Não adianta chegar e implementar um artigo em um livro ou apenas dizer que buscará por melhoras em nossa sociedade . Algo em que muitos políticos pecam e a população mais ainda em cair em sua lábia . Mas é da façanha do ser humano ter fé em mentiras pressupostas. Contudo, o Brasil necessita de mais atenção; de mais cuidado e principalmente de pessoas de palavra, que planejam e façam. Que busquem auxílio no ciclo PCDA se necessário, mas que ouçam as súplicas por ajuda e que ajudem.']",120,120,120,120,80,560
16,O Brasil é conservador,"['Nunca se falou tanto no país em direita e esquerda, em conservadorismo e liberalismo, talvez, depois de 1964, temos a maior polarização política nesses últimos tempos, em 2010, era considerado quase um crime se declarar de direita, com isso surgiram dois grandes problemas, o primeiro é que o Brasil é um país conservador, segundo é que em consequência deste conservadorismo, algumas ideias liberais modernas dificilmente serão bem recebidas.', 'Em 2010, o IBGE (Instituto Brasileiro de Geografia e Estatística) divulgou o censo sobre religião declarando que o 86,8% do Brasil é cristão , em sua maioria católica. Isto por si só já prova o quanto o país é conservador, em agosto de 2018 o Datafolha publicou uma pesquisa onde que 59% dos brasileiros eram contra a legalização do aborto. Alguns comentaristas políticos durante uma programação na rádio Jovem Pan de São Paulo, pouco antes das eleições, tinham afirmado que estas seriam decididas em pautas morais.', 'Consequentemente o lado mais liberal dessa história foi perdendo espaço, pra se ter uma ideia o país está com mais de 13 milhões de desempregados, segundo o IBGE, mas a população parece está mais preocupada é em assuntos como: casamento gay, aborto, pena de morte, armamento , entre tantos outros. Um importante fator para a decadência da esquerda brasileira foram as mídias sociais, pela qual a população passou a acompanhar mais de perto o passo a passo deste movimento e viu que suas ideias feriam os seus princípios.', 'Diante disso está mais do que provado que o Brasil é um país conservador e que não vai, pelo menos nos dias atuais, se amoldar a esse sistema liberal que bate de frente com seu moralismo, quem sabe talvez daqui a uns 50 anos isso pode mudar, mas a única certeza que se pode ter é que o país não quer negociar seus princípios, as eleições presidenciais de 2018 provaram que os números estatísticos estão certos pois', 'Estas eleições estavam bem polarizadas entre conservadorismo e liberalismo.']",120,120,80,80,80,480
5,"Nomenclatura, propaganda e saúde","['No período da ditadura militar brasileira, os governantes utilizavam-se da ilusão utópica projetada na mente da população, por meio da propaganda. A partir deste desse fato, é possível traçar um paralelo com os dias atuais: mesmo 35 anos depois, as organizações governamentais, fazendo uso da publicidade, persuadem o povo a aceitar, sem objeções, as mudanças e normas impostas por ela.', 'Fato semelhante acontece aos ditos ""defensivos agrícolas"", que que, pelo discurso do governo, caracterizam-se apenas por protegerem de pragas as propriedades reservadas para agricultura. Entretanto, de 2007 a 2014, segundo a revista Exame, foram notificados aproximadamente 34.000 casos de intoxicação alimentar decorrente da ingestão de verduras com exacerbados excesso de agrotóxicos. Tal dado demonstra que esses produtos estão também envolvidos numa problemática referente à saúde pública. Ademais, em 2019, foram liberados liberadas para uso 328 novas substâncias do tipo para uso, o que explicita a falta de medidas que visem a apaziguar a adversidade.', 'Por conseguinte, concluímos que a forma escolhida pelos governantes para definir esse produto é fator relevante na percepção popular sobre o mesmo. Logo, como uma grande variedade de problemas é gerada, o termo que transmite tal perigo deve ser escolhido, ou seja, ""agrotóxico"". Vale também salientar que as iniciativas referentes ao aumento da produção orgânica no setor agrícola mostram-se crescentes, uma vez que o mercado mundial nesse setor também o faz, portanto faz. Portanto, é imprescindível divulgar ao povo tais movimentações.']",120,80,120,120,80,520
76,,"['A desigualdade de gênero é um fenômeno muito presente no Brasil. Dentre vários fatores que se analisa, destaca-se o fato de que a mídia contribui para diferenciar homens e mulheres concomitante à educação domiciliar limitadora recebida por meninos e meninas.', 'Ao olhar novelas, propagandas e filmes percebe-se que, de modo geral, o homem sempre é o responsável por trabalhar e sustentar a família, enquanto a mulher tem o dever de criar e suprir as necessidades dos filhos e da casa. Contudo não se vê a figura feminina em uma lida como obra, motorista de caminhões, por exemplo, e cargos que exijam força física, pois, de certo modo, isso afetaria a masculinidade , bem como um homem exercendo um papel de manicure e/ou maquiador seria um choque a todos, tudo isso na visão dos promotores de entretenimento áudio visual.', 'Além disso, há o pensamento ultrapassado de pais e avós para com a educação de seus filhos e netos, pois meninos têm de brincar com carrinhos, super-heróis e usar, preferencialmente, a cor azul, da mesma forma que meninas devem se divertir com bonecas, se vestirem de princesas e usarem tons rosa. Portanto, a cultura de macho e fêmea já vai se formando dentro do contexto social e, na personalidade de cada um, engessando pensamentos que delimitam ações do homem e da mulher. Desde o século passado  essa forma de educação vem sendo disseminada, porque o movimento higienista já pregava funções do lar para a matriarca e lida bruta ao patriarca da família .', 'Como se vê, a divergência de sexo é algo muito latente no país. Logo cabe aos Ministérios da Educação e da Comunicação desenvolverem estratégias para reflexões sobre informações mais igualitárias dentro das escolas e nos programas de televisão, ainda cabe ao conjunto familiar disseminar uma criação menos condicionada às crianças, incentivando e apoiando o livre arbítrio do ser humano. Assim a equivalência dos indivíduos se tornará cada vez mais palpável.']",120,160,120,120,120,640
89,give it away now,"['Além da pandemia do Sars-CoV-2, o brasileiro se viu diante de outra problemática: a consequente crise econômica. Desta forma, a realidade da população, principalmente a de classe baixa ou média, ficou marcada pelo desemprego e pela busca por recursos financeiros. Nesse contexto, surge o isolamento social que, embora necessário, foi o que impactou na renda familiar de cada pessoa, mesmo com o governo tentando amenizar a catástrofe econômica.', 'Em primeiro plano, é válido citar que as medidas contra o agravamento da pandemia no país deixaram inúmeras famílias em condição de vida precária. De acordo com o Instituto Brasileiro de Geografia e Estatística (IBGE), em setembro de 2020 o Brasil registrou recorde no número de desempregados, com 13,5 milhões ao todo. Além de mostrar uma alta de 33,1% quando comparado a maio, tal número revela que são cada vez mais brasileiros quebrando as regras de isolamento social à procura de emprego.', 'Por outro lado, ganha destaque a ajuda dada pelo governo federal por meio do programa ´´Auxílio Emergencial``, implantado em abril do ano passado. Mediante a esse adjutório, grande parte da população conseguiu sobrevida na renda familiar, todavia, as caixas lotéricas se viram diante enormes filas e aglomerações de pessoas desejavam obtê-lo. Dessa forma, conclui-se que a instabilidade financeira pesa mais na consciência da população do que a crise sanitária.', 'Nessa perspectiva, portanto, medidas devem ser tomadas  a fim de impedir que a população se veja obrigada a sair para as ruas. Pra tanto, é dever do governo disponibilizar uma nova remessa do ´´Auxílio Emergencial`` através de meios digitais, e limitando a quantidade de pessoas nas filas lotéricas para aqueles que não fazem uso de tecnologias. Desta forma, tanto a pandemia quanto a crise econômica serão sanadas mais rapidamente no Brasil.']",200,160,160,200,160,880
3,(In)revolução pós-humana,"['No século XVII, Johannes Kepler, astrólogo alemão, considerado figura-chave na revolução tecno-científica, apresentou teorias que mais tarde serviriam de base para a evolução humana o progresso da humanidade. Hoje, no entanto, a superação dos limites humanos requer cautela, uma vez que o avanço da ciência e da tecnologia já alcançam alcança dimensões incomensuráveis. Nesse sentido, os efeitos gerados por esses mecanismos devem ser analisados de forma sucinta e sólida, sob pena de prejuízos às futuras gerações.', 'Em uma primeira abordagem, e é importante sinalizar que a revolução transumana remete, a curto prazo, a à solução de problemas do mundo atual. Como resultado do avanço científico no campo da medicina, por exemplo, o tratamento de doenças, bem como a cura do câncer e do vírus HIV da Aids, finalmente deixariam de ser uma realidade distante. Contudo, esse progresso depende da correta utilização dessas tecnologias tecnologias, o que deve, pois, ser fonte de debates entre as potências mundiais, pioneiras no estudo desses instrumentos, e a população.', 'Além disso, ressalta -se que os altos investimentos em tecnologia científica não se faz presente fazem presentes de maneira isonomia isonômica e proporcional em todas as nações. Por isso, não é razoável que, em um panorama global em que há altos índices de pobreza e miséria em países subdesenvolvidos e emergentes, somente parcela das lideranças políticas e de indivíduos influentes tenham acesso a essas inovações. Dessa forma, é de suma importância que a revolução pós-humana chegue para ambas todas as classes, sob pena de geração de uma sociedade altamente totalitária e seleta, interiorizado os demais indivíduos.', 'Torna-se evidente, portanto, que a superação dos limites humanos sob o viés tecnológico e científico requer um amplo debate sobre as suas consequências. Assim, e é necessário que o pós-humanismo beneficie os indivíduos como um todo por meio de pesquisas feitas pelos grandes centros laboratoriais na área da engenharia genética, precipuamente, que colaborem para a busca da cura de doenças transmitidas por vírus com o propósito de diminuir os índices de mortes em países pobres. Em adição Adicionalmente, essas pesquisas e a distribuição igualitária dos investimentos devem ser feitos através de fundo fundos arrecadados pela ONU a fim de viabilizar tal processo.']",120,160,160,160,120,720
110,Resquícios do patriarcalismo,"['A violência sexual                 é considerada como uma das piores práticas                cometidas no Brasil, sendo que grande parte das vítimas são mulheres. Vivemos em uma sociedade patriarcal em que é normal uma mulher ser desvalorizada e diminuída. O abuso é tolerado e visto como consequência das ações das próprias         vitimas         de estupro.', 'Há inúmeras                 comprovações que mostram que as mulheres                são tão capazes quanto os homens, e que uma                 divisão de sexos                é um atraso em relação ao desenvolvimento. Apesar de o feminismo vir lutando por tanto tempo, resquícios de uma sociedade patriarcal                 são visíveis e ignorados                . Uma mulher que possui liberdade sexual é reprimida e condenada, a sociedade santifica a virgindade da mulher e a sexualidade do homem.', 'A culpa do estupro é atribuída         a vitima         , seja por vestimenta ou comportamento inadequado. Aceita-se o fato de que o homem apesar de ser racional e pensante não consegue controlar seus instintos perante uma mulher, ou seja, além dos traumas, complicações e problemas que a         vitima         pode         contrair esta         também leva a culpa de ser estuprada.', 'O estupro é um crime tão perigoso como qualquer         um         e não deve ser tolerado,                 acredita-se na imposição de penas adequadas aos infratores e          uma          busca na mudança do pensamento medieval que envolve a “cultura do estupro”, educação sexual deve ser levada adiante assim como a valorização e igualdade dos sexos.']",120,160,120,160,120,680
78,Reforma no Ensino,"['O tão sonhado momento chegou "" Reforma no Ensino"",entretanto.', 'Desde a antiguidade, a uma busca constante, pela mudança educacional. Pais idealistas de um ensino de qualidade buscam para os seus filhos,algo que lhe foi negado, devido as condições precária da mesma.', 'Hoje a um passo , de se tornar realidade.', 'Todavia, faz-se necessário um levantamento de dados e fatores importantíssimos que devem, ser estudados minuciosamente através de anos de estudo ,para somente então obter um aprimoramento na estrutura do ensino ,fato este que ir ocorrer a partir do momento que houver uma conscientização de suma importância na interação da sociedade como um todo, pois a mesma é amais interessada nesta modificação.']",80,80,80,80,80,400
68,A Valorização do Patrimônio Histórico,"['Valorizar o patrimônio histórico é uma tarefa muito importante, pois é uma forma de manter viva as recordações vivenciadas em outros tempos.', 'É na valorização do patrimônio histórico que é possível conhecer a história de uma determinada sociedade. A valorização  não deve ser apenas por objetos de uso pessoal ou coletivo,mas também em edificações como casas e igrejas,por exemplo.', 'Preservar o patrimônio histórico é o dever de todos porque envolve muitas histórias marcantes e que fazem parte das tradições e da arte que muitas vezes é desconhecida pela sociedade.']",120,80,40,40,0,280
40,Saúde e bem estar ,"['Nos dias atuais, as notícias e os fatos à respeito da busca pelo corpo perfeito tem sido em sua maioria, catastróficas. Isso indica conflito em relação às ideias: perfeição e bem estar . Estamos vivendo na era do consumismo, onde a felicidade baseia-se ao ato de ter ou conquistar algo. Não existem limites para aqueles que buscam a perfeição, nem mesmo quando trata-se da própria saúde. Pessoas apelam por medidas drásticas para estarem dentro do padrão, padrão que é imposto pela mídia, de maneira sutil porém muito convencional. Existem aqueles que estão insatisfeitos com seu corpo por si só, mas a maioria das pessoas que submetem-se à cirurgias e tratamentos estéticos o fazem por medo de não serem aceitas da maneira que são. Falsos profissionais aproveitam a oportunidade e a falta de bom senso de algumas pessoas para oferecer serviços que prometem milagres, em baixo custo, para que tenham acesso facilitado. Temos então um ciclo interminável de consumidores inconsequentes e fornecedores irresponsáveis. Se fizéssemos uma autoanálise, listando aquilo que realmente é relevante para saúde e bem estar próprios, chegaríamos a conclusão de que cuidar do corpo é muito importante, porém a busca excessiva pela perfeição pode causar resultados indesejáveis ou até mesmo consequências irreversíveis. Saúde e bem estar devem ser prioridade.']",160,160,160,120,120,720
34,Jovens modernos  imodestos,"['Hoje em dia, as crianças estão sendo induzidas a ter uma visão egocêntrica sobre si mesmas. As pessoas que as cercam – principalmente os pais – as mimam de tal maneira que torna difícil, no futuro, a convivência adequada dessa criança em sociedade. Esses jovens narcisistas constituem a turma do ""eu me acho"" de que atualmente tanto se fala.', 'Visando o estímulo da autoestima de seus filhos, os pais exageram nos elogios e, consequentemente, criam integrantes da ""geração eu"", que acreditam que tudo o que fazem é digno de orgulho. Essa mentalidade leva à tendência de julgar seus erros como qualquer outra atitude, merecedora de glória e, assim, não aceitar quando outras pessoas apontam suas falhas e tentam corrigi-las.', 'Desde que eu e minhas irmãs éramos pequenas, nossos pais trabalhavam muito, restando-lhes pouco tempo para elogiar cada ação nossa. Ao contrário da turma do ""eu me acho"", fui instruída a reconhecer os erros em minhas atitudes e a trabalhar em melhorá-los. Dessa forma, sou capaz de aceitar opiniões alheias e admitir quando estou errada.', 'Toda essa imodéstia, incentivada desde a infância, prejudica a adaptação desses jovens na sociedade. Adolescentes narcisistas se tornam dependentes de reconhecimento e se magoam facilmente quando não o conseguem. A fim de evitar isso, os pais precisam aprender quando devem criticar as ações de seus filhos e quando devem elogia-los , para que, assim, eles consigam ter uma visão realista de si mesmos e de suas habilidades.', 'A ""geração eu"" está crescendo cada vez mais, o que não é benéfico nem para os jovens nem para as pessoas com quem convivem. Os pais precisam agir para impedir isso, devem ensinar seus filhos que eles não estão sempre certos, assim como eu fui ensinada. Só assim teremos, no futuro, uma geração de jovens altruístas e independentes.']",200,200,160,160,200,920
33,A opção pela melhoria educacional,"['Qual a função principal delas nas escolas? O que faz elas terem o mesmo valor que as outras matérias para que seja obrigatório as mesmas ? Ao entrar em discursão nesse assunto , tem-se que analisar não somente a permanência como matéria escolar, mas a forma como, elas são regidas no país, e de como ela se encaixa na vida do estudante em uma perspectiva.', 'Tanto a educação artística quanto à educação física, têm traços referidos a outras matérias ou posições sociais, como em artes possui referência da literatura, história e até mesmo da filosofia. A educação física tem traços medicinais e suas áreas em especifico através do lúdico e ao esporte.', 'Ao trazer a reforma no ensino médio, o governo objetivou a melhoria do país através do reforço das matérias que são mais cobradas em concursos e ENEM, tendo como referência, países desenvolvidos, que tem as matérias em discursão como obrigatórias, na qual a metodologia de ensino nas escolas vai muito além de aulas teóricas, ou a fixação no futebol como única atividade exercida, realidade que é vivida pela maior parte dos estudantes brasileiros, em especial os da região Norte. A educação teria que ser igual ou no mínimo similar em todo o país, pois a realidade que os estudantes da região Sul têm, é contraditória a do Norte do país, apesar de não serem todas, mas a maioria delas têm a “metodologia da mesmice” tendo uma única atividade exercida ou presos na teoria, quando deveriam ter o conhecimento da importância da pratica dos exercícios físicos, o que vale para os mesmos assuntos de modalidade artística ao longo da vida escolar, sem uma perspectiva de aprofundamento da mesma.', 'Portanto, elas sendo opcionais, poderiam se encaixar como práticas de inclusão social, tendo a educação artística fora das salas de aula, e as atividades físicas através do esporte como práticas complementares. Para tê-las como matérias obrigatórias, teria que melhorar as condições de ensino, para que seja adequada ao país como um todo, cobrando do governo investimentos na educação e em atividades sociais.']",120,120,0,0,0,240
85,alcool e seu uso indevido*,"['O uso de bebidas alcoólicas entre adolescentes é naturalmente um tema controverso no meio social e acadêmico brasileiro. Ao mesmo tempo em que a lei brasileira define como proibida a sua venda e distribuição para menores de 18 anos, é prática comum o consumo de tais bebidas pelos jovens – seja no ambiente domiciliar, seja em festividades, ou mesmo em ambientes públicos. A aceitação social da ingestão de bebida alcoólica torna, então, complexa a abordagem desse assunto com a juventude, que, segundo pesquisa concluída recentemente pela Unifesp, vem apresentando cada vez maiores índices de embriaguez e em idade mais precoce. Some-se a isso o fato de que o álcool altera diversas funções mentais e possibilita que pessoas tímidas e com baixa autoestima apresentem-se mais desinibidas e aceitas.', 'Como se evidencia mais de 60 tipos de doenças estão ligadas ao consumo de bebidas alcoólicas; além disso, a maioria dos jovens que iniciam sua vida nas drogas mais pesadas testemunham que o álcool foi a porta de entrada para elas. Outrossim, de acordo com especialistas sobre o tema, o uso de álcool na adolescência está associado a uma série de comportamentos de risco, além de aumentar a chance de envolvimento em acidentes, violência sexual e participação em gangues, está fortemente associado à morte violenta, queda no desempenho escolar, dificuldades de aprendizado, prejuízo no desenvolvimento e estruturação das habilidades cognitivo-comportamentais e emocionais do jovem. O consumo do mesmo causa modificações neuroquímicas, com prejuízos na memória, aprendizado e controle dos impulsos.', 'Além da lei que proíbe o uso de bebidas por menores de 18 anos também existe um movimento na direção do consumo responsável de álcool, com campanhas na mídia associando o consumo de álcool com moderação ou com prevenção de acidentes, e iniciativas do Conselho Nacional de Auto-Regulamentação Publicitária – CONAR em relação à regulamentação de propaganda voltada para jovens. Entretanto, o cotidiano vem mostrando que esses esforços têm impactado menos que as propagandas de bebidas alcoólicas extremamente bem elaboradas e que a participação dos pais na vida do adolescente é excencial , propiciando a qualidade de vida ao jovem e encorajar hábitos saudáveis, com passeios ao ar livre, contato com a natureza e momentos de lazer em família.', 'Diante dos fatos mencionados, buscar informações sobre os efeitos do álcool e o alcoolismo na adolescência faz com que os pais ganhem poder de persuasão no diálogo com os adolescentes. Ademais, para que o futuro da sociedade brasileira não tenha danos cerebrais ocasionado pelo uso demasiado dessas bebidas, a lei em vigor desse ser aplicada corretamente, tendo uma pressão do órgão público que verifica tal regularidade.']",0,0,0,0,0,0
97,Manifestantes x Policiais,"['A sociedade é o ambiente em que vivemos, visto que somos personagens coadjuvantes para que          se haja          uma paz e harmonia.                Entretanto sabemos que nem todos desempenham esse papel, de forma que é necessário que         hajam         burocracias e regras para                 limitar, e delimitar, um meio          pacifico          de convivência                , tendo “supervisores”, nomeados policiais, com o objetivo de monitorar, e reprimir, caso essas regras         estão         de fato ou não sendo cumpridas.                 Na teoria, essas normas e supervisores são          efetivas          , mas na prática, a          policia          de fato não é muito pacífica.', 'Visto que este é um país democrático,                 é dito que se pode haver força de expressão                , desde que não se infrinja nenhuma regra ou lei, e, olhando para atualidade brasileira, o cidadão e a milícia têm estado em contínuos confrontos                 devido ao excesso de disciplina por parte da          policia          , gerando inquietação da população.                Entretanto, se partirmos do pressuposto         que         quando depredamos algo, perdemos a razão,         se nota         que os manifestantes também estão errados, mesmo que dentre eles         estão         alguns que conseguem expor seu pensamento de forma pacata e sem quebrar patrimônios públicos. Contudo, o uso de equipamentos prejudiciais atingem por muitas vezes pessoas inocentes que estavam apenas no meio do ocorrido. É interessante ressaltar que a         policia          militar é treinada para lidar com criminosos, visto que manifestantes não se encaixam nesse contexto, tornando esses profissionais incapacitados adequadamente para esse tipo de situação.                  Vale salientar que nada          se explica         a violência,                 porque ela está associada ao nosso estado primitivo,                e hoje, como seres racionais, precisamos aprender a resolver nossas questões sem agredir         um ao outro         . Para impedir que essa onda de violência venha                se propagar mais, é necessário que o governo exija uma recapacitação e reeducação profissional         nos         militares, para que saibam distinguir criminoso de civil, e         saiba         punir o transgressor de forma que não atinjam os demais manifestantes. É importante que                 se tenha postura de ambas as partes, de tal forma          se é          cumprido o tão utópico lema “Ordem e progresso”.']",80,120,120,80,120,520
83,Esporte,"['É notório que, a prática esportiva, pode promover no homem moderno formação de valores, a socialização e o desenvolvimento humano, visto que o esporte desperta a necessidade de uma busca de superação e aprendizado constante. A prática regular de uma atividade física traz benefícios imensuráveis, proporcionando ao indivíduo uma vida mais saudável.', 'O sedentarismo é considerado um comportamento adquirido por consequências das tecnologias criadas para facilitar a “vida” do homem moderno, provocando o desinteresse por realizações de esportes. Pode-se dizer que a prática esportiva realizada com fins de competição também tem seus benefícios, uma vez que seja colocado em evidência o interesse em comum de ambos os competidores, que é a participação.', 'Ainda sob essa ótica, de acordo com a necessidade humana em praticar ou realizar algum exercício físico em consonância com o interesse na competição saudável, podemos ver hoje o que chamamos de olímpiadas. Tal Competição esportiva se deu na Grécia antiga com esportes praticados em Olímpia, e tinha como sentido celebrar a paz e a trégua entre as nações que enfrentavam um cenário de guerra mundial no momento.', 'Posto isso, fica-se evidente que a prática esportiva é de extrema valia, em tempos (em) que a tecnologia tem ocupado boa parte do tempo do homem moderno, e que diferente do cenário de guerra vivido no século XIX, hoje presenciamos o antissocialíssimo e o interesse cada vez mais forte na vida virtual. O esporte proporciona a intercomunicação e a troca de valores culturais ainda essências para o desenvolvimento humano.', 'Portanto, analisado a necessidade da população da realização de uma prática esportiva, as prefeituras devem propor melhorias nas condições dos ginásios poliesportivos, condicionando aqueles que têm o objetivo de se profissionalizar em seu esporte, (.) também é considerável a manutenção das academias públicas existentes, e em parceria com a mídia, intensificar as campanhas de incentivo ao esporte e ao exercício físico, adquirindo qualidade de vida saudável.']",80,120,120,160,200,680
112,Continuando sem solução,"['Um dos maiores problemas que o Brasil enfrenta é o ingresso cada vez maior de adolescentes na faixa etária dos 15 aos 17 anos no                 ""mundo do crime""                . Vemos                 quantos                jovens viciados nas drogas ou vendendo-as, praticando furtos e até mesmo latrocínios, como foi o caso recentemente do assassinato do jovem Victor Hugo de 19 anos.', 'Em meio a todos                 esses problemas                que a sociedade enfrenta com nosso jovens cabe a nós questionarmos, reduzir a idade penal irá resolvê-los? Creio que não! Em um sistema judiciário falho como o nosso, com cadeias superlotadas, levar um adolescente para uma penitenciária irá apenas agravar o problema da criminalidade.', 'Para o governo é muito simples ficar prendendo todos que praticam crimes e os deixando largados, dando gastos aos cofres         publicos         . A punição é algo necessário, mas um acompanhamento psiquiátrico, uma reintegração social assistida, deveria ser algo indispensável, por ser uma alternativa de                 salvação         aquele         que se desvia da ordem social.', 'Quantos detentos que ganham a liberdade não voltam a praticar os crimes de antes?         Uma         grande maioria. E com nossos jovens não será diferente. A verdadeira solução não é apenas a redução da maioridade penal, mas sim uma nova formulação das leis que regem nosso país. Com um sistema judiciário arcaico como o do         Brasil         a verdadeira causa da criminalidade não será resolvida.']",160,160,120,160,160,760
85,Psicólogos em escolas públicas e privadas,"['Ano pós ano o índice de crianças e adolescentes envolvidos em crimes cresce absurdamente, na maioria dos casos esses cidadãos não completam o ensino médio o que consequentemente dificulta entrar no mercado de trabalho  com um emprego estável. (Em) Muitos dos casos é relatado que não foram orientados quando criança, cresceram em um ambiente conturbado  onde pais são usuários de drogas e envolvimento em crimes.', 'A educação vem de casa, os pais se tornam referência para os filhos. Mas é na escola que começa o relacionamento interpessoal e o conhecimento do que pode ou não. A escola tem um papel fundamental, que é fazer o aluno enxergar e entender que somente com o estudo e dedicação este jovem terá um fututro brilhante.', 'Hoje o Brasil vive uma triste realidade em termos de violência envolvendo estes cidadãos,  contudo isso poderia ser evitado com diálogo e atenção, em muitos casos esses cidadãos saíram da escola porque algo em sua vida não estava correto.', 'Em suma com uma lei que obrigasse tanto  escolas públicas e particulares (a terem) um psicólogo em níveis da pré escola ao nível médio colheríamos os frutos futuramente. Pois muitas crianças e jovens vivem em um ambiente conturbado, onde em muitos casos estes jovens e adolescentes se envolvem no caminho errado (drogas, assaltos)  e abandonam a escola. O  propósito da implantação da  lei é dar a oportunidade de crianças e adolescentes terem orientação, atenção e a visão correta do mundo o que em muitos casos os pais não fazem este papel.']",120,120,160,160,200,760
20,A evasão do Brasil,"['Segundo uma pesquisa do Datafolha, o número de emigrantes brasileiros está aumentando cada vez mais, sendo ainda maior os que desejam sair do país. Este é um grave problema, haja vista que o país está se tornado desinteressante a seus habitantes – No âmbito estudantil e econômico. Essa evasão é reflexo de uma má gestão governamental assim como um conceito pré-constituído da população.', 'O mau manuseio de recursos públicos ocasiona investimentos precariamente efetivados, afetando diretamente a população. Eça de Queiros diz em linhas gerais “Em Portugal a emigração não é como em toda a parte, a transbordação de uma população que sobra; mas a fuga de uma população que sofre”. De forma análoga é possível perceber que a crise no Brasil que afronta o Brasil desde 2014 é um grande fator para a emigração de brasileiros para outros países, procurando por uma vida melhor do que a vivenciada no Brasil.', 'Outrossim, a população brasileira portando pré-conceitos de uma história conturbada, acaba por menosprezar instituições brasileiras, dando mais atenção a instituições do exterior – principalmente de países desenvolvidos. Ademais, este pré-conceito é corroborado pela disputa no mercado de trabalho, uma vez que pessoas com graduação no exterior geralmente são mais visados e destacados que os demais.', 'Sob essa conjuntura, medidas devem ser tomadas para atenuar esse problema. Para uma mudança de perspectiva sobre o cenário atual se faz necessário investimentos econômicos e culturais, com o intuito de amenizar o exido em busca de uma vida melhor. Ademais, tais investimentos devem ser realizados de forma eficiente, exigindo por parte do governo uma ampla pesquisa nesse âmbito para que possamos cada vez mais se afastar do panorama descrito por Eça de Queiros .']",120,120,80,80,80,480
5,Para um futuro sustentável,"['O economista Thomas Malthus, em sua teoria teoria, descreve que, o que o crescimento exponencial da população, não produção não acompanha a produção de alimentos, com alimentos. Com isso, é inevitável a ocorrência de conflitos e guerras entre as nações. O que Malthus não podia prever, foi prever foi a Revolução Verde, que possibilitou a produção de alimentos em larga escala, diminuindo drasticamente o problema da fome, mas mas, em contrapartida, criou alimentos com substâncias nocivas a à saúde e ao meio ambiente, os Agrotóxicos agrotóxicos.', 'Os agroquímicos, são agroquímicos são compostos químicos que agilizam o processo de produção e defendem os alimentos contra pragas e insetos, o problema é que eles acabam contaminando o solo, consequentemente a agricultura por inteira, sendo passado para o consumidor final, o que acarretam em acarreta problemas de saúde, onde os cujos mais comuns são: Câncer, problemas reprodutivos e distúrbios comportamentais.', 'Entretanto, isso não parece ser um problema ao Brasil, já que é o país que aprova agrotóxicos proibidos em diversos países como: como os Estados Unidos e todos os países da União Europeia, além Europeia. Além disso, apenas em 2019, aprovou cerca de 260 novos agrotóxicos. A explicação para esses acontecimentos é de que a diminuição desses produtos, diminui produtos diminui radicalmente a produção e opõe-se diretamente a uma balança comercial favorável ao país, visto que a exportação do Brasil é majoritariamente de produtos primários.', 'Portanto, para que a economia e principalmente e, principalmente, a saúde caminhem juntas, os governos federais devem direcionar investimentos maiores nas universidades, no setor de pesquisa e desenvolvimento, afim a fim de criar novos agrotóxicos que sejam seguros a população, melhorando tanto a saúde das pessoas, como a alimentação e a economia do país.']",120,120,80,120,120,560
136,Voto,"['A sociedade brasileira atual tem como sistema político vigente a democracia representativa. O voto torna-se, portanto, de fundamental importância para escolher os representantes dos seus ideais. No Brasil, a facultatividade do voto pode afetar negativamente a recente democracia do país.', 'Em relação         a         importância do voto, é por meio         do mesmo         que ocorre a manifestação dos ideais políticos, possibilitando a escolha do candidato que melhor condiz com as expectativas do cidadão.                 Outro aspecto relevante é a conquista da credibilidade política. A lei da ficha limpa tem como objetivo fomentar o desejo de voto que foi perdido ao decorrer de constantes escândalos governamentais.                  No que diz respeito às consequências negativas da facultatividade, pode-se citar a facilidade de alterações nos resultados. A compra de votos, muito utilizada no Brasil na          república velha          , voltaria a ocorrer com frequência visto que alguns políticos, principalmente          em interiores          , dariam benefícios em troca de apoio popular.', 'A participação da população na política é, portanto, necessária. Por maior desinteresse sobre o assunto, é importante a ampla difusão sobre as propostas dos candidatos, seja por meio de televisão ou internet. Espera-se que, com a formação de uma sociedade mais politizada, o desejo de votar aumente, ou de qualquer forma,         diminuia         os efeitos negativos da anulação do voto.']",160,80,120,120,80,560
31,Modernizar para evoluir,"['O país passa por uma grande crise que afeta todos os setores da economia, pois, entre outros problemas, ele perdeu competitividade. O que afeta diretamente a vida de milhões de brasileiros, por consequência empresas não são detentoras de liberdade para contratar outra onde não possuem maestria em determinada área do mesmo, como as atividades fim .Além disso, cerca de 13% da população encontra-se desempregada, segundo o censo do IBGE de 2016, causa disso está na defasada lei de terceirização do país que impede e engessa empresas acerca de suas funções, gerando queda de renda e aumento de desemprego. Ademais, segundo a revista Forbes, países que detém uma lei tratando de terceirização modernizada possuem as melhores relações em empregado-empregador do mundo, como acontece nos EUA, Japão e países da União Europeia. Portanto, medidas são necessárias para resolver esse impasse. Uma lei de terceirização nas atividades-fim deveria ser aprovada para reaquecer a economia, gerar empregos e dinamizar as relações de trabalho. Os empresários e o Ministério do Trabalho devem promover palestras esclarecendo como vai ser após aprovada a lei,  e o caráter benéfico que isso traria tanto para as empresas, funcionários como para o país.', 'Além disso, cerca de 13% da população encontra-se desempregada, segundo o censo do IBGE de 2016, causa disso está na defasada lei de terceirização do país que impede e engessa empresas acerca de suas funções, gerando queda de renda e aumento de desemprego.', 'Ademais, segundo a revista Forbes, países que detém uma lei tratando de terceirização modernizada possuem as melhores relações em empregado-empregador do mundo, como acontece nos EUA, Japão e países da União Europeia.', 'Portanto, medidas são necessárias para resolver esse impasse. Uma lei de terceirização nas atividades-fim deveria ser aprovada para reaquecer a economia, gerar empregos e dinamizar as relações de trabalho. Os empresários e o Ministério do Trabalho devem promover palestras esclarecendo como vai ser após aprovada a lei,  e o caráter benéfico que isso traria tanto para as empresas, funcionários como para o país.']",120,80,80,120,80,480
83,A importância do esporte na vida humana,"['Qualidade de vida, bem-estar, autoestima, concentração nas ações cotidianas; são resultados notórios com da prática de esportes. Dessa maneira, portanto, quando se busca esses exercícios, tem-se um aprendizado do quão importante as atividades físicas proporcionam à fisiologia humana, bem como à socialização e trabalho.', 'Com base nessa compreensão, deve-se buscar realizar de modalidades olímpicas, que constituem habilidades motoras, mentais e psicológicas; melhorando a flexibilização, o equilíbrio, agilidade e , o raciocínio. e Desenvolvendo capacidade a um indivíduo. Deste modo, haverá progressão pessoal e coletivo mediante às realizações de vida educacional, cultural e profissional. Também, segundo a Unesco, relatórios da Organização Mundial da Saúde – OMS e especialistas da área fisioterapêutica;  tais exercícios proporcionam cidadãos mais atenciosos, humorados, dispostos e, acima de tudo, éticos em estender esta positividade às outras pessoas.', 'Tal direcionamento, soma socialização. Assim, o civil, quando praticante dessas realizações saudáveis, configura um ambiente social melhor, interativo e cultural. Este último é respondido pelas múltiplas nacionalidades dos esportes existentes, favorecendo aprendizagem. Por outro lado, o mundo profissional ganha novas perspectivas quando se mescla o Futebol como entretenimento nas horas vagas.  Aperfeiçoando o cotidiano, tornando seres humanos menos sedentários e ávidos em viabilizar seus afazeres.', 'Em última análise, incluir uma vida desse gênero, constitui saúde a longo prazo, evitando malefícios ao corpo humano;  inibindo doenças de coração, pressão, vasculares e dores de cabeça. Por isso, realizar ginástica, jogar tênis, futebol, corrida, natação e desportivos variados, favorece a resistência humana. No entanto, a população precisa ser estimulada. Nisso o papel do Estado é crucial. Governos municipais, estaduais e federal, podem desenvolver normativas rígidas que proporcionem academiais assistências nas grandes cidades, com fisioterapeutas e médicos de plantão. Além disso, a mídia pode acrescentar em horários comerciais incentivos ao esporte e seus benefícios.']",120,160,120,160,200,760
8,A recusa da vacina,"['A era da pós-verdade questiona vários aspectos antes visto vistos como ""do bem"" ou ""pró-saúde"".', 'Afinal, vacinação faz bem a à saúde ou não?', 'Segundo a OMS OMS, a resistência a à vacinação foi considerada uma das dez maiores ameaças à saúde global em 2019.', 'Muitas pessoas se recusam a tomar vacinas, e muitas vezes vacinas e, muitas vezes, impedem que seus filhos tomem, alegando que tomando a vacina é mais fácil de se contrair a doença.', 'É fácil de se observar que o crescimento da doença do sarampo (altamente contagiosa contagioso) chega a 300% nos primeiros 3 três meses do ano, em comparação ao ano anterior (2018).', 'Isso se deu devido a à recusa das pessoas à vacinação. As pessoas se negam a serem vacinadas.', 'Mas afinal, como funciona a vacina? Em si, a vacina é o vírus morto aplicado ao corpo do ser humano, que que, ao contrair esse vírus morto, crie cria anticorpos e e, caso futuramente ele venha contrair a doença, seu corpo está imune a ela.', 'Falta informação e conscientização às pessoas do sobre o bem que a vacina faz e conscientiza-las de que é ideal tomar. Evitando assim a recusa das pessoas a à vacina.']",80,80,80,80,80,400
136,"Nulo, uma forma de protesto","['Desconfiança, medo e desonestidade são         alguns dos aspectos         que levam alguns eleitores a tomar a atitude de anular seu voto.         Este         ato talvez não mude os         resultados mais         ameniza o “peso” na conciência de quem irá votar. Não há         opções         só         desepicões         , votar em quem?', 'O voto nulo é o única meio para protestar contra a obrigação de votar,                 em um país dito de direito como nosso onde seu art.1 revela, não deveria impor ao povo votar, já que estamos vivendo          uma ""democracia""          não seria necessário                . A sociedade tem que escolher melhor seus representantes, ou                 a forma das eleições deveriam ser mais rígidas para os candidatos                ,         pois         o que se         ver         é algo         contrário         as pessoas são persuadidas com coisas         futéil         , dando vazão para um qualquer decidir o futuro de uma nação que precisa de muito mais que palavras e promessas.', 'Anular o voto também é exercer a cidadania e ainda mais, uma forma valente de         não deixar-se         levar por discursos bem elaborados que não surtem nenhum efeito,                 após a posse do cadidato, por sua vez não          vale          muito, pois são poucos ainda que          conhece          um modo de não compactuar com os corruptos que          corronpem          a humanidade com palavras          ênfaticas         .', 'Enquanto votar for         obrigação averá nulos, a única         saída é a         transparência         tanto dos         candidatos          quanto do povo eliminar a venda de sua vontade                .         Obrigrar         não resolve, aliás, acabou o período de regime ditatorial         para começar         uma         democracia, está         mudança tem que começar nas urnas.']",80,160,120,120,80,560
37,Sobre a cultura do estupro,"['Estatísticas levantadas recentemente apontam que, a cada 11 minutos, uma mulher é estuprada no Brasil, ao passo que 58% das pessoas entrevistadas nessa mesma pesquisa acredita que a vítima teve uma parcela de culpa. “O que ela estava fazendo na rua a essa hora?”, “Usando uma saia curta dessas, não poderia ser de outro jeito!”, “Ele é homem, não controla seus instintos”. Não faltam desculpas para legitimar e justificar o crime, sendo todas sem base e machistas.', 'Esse tipo de violência, muitas vezes, não tem nada a ver com a natureza masculina ou com necessidades sexuais mal administradas, mas está ligado ao pensamento de que a mulher é um objeto a ser consumido e dominado, um aspecto fundamental da cultura do estupro. Essa concepção faz parte da formação do indivíduo nessa sociedade desigual. O garoto, desde a pré-adolescência, é incentivado a se relacionar com o máximo de garotas e trata-las como uma mercadoria, e é aplaudido quando atinge essa meta. A garota, em contrapartida, aprende que “menina deve ter modos” e que não pode namorar muitos rapazes, se vestir de determinada forma ou frequentar certos lugares, sob a pena de ser taxada de vagabunda.', 'Sendo assim, a chave para mudar esse quadro é a educação, que tem o dever de ensinar que ambos os sexos são iguais, que todos merecem respeito e que o não da moça na balada não é charme, mas representa sua voz e seu direito de escolha.']",160,200,160,160,160,840
21,A greve dos caminhoneiros e a malha ferroviária,"['A grande importância dos caminhoneiros para o país foi perceptível por todos durante a greve, que recebeu o apoio de 87% dos brasileiros, de acordo com uma pesquisa DataFolha . Porém, existem alternativas mais inteligentes e sustentáveis que o transporte rodoviário de mercadorias, como por exemplo o transporte por malhas ferroviárias.', 'A escassez de alimento e de combustíveis em todo o país foram apontados como consequência da falta de transporte dessas mercadorias por conta da paralisação dos caminhoneiros. Porém, essa escassez só ocorreu devido ao desespero das pessoas que acabaram comprando quantidades exageradas de alimento, sendo necessário que as redes de supermercado limitassem a quantidade de produtos por pessoa que poderia ser comprado. No caso dos combustíveis, muitos optaram por garantir o abastecimento dos seus automóveis se submetendo a pagar valores altos para isso.', 'Por outro lado, a minoria das pessoas não se entregou para os problemas enfrentados pela greve e optaram por formas mais sustentáveis de se locomover, fazendo uso de transporte público, bicicletas ou caminhando. O transporte rodoviário de mercadorias é um sistema atrasado e caro, fazendo com que os impostos cobrados sejam elevados. No Brasil, temos uma malha ferroviária que foi esquecida pelo governo federal e empresas privadas, seu funcionamento foi interrompido na década de 50, fazendo, então, com que essa ferrovia se encontre em situações precárias atualmente.', 'Após o fim da greve, o presidente da república Michel Temer anunciou que verbas públicas para a educação e saúde serão cortadas para cobrir a diminuição do preço do diesel (o valor alto do diesel foi o principal motivador da greve) . Porém, não seria mais inteligente se o presidente investisse novamente no transporte por ferrovias? A malha ferroviária possui baixo custo de frete, baixa taxa de poluição ambiental, baixo custo de manutenção, isenção de pedágios e o transporte ocorre de forma mais rápida e segura. Com isso, o governo teria um maior retorno monetário e a população pagaria menos impostos pelos produtos, fazendo assim com que fosse desnecessário prejudicar ainda mais o investimento em educação e saúde pública brasileira.']",160,160,120,120,120,680
47,Os entraves do EAD,"[""Segundo declarou o líder sul - africano , Nelson Mandela, a educação é a arma mais poderosa que alguém pode usar para transformar o mundo. No entanto, apesar da grande relevância da educação para a formação sociocultural de qualquer cidadão , ela se depara com alguns entraves no seu desenvolvimento, e na modalidade de ensino superior a' distância, conhecido como EAD pode-se destacar dentre eles , a evasão dos cursos, como também o descrédito quanto a sua qualidade."", ""Em primeiro lugar, é importante frisar , dentre os muitos desafios enfrentados por cursos superiores 'a distância, está a evasão. Isto , ocorre em alguns casos devido desistimulo da perda de auto- disciplina , muito importante no processo de aprendizagem."", 'Partindo deste pressuposto, é valida afirmação do filósofo Immanuel Kant , o qual disse que o problema da educação se assenta o aperfeiçoamento da humanidade ,ou seja, a educação promove melhorias intelectualmente e socialmente no ser humano.', 'Ademais, outro fator desafiador a ser vencido por cursos EAD, é o preconceito quanto a qualidade de seus cursos .Isto , se dá devido aos poucos de aula  ,mas que na sua maioria não interfere na sua qualidade.', 'Outrossim, a questão das deficiências do sistema educacional no Brasil , se estende desde o ensino primário ao superior. Sendo assim , é como afirmou o filósofo Aristóteles, que a educação é fundamental, pois desenvolve a segurança e a saúde do Estado.', 'Portanto, a evasão de cursos e a desconfiança da sua qualidade são desafios a serem superados por cursos EAD. E para isso, é necessário a intervenção do MEC ( Ministério da educação), por meio de financiamento a estudantes com dificuldade de continuar o curso ,bem como maior divulgação sobre a qualidade dos cursos EAD. Assim sendo , a educação superior do Brasil superará os seus bloqueios , proporcionando qualidade aos seus estudantes.']",120,120,120,160,120,640
89,Darwin está errado.,"['A obra ""O grito"", do autor norueguês Edvart Munch, coloca em destaque um ser que experimenta extremo desconforto e pânico diante do desconhecido. Essa representação vai de encontro à ausência do sentimento de estranhamento social diante do não cumprimento das medidas para combater o C-19, visto que, contrário ao pensamento do personagem, a sociedade não mais se espanta, sendo indiferente a não compreensão do problema. Nesse sentido, torna-se evidente que essa situação tem origem na desigualdade econômica na sociedade brasileira . Assim, não só a falibilidade estatal em garantir os meios para se manter o isolamento social como também a falta de estrutura do sistema unico de saúde (SUS) intensifica-se esse quadro.', 'Convém ressaltar, princípio, que muitos brasileiros não têm como manter o isolamento social por não ter condições financeiras de se sustentar. A biologia nos mostra com Darwin que nem sempre é o mais forte que sobrevive, mas aquele que melhor se adapta as novas circunstâncias. Deste modo, temos que nos adaptar as circunstâncias causadas pelo corona vírus, em que o isolamento social não é mais algo facultativo, mas algo necessário para frear a aumento de casos. Então, o governo tem que garantir subsidio as classes social E e D que são as mais afetadas, por tempo indeterminado, assim será possível fazer o isolamento social por completo e garantir medidas efetivas para combater o COVID-19 e proporcionar garantias financeiras para quem mais é afetado por não conseguir trabalhar.', 'Outrossim, destaca-se a falta de estrutura do SUS como propulsionador do problema. É fundamental ressaltar que essa é uma crise sem precedente e desafiadora, logo o sistema de saúde pública do Brasil não consegui atender a demanda causada pelo vírus e consequentemente, resulta em milhares de morte por falta de equipamento necessário para atendimento, além da grande demanda já existente, causando assim um colapso ao sistema.', 'Portanto, medidas são necessária para resolver o impasse. Logo, o Ministério da Economia deve proporcionar subsídio para as classes mais afetadas, por meio de emenda parlamentar, para fornecer ajuda financeira aos mais necessitados, assim não terão que se expor ao perigo para ter seu sustento e instituir rodizio no comércio, para evitar uma crise na economia. Destarte, o Ministério da Saúde, juntamente com mídias de grande circulação, como rede globo, revista veja, divulgar de0 formar massiva a importância de se manter o distanciamento social, de modo a conscientizar a população sobre os riscos do COVID-19, espera-se que com essa medida frear a propagação do corona vírus no Brasil.']",160,160,160,200,160,840
59,"fome, a pior desigualdade que existe no século XXI","['Quando falamos em desigualdade social no Brasil podemos pensar em vários fatores, porém o mais grave até os dias de hoje é a fome. Onde ainda afeta milhões de brasileiros em vários estados do país.', 'As condições em que se encontra diversos casos de família em extrema pobreza é realmente chocante . Os indivíduos passam dias sem comer ou ingerem pouco alimento que não é o suficiente para o corpo que em decorrência a saúde também vem a ser prejudicada.', 'Este fato se d por consequência ao difícil acesso aos alimentos, visto que umas das desigualdades é a renda familiar baixa por falta de oportunidades de empregos e terras para plantar.', 'Portanto a fome não é um problema que ocorre só no Brasil como também em diversos países. Para tomar providencias sobre esta situação é necessário que o governo Brasileiro tome como prioridade este problema, tendo como foco disponibilizar oportunidades de emprego e acesso fácil aos alimentos para estas famílias precárias tornando assim estes estados ""abandonados\'\' uma cidade urbanística. Consequentemente com tais implantações a fome poderá ser uma mazela passada na histria brasileira.']",120,120,80,120,80,520
12,A importância de cantar o hino,"['É notório que os alunos da rede regular de ensino, estão ensino estão perdendo o costume de cantar o hino nacional. Dentre tantos fatores relevantes que concorrem para isso, destacam-se: o desinteresse patriota e também como elemento marcante a corrupção.', 'Sabe-se que a maioria dos adolescentes crescem com sua atenção voltada a à tecnologia, coisas do momento e acabam perdendo o interesse a por velhos hábitos, como por exemplo o canto do hino. É necessário ressaltar que muitos alunos usam palavras rudes e até mesmo imorais no momento cívico.', 'Além disso, a política de um pais país revela diretamente como o mesmo é visto, por esse lado visto. Por essa perspectiva, o Brasil se destaca ao se falar de corrupção, esse é um dos motivos pelo qual a sociedade está perdendo seu senso patriótico.', 'Diante disso, ficasse claro fica clara a importância das de as escolas organizarem um momento para que possa se cantar o hino, pois é de suma importância para o desenvolvimento de um pais país que seu povo se orgulhe e acredite em seu potencial.']",120,80,80,120,80,480
93,As responsabilidades na concepção de um indivíduo.,"['O Código de Ética Médica, em seu capítulo V, expõe ser vedado ao médico desrespeitar o direito do paciente ou representante legal na escolha de práticas diagnósticas, ou terapêuticas, a não ser em casos de risco de morte eminente. Acerca do nascimento de um novo indivíduo, é indispensável que seja de maneira afável e humanizada, visando respeitar e cumprir com esse direito ao longo de todo o processo, mas principalmente no trabalho de parto.', 'Quando se trata de saúde, é natural que haja a confiança nos profissionais, para que os mesmos ofereçam a melhor solução. Porém, cada indivíduo possui suas particularidades, e se tratando do ato de conceber um filho, é compreensível que existam medos, dúvidas e ignorâncias . Sendo assim, é responsabilidade do médico expor as possibilidades de tratamentos disponíveis, assim como esclarecê-los, proporcionando uma escolha mais consciente.', 'Ainda convém lembrar que, não se trata apenas de ética, e sim de uma relação profissional primeiramente entre o Ministério da Saúde e seus funcionários, e em seguida, entre paciente e equipe hospitalar, sendo necessária a empatia, a confiança e o respeito. Dessa forma, o ambiente adequado, com equipamentos de qualidade e recursos básicos que supram o essencial, influencia diretamente no cumprimento de um bom trabalho.', 'Portanto, para ser ofertado um acompanhamento, e principalmente um parto,  mais humano, o qual respeite além do corpo, as preferências de cada mulher, deve haver um constante monitoramento, por parte das pacientes e/ou seus acompanhantes ao longo do tratamento, do cumprimento do direito de autonomia de escolha, garantido no Código de Ética Médica. Assim como, é de responsabilidade do Ministério da Saúde garantir aos seus funcionários os meios, como: equipamentos de qualidade, remuneração apropriada, e infraestrutura que possibilitem a execução de um trabalho adequado.']",160,120,120,160,80,640
83,,"['É notório que a atividade esportiva pode trazer diversos benefícios. Dentre eles, podemos citar: saúde e bem estar; melhora da autoestima, e ainda no plano externo os investimentos na cidade quando ocorrem grandes eventos esportivos, como por exemplo, as olimpíadas. Esses são apenas alguns dos benefícios, entretanto, o Brasil ainda precisa avançar muito no quesito esporte.', 'Quando o assunto é saúde, a prática esportiva tem grande contribuição na prevenção de doenças. Podemos ver que doenças cardíacas são mais comuns em pessoas que não praticam atividade física ou esportiva. Isso é relevante, pois estimula as pessoas a saírem do sedentarismo e levantam a autoestima quando elas enxergam resultados positivos em sua saúde.', 'Além disso, grandes eventos esportivos como as olímpiadas promovem desenvolvimento nacional, trazendo investimentos e geração de empregos para a sociedade. Exemplo disso são as olímpiadas no Rio-2016 que deixará um legado para a cidade, além de grandes transformações de arenas e estádios em bares e restaurantes.', 'Sendo assim, faz-se necessário que o governo tome iniciativas para estimular e incentivar principalmente as crianças e jovens para a prática esportiva em suas diversas modalidades. Também investir resursos para que seja possível a concretização dessas açoes.']",160,120,120,160,200,760
119,"Aceitação ou não, eis a questão","['O padrão estético imposto pela sociedade         contemporânea, faz         com que muitos jovens se arrisquem em cirurgias e fórmulas milagrosas para conseguir um corpo perfeito                 perante os padrões da atualidade                . Contudo, várias complicações podem acontecer, as quais,         muitas vezes com         sequelas irreversíveis e até         mesmo com         risco de morte.', 'A sociedade hoje,         principalmente, pela         influência da mídia,                 vive uma nova concepção de padrões estéticos                . Belas modelos com corpos         esculturais         em quase todos os programas de televisão,                 contrastam com as modelos de alguns anos. E com isso,          acaba          impondo          nas          pessoas um novo modelo corporal,          ressaltando que, a          mídia é responsável por várias fatores relacionados          a          moda e outras características sociais                .', 'Porém, os jovens, correm muitos riscos ao tentarem acompanhar esse modelo corporal. Como o cantor da extinta banda Ls Jack,         que         ao fazer uma lipoaspiração, teve complicações cirúrgicas e isso colocou um fim a sua carreira promissora, pois,         o mesmo         teve sequelas que o impedem de cantar                 normalmente. Denotando assim que a busca por uma melhor aceitação social atualmente, se baseia não nos princípios e virtudes do ser humano e sim no número da roupa que usamos.', 'Fica claro, portanto, que o corpo humano se transformou em um objeto de consumo.         Em que         jovens na busca por                 um de destaque                , muitas vezes por meios perigosos, pensam que a única maneira de se encaixar no meio social é conseguir uma barriga sarada, braços fortes e pernas grossas. No entanto, devemos         nos atentar         que os perigos existentes são inúmeros         e para evita-los,         uma                 nova concepção midiática                deve ser adotada. Com propagandas mostrando os riscos que muitas pessoas correm         as         tentar métodos invasivos em cirurgias e usando produtos ilícitos. E ações das autoridades competentes contra médicos sem registro que realizam operações ilegais e contra pessoas que vendem anabolizantes.']",120,120,120,120,80,560
71,Um ato silencioso,"['Suicídio  um ato silencioso que leva a pessoa ter o desejo de tirar à própria vida,muitas vezes diagnosticado como transtorno mentais ou psicológicos ,porém nem sempre está agregado a uma doença. Esse ato vem crescendo ao longo dos tempos,principalmente entre os jovens. Os motivos que leva uma pessoa ter pesamentos suicidas podem ser variados entre eles estão:a depressão,o desemprego,a dependência química, entre outros. Não há um único fator ou um único culpado.', 'Mundialmente,o suicídio já é a segunda maior causa de morte de jovens entre 15 a 29 anos. E,no Brasil,pesquisas indicam que a morte autoinfligida de crianças de 10 a 14 anos aumentou 65% entre 200 e 2015.No dia 10 de setembro, dia mundial de prevenção ao suicídio a organização Mundial de saúde (OMS) alertam para esse grave problema de saúde pública.', 'Os sintomas muitas vezes são explícitos,como a depressão que leva a pessoa ao isolamento perdendo o prazer do convívio social e familiar,a dependência química com o uso continuo de medicamentos para controlar a ansiedade e reduzir a sensação de stress da mente .Os jovens estão vivendo uma pressão muito grande, ao mesmo tempo que estão cercados por centenas de amigos nas redes sociais,Facebook,twitter, instagram e em vários grupos de whastApp sentem-se sozinhos e recorrem a grupos que estimula a acabar com essa solidão, induzindo esse jovem a ter coragem e acabar com a própria vida .Isso tudo são indícios para aqueles que estão próximo ficarem em alerta quando comportamentos diferente der sinal que algo não esta bem,que aquela pessoa necessita de ajuda.', 'Portanto preservar a vida é fundamental,esse aumento do ao alto índice de suicídio, deve incomodar a sociedade de um modo geral e trazer debates nas universidades,palestras com especialista na área da saúde,aproveitar os meios de comunicação com noticias, propagandas de uma forma que transmita um alerta e a importância da prevenção, incentivando o diálogo e a busca por um tratamento.']",120,160,120,120,120,640
93,Concepção,"['O romance ""memórias de um sargento de milícias"" configura um verossimilhante retrato da vida de diversas camadas sociais do Rio de Janeiro da época joanina. Dentre os arquétipos representados, destaca-se o da comadre do protagonista, cujo ofício de parteira lhe atribui certa relevância na comunidade. Contudo, no cenário obstétrico atual, o aumento de intervenções cirúrgicas, aliado à inocuidade governamental, gera um declínio dessa atividade tradicional, bem como fomenta um cenário nefasto para as parturientes. Logo, urge uma maior humanização durante os partos e o debate acerca dessa importante questão de saúde pública.', 'Em primeira análise, é importante ressaltar que o crescente número de procedimentos obstétricos, sobretudo as cesáreas, ocasiona o declínio da humanização durante a concepção. Nesse viés, faz-se imperiosa a perspectiva de Hipócrates- pai da medicina- que defendia uma racionalização do processo médico, aliado a um atendimento mais empático dos pacientes. Sob essa ótica, no mundo hodierno, nota-se o oposto dos ideais de Hipócrates, uma vez que o vertiginoso número de cirurgias obstétricas (inclusive ultrapassando o recomendado pela Organização Mundial de Saúde - OMS) retira a autonomia das parturientes e a aplaca a importância social das parteiras, consequentemente, desumanizando o processo de concepção .', 'Em segundo plano, salienta-se o descaso do poder público com essa significativa questão de saúde pública. Nesse sentido, consoante ao pensamento do filósofo inglês John Locke, o Estado- mediante um contrato social- deve garantir o direito de bem-estar social a todos os indivíduos. Por extensão desse raciocínio, no mundo contemporâneo, a vigência de embargos à autonomia feminina e ao ofício das parteiras contraria a perspectiva de Locke, uma vez que o governo não elabora ações e metas sociais para combater esses óbices e, por conseguinte, instaura uma realidade mordaz para as puérperas . Sendo assim, é inadmissível que o mundo hodierno- regido pela Declaração Universal dos Direitos Humanos- permita o padecimento de grande parte da população feminina, contrariando as concepções defendidas por tal acordo.', 'Portanto, urgem mudanças posturais do setor médico e do poder público. Para isso, o Estado deve criar programas de saúde pública , que estimulem a humanização do parto e promovam uma abordagem clínica mais empática desse procedimento . Isso ocorrerá por meio do maior repasse de verbas ao Sistema nico de Saúde (SUS) e da realização de debates entre médicos, parteiras e sociedade civil na busca por uma análise mais compreensiva desse processo. Desse modo, torna-se possível a humanização dessa questão de saúde pública.']",160,200,160,200,200,920
92,"Preconceito amarelo, uma discussão social","['Segundo a Organização das Nações Unidas para Educação, a Saúde e a Cultura – UNESCO: “o respeito as questões identitárias de um povo está circunstanciado no desenvolvimento socioeducacional da sociedade”. Dessa forma, na atualidade, devido pandemia do Covid-19, perpetuou discussões preconceituosas contra indivíduos asiáticos, culpando-os. Outrossim, por considerar um cenário de saúde pública o combate ao “preconceito amarelo” adentra numa resposta assistencialista, cuja educação formal possibilita reflexão ética e empatia ao próximo. Então, a reformulação da base curricular brasileira pode influenciar nesse impasse étnico. Além disso, as fake news – noticiais falsas equacionam desequilíbrios sociais por propagar assuntos errôneos e, consequentemente, pode prejudicar uma cultura.', 'Nessa abordagem, infere-se dimensionar, inicialmente, como o ensino configura ação responsável diante desses atos adversos, pelos quais taxam a população da China, por exemplo, como “fabricadores de vírus” ou espiões tecnológicos. Este último denunciado, sem comprovação, pelo ex-presidente norte americano Donald Trump. Sendo assim, o meio educacional ainda edifica solução viável para eliminar esse desrespeito. No entanto, no Brasil, principalmente, as escolas necessitam estabelecer disciplinas mais reflexivas e humanas, tais quais a filosofia, sociologia e a ética. É só por intermédio de uma base curricular humanística na qual a responsabilização cidadã efetivará moralidade e justiça a qualquer civilização.', 'Por conseguinte, observa-se uma problematização dessa situação quando as fake news – notícias falsas disseminam conteúdo sem veracidade. Tal exemplificação é o fato de ser compartilhado na internet a notícia de que o vírus –Covid19 foi criado em laboratórios do oriente ou que mercadorias advindas da China estão infectadas por patógenos. Logo, sendo o ciberespaço ambiente anônimo, muitas vezes, sem leis definidas, é preciso atenção e cuidado ao compartilhar informações.', 'Com base nessas considerações, o preconceito amarelo é combatido com soluções educacionais e atitudes éticas indivíduas . Para tanto, resoluções são imprescindíveis para resolver a temática. Isto posto, cabe ao Ministério da Educação – MEC, orgão responsável por políticas pedagógicas do país e de inclusão social,  propor, por meio da Base Comum Curricular da educação brasileira, a inserção de disciplinas humanas e de estudos-sociais, com ênfase na ética cidadã e no respeito à cultura alheia. Além de enrijecer o conhecimento pode esclarecer dívidas étnicas e, assim, criar responsabilidade e um país democraticamente correto.']",160,160,160,200,160,840
55,Valorização do Índio,"['No que se refere à importância de valorizar e garantir os direitos dos povos indígenas no Brasil é possível afirmar que o Estado brasileiro não valoriza e nem garante direitos a essa parte da população. Visto que, não há incentivo disseminação da cultura e da história aborígene brasileira, nem rigor no cumprimento de leis  que garantam a preservação dos territórios e das tribos que neles residem.', 'A cultura indígena brasileira não é suficientemente difundida, só se ouve sobre o índio quando se estuda a colonização do Brasil, em 1500 com ênfase principal no colonizador e não no colonizado. Tendo-se em vista que desde 2008 a Lei 11.645 torna obrigatório o ensino da cultura afro-brasileira e indígena no país, onze anos depois essa ainda enfrenta obstáculos para sua implementação . É inadmissível, que o Brasil tendo sua origem baseada no povo indígena, o Estado seja incapaz de garantir o cumprimento de uma lei fundamental para propagar a importância do nativo brasileiro na cultura e história do país.', 'Aliado a isso,  há a falta de comprometimento do Governo na preservação das terras e das tribos que nelas habitam, uma vez que o indígena tem seus direitos muitas vezes cassados em favorecimento ao agronegócio. De acordo o portal de notícias G1, em 2017 foi registrado oito casos de violência contra o patrimônio sem terras indígenas  no Mato Grosso  e 68 índios foram mortos por fazendeiros em todo o país. Tal panorama é inaceitável levando-se em consideração que a Carta Magna Brasileira promulgada em 1988 consagra direitos aos indígenas incluindo território, o Governo seja incapaz de garantir e preservar os direitos de tais povos.', 'Sendo assim, o Governo Federal deve ter mais empenho em cumprir as leis já existentes para esses povos, por meio da implantação definitiva no currículo escolar, da disciplina de história e cultura Afro-brasileira e indígena, com capacitação de professores e distribuição de material didático;  e punição criminal a todos que desrespeitarem a demarcação de terras indígenas. Espera-se com isso, preservar a cultura e o povo indígena  e disseminar sua importância para a construção da cultura e da história brasileira.']",120,120,120,120,120,600
62,O ódio na sociedade contemporânea,"['Antigamente, a questão do ódio na sociedade manifestava-se de maneira explícita, cujo o indivíduo demonstrava aversões ao outro, portanto, a vítima era submetida a perseguições cotidianas, algumas vezes até por motivos banais . Hodiernamente, isso não mudou muito, pelo contrário, as redes sociais tem favorecido o surgimento dos anonimatos, onde vítimas recebem desde ofensas até ameaças de morte sem saber quem ou por que dessa insistente perseguição. Perante a isso, qual seria a verdadeira motivação que instiga a prática desse crime?', 'Logo, é relevante analisarmos as causas desse problema contemporâneo, porém arcaico, pois o ser humano ainda não aprendeu a amar, muito menos promover a igualdade ao próximo . Para o filsofo francês Jean Jacques Rosseau, o homem nasce bom, mas a sociedade o corrompe . No entanto, desde pequenos, aprendemos  a odiar e rejeitar o que há de diferente, devido a convivência com os contextos históricos ao qual são estudados e a influência das pessoas que nos cercam , ou seja, s vezes a própria família torna-se culpada na criação de seus filhos, onde os jovens imitam o comportamento dos pais e aplicam isso na sociedade com atos preconceituosos, xenofóbicos e discriminatórios na internet, sem mesmo saber a causa que leva-o a ser intolerante.', 'Além disso, as novelas e propagandas publicitárias tem sido um grande problema, pois expõem as questões sociais de forma que prescinde de exageros, o que tornam-se consequências, tanto aos que acompanham e criticam na internet quanto aqueles facilmente movidos por influências provocadas pela mídia.', 'Sendo assim, as pessoas não tentam unir-se mais e criar dialógos convincentes em vez de conflitos e brigas nas redes sociais, aumentando assim,  as rivalidades com o outro . Dessa forma, julgar e humilhar não é o caminho a se seguir, muito menos apontar para quem está certo ou errado, pois enquanto o ser humano não mudar a sua racionalidade, jamais haverá igualdade no mundo moderno.']",120,120,80,80,80,480
63,Nem carrascos nem vitimas cidadãos consciêntes,"['As soluções para impactos ambientais causados voluntrias ou involuntariamente por grandes corporações chama-se fiscalização!  O Brasil não pode mais seguir com essa negligência na fiscalização pública . No dia 25 de janeiro deste ano, a barragem da Mina Córrego do Feijão se rompeu, matando centenas de pessoas e contaminando o Rio Paraopeba, um dos afluentes do Rio São Francisco. Os rejeitos devastaram a área administrativa da mineradora, incluindo o refeitório, onde muitos trabalhadores almoçavam na hora do rompimento. Pela segunda vez o Estado de Minas gerais e o Brasil choram seus morto, por negligência e ganância da mesma empresa a Vale.', 'Quanto vale uma vida? Um rio, uma flora, uma fauna, um sonho, uma família, uma cidade e um país? Não há dinheiro nesse mundo que possa comprar uma cola,  para colar os pedaços de tudo que essa grande tragédia deixa. Qual o preço da negligência alguém é capaz de calcular?  Não basta s leis, não basta punição, tem que haver fiscalização. O homem não pode seguir com o progresso, sem o compromisso de seguir pelo caminho certo, do cuidado com o planeta e seus habitantes. Duas tragédias seguidas de repercussão mundial e a mesma empresa. É o acaso? Falta de sorte? O processo civilizatório não aguenta mais amador. É preciso ser profissional, para que não aconteça tragédia em cima de tragédia e povo brasileiro se acostume a isso como se natural fosse.', 'A escravidão brasileira deixou sequelas profundas na população negra desse país e a ditadura militar deixou em toda sociedade. O brasileiro é um povo pacato e submisso aos poderosos, eles votam em pessoas para tirar seus direitos e assistem a tudo isso indignados e parados. O Brasil é hoje um dos países mais violentos do mundo. E o que o brasileiro faz? Vivem trancados em verdadeiros presídios, casas e prédios com muros altos, cercas elétricas, câmaras, cachorros e até seguranças armados. Tudo para manter sua integridade física, um direito garantido a todos os cidadãos de bem deste país pela Constituição Federal.', 'Entra governo e sai governo e nada muda! Será que a culpa é da politica ou da sociedade? Professores sendo massacrados como vilões da educação, brigando por um salário digno, sendo agredidos e ofendidos e a sociedade aceita. Será que realmente a culpa é dos políticos? Leis severas, punições e prisões nada disso mudará esse país se o povo não mudar. Só um povo consciente de seus direitos e deveres, mudará essa nação para sempre. Todo o mundo é composto de mudanças, tomando sempre novas qualidades. A solução está na mudança de todos. Nem carrascos  nem vitimas. Mas, cidadãos conscientes de seus direitos e dever.']",120,120,80,120,80,520
58,O último suspiro da Floresta Amazônica,"['Atualmente, o aumento do desmatamento aliado com o aumento no número de focos de calor população na Amazônia (Instituto Nacional de Pesquisas Espaciais - INPE) está preocupando todos os brasileiros, principalmente devido aos impactos gerados nos ecossistemas como liberação de dióxido de carbono na atmosfera, na morte da fauna e da flora, alterando a alimentação e geração de renda dos povos tradicionais . Além disso, isto representa a perda do potencial para desenvolvimento de medicamentos pela ciência. Além disso, a fumaça é responsável pelo aumento de problemas respiratórios entre jovens e idosos. A prática de queimadas ainda é recorrente, pois a população ainda acredita que as queimadas é a maneira mais rápida para abrir áreas e aumentar a produtividade agrícola.', 'Historicamente, o desmatamento é utilizado pelos povos tradicionais para implantação das suas roças. Além disso, em 1970, o Governo Militar incentivou a ocupação da Amazônia, principalmente de sulistas, com o slogan “Ocupar para não entregar”. Nessa época, na abertura de florestas utilizava-se o machado e posteriormente  esta área era queimada, pois acreditava que esta era a maneira mais rápida de abrir terreno e valorizar a propriedade. No entanto, esses ensinamentos foram passados para as próximas gerações, o que dificulta a redução destas práticas. Algumas creem que a fumaça afeta somente o outro e não a minha família.', 'Em pleno século XXI, existe o mito de que as cinzas favorecem aumento na produtividade agrícola, então será necessário aplicar menor quantidade de adubo na área. Porém, uma parte dos nutrientes permanece no solo e outra parte é volatilizada para a atmosfera e após três anos, a concentração desses elementos no solo reduz como consequência da colheita das plantas. Por isso, observa-se atualmente, um aumento na quantidade de áreas pastagens degradadas e propriedades subutilizadas.', 'Diante disso, conclui-se a queimadas e desmatamento é uma prática cultural brasileira. Portanto, recomenda-se que a Empresa Matogrossense de Pesquisa e Extensão Rural - EMPAER, órgão extensionista, elabore cursos práticos relacionados às técnicas existentes para aumentar a produção sem desmatar novas áreas. Além disso, o Instituto Brasileiro de Meio Ambiente e Recursos Naturais Renováveis - IBAMA deverá investir em fiscalização das queimadas no Brasil. Com isso impõe-se a sociedade um ambiente equilibrado e vida saudável  e também o dever preservá-lo para os presentes e futuras gerações.']",120,120,120,120,120,600
47,Desafios Enfrentados pelo Ensino EAD no Brasil,"['A Declaração Universal dos Direitos Humanos - promulgada em 1948 pela ONU (Organização das Nações Unidas) - assegura a todos indivíduos o direito à educação e ao bem-estar social. No entanto, na prática, tal garantia é deturpada no que tange à questão do sistema de ensino a distância no Brasil,que enfrenta diversos entraves para sua efetivação de forma eficaz nas escolas brasileiras. Dessa forma,evidencia-se a configuração de um grave problema de contornos específicos, devido não só à desigualdade no acesso à internet, como também à inexistência de processos pedagógicos específicos para o meio digital.', 'É relevante abordar,primeiramente,que a aquisição de internet para atividades a distância não se reflete de forma igualitária à população brasileira, promovendo assim,a persistência do problema. De acordo com Hannah Arendt, filósofa alemã, a essência dos Direitos Humanos é o direito a ter direitos. Todavia, esse pensamento está distante da realidade brasileira, uma vez que as pessoas localizadas em áreas rurais e periferias dos grandes centros urbanos , não usufruem de recursos tecnológicos primordiais para a realização das atividades EAD. Logo,é indubitável a mudança desse cenário alarmante.', 'Paralelo a isso,outro fator limitante é a falta de metodologias específicas para o mundo virtual .Conforme Zygmunt Bauman, sociólogo polonês, nenhuma sociedade que esquece a arte de questionar pode esperar encontrar respostas para os problemas que a afligem. Sob tal ótica, percebe-se que para o progresso da sociedade,é imprescindível o questionamento dos brasileiros sobre a ausência de atividades que sejam mais dinâmicas e interativas e, que motivem e melhorem o desempenho dos estudantes, sendo essas ideias, negligenciadas pelo Poder Estatal. Sendo assim,fica evidente que a omissão de projetos elaborados para a rede virtual só perpetua o problema.', 'Diante do que foi exposto,urge que o Governo Federal  - órgão responsável pelo bem-estar e lazer da população - deve criar centros tecnológicos informacionais, que contenham computadores e internet nos locais marginalizados das grandes cidades,como também nas áreas rurais afastadas dos grandes centros metropolitanos,por meio de verbas governamentais, com o intuito de tornar o estudo a distância possível e alcançável aos alunos brasileiros. Com isso,o que foi promulgado pela ONU será corroborado em todo território nacional.']",160,200,160,200,160,880
43,Julgamento virtual,"['O conceito de ""banalidade do mal"" da filósofa alemã Hannah Arendt afirma que quando uma atitude hostil é repetida com frequência, a sociedade para de vê-la como errônea. Atualmente, com o uso excessivo das redes sociais a ""cultura do cancelamento"" se tornou banal perante a sociedade. Dessa forma, o julgamento virtual é normalizado pela insuficiência na aplicação de leis e a distorção midiática.', 'Primeiramente, é necessário expor a impunidade da questão. De acordo com Thomas Hobbes é dever do estado garantir o bem-estar da população, o que não ocorre no Brasil. Nessa perspectiva, a insuficiência legislativa para crimes virtuais causa impunidade, pois o cancelamento em sua maioria oferece ofensas aos indivíduos ""cancelados"", sendo preciso mudanças para alcançar a idealização de Hobbes.', 'Ademais, é importante visar a distorção midiática como promotor do problema. Segundo Pierre Bordieu o que foi criado para ser instrumento democrático não deve se tornar mecanismo de opressão. Sob essa lógica, a influência da mídia eleva a propagação do cancelamento, pois sendo um tema polêmico a visibilidade em sites e redes sociais aumentam, retardando a solução para a problemática.', 'Portanto, medidas são necessárias para resolver o impasse. Para diminuir a troca de ofensas nas redes sociais urge que o Tribunal de Contas da União , forneça capital por meio do Ministério da Ciência e Comunicação para promover campanhas publicitárias nos principais meios de comunicação, visando combater o cancelamento em massa, além da Delegacia de Crimes Cibernéticos enquadrar ""o cancelamento"" como Cyberbullying quando houver ofensas redigidas. Espera-se assim, a diminuição da banalidade social do cancelamento.']",160,160,120,200,160,800
86,O problema do século XXI,"['Ultimamente nos dias de hoje, muitas pessoas não tem vida social .As redes sociais tomaram grandes proporções nas vidas de todos seres humanos.', 'Somos arrastados e devorados por essa pequena telinha que te permite dominar o mundo seja por bem ou mal. Crianças, adultos, idosos e principalmente adolescentes esqueceram o proposito da vida, com o passar dos anos tudo vai sendo esquecido.', 'A cada segundo ou minutos pessoas sofrem problemas psicológico por conta de uso abusivo das mídias sociais. Nesse meio você só é bemvinda por ter 1 milhão de seguidores, postar fotos lindas e vazar fotos prejudiciais a você mesmo. Hideraldo Montenegro nos deixou essa pequena grande verdade "" A internet é uma solidão dividida e uma fantasia compartilhada""', 'Usar a internet moderada é um direito de todos, porem pense antes de atingir uma pessoa com fake news e coisas prejudiciais a imagem dela, uma vida perdida doí mais que imaginamos.', 'Bullying, racismo ,preconceito, transtornos mentais, depressão e suicídio não são palavras bonitas de se ler.']",120,120,120,120,0,480
65,Sem educação nem tente,"['A criminalidade entre jovens no Brasil está muito longe de acabar. Enquanto a polícia for despreparada, opressora e seletiva. A justiça for morosa e os governos negligentes tudo continuará do jeito que está com perigo de piorar. Os delinquentes pobres são tratados como criminosos . Fazem o que bem querem com eles. Já os ricos são tratados com cortesia das autoridades. Em 1987, um estudante de direito, baiano, pobre e negro roubou um livro em uma livraria famosa. O dono chamou a policia, e sem processo nem condenação conduziu o delinquente ao presidio da Mata Escura em Salvador. Mesmo, ele tendo devolvido o livro e pedido desculpas.', 'O Caso teve uma grande repercussão da imprensa e sociedade, e a OAB Bahia entrou no caso e deixou o jovem em liberdade. Esse jovem teve ajuda, saiu de cabeça erguida seguiu seus estudos e hoje, é um grande defensor público das minorias. Mas,  quantos jovens nas mesmas condições cometem pequenos delitos e são amparados? Quantos? A sociedade é perversa!  Uma falta de compaixão pode estragar a vida de um jovem pra sempre. É preciso um novo olhar. Eles precisam de ajuda e não de criticas. Dentro de cada um existe o bem e o mal, cabe a cada um alimentar o bem para o mal não prevalecer.', 'A violência que hoje, assola o país é fruto do modelo de sociedade errada, que se criou no Brasil. E isso não tem nada a ver com falta de educação. É a falta de princípios, de exemplos e de estima. Quando a maioria da população era analfabeta o povo era menos violento e mais respeitoso. O numero de presos é alarmante e mesmo assim,  a violência não cessa. Agora, o novo governo quer liberar arma de fogo. Quem irá morrer? O rico? A policia pode abater qualquer um? O dever da policia é servir e proteger! E não abater. Matar é crime.', 'A resposta para o presente está no passado. O governo deve oferecer oportunidades para esses jovens,  e os pais devem cobrar responsabilidade, obediência e respeito. Em casa e na rua. Nos anos 60,70 e 80 os filhos tinham limites. É isso o que falta hoje. Esses jovens são frutos de uma sociedade machista, preconceituosa e injustas. Tem que transformar a sociedade. A violência não se combate com armas, é com livros que se muda o mundo. O governo deve ouvir e valorizar os professores, só eles podem com educação e planejamento fazer a transformação destes jovens, que estão transformados em carrascos e vitimas de si mesmos. Não existe problema sem solução, as, só existe solução com educação. A educação não deve ser considerada custo e sim um investimento lucrativo para o progresso e a paz de uma nação.', '.']",120,120,80,120,80,520
45,"Abuso de autoridade,um problema social","['O abuso da autoridade é uma ação humana de permanecer em cargos para fazer valer vontades em particulares, onde o agente atua com excesso de poder, ou desviar uma finalidade onde o agente usa indevidamente o poder para atingir um fim diverso que a lei lhe confere . Atualmente, o abuso de poder pode ser considerado um assunto conhecido devido ás situações que são vistas no dia a dia que tem dominado noticiários e redes sociais que faze recapacitar sociedade sobre a injustiça do poder autoritário que têm os agentes que ocupam um cargo considerável', 'De acordo com a Constituição Federal, todos são iguais perante a lei, mas, a ocorrência de numerosos casos de abuso de poder dão a impressão de que algumas pessoas são superiores a outras, observa-se casos onde pessoas são humilhadas, enquanto o abusador atua fora dos limites que a lei lhe permite ou evade a finalidade de esta, paralelamente,. Outra situação para ter em consideração em relação ao abuso de poder é o assédio moral no trabalho, onde os chefes expõem aos subordinados a situações que podem ser degradantes e repetitivas', 'Recentemente, ocorreu um caso em particular que gerou revolta em noticiários e redes sociais, o caso de George Floyd, um homem afro-americano que foi assassinado em Minnesota, Estados Unidos, por Derek Chauvin, que ocupava o cargo de policial naquele momento, na cidade de Minneapolis, Derek ajoelhou-se no pescoço de ele até a morte, enquanto Floyd estava deitado de bruços na estrada, o acontecimento mostrava a humilhação e crueldade dos atos, como resultado os policiais envolvidos foram demitidos no dia seguinte e a morte levou ao movimento ativista antirracista Black Lives Matter e algumas celebridades como Lady Gaga, Billie Eilish e Aidan Gallagher se manifestar pelas redes sociais também iniciou-se protestos e manifestações que no começo foram pacíficos, mas depois se tornou-se violentos com destruição de bens públicos e repressão policial.', 'Infere-se, portanto, que é preciso que o estado promova cursos sobre direitos humanos tanto nos novos ingressantes nas forças policias e militares, como aqueles que se encontram em função. É necessário, da mesma forma, educar no ambiente privado sobre assedio de todo tipo, tanto para funcionários como para chefes ou pessoal que tem funcionários a cargo . Com o propósito de evitar os casos de violência policial, o governo deve criar um organismo Independiente  sob o mando de pessoal civil trabalhando com equipes mistos de civis e policiais que se ocupem de controlar,  fiscalizar e investigar o acionar policial onde primeiramente, se afaste o suspeito e certificando-se o abuso, os responsáveis sejam punidos administrativamente.']",120,160,120,160,120,680
142,"""Correr atráz  de nossos objetivos""","['Geralmente confiamos trabalhos, como cuidar de um ferimento grave,         retirar a nossa ""dor de dente""         e ensinar nossos filhos a ler, a um profissional qualificado, ou seja, uma pessoa que tenha estudado muito para                 praticar                esses                 trabalhos                . Por isso o estudo é importante para se conseguir uma         carreira,         quanto mais conhecimentos procuramos ter, mais saberemos sobre nossa         areá         de                 trabalho                e mais as pessoas vão confiar em nós para         praticamos         o                 trabalho                que escolhemos, mas é claro, estudo não é tudo.         Pratica  , experiência         e para os mais                 religiosos                um ""tantinho de sorte"" são também                 ingredientes                de uma                 receita                para se ser um profissional ideal e ganhar bastante dinheiro. Mas o                 ingrediente                especial da                 receita         é         duas palavrinhas mágicas:                 ""Correr          atráz""         .', '""Correar atráz""         é a expressão certa. Tanto para uma pessoa com conhecimento escolar elevado quanto para um sertanejo sem estudos. No mundo         capitalista  que         vivemos, uns         perde         outros ganham, uns são ricos         outros         pobres, é assim que o                 capitalista                vive. Quer         disser         ,         você pode ser um gastronomico recém formado da         faculdade, com estudo elevado, mas não consegue arrumar emprego. Por que não consegue? A explicação é simples, existem mais de mil formandos em gastronomia na                 sua                frente, todos querendo um lugar no mercado de trabalho.                 Se é o senhor ou a senhora que está nessa situação,                a         única         coisa         que podes         fazer é                 correr atrás                desse lugar, ""lutar até ganhar a batalha"" e se tornar um chefe de cozinha.         Essas duas palavras         também explicam como as pessoas com poucos conhecimentos escolares conseguem um lugar bom no mercado de trabalho.', 'Todos sabem que uma pessoa que nasce em uma classe social baixa geralmente tem que ""lutar mais"" para elevar sua qualidade de vida. Já um universitário, com as contas         tudo         pagas pelos pais, tende a ficar mais tranquilo         perante o         sustento da vida. É por isso que grandes nomes que já foram de classe social baixa aparecem na mídia hoje, a exemplo do Silvio Santos que, com certeza,         ele correu atráz         uma qualidade de vida melhor,         então, ele consegui.', 'Estudar é um dos grandes         passo         para se tornar um profissional de nível superior, porém não podemos esquecer,         que se ficarmos parados e esperar         as oportunidades         ""caírem do céu""         nunca conseguiremos um         lugar, tao desejado, no         mercado de trabalho.']",80,160,160,120,160,680
90,Como combater transfobia no Brasil.,"['Na constituição federal de 1988 – documento jurídico mais importante do país- garante que todos os cidadãos são iguais perante à lei, independente da religião, etnia, condição social ou orientação sexual. No entanto essa perspectiva corrobora com a realidade, uma vez que a transfobia no brasil é um problema atual na nossa sociedade. Nesse sentido, vale destacar causas, consequências e uma possível solução para essa problemática.', 'Em primeiro lugar, a incompreensão da sociedade em respeitar a decisão do outro é causadora desse impasse. De acordo com o filosofo e escritor Denis Diderot, a ignorância é um dos maiores impasses para se alcançar a verdade, atrás apenas do preconceito. Com esse raciocínio, sintetiza no qual é o que acontece na sociedade atualmente, e essa ¨ignorância¨ é ocasionada pela falta de explicação sobre o assunto principalmente na área de ensino.', 'Outrossim, é notório a ineficácia do Estado em lidar com a minoria que necessita do amparo governamental. Segundo a ONG europeia , em nenhuma outra nação há tantos registros de homicídios de pessoas transgêneros quanto no Brasil. É lamentável ver o quanto vidas são interrompidas apenas por não seguir um padrão da sociedade, por ter suas escolhas e opções diferente da maioria.', 'Portanto medidas são necessárias para combater a transfobia no Brasil. Ademais fica nítido a responsabilidade do Estado em lutar contra a violência, por meio do poder legislativo, incluindo leis severas, com punições de multas e prisões contra qualquer ato de discriminação e preconceito. Além de incluir no meio escolar palestras para conscientizar os jovens a desconstruir um pensamentos preconceituoso que são passadas de geração a geraçõe. Só assim será valido  direito proposto pela carta Magna.']",160,120,120,200,160,760
50,Coronavírus,"['Em 1948, a Declaração Universal de Direitos Humanos (DUDH) reconheceu a saúde como um direito inalienável de toda e qualquer pessoa e como um valor social a ser perseguido  por todos. Trazendo  para a atualidade, percebe-se que a ciência exerce papel fundamental na garantia desse direito, já que é por meio desta área que várias descobertas são realizadas tanto como forma de prevenção quanto ao combate de diversas doenças , como a atual pandemia mundial, vírus Covid - 19. O Brasil passa por um momento de crise econômica, sobretudo na produção científica, devido ao contingenciamento adotado pelo governo federal atual.', 'Primeiramente, destaca-se a importância do isolamento social, como precaução, não somente no país de origem, mas também entre as nações, já que através da quarentena é possível restringir de maneira eficiente a contaminação entre a população. Sem a implantação dessa medida, percebe-se que o contágio tende a ser em maior proporção e com isso haverá dificuldade em administrar a situação, visto que o número de leitos nos hospitais não comportarão esse contingente. O país, acertadamente, conseguiu controlar a última pandemia, influenza A H1N1, entre os anos 2009 a 2010, adotando medidas preventivas,  através de estudos realizados a partir do ano de 2006. Diante disso, não houve muitos problemas em controlar a doença, pois já tinha tomado as ações necessárias ao combate do vírus.', 'Ademais, na contramão de uma solução atual , apesar de o Brasil ter diminuído os recursos na produção científica, cientistas locais estão interligados com outros no restante do planeta, com o objetivo comum de descobrir uma vacina para a cura do coronavírus. Pesquisadores da Universidade de São Paulo (USP), em parceria com a Universidade de Oxford, conseguiram sequenciar o genoma do vírus em 48 horas , essa descoberta foi fundamental para entender como se dá a mutação do vírus e como uma vacina pode ser criada para evitar ainda mais o contágio comunitário.', 'Em face dos aspectos apresentados, conclui-se que faz-se necessário ações políticas no sentido de fortalecimento da rede científica. Segundo a professora e pesquisadora da Fio Cruz, Deisy Ventura, “Um país Soberano precisa ter instituições de pesquisa fortes e valorizadas”. Portanto, cabe ao Estado, por meio dos Ministérios da Economia e da Saúde, os investimentos essenciais na área científica, aumento de profissionais e valorização desses. Além disso, é indispensável o alinhamento entre os Estados e Municípios, a fim de combater o Covid – 19 e possa ser garantindo saúde a todos, conforme reconhecida pela DUDH como um direito inaliável e valor social.']",160,160,120,160,120,720
54,Crise No,"['Vivemos em um mundo onde as modificações são constantes, onde as mudanças são para ontem e onde os nossos inimigos estão a espreita, acompanhando as evoluções da vida, prontos para nos atacar.', 'Quando tratamos do assunto vacinação vemos um grande exemplo da capacidade de conhecimento humana e suas inovadoras criações que visam sempre trazer melhorias e avanços tecnológicos no quesito de cuidados com a saúde.', 'Entretanto nos últimos tempos estamos vivendo uma crise no ""Sistema Vacinário\', aonde doenças quase extintas estão regressando com força total, levando pessoas a óbito e se espalhando de forma assustadora entre os Estados do nosso país.', 'Mas será isso hipocrisia humana? ou o governo não presta os devidos serviços para conscientização das pessoas em relação a proteção de sua própria saúde?', 'Digamos que ambos tem parcela de culpa nesse caso, pois muitas das vezes os que nos representam nos autos cargos políticos não proveem o necessário para á imunização e seu alerta mediante a uma população que não cumpre o seu dever como cidadão, que simplesmente é buscar sua proteção conta ""agentes"" biológicos ofensivos.', 'Para sanar esses problemas devemos nos conscientizar através de campanhas púbicas e se mobilizando nas escolas fazendo com que os mais jovens sejam esse canal de comunicação e conscientização, para assim dizimar essas doenças que tanto nos assolam e nos abala de forma física e emocionalmente.']",120,80,80,80,40,400
82,Consultar o médico é o melhor remédio,"['A automedicação é a utilização de medicamentos por conta própria ou por indicação de pessoas não habilitadas,   para tratamento de doenças cujos sintomas são percebidos pelo usuário sem a avaliação prévia de um profissional de saúde. É uma prática bastante comum,  adotada pela grande maioria da população.', 'O Sistema Único de Saúde não garante aos cidadãos um acompanhamento regular nem preventivo, e nem mesmo nas emergências o atendimento é eficaz. A dificuldade de acesso das pessoas aos meios de saúde e a facilidade da indústria farmacêutica em vender seus produtos,   influenciam a procura de formas alternativas de tratamento, como a utilização de medicamentos sem a orientação de um profissional habilitado.', 'Os medicamentos que são alvos principais da automedicação estão destinados a aliviar incômodos comuns, como dores leves, febres moderadas, gripes e certas perturbações digestivas. A automedicação não pode ser considerada um ato estritamente reprovável, pois cura situações ligeiras de doenças em que a não utilização de um serviço de saúde reduz os custos e a perda de tempo. Além disso, os profissionais de saúde são liberados para tratamento de situações clínicas mais graves.', 'No entanto, o uso de remédio sem orientação médica pode agravar uma doença, uma vez que a utilização inadequada pode esconder determinados sintomas. Ademais, isso pode causar outros sérios problemas de saúde, como reações alérgicas, intoxicações e até dependência química.', 'Portanto, a consulta médica deve sempre ser a principal opção. As políticas públicas utilizadas pelo Estado devem incentivar a prevenção de doenças, a contratação de mais médicos para diminuir o tempo de espera da consulta e a promoção de campanhas educativas alertando para os riscos da automedicação.']",160,160,160,160,160,800
63,,"['Atualmente, no Brasil, ocorreram duas grandes tragédias ambientais, as quais abalaram a população. Presenciou-se os desastrosos rompimentos das barragens da mineradora Vale de Mariana, em 2015, e de Brumadinho, em 2019. Esses melancólicos acontecimentos evidenciaram a complexa situação do país, em que, apesar de a legislação estabelecer punições aos criminosos ambientais, assim como fiscalizações regulares a áreas de risco, o que se observa na prática é uma negligência governamental e uma imunização de grandes corporações.', 'Segundo o artigo 225, inciso 3, da atual constituição brasileira, empresas e agentes que lesam o meio ambiente estão sujeitos a punições já pré-estabelecidas. No entanto, situações como a da empresa Vale, evidenciaram uma escassa atuação do governo nesse quesito, visto que não puniu adequadamente os agentes causadores do crime ambiental. Nesse contexto, a consolidação de ações que poderiam coagir essas grandes empresas não ocorre, fragilizando a situação do país.', 'Além disso, a elevada participação de grandes corporações no PIB (Produto Interno Bruto) brasileiro fomenta seu poder de barganha frente ao Estado, o qual fica sujeito aos interesses dessas empresas. Caso não atenda a suas vontades, o governo é ameaçado de perder o investimento de capital produtivo oriundo delas, assim como sua saída do território, o que prejudicaria não só o PIB, como geraria desemprego e poderia resultar em uma crise econômica . Diante disso, essas grandes corporações determinam limites econômicos e ambientais razoáveis aos seus interesses, contornando a legislação.', 'Tendo em vista essa dificuldade em combater os desastres ambientais causados pela ação de grandes corporações no Brasil, deve-se buscar soluções para o problema. Para isso, o governo pode, por exemplo, reforçar o cumprimento da legislação, visando, assim uma maior segurança e controle em relação aos possíveis desastres ambientais. Ademais, ele pode, também, diversificar os investimentos estatais para, assim, diminuir a dependência do PIB nacional em relação às grandes corporações e poder impor a legislação de maneira adequada a elas. Agindo dessa maneira, será possível a manutenção de, como apresentado na canção de Jorge Ben Jor, um país tropical e bonito por natureza .']",160,200,160,160,160,840
90,transfobia,"['Durante está pandemia temos bastante tempo para pensar, em qual faculdade devo fazer? qual carro ou moto devo comprar?,temos tempo para pensar em qual procedimento estético queremos fazer primeiro,qual religião seguir,qual e a minha sexualidade? Quando entramos neste assunto muitas pessoas se fecham, outras já são mais rígidas devido a sua criação. Nasceu mulher vai morrer mulher,nasceu homem,homem morrerás .Infelizmente as pessoas transgênero sofrem com este preconceito que a sociedade impõe,onde chegam são motivos de comentários maldosos,as pessoas transgênero sofrem até mesmo para arrumar um emprego por conta da sua sexualidade,são discriminadas pela sua escolha de sexo, estas pessoas sofrem bullying agressões físicas e verbais. Mesmo com a lei implantada para proteger as pessoas trans, há um número de assassinatos,violencia muito auto. Temos que ter mais compaixão e respeito com o nosso proximo, para vivermos em paz.', 'Devemos respeitar as escolhes e sexualidade de cada um.']",160,80,80,80,0,400
148,Avançar para realizar.,"['É                 plausível,         que         com o avanço da tecnologia e                 conhecimento da sociedade                , a viagem para Marte não seja totalmente uma alucinação. Como                 descrito                no artigo da         Folha de São Paulo         , é necessário ainda muito tempo para que seja realmente algo a ser colocado em prática, mesmo que para NASA.', 'O projeto MARS ONE tem uma proposta ótima, levando em conta                 que de pouco a pouco                , povoaríamos outro planeta, conheceríamos outro tipo de                 vegetação, habitat                e nos adaptaríamos a outros modos de vida e sobrevivência.         Porem         , como poderia o ser humano viver em um planeta com o meio ambiente tão hostil, como também relatado na         Folha de São Paulo         , com temperaturas médias de -63ºC e com falta de         oxigênio         .', 'É necessário ainda pesquisas         , obter informações, conhecer outros planetas, para que realmente possa         se         diagnosticado um local                 adaptável                , para que o ser humano possa sobreviver bem, saudavelmente e para o resto dos seus dias já que é uma viagem só de ida, por conta da                 taxa para financiar o custo do projeto                que         chega a ser em cerca de R$ 15 bilhões         .', 'Concluo que no fim das contas a ideia é valida, mas ainda temos que aperfeiçoá-la muito para um feito de tamanha proporção. É algo que exige tanto a evolução da tecnologia, quanto do ser humano para                 habitação e adaptação                em outro planeta. Mas vale a                 brincadeira                e a expectativa para quem sabe em um futuro próximo, possamos                 idealizar                esse feito.']",80,120,120,120,120,560
38,Tratamento que cura,"['A saúde pública é um bem que todos presam, a notícia da antecipação do circulamento comercial de medicamentos sem comprovações para o câncer, que antes não tinha tratamento é um despreparo do governo brasileiro, mas também pode ser a solução de muitas famílias que carecem de cuidados.', 'O que diz respeito ao despreparo do governo brasileiro, este aprovou a circulação de medicamentos para o câncer, que ainda não passou por seus devidos testes e comprovações o que pode comprometer na', 'Em relação às famílias que carecem de uma solução à doença, esta pode ser uma iniciativa aos resultados de estudos feitos para o tratamento voltado ao câncer, que infelizmente atinge a população.', 'Com isso o governo federal deveria investir mais na saúde pública, beneficiando a todos de forma igualitária com um tratamento eficaz.']",80,80,0,80,0,240
87,A cultura da erotização infantil,"['No episódio “Blame It On Lisa”, “Os Simpsons” - famoso desenho animado americano –, pela primeira vez, vêm ao Brasil. Entretanto, o jovem Barth Simpson é instigado pela programação infantil televisiva brasileira sob a custódia de uma apresentadora que usa trajes vulgares para chamar a atenção dos seus telespectadores. Esse episódio é de 2002 e essa crítica se refere a gama de erotização que existia nos programas infantis das décadas de 1980 e 1990 – como os programas da Xuxa, por exemplo. Paralelo a isso, atualmente, a erotização infantil se torna mais evidente de acordo com vários veículos midiáticos que permeiam a vida desses indivíduos. Nesse parâmetro, vale ressaltar como que as mídias e a sociedade contribuem com a cultura da erotização infantil, a fim de propor intervenções para mitigarem essa problemática social.', 'Em primeiro plano, a mídia contribui bastante para a cultura de erotização infantil. Consoante a isso, diante da era digital vigente, as crianças possuem um enorme acesso a veículos digitais, como celulares, tabletes e televisores, em que se torna nítido o contato delas com conteúdos que podem instigar, precocemente, a sua sexualidade. A título de explicação, com o auxílio dos meios tecnológicos, como as redes sociais, as crianças podem copiar comportamentos adultos – roupas, relacionamentos amorosos, estilo de vida - que ainda não condizem com a sua faixa etária e, com isso, ocasionar a uma adultização; além disso, elas podem ter fácil acesso às mídias pornográficas em virtude de vários sites disponíveis gratuitamente no Google, por exemplo. Logo, sem um controle efetivo dessas mídias digitais, elas podem aumentar a forte cultura da erotização infantil que está evidente no Brasil do século XXI.', 'Em segundo plano, a sociedade atual também contribui com a erotização infantil. Nesse sentido, diante de uma sociedade gerida por uma modernidade líquida - conceito atribuído ao filósofo Zygmunt Bauman – cada vez mais os relacionamentos humanos são instruídos pela superficialidade e normalização do que outrora era inadequado. Assim sendo, essa liquidez permeia a erotização infantil, pois há uma banalidade na forma como as crianças devem se comportar. Diante disso, como exemplo, muitos cantores mirins são aplaudidos pela sociedade ao cantarem músicas com forte conotação sexual e/ou ultrarromânticas . Em síntese, esses comportamentos dessas crianças são inadequados para a suas idades, porém ganha forte legitimação social, sendo assim vistos como normais.', 'Verifica-se, portanto, que a erotização infantil tem grande apelo das mídias e da sociedade. Dessarte, as escolas, instituições responsáveis pela educação formal, por meio de profissionais aptos, como psicopedagogos, devem implementar a Educação Sexual para os seus discentes, com o fito de educar as crianças sobre os danos da erotização infantil para a sua vida social e psíquica. Somado a isso, o Estatuto da Criança e do Adolescente (ECA), principal marco legal e regulatório dos direitos das crianças e dos adolescentes no Brasil, por meio de parcerias com as mídias digitais e televisivas, deve elaborar propagandas que visem informar a população sobre os danos da cultura da erotização infantil presente nas mídias e reforçado pela sociedade. Isso posto, com essas medidas, a cultura da erotização infantil seria cerceada no Brasil.']",160,160,160,200,200,880
37,Medo x Proteção,"['Em pleno o século xxi o estrupo ainda acontece com frequência. Sabendo disso, muitas mulheres sofrem caladas e, consequentemente, não procuram denunciar o agressor.', 'Nesse sentido, cerca de 35% dos casos de estrupo são notificados no brasil , mas 65% ficam em oculto de acordo com a revista Época. Dessa forma, por falta de proteção e medo, acaba que prejudicando as investigações.', 'No entanto, sabe-se que esse tipo de agressão provoca danos físicos, psicológicos e problemas em algum outro relacionamento. Por isso, não se pode deixar que a sociedade conviva com esse tipo de violência, principalmente com crianças, adolescentes, jovens e mulheres.', 'Contudo, faz-se necessário que o governo aprove uma lei, afim de punir aqueles que realizar realizarem o estrupo . Além disso, na tentativa de conscientizar, o MEC (ministério da educação ) deve organizar palestras nas escolas, com o objetivo de educar os alunos a não praticar esse mal. A final, como afirmou Immanuel kant ""o homem é aquilo que a educação faz dele"".']",120,120,120,120,120,600
23,Informação é Meu Direito,"['Nobre deputado , o projeto PLC número 34 é um atentado contra o meu direito de informação, que é assegurado no Código de Defesa do Consumidor por meio dos artigos: Seis, Oito e Trinta e um. Que prevê que a composição do produto deve ser informada de maneira adequada e clara e que também estipula proteção à vida, à saúde e à segurança, expressando de forma clara e objetiva os riscos existentes no produto.', 'O uso de alimentos transgênicos pode apresentar uma economia para os grandes produtores de alimentícios transgênicos e um maior lucro para a engenharia genética que é responsável pela mutação dos alimentos . Mas, também existem desvantagens que não são vistas a pequeno prazo, como o aparecimento de doenças em quem consome alimentos transgênicos, semanalmente ou até mesmo diariamente. Além dos danos causados ao meio ambiente. Fica então a certeza. Busca ascensão econômica em detrimento da saúde é algo perigoso, que não é sentido agora. Mas, futuramente será facilmente notado.', 'A população brasileira não tem o habito de lê os rótulos de produtos durante suas compras. Fica então claro que é necessário um aviso de grande visibilidade como, atualmente', 'É necessário pensa na população, respeitas os direitos já conquistados, respeita o Código de Defesa do Consumidor. Leis devem existir para garantir avanços e não retrocessos. Fica claro que é necessário de fato pensar com a cabeça, ou melhor, com o cérebro e jamais com os bolsos.']",160,160,160,160,80,720
79,Reformas Já,"['O sistema penitenciário surgiu como uma alternativa à pena de morte e castigos violentos. Entretanto, seu objetivo de ressocializar o preso distancia-se da realidade. Segundo José Eduardo Cardozo, ex-ministro da justiça, os presídios apresentam características medievais. Esse quadro precisa ser revertido para o bem dos brasileiros.', 'Sabe-se que agentes das cadeias não estão preparados para trabalhar com os detentos. Assim, chutes, tapas e outros tipo de agressão física tornam-se comuns. Segundo dados do ministério da justiça , dois em cada três presidiários são negros e a maioria possui baixo nível de escolaridade. Mediante isso, percebe-se o círculo da marginalização.', 'Outro aspecto relevante é que pessoas ainda não são julgadas ocupam os mesmos presídios. Isso corrobora para a superlotação das celas e o recrutamento de indivíduos para o crime organizado. Esse problema transcende o cárcere e atinge a sociedade. Logo, os assaltos e o tráfico de aumentam significativamente.', 'Em suma, o estado no qual se encontram as prisões não pode ser negligenciado. Para tentar reverter a situação, os Estados poderiam desenvolver cursos para treinar os agentes, criar telefones para denunciar abusos de poder de forma anônima e construir de novos presídios para remanejar as pessoas que ainda não tiveram seu julgamento. Já as escolas, desenvolver palestras para conscientizar ás crianças desde pequenas de que o crime não compensa. Quem sabe, assim, os direitos humanos serão respeitados e haverá mais segurança no Brasil.']",160,160,160,160,160,800
51,Analfabetismo,"['De acordo com uma pesquisa realizada pela Pnad,o índice atual de analfabetos no país corresponde a 93,2%,dado que pode ser considerado elevado e que mostra que muitas pessoas não sabem ler ou escrever até mesmo textos simples.', 'Em primeira análise,os fatores que impulsionam a esse número de analfabetos são diversos,porém, valem ser lembrados aqueles que mais causam o abandono da escola,como por exemplo,o ensino básico de baixa qualidade que ocasiona em uma desmotivação do estudante  e consequentemente levando-o ao abandono escolar .Por conseguinte, têm-se pessoas com baixo senso crítico,ou seja, não procuram se questionar sobre assuntos do seu redor ou até mesmo do mundo .Logo,fica claro a dificuldade que esses indivíduos terão de enfrentar para conseguir um bom emprego, em virtude de não saberem interpretar textos ou fazerem contas básicas.', 'Em síntese, faz-se necessário diminuir o percentual de analfabetos funcionais consideravelmente. Para isso, é mister que o Ministério da Educação (MEC) por meio de políticas públicas ofereça oficinas ou cursos de leitura e interpretação,no intuito de dar continuidade ao aprendizado daqueles que acabaram não concluindo a vida escolar. Ademais,o incentivo da família é de suma importância,já que possui uma grande influência sobre os filhos. Pois já dizia Paulo Freire "" A educação,qualquer que seja ela,é sempre uma teoria do conhecimento posta em prática "".']",120,120,80,120,120,560
125,Legalizar e a abertura de diversos problemas,"['Na         conjutura atual         o uso de drogas         e          recorrente em muitas          familias         brasileiras, devido ao acesso         da         maconha                 em lugares de poucas fiscalização                e em festas, fazendo com que         esse consumidores  tenha         a dependência dela, mas ela         têm         suas vantagens na área da saúde.                 Assim sendo que a maconha é um incetivo para o uso indevido de outras drogas.', 'Convém observar que os jovens estão usando drogas cada vez mais tóxicas e também,         mais cado, sobre         influência de amigos e                 próprios familiares. Cabe ressaltar que a maconha é uma alternativa para algumas doenças a exemplo de alzheimer, câncer, dores musculares, entre outras. Isso indica que a maconha é          necessaria          para o tratamento desses doenças, entretanto dever ser usada com o          auxilio          de um médico.', 'Entretanto se essa droga         ser         usada de modo indevido pode levar a pessoa a uma dependência química,         na qual         acarreta         varios problemas         tanto na vida do dependente         e na familia         . Com o         vicio          ele vai se aprofundando em outras drogas até chegar ao crack.', 'Torna-se evidente, portanto, que         legaliza-la         não         e         apropriado, pois gera problemas sociais. Dessa         forma         a fiscalização é         necessario         para que a maconha não         chegar         nas mãos de jovens, e que haja uma educação         domestica         , para que esses não         caia         em um mundo sem volta.']",80,80,80,80,80,400
78,revoluçao do conhecimento,"['A chamada Terceira Revolução Industrial ou Revolução Informática provocou rupturas na organização social e política do mundo contemporâneo . Os avanços tecnológicos na área da informação e da comunicação têm provocado uma rápida superação dos conhecimentos e coloca para os educadores uma questão decisiva: para que serve a Educação, nesta sociedade, se forem mantidos o mesmo padroes de trabalho, os mesmos procedimentos docentes .', 'Por isso que a reforma do ensino médio é tão importante pois,  traz novas diretrizes de ensino que o governo planeja implementa através de uma medida provisória . om isso esperam atrair e manter os jovens nas escolas , mas essa reforma deve ser feita de maneira cautelosa para não trazer mais prejuízos ao ensino brasileiro', 'por tanto antes da unificação da 13 matérias que serão compostas nas áreas de matemática, linguagem, ciências humanas e ciências da natureza  o governo devera fazer debates entre aos alunos e os professore de modo que aperfeiçoe o projeto']",80,80,80,80,80,400
69,O uso de agrotóxicos no Brasil,"['Funcionando como a segunda lei de Newton, um corpo tende a permanecer do jeito que está, até que uma força atue sobre ele, o uso de agrotóxicos no Brasil é um problema que persiste na sociedade brasileira há algum tempo . Com isso, ao invés de funcionar como uma força suficientemente capaz de mudar o percurso desse problema, da permanência para a extinção, a combinação de negligencia governamental com a falta de cuidado humano, acabam por contribuírem com a situação atual.', 'Em primeiro plano, a negligencia do governo, contribui com esse impasse, já que não determina leis que possam acabar ou diminuir essa dificuldade , ao invés disso querem é afrouxar as poucas leis que existem. Por conseguinte, muitas pessoas estão contraindo doenças, como por exemplo o câncer e muitos chegam até a morrer.', 'Outro plano relevante, é a questão da falta de cuidado humano, que no caso já que o uso dessas substancias são usadas nas lavouras em questão de proteger os alimentos e assim deixar distante e matar os insetos , acaba por prejudicar a saúde das pessoas, contaminar o ar, o meio ambiente, o solo e a água.', 'Portanto, fica evidente diante de tantos problemas causados, a necessidade de uma tomada de medidas que realizem mudanças,  Ministério da Agricultura deve orientar o uso e selecionar o produto de forma certa a plantação, sendo este fiscalizado pelo Ministério da Saúde que deverá dar apoio a saúde da população e animais utilizados para a alimentação, o Ministério do Trabalho deve fiscalizar os trabalhadores para que eles recebam o treinamento adequado, o Ministério do Meio Ambiente deverá monitorar a fauna e flora. E como já disse Immanuel Kant , o ser humano é aquilo que a educação faz dele, e o Ministério da Educação pode inserir este tema em debate com alunos e população.']",120,120,120,120,120,600
51,A educação e seus caminhos contra o analfabetismo funcional no Brasil.,"['No livro ""Cidadão de Papel"", de Gilberto Dimenstein, é mostrado a correlação entre o analfabeto funcional e a falta de liberdade acerca do seu papel como cidadão, que é causado pela pouca informação ao qual ele tem acesso . Nesse sentido, o analfabetismo funcional no Brasil traz sérias consequências para o país, tais como a desinformação e problemas sociais, reflexo de anos de educação falha e negligências nesse setor.', 'Uma das vertentes dessa problemática é a falta de informações que tais indivíduos estã acometidos, comprometendo seriamente suas escolhas perante assuntos de natureza política, pois é mais difícil avaliar propostas e perceber contradições, sendo assim, isso afeta de maneira significativa no resultado de eleições e afins.', 'Em um país onde há milhões de analfabetos acima dos 15 anos de idade percebe-se que existe uma educação falha , logo, há problemas que são desencadeados , contribuindo para baixos indicadores sociais e afetando, de certo modo, a economia da nação, pois a situação em áreas socias em um país revela a situação real em que ele se encontra política e economicamente.', 'Como forma de amenizar tal cenário, o governo deve realizar investimentos na educação básica que estimulem o pensar e a criatividade através de novos métodos de ensino , pois como diz Gilberto Dimenstein ""se um país é a árvore, as crianças são os frutos"". Ademais, deve também promover campanhas publicitárias que incentivem jovens e adultos a lerem, para que dessa forma possam desenvolver suas ideias e pensamentos. Ainda nessa perspectiva, os empresários, juntamente com o governo, devem realizar projetos que estimulem a leitura em suas empresas como forma de disseminar tal hábito, contribuindo de maneira idônea contra o analfabetismo funcional no Brasil.']",160,160,120,160,160,760
82,O uso indevido de medicamentos,"['Automedicação é o consumo de medicamentos sem prescrição médica e é uma prática que pode ser bastante perigosa para a saúde. Apesar disso, é algo muito comum no Brasil,  segundo dados do Jornal Nacional, 72% dos brasileiros se automedicam. ', 'Esses altos índices são reflexos da burocracia para se conseguir uma consulta no Sistema Único de Saúde (SUS),  que leva as pessoas a buscar soluções mais rápidas para a dor. Dentre  aqueles que se automedicam, 40% pesquisam remédios na internet por ser mais fácil e prático.', 'Porém, esse uso indevido de remédios causa muitas consequências   como intoxicação e alergias.   Ou até pior,  pode camuflar uma doença grave, por amenizar os sintomas, mas não tratar a causa do incômodo.', 'Além disso, é necessário compreender que se a automedicação é tão comum, é devido à falta de fiscalização na venda de remédios. Há muitos atendentes e farmacêuticos que vendem medicamentos tarjados sem prescrição médica, apesar de serem proibidos por lei.', 'Portanto, a automedicação é uma prática que deve ser combatida. Em primeiro lugar, por meio de uma maior fiscalização e controle de estoque do remédio das farmácias, com um sistema eletrônico monitorado pelo Ministério da Saúde. Também é preciso facilitar o acesso a  consulta pelo SUS, com mais postos de saúde e médicos.   Pois, com um atendimento cuidadoso, exames médicos e uma prescrição correta de remédios, as pessoas poderão resolver seu incômodo ao invés de piorá-lo.']",120,160,120,120,200,720
49,Influencia da tela,"['O quadro ""Opérario"" da artista plástica Tarsila do Amaral, retrata vários rostos de brasileiro e estrangeiro, dessa forma é possível interpretar a adeversidade de pensamento e influencia que cada pessoa pode ter em um grupo social. Nesse sentido, a popularidade de um cidadão na web é evidenciada pelo número de seguidores, no Brasil os formadores de opinião utilizam da internet para construir uma ligação com o público . Contudo, essa construção  torna-se perigosa no âmbito informativo e também na influência dos jovens do país,o que, causa um problema na sociedade.', 'Em primeiro lugar, com o avanço da net pessoas anônima revela-se referência nas redes socias, tais como Facebook,Instagram e YouTube, essa interação dar-se através de assuntos publicados pelo influenciador digital como política, por exemplo. Ademais a população tem que interpretar bem os contedos apresentados para não forma opinião baseado em potências ""Fakenews"" . Segundo o filósofo John Locke, o desenvolvimento humano monta a personalidade a parti de suas experiência, nesse raciocínio, tal celebridade virtual precisa ter cuidado ao notíciar informação, pois tem o papel de contribuir com o caráter do cidadão, indo de encontro com a ideia de John Locker. Então, fica claro o cuidado na divulgação de imformativo para grande massa.', 'Em segundo lugar, o dominio sobre o pesamento do adolescente por meio dos influencers, despertou o interesse de empresas como Nike e Adidas nesses lideres virtuais para divulgar seus produtos, levado pelo alcance nacional e a popularidade de transforma comportamentos, cria uma relação influenciadora com a juventude ditando moda e estilo de vida, isso relata o contextualização da pintura ""Opérarios"" .Desse modo, é necessrio que a população tenha uma reflexão critica sobre os conteúdo recebido na web, para não entrar na mira do marketing ,que muitas vez, abandona a ética na busca do consumo.', 'Portanto, o Ministério da Cidadania crie , por meio de verba governamentais, campanha publicitaria na redes socias e televisivas com Globo,SBT e Band, que detalhem a importância de ter o hábito de pesquisar em diversas fontes e saindo  da bolha que vive , isso aumenta o conhecimento pessoal com experiência destinta, o que leva ao desenvolvimento de Locke .Além disso,a comunidade apresenta-se com intelector racional para decidir o que é melhor para sua liberdade.']",120,160,120,160,120,680
97,Todos por um.,"['O povo tem perdido o medo de lutar por seus direitos e não         serem ouvidos, sendo         assim,                 organizão                manifestações com grande quantidade de pessoas e                 saem                para as ruas, porém,                 muitas vezes                tais manifestações                 nem sempre                são organizadas o bastante e acabam gerando confusão ao invés de conquistarem os anseios dos cidadãos.', 'Em todos os casos, a fiscalização da         policia         é fundamental,         pois         dentro desses movimentos, também existe a penetração de vândalos, que acabam                 digredindo                o patrimônio publico e também a imagem de um povo lutando por seus         direitos, são         momentos         onde         os policiais precisam interferir muitas vezes excedendo o seu poder e agindo violentamente com tais manifestantes.', 'Na maioria das vezes, o povo luta pacificamente e a         policia         apenas fiscaliza para o bem da sociedade, porém quando as autoridades         são deparadas por         imprevistos,                 muitas vezes despreparados belicamente em uma porcentagem muito mais inferior do que as próprias gangues e vândalos                , são         obrigados         a partir para a agressão com o intuito de acabar o mais breve possível com         os manifestos e         riscos ao patrimônio         publico         .', 'Se desejamos lutar por nossos direitos, é necessário que antes de qualquer ato de manifestação, haja                 conscientização, de sair as ruas com um          alvo         , e um         alvo         que gere paz. Para a         policia         , preparação e respeito, e ao         governo         que muitas vezes ordena aos policiais a agir         bruscamente         , que possa ouvir a voz do povo, ao invés de apenas querer acabar com         os manifestos         rapidamente sem que o problema seja resolvido. A realidade é que se desejamos viver em uma sociedade         pacifica         , todos devemos agir cooperando para a realização         desta ideia         ,                 afinal todos juntos formamos apenas uma população, a população Brasileira, e toda melhora, resultará na melhora de todos!']",120,120,80,120,120,560
90,Caminhos para combater a transfobia no Brasil,"['Os transgêneros enfrentam diversos obstáculos para se inserirem na sociedade brasileira, visto que, conforme dados da Associação Nacional de Travestis e Transexuais(ANTRA), cerca de 90% das travestis e transexuais usam a prostituição como fonte de renda. Nesse contexto, a falta de acolhimento da família e o preconceito nas instituições de ensino dificultam a ascensão dessa população e a sua representatividade nos diferentes espaços e, por conseguinte, acarretam a permanência da transfobia e da marginalização desses indivíduos. Logo, medidas devem ser tomadas, a fim de combater esse preconceito e facilitar a inclusão dessa comunidade.', 'Nesse âmbito, diversas vezes, a discriminação começa a aparecer no ambiente familiar que deveria ser um espaço de acolhimento. Como resultado, várias pessoas que possuem uma identidade de gênero diferente do sexo atribuído são expulsas de casa e encaram bastantes desafios para a sua sobrevivência. Prova disso é a ovem Patrícia Borges que foi banida da residência da sua família aos 13 anos, em razão de ser trans. Nesse sentido, é necessário desenvolver uma maior tolerância dentro desse meio.', 'Além disso, em virtude do enorme preconceito nas escolas, inúmeros transgêneros abandonam os estudos e, por consequência, encaram várias barreiras para ingressarem no mercado de trabalho e acabam na prostituição, tendo sua imagem marginalizada. Segundo dados da Rede Nacional de Pessoas Trans do Brasil(RedeTrans) 82% das mulheres transexuais e travestis abandonam o ensino médio, devido à discriminação. Nesse contexto, deve-se criar condições para a permanência desses cidadãos no meio acadêmico.', 'Portanto, embora não haja soluções imediatas para esse problema, torna-se indubitável que a transfobia precisa ser combatida. Nesse sentido, cabe ao governo, em parceira com o Ministério da Educação, diminuir esse impasse . Para isso, esses agentes devem contratar psicólogos para fornecer palestras sobre esse tema e oferecer auxílio aos transgêneros, com o intuito de diminuir o preconceito na família e nas instituições de ensino e amparar as vítimas, além de ofertar bolsas para esses indivíduos, com o intuito de diminuir a evasão escolar. Assim, a transfobia será um mal cada vez menor na sociedade.']",160,200,160,200,160,880
82,,"['Um perigo cada vez mais comum e ignorado pela população é a automedicação   que disfarça problemas de saúde, pode causar intoxicações, paradas cardíacas   podendo ser fatal em alguns casos, desse modo, a medicação sem prescrição médica deve ser abolida.', 'Os defensores da automedicação alegam que o SUS sofreria uma lotação maior do que a decorrente por pessoas com quadros triviais se a mesma  não fosse praticada, no entanto, existem situações em que problemas considerados corriqueiros caracterizam graves doenças, nesse caso, a automedicação pode evitar o descobrimento da doença e agravá-la. Aliado a isso, existe uma lista de remédios cuja compra é considerada pela ANVISA como isenta de prescrição médica,  seu uso não caracteriza automedicação, pois são considerados pela OMS como remédios para autocuidado   não oferecendo risco ao paciente, assim, para uso de remédios não inclusos nessa lista   deve-se consultar um médico.', 'Além disso, o uso de medicamentos sem prescrição médica pode causar intoxicação e fatalidades. Muitos indivíduos tomam doses maiores do que as recomendadas na bula com a falsa impressão de que atenuará a eficiência do remédio,  isso ocorre devido à ausência de uma prescrição adequada da dosagem por um médico. Somado a isso, o uso incorreto de remédios como antibióticos pode gerar bactérias resistentes   levando a alterações gênicas na bactéria e, consequentemente, complicações ao paciente.', 'Medidas de intervenção devem ser tomadas para que a automedicação seja abolida. Governo Federal, Ministério da Saúde e meios de comunicação devem trabalhar juntos de modo que se crie uma sinergia que será benéfica a toda população,   a partir de disponibilização de recursos para construção de unidades de prontos atendimentos  pelo primeiro, promoção de melhores condições de saúde pelo segundo e desenvolvimento de propagandas que atentem para os perigos da automedicação e a necessidade de consultar um pronto atendimento pelo último. Assim, o direito à saúde assegurado pela constituição será garantido a toda sociedade.']",80,120,120,120,160,600
80,Preconceito racial é uma herança colonial,"['Durante o período colonial no Brasil no  século XIX , os lusos escravizaram os índios e os negros, criando assim um enorme preconceito racial.  E isso tem durado até os dias atuais. Acerca disso, dois aspectos podem ser observados: as diferenças sociais fruto  da escravidão e o preconceito e violência racial.', 'Segundo o cantor Bob Marley, enquanto a cor da pele for mais importante do que o brilho nos olhos  haverá guerra, ou seja, à medida que a sociedade cultivar o preconceito racial, seja contra negros,  pardos, indígenas   haverá violência, brigas, bullying, pois os brasileiros carregam esse preconceito português. Além disso, pelo fato da  escravidão ter ocorrido no Brasil   dificulta ainda mais a inclusão do negro em sociedade mesmo nos dias atuais, como nas escolas de alto porte trabalhos tudo por conta dos reflexos da escravidão que deixaram os negros em desvantagem social se comparados aos brancos.', 'Como nos lembra o filósofo Jean Paul Sartre  a violência, seja qual for a forma que ela se manifesta   é sempre uma derrota. Seja física,  psicológica é banal e imoral, pois as pessoas que praticam esses atos sempre julgam os outros por sua aparência, cor da pele, cabelo, corpo e essas pessoas que são alvo desse tipo de violência tendem a se tornar agressivas, depressivas.', 'Logo, como nos lembra o pastor Martin Luther King, toda hora é hora de fazer o que é certo, ou seja, é hora da  sociedade abandonar esse pensamento luso. Isso seria possível com a ajuda das escolas e dos pais de crianças e adolescentes  ademais, cabe aos pais ensinar aos seus filhos que somos todos iguais,e a escola poderia organizar debates contra o preconceito racial e atividades abordando diversos assuntos sobre miscigenação brasileira. Além disso, o Governo Federal deveria propor propagandas televisivas contra a violência e o preconceito racial.  A fim de melhorar a convivência entre os povos brasileiros.']",160,120,120,120,160,680
91,Negando o desenvolvimento,"['. Na obra “Sociedade do Espetáculo”, do escritor francês Guy Debord, é retratada uma sociedade ideal, na qual o corpo social padroniza-se pelo discernimento social. Contudo, essa sociedade proferida pelo autor está muito distante da realidade brasileira, uma vez que inúmeros problemas, como os efeitos do negacionismo científico, dificultam que o país alcance o patamar proposto por Guy. Nesse contexto, fatores como a irresponsabilidade social e a negligência estatal agravam a situação.', 'Sob esse viés, é fulcral ressaltar a insensatez social como impulsionadora do imbróglio. Nesse sentido, em meados do século XX, com o advento da Revolução Terceira Industrial, a revolução Técnico-Científica, a internet alcançou uma proporção mundial obtendo vários navegantes e, assim tornando-se uma ferramenta fundamental para a propagação de notcias, principalmente nas mídias social. Entretanto, é fato que tal alcance muita das vezes não influencia positivamente, visto que milhares de informações discrepantes sobre os meios científicos são postadas diariamente por seus usuários, por exemplo as fake news. Por consequência, a parte da população que tem acesso a essas informações acabam acreditando e criando uma barreira para a aceitação dos benefícios da ciência para a nação.', 'Outrossim, é imperativo pontuar que o negacionismo científico deriva do negligenciamento estatal. Nessa perspectiva, em 1904, devido à falta de conhecimento popular sobre os benefícios da vacinação e de campanhas por parte do Estado, ocorria, no Rio de Janeiro, a Revolta da Vacina, um motim popular contra a vacinação anti-varíola. De maneira análoga, grande parte dos brasileiros tende a negação da ciência, pois as entidades estatais direcionam pouca atenção, no que concerne a investimentos, por exemplo, em campanhas e propagandas que expliquem sobre os benefícios dos métodos científicos para o bem-estar populacional. Logo, urge uma mudança dessa postura estatal, já que tal situação auxilia com o atraso no desenvolvimento do país.', 'Portanto, diante do problema exposto, medidas são necessárias para conter o negacionismo científico no cenário brasileiro. Para isso, o Estado, no papel do Ministério Educação, esponsável pela Política Nacional da Educação, deve investir, por meio de palestras com psicólogos, em campanhas nas escolas que alertem sobre as falsas notícias e suas consequências. Ademais, a fim de combater a desinformação, o Ministério da Saúde deve criar projetos de propagandas e campanhas nas mídias sociais que expliquem os benefícios da ciência. Destarte, o negacionismo científico não estará mais presente no Brasil e se aproximara as sociedade ideal de Guy.']",160,200,160,200,160,880
59,Atuação do poder público na fome,"['A fome no Brasil é um problema que ainda persiste no país. Apesar da grande extensão territorial do Brasil e de seu enorme potencial agrícola, problemas como a desigualdade social e a concentração fundiária fazem com que pessoas não tenham o suficiente para sua nutrição, apesar do país ter alimentos em quantidade suficiente. Uma pesquisa do IBGE (Instituto Brasileiro de Geografia e Estatística) mostrou que 7 milhões de brasileiros ainda passam fome e muitos outros tem alimentos insuficientes.', 'A luta contra a fome no Brasil teve uma atenção especial durante o governo Lula, quando foram criados programas sociais como Fome Zero, sistema que possibilitou alimentação para a população brasileira, facilitando o acesso, consumo saudável e melhoria na saúde, junto ao Bolsa família buscando fazer distribuição direta de renda em 2014.', 'Principais causas de avanço da subnutrição são crises econômicas e a desigualdade ao acesso . No brasil 2,5 da população passou fome em 2017, corresponde 5,2 milhões de pessoas, números em que vem crescendo.', 'Nesta desigualdade social e de gênero , com a má distribuição afeta principalmente a população mais pobre e mulheres. Em que políticas públicas se tornam importante em combater não só a fome  más também suas causas, diz Julio Berdegué representante da FAO (Organização das Nações Unidas para a Alimentação e a Agricultura).', 'A população não conta com alimentos suficientes para satisfazer suas necessidades, o nível está abaixo do limite de consumo mínimo energético para um indivíduo, confirma estatísticas da Organização Mundial da Saúde.', 'Para diminuir a fome no país é preciso manter investimento de segurança alimentar em diversas áreas tanto no meio rural quanto no urbano, como: políticas de transferência de renda; programas de atenção médicas; bancos de alimentos. Isso permite a população mais pobre acesso a alimentos através de poder público.']",120,80,80,120,80,480
82,Necessidade de acompanhamento médico,"['No que se refere à automedicação   a qual é uma prática extremamente comum entre a sociedade em geral.   Leves dores de cabeça ou um mal-estar levam-nos logo a tomar um medicamento.   Medicamento a qual tomamos por indicações de terceiros sem souber  o motivo das dores ou   até mesmo, não procurando um médico. Mas,    será que realmente devemos  combatê-los?', 'Desde o período em que os povos se estabeleceram como sociedade, eles não veem as necessidades de serem acompanhados por especialistas, mesmo não sentido  dores.    Pois, para muitos, cada desconforto que sentem, eles sabem fazer ‘’remêdios casairos ’’ que ‘’curam’’ melhor do que medicamentos prescritos pelos médicos. Essa prática, no entanto, estabelece vários riscos, as quais podem ser levadas a  morte. Primeiro, devemos saber o motivo desses desconfortos, com vários exames que serão exigidos pelo médico.  Para que assim, não tomem medicamentos que podem ser prejudicial  em suas dores, fazendo com que agravem o problema.', 'Eis um problema, a  pessoas que são ignorantes por não entenderem a necessidade de acompanhamento médico. Com isso, por sentirem sempre a mesma dor ou até mesmo por ouvirem casos como o mesmo, acabam tomando medicamentos seja por experiência, seja por amigos, familiares, etc. Para isso,   que existem medicamentos que possam combatê-los  quaisquer situações, medicamentos as quais serão prescritos por um especialista diante do mesmo. Fazendo uso, combaterá todas as dores, ao contrario  pode haver desenvolvimento de micro-organismo  que agrave o problema.', 'Diante do elemento apresentado, as sociedades devem exigir a si mesmo de procurar um médico. Entendemos a preocupação que nos causa, ao sentir dores e por querer a cura rápido, mas,    não será por indicações de terceiros, pois, a  situações que podem ser gravíssimos , e agindo dessa maneira que foi citado não haverá sucesso. Então, devemos    sim, procurar médicos para que eles nos prescrevessem  medicamento para combater a situação, e no final terá o prazer de dizer: Fiz um bom combate!']",120,120,120,80,120,560
94,autismo 111,"['O autismo, ou Transtorno do Espectro Autista (TEA) é uma condição neurológica que tem como característica o desenvolvimento diferenciado do cérebro, afetando as habilidades sociais e intelectuais do indivíduo. O TEA pode, no entanto, se manifestar de diversas formas, o que acarreta desafios para a inclusão social dos que possuem a condição.', 'Em primeiro lugar, destaca-se a dificuldade de compreender as diferentes formas de manifestação do autismo. Nesse sentido, as características mais conhecidas do TEA são apresentadas por homens, mas pouco se sabe acerca do autismo feminino. As mulheres são, por exemplo, mais propensas a camuflar os traços do transtorno, o que impede ou atrasa o diagnóstico. Por isso, é muito comum o sentimento de incompreensão e de solidão entre as pessoas dentro do espectro.', 'Além disso, a falta de preparo das escolas e de profissionais da educação para acolher os indivíduos neurodivergentes é um grande empecilho na adaptação social destas pessoas. Raras são as instituições aptas a receber crianças com TEA, que têm dificuldade de socialização e de aprendizado e necessitam de suporte especial, com atividades que não envolvam contato físico nem ambientes com ruídos altos. Ademais, é necessário o uso de materiais de estudo e métodos pedagógicos específicos, o que demanda a adaptação das escolas.', 'Por fim, é necessário que o Poder Público invista recursos na área da educação, promovendo palestras com o tema, de forma a conscientizar a comunidade, capacitando professores e adequando estruturalmente as instituições, a fim de promover o desenvolvimento adequado de crianças dentro do espectro. Por outro lado, também é papel da família e da sociedade acolher e viabilizar a inclusão dessas pessoas, tratando-as com respeito e compreensão.']",160,40,40,200,40,480
18,Direitos humanos sem humanidade,"['Quando a atual Constituição Federal do Brasil foi promulgada, em 1988, previa-se direitos que assegurariam o que se entende por direitos humanos. Direito à vida, à moradia, à saúde, à liberdade, à educação, entre outros, estão previstos na Carta Magna, no entanto, a defesa pelos direitos humanos tomou outro rumo no país.', 'No Brasil, assim como em todas as áreas, a defesa pelos direitos humanos seguiu um caminho diferente do que o esperado. Enquanto crianças não têm uma estrutura mínima para aprender a ler e a escrever, famílias passam fome e hospital sequer têm leitos para seus pacientes, as Comissões de Direitos Humanos, espalhadas pelo país afora, estão mais preocupadas em proteger bandidos já condenados pelos seus crimes.', 'É claro que todos merecem uma vida digna, seja no sertão nordestino, nas grandes metrópoles brasileiras ou em presídios sucateados, no entanto, proteger criminosos (como tem acontecido) apenas faz com que aumente a criminalidade no Brasil e garanta votos nas urnas a cada eleição municipal, estadual ou federal, porém, sem resolver o problema da desigualdade social cada vez maior em território tupiniquins .', 'Dessa forma, é possível concluir que a atuação das Comissões dos Direitos Humanos nem sempre está em consonância com a Constituição Federal, pois, enquanto alguns são privilegiados, outros caem no esquecimento. Para que isso mude, umas das soluções é desvincular estes órgãos na política nacional, porque o que se relaciona com o que é corrupto, tende a se tornar igual.']",160,160,120,160,120,720
78,Medida Provisória ou Manobra?,"['O governo alega que a MP tem como objetivo principal manter e atrair os jovens na escola, aponta também a defasagem no ensino, o aumento da carga horária e a estagnação no ensino brasileiro comparado a outros países. O governo quer deixar a escola atraente para o aluno, dando-lhe a oportunidade de escolher dentre um ou mais itinerários formativos, alega ainda que treze disciplinas é um excesso e que quer dar autonomia ao jovem.', 'A MP tem aspectos de governo privatista, essa medida é uma manobra do governo que ao invés (que, em vez de) de trabalhar as dificuldades, está procurando meios para diminuir os repasses dos recursos  como é o caso do Fundo de Manutenção e Desenvolvimento da Educação Básica,  (FUNDEB). Ao dar oportunidade de emprego a jovens  baixa renda, reduz as chances de igual acesso a oportunidades e desenvolvimento intelectual. Um aluno que não se aprofunda nas Ciências Humanas deixa de ser um ser pensante.', 'Uma grande parte das escolas não têm  estruturas para que os alunos fiquem quatro horas, a grande maioria encontra-se sucateada, sem possibilidades e condições adequadas para manter o aluno na escola. A sociedade é soberana e está cobrando participação nas decisões, é preciso pressionar o Estado para que haja diálogo na elaboração das propostas, o povo deve ir as  ruas e manifestar-se. O governo deveria incentivar e criar melhores condições, promover igualdade para que o jovem possa ir além do ensino médio, as propostas devem priorizar à  formação humana e cidadã.']",160,120,120,160,120,680
43,A Cultura do Cancelamento Deve Ser Cancelada,"['A cultura do cancelamento surgiu com o intuito de permitir que as minorias pudessem denunciar e boicotar pessoas ou empresas com atitudes reprováveis. Contudo,essa atitude acabou se tornando autoritária,assumindo,assim,uma face insensível e intolerante. Por isso,é fundamental discutir sobre esse tema e resolver os problemas envolvidos nele.', 'Primeiro,é necessário reconhecer que o cancelamento já foi válido,mas foi deturpado .O cancelamento surgiu para que pessoas,que antes não tinham voz,pudessem,por meio das redes sociais, fazer denuncias que não poderiam ser ouvidas de outra forma,como no caso da #metoo,em que mulheres puderam denunciar casos de abuso sexual pelo Twitter. Porém,o cancelamento foi mal interpretado,e,por conta disso,o simples ato de discordar se tornou motivo para o cancelamento,como no caso do comediante Danilo Gentilli,que foi cancelado por discordar de uma decisão do Presidente Bolsonaro,segundo noticiado pelo UOL. O cancelamento se tornou opressor ao ponto de um indivíduo poder ser punido por uma atitude passada independente da atual,além disso,quando se é cancelado não adianta pedir desculpas ou aprender com seus erros,porque,depois do cancelamento,não há mais espaço para discussão .Sendo assim,um movimento que era para dar voz aos oprimidos calou a todos.', 'Em segundo plano,é necessário entender,  porque , apesar de tudo, a cultura do cancelamento ainda existe. Segundo Foucault o discurso é o poder,e sendo, em teoria,a ultora do cancelamento a representação de um discurso e não de uma ideia indivídual,ela acaba tendo poder para atingir qualquer um,ainda mais com o advento da internet,que permite que qualquer informação se espalhe facilmente,fazendo assim com que as pessoas tenham medo de atingir essa cultura, tornando-se,por isso,alvo dela.', 'Portanto,o impasse deve ser resolvido,porque o cancelamento está sendo injusto e,como diria Aristóteles ""a base da sociedade é a justiça"".Para isso,o Ministério da Economia  deve liberar dinheiro para o Ministério das Comunicações, para que este segundo por meio de uma campanha, que deverá ser divulgada em toda mídia,possa conscientizar as pessoas sobre os riscos da cultura do ancelamento. Paralelamente,oMEC, (Ministério da Educação) incentivará debates nas escolas para que os jovens se tornem abertos as discussões. É esperado que, a exemplo do Brasil,outros países ajam de forma análoga,para assim enfraquecer a cultura do cancelamento.']",120,160,160,200,200,840
45,Abuso de autoridade em uma sociedade contemporânea,"['No contexto atual em que vivemos os abusos das autoridades públicas tem ficado evidente na sociedade .', 'Primeiramente a diversos fatores que influenciam nesse cenário como as atitudes desses indivíduos relacionado a questão pessoal mal resolvida, a falta de capacitação dos funcionários em determinadas situações recorrendo a ações agressivas e o salário precário em determinadas funções .', 'As consequências disso contribui para o aumento das violências física, psicologica e verbal existente no cotidiano . Além disso ações como essas deixam impressões negativas havendo ausência credibilidade , já que como autoridade deveriam passar bons exemplos e confiança para a população.', 'De acordo com  G1 houve aumento de 74% desse problema nos últimos anos, incentivado por uma ideologia que o uso da força a melhor forma de solução podendo ser visto no período da ditadura militar , sendo utilizado a força para reprimir as pessoas contra os principios daquela época .', 'Diante disso é preciso elaborar medidas  a fim de acabar com esses acontecimentos por meio de capacitação desses prestadores de serviço e fazer punições eficazes com intuito de os responsibilizar pelos seus atos proporcionado pelo Ministério Público .']",120,120,120,160,120,640
121,Eleições na imprensa,"['A         republica         no Brasil foi instituída em 1889         a         partir daí, passou o pais a ser sem monarquia e democatra         em         que se consiste         no         povo ter direito de escolha, direito de voto. Há, então, as eleições municipais, que         elege         prefeito e vereadores, e as estaduais e federais, que         elege         governadores, deputado estadual, deputado federal, senador e presidente.', 'Essa troca de governo ocorre de 4 em 4 anos e conta com                 milhões de propostas, promessas e intrigas.                Durante o período das campanhas é obrigatório as emissoras de rádio e televisão         que ceda         30 minutos da sua programação em dois períodos, no meio do dia e         a         noite, para que nesse curto período todos os         candidatos os         apresentem seus nomes, números e o que irão fazer.', 'É esse pequeno tempo que causa tantas discussões. Primeiro                a pessoa não tem direito de escolher se quer ver o horário eleitoral ou a programação normal da emissora, já que é algo obrigatório a todas exibir,                 segundo                o tempo é tão curto que não dá nem para o candidato se apresentar direito e,                 terceiro, e talvez a pior                , ouvir e ver propostas ridículas e absurdas.', 'Se o Brasil é um         pais democrata que o povo que escolhe, porque         não escolher                 sobre isso também          .         O horário         dedicado         deve ser maior e dividido por igual entre os candidatos para que se possa analisar o plano de governo de cada um. E os partidos         escolher         melhor seus candidatos porque isso é algo sério e o eleitor vai acreditar no que for dito.', 'Pode-se então concluir que para eleições justas e que         beneficie         a         nação e         a população precisa de bons candidatos, para que possa escolher o         melhor,         campanhas         limpas sem muita invenção de historia para denegrir a imagem do outro e uma escolha certa da população.          Por isso, em outubro vote certo,vote consciente, é o seu futuro por mais 4 anos.']",120,120,120,120,120,600
137,Alimentos transgênicos,"['Atualmente         a engenharia genética         proporciona          estudos         voltado         para a modificação em         alimentos         com o intuito de obter um                 produto mais resistente                e, consequentemente, com melhores condições de         comercializa-lo         em larga escala. Ocorre que alguns críticos procuram         apenas dar ênfase         aos possíveis efeitos negativos causados por                 essas experiências                , deixando de enxergar os benefícios que essa nova tecnologia pode trazer à humanidade.', 'Observa-se que a maior parte das grandes invenções traz alguma consequência negativa como, por exemplo, em relação à invenção do antibiótico. É sabido que esse medicamento proporcionou                 maior longevidade à vida dos          seres         já que consegue eliminar bactérias que antes poderiam até causar a morte prematura de um indivíduo. Entretanto, a consequência negativa é a de que, pelo seu uso excessivo, as bactérias tornaram-se cada vez mais resistentes, gerando as         ""super bactérias""', 'Seguindo ainda esse raciocínio,         frisa-se                   também         que a invenção do automóvel foi um avanço que colaborou com o problema de locomoção; entretanto, trouxe                 também                algumas consequências negativas para a saúde como, por exemplo, problemas pulmonares                e o estresse decorrente dos congestionamentos.', 'Portanto, não há que se sobressaltar apenas os danos causados pelos avanços tecnológicos. O que o homem sensato deve enxergar é se os benefícios dessas descobertas superam os malefícios. Se a resposta for positiva,                 como é o caso dos alimentos transgênicos                ,         deve-se sim         garantir a sua         execução         em nome do progresso.']",160,160,120,160,160,760
51,É essencial a alfabetização,"['A alfabetização é indispensável para se ter uma boa escrita e uma boa leitura dentro do limite , mas o analfabetismo esta presente tanto para adolescentes, para jovens quanto para pessoas já de idade.', 'A porcentagem de analfabetizados é bem maior para idosos, pelo fato de que muitos em sua época escolar,  não permaneceram firmes em seus estudos, para hoje serem alfabetizados, muitos largavam as escolas para poderem trabalhar, ou nem sequer tinham a oportunidade de aprender.', 'E nos dias atuais,  a analfabetização esta em campos de jovens/adolescentes desistentes ou repetentes, que de alguma forma até buscam mudanças, procuram aprender, procuram se alfabetizar, voltar s salas de aulas, mas são intimidados por outros jovens, fazendo com que eles se sintam envergonhados de estarem a um passo atrás dos outros, alguns até conseguem se manter firme, passar por cima de zoações alheias, mas alguns possuem um psicológico mais fraco.', 'Uma das maneiras de se alfabetizar,  é voltar s escolas, procurar programas de alfabetização, cursos, reforços de leitura ou escrita, e as pessoas as voltas dos analfabetizados procurar sempre estar incentivando os, ajudar quando for preciso, levar até a uma solução, nunca julgar, sempre apoiar, e os própios analfabetizados precisam também querer uma mudança, precisam querer aprender. Como Imannuel Kant nos diz : ""O homem não é nada além do que a educação faz dele"". Para querermos um sucesso promissor devemos de fato nos educar, melhorar sempre, crescer metalmente, e buscar aprender sempre mais.']",120,160,120,120,80,600
82,Automedicação,"['A Automedicação é um problema relevante no Brasil, visto que quase 40% das intoxicações são acometidas peça mesma . A OMS e o Estado brasileiro alertam quanto aos danos herdados desta  prática, entretanto  expõe à tona a seguinte questão: a automedicação seria um mal necessário diante dos já saturados sistemas de saúde?', 'Uma tradição folclórica do povo brasileiro, no que tange a automedicação, hoje é discussão no meio médico quanto aos malefícios advindos. A combinação de fármacos, sem prescrição médica, além de ser causadora de boa parela  das intoxicações, pode anular efeitos de outros remédios, potencializar a  até agravar o estado clínico. Um dos exemplos é o uso indiscriminado dos antibióticos, tornando as colônias bacterianas mais resistentes a farmacêuticos, dificultando o tratamento.', 'Todavia, se todos os casos considerados triviais direcionassem para os sistemas de saúde – tanto público com privado- haveria uma superlotação e proveniente colapso nos já sucateados e saturados centros médicos, que por si só, necessita  de mais profissionais da saúde e financiamento, situação que hoje não é suprida.', 'Devido a estes  fatores que a população torna-se resistente a abandonar esta  prática.  O mau atendimento médico e a superlotação hospitalar são pilares centrais no fomento a automedicação. Os brasileiros entendem que os riscos desta  prática em seus lares e  mais vantajosa  do que testemunhar a falta de humanização no atendimento hospitalar e, por vezes, nem sequer haver resquícios desta quando não há nem mesmo o próprio atendimento.', 'Fica evidente, portanto, os riscos provenientes desta  prática, incentivados pelo falido sistema de saúde brasileiro, a qual devemos combatê-la . O Estado, além de tudo, deve reestruturar o sistema público de saúde através  do investimento em infraestrutura e mão de obra na área, criando também novos centros clínicos para evitar a superlotação, para que  assim  inicie-se a divulgação de campanhas contra a automedicação nas escolas, alcançando o público jovem e desenvolvendo uma geração consciente, bem como disseminar nas plataformas midiáticas em prol de englobar o debate na sociedade como um tudo.']",120,160,160,160,160,760
86,Impactos do uso das redes sociais na saúde mental 2,"['Observa-se que em meio a pandemia em que vivemos, as pessoas tiveram que se adaptar e se reinventar através das redes socias. Tal contexto,  se deve ao crescimento de usuários que passaram a utilizar as redes socias não apenas como lazer, mas também como fonte de trabalho. Em geral, as pessoas veem nas redes socias como o Facebook, WhatsApp, Instagram e Tik Tok, uma forma de entretenimento após um dia cansativo de serviço ou até mesmo adquirir uma vida fitness através de uma transmissão ao vivo.', 'Alguns argumentam que as pessoas, principalmente os jovens, têm usado as redes com excesso e de maneira errada, quando se encontram horas em seus quartos com os olhos fixos nas telas. Como exemplo disso, podemos citar o jogo Free Fire, lançado em 2017 pela Garena. O jogo foi baixado por milhões de pessoas e faz até hoje jovens ficarem horas no celular, resultando assim em jovens depressivos, sem disposição e ansiosos, porém, cabe ressaltar que do mesmo modo, o jogo tirou jovens do mundo das drogas e trouxe oportunidades de educação a população carente . Outro argumento válido existe quando citamos que com a evolução da tecnologia, surgiramse muitos jovens youtubers que expõem suas vidas nas redes e ficam vulneráveis aos ataques virtuais, resultando assim na necessidade de controle de dados.', 'Por outro lado, podemos usar como exemplo a série Black Mirror, que aborda como assunto o excesso das redes socias e seus impactos em um todo, que tem o objetivo de nos alertar das consequências de uma vida virtual despreocupada. Além disso, vale ressaltar que os usuários chegam a usar fake newews ou até mesmo a própria conta para disseminar o ódio e a raiva nas redes a pró da felicidade individual. Isso sem contar que alguns dos impactos negativos se deve a criar uma vida virtual considerada ideal, estimulando outras pessoas a entrarem em depressão e até mesmo o suicídio devido a não conseguirem alcançar a perfeição.', 'Levando em consideração esses aspectos, cabe as empresas junto com o Ministério da Saúde lançar aplicativos de controle de saúde/bemestar gratuitos à população, uma vez que tem como objetivo assegurar a saúde mental e física da população. Fica claro, portanto, que é necessário que seja feito campanhas e eventos que incentivem os usuários a se desconectarem das redes e se conectarem uns aos outros. Logo, por meio de eventos esportivos e culturais será possível conter os impactos e garantir uma saúde mental saudável.']",160,160,120,160,160,760
84,Porte de Armas,"['Com a lei em vigor sobre o ,  Porte de Armas , vem sendo discutido vários tópicos á respeito do assunto. Em pauta temos de cara * 3 tópicos , Será que vai melhorar o paiz com essa nova lei? Será que vamos poder dormir sem medo? Será que vamos conseguir viver com essa nova lei?', 'Com esses tres tópicos sobre o Porte de Armas , é que comessaremos á refletir sobre o real sentido do que, é , termos a passagem livre ão uso de armas. A onda de violência cresce a cada dia, com a lei tende á aumentar .Todo cidadão na sua sã conciência , pode tirar seu porte de armas , ai onde está o grande problema .Como vai ser nosso paiz , se todos  tivessemos Armas dentro de nossas próprias casas ?', 'Para chegar á um consenso , o ideal seria se o Governo não adquirisse á lei .Seria bom para todos , em questão de segurança e do medo , que é viver cercado de ARMAS.']",120,120,120,120,160,640
148,Um país onde impera a violência,"['Os eventos esportivos dos quais o Brasil será palco são um grande termômetro para o país. Será graças a esses acontecimentos que o Brasil poderá medir                 muitos aspectos                , dentre eles a segurança, que nos dias de hoje é tão precária e ridícula que às vezes chega a ser motivo de piada nas rodas de conversa. Sim, infelizmente o brasileiro parece já ter perdido as esperanças de melhorar a segurança de seu país, mas este vai ser obrigado a rever seus conceitos diante         de um         mundo, que vai observar e julgar o nosso país.', 'O ser humano, no seu infinito poder de adaptação ao meio,                 vem exercendo o seu papel no          Brasil,  já         estamos acostumados a andar nas ruas de maneira preocupada, sabemos a melhor maneira de         se portar         diante de um assalto: “não reaja”, é o que dizem os que tinham o dever de nos proteger. Como se o culpado de um assassinato fosse a vítima. Por sorte,                 no Brasil não é muito provável que sejam relatados casos de terrorismo                , e não é isso que devemos temer, mas sim                 os mal intencionados                , os quais nem mesmo                 a polícia consegue corrigir e punir exemplarmente.', 'A proposta do         governo, é de colocar         as forças armadas nas ruas, para garantir a segurança dos turistas durante essas         datas, é         uma proposta bastante prudente, já que não há nada mais correto do que o exército de um         país, trabalhe         em prol da segurança de sua população,         pois         a polícia se mostra incompetente para desempenhar tal         função, a prova         é o Brasil ser o país com maior número de empresas         que fornecem         segurança particular, o que mostra o fracasso da segurança         que é fornecida pelo estado         . E é claro que com a inserção desse grupo de militares nas ruas, as possibilidades de atentados terroristas se         fazem         cada vez mais         remotas, ainda         assim, convém redobrar as atenções, já que é uma ocasião perfeita para                 protestos                , que geram confusões,         e que         por sua vez, manchariam ainda mais a nossa reputação no exterior.', 'Sendo assim, tudo deve ser analisado e nenhuma hipótese descartada, mas o que deve realmente nos preocupar são os ladrões que já não temem a lei, tampouco a polícia, ficando atento às possíveis reações terroristas, e          a          maneira mais eficaz de combater os dois problemas com uma só ideia é utilizar o exército brasileiro, muito pouco utilizado, para          ajudarem a policia          na segurança e patrulhamento das cidades e          garantindo          a segurança dos turistas mas também da população brasileira, utilizando de todos os artifícios possíveis para isso, pois como dizia Nicolau Maquiavel, “Os fins justificam os meios”, e nesse casso o fim é nossa segurança e nossa imagem.']",160,120,120,120,160,680
92,"Preconceito, um mau oculto","['No século passado, o mundo passava por diversas guerras e perseguições, uma delas foi o nazismo, movimento que perseguiu e matou cerca de 8 milhões de pessoas de origem judaica. Isso mostra que o preconceito contra pessoas de diferentes etnias é um problema recorrente na história da humanidade. Apesar de o Brasil ser um país bem mistificado, é comum relatos de vítimas que sofreram discriminações por conta de suas origens étnicas. Dessa forma, o combate ao preconceito amarelo é um desafio que precisa ser combatido com uma desculturação de pejorativos aos asiáticos, como também uma fiscalização dos meios virtuais.', 'Convém ressaltar, a princípio, que a cultura de se criar apelidos aos povos de origens asiáticas é um fator determinante para permanência do preconceito, caracterizando-se como violência verbal. De acordo com as ideias do filósofo Jean-Paul Sartre, a violência seja ela física ou verbal, quando manifestada é uma derrota quando se há um mau a ser combatido. Nesse sentido, esses costumes de maus hábitos têm se tornado um empecilho para se combater o preconceito, visto que ele é um dos responsáveis pela disseminação de estigmas dos povos asiáticos.', 'De mesmo modo, destaca-se o aparecimento de notícias falsas como uma das ferramentas usadas para caluniar certos países com divulgação de conteúdos falsos e até mesmo de ódio contra essas nações. Isto é, recentemente a China foi vítima de uma cancelamento virtual, na qual muitas pessoas publicaram inúmeras notícias inverídicas na internet que diziam que ela foi a responsável pelo aparecimento da covid-19, fato esse que provocou um aumento no número de crimes contra os chineses espalhados pelo mundo. Assim como a internet se tornou um ambiente para divulgação e debate sobre diversos assuntos, infelizmente tem sido usada também para propagação de “fake news” com o objetivo de cancelamento virtual de uma pessoa ou nação.', 'Portanto, diante dos fatos supracitados, faz-se necessário que sejam tomadas ações para amenizar a questão. Logo, o Estado junto com os poderes legislativos e judiciais, por meio de criações de leis, ademais dos cumprimentos das que já estão em vigor, devem aumentar a fiscalização e fazer a justiça de forma mais ágil, para que assim diminua o compartilhamento de discursos de ódios, como também para as pessoa que infringem as leis respondam processos criminais. Além disso, as escolas devem formar cidadãos que respeitem as diferentes etnias. Em suma, é importante que sejam discutidos na aulas assuntos sobre as culturas de cada país, bem como o respeito a todos. Somente assim, esse preconceito será gradativamente erradicado, pois, conforme Gabriel O Pensador, “Na mudança do presente a gente molda o futuro”.']",160,160,120,200,160,800
79,Sistema Penitenciário Humanizado,"['O Sistema Penitenciário do Brasil apresenta o quarto maior contingente carcerário do mundo. Os presos são tratados de forma desumana e degradante.  Fatores que prejudica  a ressocialização do apenado, transformando  assim, os presídios em verdadeiras escolar do crime.', 'A superlotação é um dos principais problemas a ser resolvidos pelo Governo Federal e,  uma das medidas apresentadas foi à  liberação de 1,2 bilhões  com destino a  construção de presídios e aparatos tecnológicos. Segundo o Ministro da Justiça em reportagem feita pelo Jornal O Globo;  só com a construção de presídios não é suficiente para que haja uma melhora no sistema. Deve-se investir em tecnologia com intuito de fiscalizar os presos,  e policiar também as autoridades como Juízes, Promotores e Advogados que adentram nos estabelecimentos penais, porque,  um dos principais problemas enfrentados é a corrupção, que fazem  com que os detentos consigam armamentos e celulares capazes de gerarem  um motim.', 'Foi feito também relatório fomentado pela Organização das Nações Unidas (ONU) em 2015,  com o objetivo de averiguar a condição dos presídios. Nesse relatório a ONU questionou a super lotação , o abuso de autoridade e o controle de estabelecimentos penais por entidades particulares.  Fotos  notificados pelo jornal Nacional. Portanto, para que o sistema melhore  esses problemas devem ser resolvidos.', 'Deve-se relatar também a rebelião ocorrida no Complexo Penitenciário Anísio Jobim, onde 60 detentos foram mortos, sendo alguns decapitados. Essa barbárie criou um alerta tanto da sociedade como do governo para que haja um planejamento com intuito de resolver essas disparidades. Apesar dos crimes cometidos pelos apenados  todos nos somos humanos.', 'Por fim, para que haja no sistema penitenciário caráter ressocializador e humanizado.  O governo deve propor medidas que tenham objetivo de solucionar os problemas explanados. Além de construir penitenciária, e investir na coibição do controle das penitenciárias pelos próprios apenados.']",120,120,120,120,120,600
69,A Utilização de Agrotóxicos no Brasil,"['O uso excessivo de agrotóxicos vem crescendo cada vez mais no Brasil,pois são produtos químicos utilizados para benefícios da agricultura.', 'Apesar dos agrotóxicos protegerem a agricultura podem prejudicar os seres vivos através da contaminação,poluição do solo,da água e do ar.', 'Nos seres humanos os agrotóxicos podem causar graves problemas como  por exemplo:lesões nos rins,câncer,entre outros e ainda levar morte.', 'É fundamental que se utilize os agrotóxicos de maneira moderada para que assim diminua os problemas de saúde e os impactos ambientais.']",120,40,40,80,0,280
84,Segurança a prova de balas,"['Devido a algumas circunstâncias ocorridas não só no Brasil como também no mundo trouxe  (vieram) à tona as discussões sobre a liberação do porte de armas para civis, enquanto alguns pensam que o mais seguro seria ter algum armamento como forma de defesa pessoal, outros têm em mente que quanto menos armas dentro da sociedade maior será a segurança. Hoje em dia é notável a facilidade de um criminoso em conseguir tais objetos e cometer diversos crimes podendo ser, na maior parte das vezes, fatais para as vítimas.', 'No caso do Brasil, há regras estabelecidas em 2003 que determinam um controle na posse de armas de fogo, dificultando o uso de forma legal. Porém, em 2014 ocorreu uma tentativa de revogação dessa norma, foi discutido na Câmara dos deputados um projeto de lei que tornaria mais fácil a liberação para cidadãos que não tivessem antecedentes criminais e que os mesmos tivessem aptidão técnica e psicológica para o uso.', 'Já em países como os Estados Unidos, onde é possívelo poder de compra e porte de armas de maneira acessível, a situação parece ser contrária, o próprio presidente Barack Obama é a favor de maiores restrições para o acesso ao armamento no país. A pouco tempo aconteceu um massacre na cidade de Orlando localizada na Flórida, dentro de uma boate na qual um indivíduo fez vários disparos deixando pelo menos 49 mortos e 50 feridos, esse fato colocou em dúvida a sociedade já que as armas foram compradas e livremente usadas no mesmo país.', 'Levando em consideração esses aspectos, pode-se concluir que seria mais seguro o controle rigoroso sobre o uso de armas de fogo, em relação as autoridades e ao governo, deveriam apresentar uma maior fiscalização para que tal poderio não caia nas mãos de criminosos. Também (deve-se) tornar restrito o uso de armamento para militares treinados de forma correta.']",120,160,200,160,200,840
85,Iniciativa  popular e sua democrácia*,"['Atualmente estamos no país democrático onde  as  pessoas  podem  se   eleger, ou seja escolhendo seus governantes, com o voto. Que é o  direito de todos, é com ele que as pessoas se tornam cidadão , tendo seus direitos, e livre participação política na população.', 'Antigamente só  a minoria  tinha  o  direito  de  votar,mas na  atualidade  tudo  mudou .Agora  todos  têm  essa  participação  política. Ela é o que chamamos de  democrácia . A  população  pode  participar  da  política, e  enpondo as  leis  de  iniciativa  popular. Ou  seja,  as  pessoas apresentam  um  projeto  de  lei  na  camara  dos deputados ,que  seja  assinadas por  cidadãos, e  essas  assinaturas  é distribuidas  pelo (menos por 5)  Estados  brasileiros. É a forma de planejamento da  sociedade contra vários acontecimentos na vida, que atormentam o povo.', 'Além disso como , o combate a corrupção eleitoral, que é  a compra de votos, (e) a  lei  Daniella  Perez, que  trata  de  crimes  com  maior  gravidade, de intenção de matar. Por tanto dar o direito a sociedade  de  criar  leis, é uma  ótima  proposta, para (que) sejam implantadas outras novas práticas de iniciativa popular, poder ser que mais adiante tenha outras  formas de  combater o  preconceito racial, e o abuso  sexual.']",120,80,120,120,160,600
139,Não a razão no fim do mundo,"['O fim do mundo é um assunto antigo que vem se arrastando junto com o tempo.                Já foram estipuladas inúmeras datas para tal acontecimento que, embora nunca tenha ocorrido,                 tira o sono                de muitas pessoas em todo o planeta. Diversas vezes, pessoas se deixam         acreditar em         tal absurdo                 pela sociedade religiosa ou até mesmo a mídia.', 'O         fim dos tempos é um exemplo de que, se uma mentira é contada muitas vezes, o ser humano perde a razão e é tomado pela dúvida da possibilidade de ser verdade. E esse assunto ainda         trás          mais dúvidas por envolver tudo o que existe.                Foi isso que levou o calendário maia -         onde foi estipulada         uma data para o fim do mundo - a ter o status que tem hoje. Muitos         crêem         por         medo, outros         como uma chave para o propósito da vida.', 'Mas fato é que nenhuma das previsões         tiveram         alguma prova ou         embasamento para                   alguém acreditar em tais afirmações.         E isso, de certo modo, é preocupante, pois mostra o quão é fragilizada a nossa espécie quando o assunto é morte ou o fim de tudo. No entanto, isso demonstra o poder de sobrevivência do ser humano. Ou seja,         de         qualquer ameaça que apareça, seja real ou não, somos levados pela nossa natureza a nos proteger. Alguns se protegem rezando, outros construindo abrigos e estocando mantimentos e armas.', 'Só não podemos esquecer que somos seres inteligentes, ou seja, podemos pensar e agir de maneira         correta,         analisando os fatos.                 Ao longo do tempo,         adquiridos         a capacidade de refletir sobre o que faz e não faz sentido e devemos usar isso a nosso favor. Temos que ponderar as provas e só então analisar o que é um perigo real ou o que é um perigo imaginário. Se fizermos         isso         o fim do mundo não vai passar de um assunto meramente curioso.']",160,200,120,160,160,800
102,A importância da água para os seres vivos,"['A água é a substância                  que          nós          seres          humanos          mais          precisamos, e que não          importa quem somos e de que jeito somos, todos          precisamos          dela para sobreviver,         e mesmo         sabendo disso, as pessoas continuam poluindo e esquecendo o quanto ela                 é importante                para nossas vidas.', 'A água é um recurso natural que          nós mais utilizamos          , seja como componente bioquímico dos seres vivos ou um meio de vida de vegetais e animais, como valores sociais e culturais e também para a produção de vários bens de consumo e para a          agricultura, precisamos          dela para termos alimentos e nos alimentar, para bebermos e sermos saudáveis, limpar a casa e tomar banho. Por ser uma substância que          mais usamos          e          mais precisamos          , as pessoas pensam que podem          usar e abusar da água,          sem ter a consciência de que ela não é tanta como pensamos que é,          poluindo-a          e gastando mais do que          deve          , pensando que ela irá durar para sempre.                  Os recursos hídricos têm profunda importância no desenvolvimento de diversas atividades econômicas. Em relação à produção agrícola, a água pode representar até 90% da composição física das plantas. A falta d’água em períodos de crescimento dos vegetais pode destruir lavouras e até ecossistemas devidamente implantados. Na indústria, para se obter diversos produtos, as quantidades de água necessárias são muitas vezes superiores ao volume produzido.                Segundo estatísticas 70% do planeta         é constituído em         água, sendo que 3%         é         de água doce e 98% de água         subterrânea, isso         quer dizer que a maior parte da água disponível e própria para consumo é mínima perto da quantidade da água existente na terra.', 'Por tanto,          sem a          água          nós não conseguimos          ficar,  e         com a crise hídrica, vemos que ela não dura para sempre e que devemos cuidar                ,         economizar  para sempre termos ela         quando precisarmos                ,                 pois todos          nós          seres          vivos          precisamos dela para nossa existência na terra.']",80,80,0,0,0,160
134,Nossa maior vitória,"['Se as manifestações que começaram com o Movimento Passe livre em São Paulo e se estenderam para outras regiões servirão para realizar as mudanças políticas e sociais que queremos, ainda é cedo para         dizer, o que         já sabemos com certeza é que a população hoje, como não acontecia há muito tempo, sente que tem         voz, as vitórias         ainda que pequenas, foram representativas e serviram para mostrar que a sociedade brasileira quer ter mais participação política, além do voto de quatro em quatro anos, e essa já pode ser considerada nossa maior vitória. É pouco provável que as manifestações acabem tão cedo, já que existem varias necessidades que precisam ser                 ouvidas                e para quais esperamos respostas em forma de leis.', 'O Brasil não acordou, o Brasil sempre esteve acordado, mas estava ""deitado eternamente em berço         esplendido"" as         pessoas se indignavam com a corrupção, com a falta de educação e saúde e assistiam TV indignadas, iam trabalhar indignadas e conviviam com esse indignação diariamente, como uma         fatalidade, o         Brasil apenas levantou do “Berço esplendido” e foi para                rua mostrar que quer mudança.', 'Para os descrentes nas manifestações e para os manifestantes ""xiitas"", é preciso ser explicado que um país inteiro não muda em um mês de passeatas, precisamos ir para as ruas com objetivos muito bem definidos, algumas manifestações tinham cartazes de todos os tipos, e ecoavam gritos ""genéricos"" como ""chega de corrupção"" bonitos, mas sem funcionalidade prática, uma luta contra tudo é o mesmo que uma luta contra nada, esse talvez seja o momento de voltarmos pra casa nos reorganizarmos definirmos uma luta e irmos para rua todos em uma só voz, e a Internet à exemplo da Primavera árabe é nossa principal ferramenta, se não desistirmos da nossa participação política, chegará um momento em que não precisaremos ir as ruas, os políticos virão até o povo para entender o que ele quer e como          atende-lo          , esse será um processo de anos, e as pequenas vitórias serão o fôlego e a motivação para continuarmos.']",120,200,160,160,120,760
89,Vacinar é preciso,"['A ovid19 é um problema de todos. É uma doença mortal e muito contagiosa. Não tem remédio, mas tem prevenção com ouso de máscara, distanciamento social e muita higiene pessoal, nos alimentos e na casa. Essas medidas são eficazes e devem ser adotadas por todos. Se o povo não ajudar nenhum governo dará jeito. Só a vacinação de todos poderá conter a pandemia. O Brasil e a América do Sul foram afetados por último, quando a doença chegou em solo brasileiro já se sabia mais sobre esse vírus que a Ásia e a Europa. No entanto isso não foi vantagem nem para o país e muito menos para os brasileiros.', 'O presidente ignorante negligenciou em tudo. Primeiro quis negar, depois não respeitou os cientistas, médicos, jornalistas e todos. Foi e é um exemplo vergonhoso, fez aglomeração e foi contra o uso de máscara e vacinação, fez propaganda de um remédio ineficaz. Ignorou a falta de oxigênio em Manaus e diversas pessoas morreram sem ar. A pandemia no Brasil é uma tragédia anunciada. O lado da economia todos perdem. Escolas, alunos, professores, indústria, comercio, transportes ,esporte, cultura, igrejas e o país. O mundo está em guerra e o inimigo é invisível e mortal e a melhor fortaleza e a casa de cada um.', '270 mil pessoas morreram no país de Norte a Sul. Ricos, pobres, anônimos e famosos. O governo federal tem que fazer a sua parte. Tem que obrigar o povo a ficar em casa. Tem que fazer medidas rígidas com multa e até detenção para conter essa pandemia. É urgente que todos sejam vacinados. Só a vacina é a cura. Mortos não geram riquezas. Só geram tristezas. É fundamental que o presidente acorde e salve o país, o SUS tem o melhor programa de vacinação do mundo, é inaceitável que viva esse caos.', 'Está provado que no embate para restaurar a economia quem vence é a pandemia . É preciso uma atitude enérgica do ministério da saúde enfatizando a importância da vacina, da máscara e de não aglomerar. Que encha o coração do povo de esperança! Que é preciso lutar junto para essa cura chegar logo para todos e tudo voltar ao normal. Que cada um seja seu próprio guerreiro que se salve e salve o outro. Que cada um transfira o que sabe e aprenda o que ensina. Para a economia voltar a crescer só a vacina resolve.']",160,120,120,120,80,600
54,Esclarecimento,"['No ano de 2019, surtos de sarampo têm ocorrido com frequência em diversos municípios brasileiros. Parte disso se deve à diminuição dos índices de pessoas vacinadas contra a doença, o que interferiu na imunização geral da população. Tais fatores culminaram no advento de discussões sobre a evidente importância das vacinas para a sociedade, para o bem-estar social, para a prevenção e erradicação de enfermidades. Mas se é evidente, por que, então, os indivíduos deixam de se vacinar? Duas razões são preponderantes: falta de esclarecimento da população - no cerne - e carência de estratégias efetivas por parte do governo.', 'O esclarecimento é a “vacina contra o medo e contra a ignorância”. Na verdade, a “ignorância é o vírus causador do medo”: a psicologia moderna diz que as pessoas têm medo do desconhecido. Desde quando Oswaldo Cruz tentou vacinar a população contra a varíola, já se percebe, no Brasil, uma relutância da sociedade em relação à vacinação. Em geral, os indivíduos deixam de se vacinar ou de vacinar seus filhos por acharem que a vacina lhes fará mal ou lhes causará doenças . As causas para tais pensamentos são variadas e incluem: falta de conhecimento sobre os mecanismos de ação da vacina, bem como crenças baseadas em falsas premissas (influenciadas por conspirações, correntes disseminadas na internet, notícias ilegítimas e o famoso “ouvi falar...”).', 'Numa outra instância, é responsabilidade do governo adotar medidas mais eficientes para a ampliação do número de pessoas vacinadas. A Constituição Federal Brasileira diz, em seu Art. 227, que “É dever da família, da sociedade e do Estado assegurar à criança, ao adolescente e ao jovem  o direito  à saúde ”. Assim, se a família não cumpre bem o papel que lhe cabe, a sociedade e o Estado devem intervir a fim de sanar essa carência de alguma forma, e isso deve ser feito com parcerias entre Saúde e Educação.', 'Deste modo, o Estado deve promover campanhas de conscientização nas escolas e fora delas, a fim de informar a população sobre os benefícios da vacinação e sobre os mecanismos de ação das vacinas. Deve-se, ainda, alertar para as grandes perdas decorrentes da ausência de vacinação, o que decerto apelará para o lado emocional dos sujeitos, influenciando-os a adotar uma conduta assertiva. A mídia pode ser grande aliada nessas campanhas, disseminando conhecimentos e, nesse sentido, extinguindo a ignorância. Como último recurso contra a negligência de algumas famílias, o Estado necessita levar as vacinações às escolas - semelhantemente ao que foi feito em relação à vacina contra o HPV -, monitorando anualmente os cartões de vacinação dos alunos e, em determinadas situações, aplicando as vacinas que as crianças e jovens necessitam tomar.']",120,160,120,160,120,680
16,O movimento conservador até a Física explica,"['Desde o fim da Ditadura Militar, o movimento conservador vinha sendo reprimido. Tal fato fez com que os simpatizantes desde movimento não encontrassem meios de serem ouvidos em detrimento ao discurso socialista e politicamente correto inspirados em Karl Marx. Até que então, surge uma conversão de preferência das mídias sociais. Tal movimento se mostrou eficaz na transmissão de pensamentos e argumentos que não precisavam ser auditados para alcançar a massiva população. A mudança de orientação política da população brasileira foi bem exposta nas eleições 2018.', 'O consoante filósofo conservador Luiz Felipe Pondé cite que : “Se não fosse por Karl Marx, eu teria conquistado muito mais mulheres”. Através desse trecho é possível constatar que o discurso socialista, de esquerda, aquele que defende de uma forma romântica a igualdade e a liberdade soava muito mais atraente e atual se comparado a questões de ordens econômicas e políticas. Por muito tempo, o movimento esquerdista utilizou a força jovem para ganhar reconhecimento. Deixando os mais velhos, conservadores, com a imagem de pensamento ultrapassado.', 'Outro aspecto de suma relevância para essa mudança de orientação política pode ser exemplificado na Física. Ao utilizar uma mola como exemplo para com o movimento conservador, podemos aferir que: Ao impor uma força sobre a mola, esta irá se retrair. Quando se retira o peso, esta ganha sua maior amplitude. Da mesma forma, o movimento conservador ganhou força sobre a população brasileira. O regime de governo durante muitos anos não deu atenção ao que seus eleitores buscavam.', 'Infere-se, portanto, que o movimento conservador sempre existiu porém estava por muito tempo sendo reprimido. O advento das mídias sociais e sua popularização fizeram que vozes antes não ouvidas ganhassem amplitude suficiente para enxergar os reais problemas da população população, que não mais tolera discursos socialistas em esquecem fatores condicionais á satisfação do cidadão que são segurança, emprego e os índices de corrupção.']",120,120,120,80,80,520
81,A ignorância como intolerância,"['A partir do século XVII, com a Reforma Protestante e a invenção da imprensa, por Gutemberg, surge  inúmeras matrizes religiosas de oposição ao catolicismo. Nesse contexto, aparece também a aversão às diferentes crenças religiosas. A intolerância pode acarretar em sérios problemas, como as agressões físicas. É importante construir na sociedade o respeito aos diferentes modos de expressões culturais e religiosas. Consoante a Constituição Brasileira de 88, todo indíviduo tem o direito de se manifestar de acordo com as suas crenças e interesses, e o Estado deve proteger esses indíviduos. Porém, é vigente no Brasil o total desrespeito à Constituição e o número de casos de agressões ainda é alto. A palavra religião significa respeito, mas grande parte da sociedade insiste em se opor a isso. No século XVI, quando os portugueses invadiram as terras indígenas, o etnocentrismo foi exposto, ? acerca das ideologias dos cativos. Os portugueses, então, impuseram o catolicismo aos índios. Uma reelaboração do que acontece nops dias atuais, como mostra  as estatísticas, a sociedade brasileira tem um enorme preconceito com religiões de matrizes afro-brasileiras. Portanto, é urgente que se constitua, por meio da educação, o respeito às diferentes formas de expressão. Para Hellen Keller, escritora americana, o efeito mais sublime da educação é a tolerância. Nesse sentido, é pontual que as famílias passem para as crianças os valores éticos e morais,   de respeito à pluralidade cultural brasileira. Outrossim, as escolas devem ampliar esses valores, diante da atual conjuntura do país,   para que esses valores possam ser transmitidos para a sociedade.']",160,120,120,160,120,680
54,Vacinar-se é importante?,"['O aumento da desvalorização contínua da importância da vacinação na sociedade brasileira é evidente. Isso deve ser freado , pois as maiores vítimas são as crianças, os idosos e a população em geral. Sendo relevante uma análise dos aspectos que corroboram com essa problemática: descaso do governo e parcela de culpa da sociedade.', 'É compreensível que a questão legislativa e sua aplicação estejam entre os fatores que atenuam o problema. Nesse contexto, é importante enfatizar que, o governo não leva isso a sério e é válido analisar que o desconhecimento acerca da importância da vacina influi em comportamentos inadequados contra os brasileiros . A exemplo de quando em 2018 houve uma forte epidemia da febre amarela que segundo o Ministério da Saúde foi a pior epidemia da doença já registrada no país que levou a óbito 340 pessoas.', 'Além disso, é cabível salientar que, segundo Drauzio Varella, ""A vacina foi a grande responsável pelo aumento da expectativa de vida no Brasil."". Dessa forma, a sociedade se faz plenamente responsável por tal visão da sociedade.', 'Assim sendo, fica evidente a problemática da importância das vacinas no Brasil. Tomando assim indubitável a importância do Governo Federal, mediante o ministério da Saúde. Ainda cabe a mídia o papel de promover campanhas publicitárias, debates em horários nobres, fomentando a conscientização sobre o quão é importante se vacinar. Afim de que, essa problemática de cunho social seja cada vez menos recorrente na sociedade brasileira.']",120,160,80,120,120,600
126,Existe racismo no Brasil?,"['O         preconceito no racial         é tema recorrente de discussão.         Embora não possa se comparar na proporção em outros partes do planeta, tais como o racismo nos EUA e no período Apartheid na África do Sul,tal preconceito ainda persiste no nosso Brasil, por meio de desigualdade social.', 'A escravidão         limitou          a população negra de ser inserida na economia do país, no século XIX.                Com o                 “fim”                da escravidão, muitas pessoas                 de cor escura                não         tinha do que sustentar-se         , não         era aceita         no mercado de trabalho.', 'Muitos por não serem inseridos na sociedade          ficam          sujeitas a          marginalização. Contudo                , o número de estudantes negros em universidades públicas brasileiras é pequeno.         Mais existe         programas sociais, como o sistemas de cotas para tentar diminuir essa diferença.', 'Seria necessário políticas para ser desenvolvida para a melhoria da condição de vida das pessoas com afrodescendência. Cada cidadão brasileiro, deveria colocar um fim nesse preconceito racial.']",0,0,0,0,0,0
148,Ataques terroristas no Brasil?,"['O Brasil                 será                palco de muitos eventos como a Copa das Confederações e a Copa do         mundo         .                 Nesse momento                , a atenção do mundo                 está                voltada para o país que nunca registrou um ataque terrorista. É devido a esses fatores que surge a indagação: os eventos podem ser considerados chamativos para a ação                 desses adeptos                ?', 'A participação da política brasileira nas relações mundiais está crescendo e seu reconhecimento também.                Isso pode chamar atenção dos                 simpatizantes dessa prática violenta                . Alianças com países que são alvos de ataques como os Estados Unidos podem constituir         num         caminho para o surgimento de                 intenções                terroristas                 devido à influência que essas potências exercem no território                , além de outros fatores.', 'Os eventos de caráter mundial que acontecerão no Brasil ajudam                 no crescimento da imagem do país perante a visão internacional                . A partir desse fato e diante         ao         que se sucedeu em eventos passados como a Maratona de Boston, o temor por ataques terroristas é crescente. Pensando nisso e                 em outros ataques onde haja violência                , o país passou a investir em segurança principalmente nas cidades sedes dos eventos.', 'Logo, deve-se privilegiar a segurança do país e dos brasileiros. Para tamanhos eventos, é preciso que o Brasil passe segurança para o mundo, erradicando toda e qualquer dúvida sobre ataques terroristas. Para isso, investir em segurança                 dentro do próprio país, limitando o crescimento da violência através do aumento de policiais                ,         trás         ao mundo maior confiança no país que hoje se tornou o centro das atenções.']",120,80,80,80,80,440
63,Impactos Ambientais,"['O Brasil é um país rico em todos os sentidos, mesmo sendo classificado em desenvolvimento , possui um clima propício para plantação de alimentos, o maior em extensão territorial da América do Sul, água potável em abundância, praias maravilhosas, muitas riquezas com o capitalismo, mas nas mãos de poucos, que ainda conseguem destruir criminalmente. O subdesenvolvimento nesse sentido pode-se dizer que está consumindo a nação, e que a ganância é um mal destruidor, e empobrece, e sendo evidente a destruição, com os crimes ocorridos em menos de 4 anos.', 'No final de 2015 houve o maior crime ambiental mundial da história, ocasionado pela mineradora Samarco, em Mariana Estado de Minas Gerais, o que ocasionou mortes e destruição. A contaminação em 2019 ainda é evidente, o lamaçal que escorreu do rompimento da barragem matou o rio doce, onde muitas famílias se beneficiavam, obtinham seu ganha pão e alimentação, a água já não é mais potável, e provavelmente irá demorar centenas de anos para se recuperar. Em 2019  mais um crime, o de Brumadinho, ocasionado também por uma mineradora, mesma história , ainda mais mortes, contaminação do meio ambiente e destruição.', 'Muitos irão colocar a culpa no capitalismo , pois o desejo por dinheiro a todo custo, sem um monitoramento das extrações é o mais lógico. Mas em todo caso o capitalismo não pode parar e nem deve, é um meio de se viver, e que já existe há muito tempo. Há a necessidade de leis mais rígidas, para que evite crimes, ditos como tragédias, pelos detentores do poder. O Estado tem a obrigação e o dever de rever seus conceitos, criar novas leis, com o Ministério do Meio Ambiente, para que a fiscalização seja mais eficaz, e que possa ser evitado mais destruição desse patrimônio rico. O desenvolvimento para não ser sub., deve ser pensado, balanceado, para que não ocorra novamente.', 'Como dizia John Lennon, a nossa sociedade é gerida por pessoas insanas que tem objetivos insanos . Indiscutivelmente isso deve e pode mudar, um olhar maior, não tão economicamente, mas sim um olhar ambiental, pois recursos que não são renováveis, se perdidos não irá se recompor. Temos um planeta, uma nação, que a ganância está matando, pois, o dinheiro é mais importante, o restante são deixados para trás, não se deve esperar o pior, para poder concertar, e sim evitar que coisas nesse sentido aconteça, e que o patrimônio seja possível de se passar para a próxima geração. Pois dinheiro não se come ......']",120,160,120,120,120,640
85,Ainda há solução,"['Já há décadas atrás* o famoso sociólogo “contratualista” Rosseau afirmava que a participação da população em decisões políticas era essencial. Apesar dos plebiscitos  e das leis de cunho popular serem legitimadas pela constituição, eles não são postos em evidência pelo governo. Para que isso não ocorra, dando voz ao povo, um projeto que institui o voto distrital no Brasil deve ser colocado em prática.', 'Através desse modelo político, o país seria dividido em distritos com apenas um representante cada. Isso faz com que os cidadãos tenham uma maior comunicação com os dirigentes de suas regiões, já que não há um grande número de eleitos como ocorre atualmente. Desse modo, as demandas dos distritos seriam repassadas para um único governante que estaria ciente de todos os problemas de sua área administrada de uma forma mais consistente.', 'Além das questões sociais, a organização dos distritos facilitaria a resolução de falhas políticas como a corrupção. Por possuir uma estrutura mais simples que a atual, na divisão distrital os gastos públicos são melhores distribuídos e organizados, fazendo com que possíveis casos de corrupção sejam descobertos de maneira mais clara.  Por consequência, as cobranças por parte do eleitorado, aumentariam. Ademais, aquela situação estranha em que um candidato de menor expressão é eleito através de outro que conseguiu mais votos, não existiria mais.', 'Logo, ainda que a participação popular esteja posta no papel, não se vê muitos indícios dela na sociedade brasileira; apenas no momento de eleição. Aliás, o voto, muita das vezes, elege governantes omissos e que não suprem as necessidades da população, ou seja, a participação dos cidadãos se reduz ainda mais. O voto distrital seria uma mudança positiva para essa questão, tornando o Brasil um país de todos e  capaz de transformar a realidade atual.']",160,200,160,160,200,880
44,Mulher é mulher,"['""Alguém já parou para comparar os níveis de testosterona do Usain Bolt ?"" Indagou Jackie Silva,embaixadora do movimento Let Her Run. É indiscutível que as mulheres ainda são obrigadas a comprovarem que são capazes de fazer algo ou até mesmo o seu gênero,como aconteceu no esporte. Entre tantos motivos relevantes temos, o preconceito e a falta de assistência.', 'Em primeira análise,é nítido que as mulheres sofrem o preconceito dentro e fora do mundo dos esportes. Um claro exemplo foi o que ocorreu com uma das atletista,que teve seu nível de testosterona verificado,caso o nivel seja alto elas apenas tem duas escolhas,tomarem remédios para diminuir ou serem desclassificadas mesmo sendo natural do corpo dela .No entanto essa atitude não são tomadas na liga masculina.', 'Além disso,a falta de assistência é um ponto a ser ressataldo,uma vez que as atletas são submetidas a humilhações ou até abusos psicológicos,porém não têm a ajuda necessária. Isso faz relembrar episódios que aconteciam no esporte na década de 1960, visto que mulheres eram obrigadas a passarem por exames abusivos para comprovar seu sexo biológico.', 'Fica evidente,portanto,que as mulheres sofrem esse preconceito e que precisam ainda provarem que são capazes ,que ela é uma mulher. Neste contexto, cabe a os organizadores do esporte , junto até mesmo com a população, garantir que a liga feminina tenhar seus direitos exercidos da mesma forma que a masculina,a fim de incluir todos no esporte sem que ninguém precisasse comprovar algo.']",160,160,120,200,160,800
74,,"['Hodiernamente , no Brasil, é notório que muitas conquistas em prol da garantia de igualdade social, política e econômica dos gêneros já foram alcançadas, a exemplo do sufrágio feminino e da maior inserção das mulheres no mercado de trabalho. Entretanto, essas conquistas não foram suficientes para eliminar o preconceito e a violência contra a mulher na sociedade brasileira. Nesse sentido, dois aspectos fazem-se relevantes: o legado histórico cultural e o desrespeito às leis.', 'Ao longo dos séculos, a mulher sempre foi vista como inferior e submissa ao homem. As mulheres de Atenas ficaram conhecidas na história, e na música, como canta Chico Buarque, como exemplos de submissão. No início da idade moderna, Martinho Lutero disse que não há maior defeito numa mulher que o desejar ser inteligente . Atualmente, propagandas, novelas e músicas ainda sustentam e corroboram essa inferioridade, gerando atos de violência moral, física, psicológica e sexual. Exemplifica tal situação o grande apelo sexual da mulher nos comerciais de cerveja e o funk “surubinha de leve”, cuja letra recebeu diversas denúncias de apologia ao estupro. Assim, muitos homens julgam ser normal tratar o sexo feminino de maneira agressiva e desrespeitosa.', 'Somada a essa construção ideológica, a lentidão e a burocracia do sistema punitivo colaboram com a permanência das inúmeras formas de agressão, uma vez que favorece a sensação de impunidade. A vigência da lei “Maria da Penha” possibilitou o aumento no rigor das punições das agressões e mais segurança às vítimas. Além disso, a criação da Delegacia da Mulher contribui para o crescimento das denúncias relacionadas à violência contra a mulher. Contudo, a morosidade processual e fatores como o medo e a submissão econômica ao parceiro, muitas vezes desencorajam as delações.', 'Fica evidente, portanto, que, comparando com décadas anteriores, muito se evoluiu em termos de garantias em prol da mulher. No entanto, no que diz respeito à violência, há muito ainda para ser feito. O Estado deve fiscalizar severamente a celeridade dos processos, para a resposta rápida estimular a denúncia das vítimas. Ademais, as escolas e a mídia devem promover campanhas de conscientização da problemática, estimulando debates de modo a dissolver dos indivíduos os ideais machistas e incentivar a consciência ética e o bom senso.']",160,160,120,160,120,720
49,Nova era de influências,"['No filme brasileiro Modo avião, a personagem Ana é uma influenciadora digital,  e através do uso de suas redes sociais,  influencia seus milhões de seguidores a comprar determinado produto e a seguir certo tipo de comportamento. É observado que os influenciadores digitais crescem cada vez mais e com variados tipos de públicos alvos. Diante disso, é necessário se atentar ao papel desses influenciadores na vida do cidadão.', 'Sob esse viés, é necessário que se discuta as informações, atos e ensinamentos que esses influenciadores passam para os seguidores  visto que isso reflete nas escolhas e futuras ações dessas pessoas. Também deve se destaca a importância de se disseminar conteúdo saudável, que respeitem os direitos humanos e que promovam relações diretas.', 'Outro ponto relevante, nessa temática, a ser discutido é  a alienação do indivíduo frente a tamanho número de propagandas e seu consequentemente, desejo de comprar aquele produto, que por vezes, não lhe é necessário.', 'De acordo com o citado acima, é necessário que a comunidade , juntamente com o governo  desenvolva palestras educacionais, para influenciadores e seguidores para que haja uma união de idéias, e consequentes melhoras nessa área, para que os influenciadores digitais possam continuar fazendo  seu trabalho, sem prejudicar os seus influenciados.']",120,160,120,160,120,680
119,Um samba-enredo que está por vir,"['No carnaval deste ano, a escola de samba União da Ilha do Governador trouxe para a avenida o         samba enredo onde         questionava         ""beleza pura?""         , uma crítica ao mundo que valoriza mais a beleza exterior do que a interior. É nesse contexto         no qual         vivemos atualmente, numa sociedade consumista que almeja padrões de beleza preconizados pela mídia, no entanto, esses desejos podem colocar em xeque a saúde dos indivíduos.', 'Em meados de 1920 o consumismo reinava, no momento presente ele continua imperando veementemente. Com base nisso                , na década de         20         nos Estados Unidos da         América         os cidadãos consumiam bens e serviços, desenfreadamente,         fomentados         por meio de propagandas, sobretudo, acessórios e roupas usadas por modelos nas campanhas publicitárias         no American Way of Life         ou estilo de vida americano.                 Esse cenário na esfera mundial não mudou no século XIX, aliás, foram os meios de comunicação que inovaram com o advento de novas tecnologias.', 'Com a modernização na área de comunicação, a mídia que já tinha uma papel fundamental na divulgação se intensificou. Prova         disso, é         a TV e internet, canais usados constantemente para transmitir                 elevados tipos de vida                e estereótipos a serem obtidos pelo público-alvo, e quem não segue esse paradigma é rotulado de antigo, obsoleto, só         porque         não se deixar         ser persuadido         pelos meios de comunicação         em         massa, contudo, o anseio em excesso por                 padrões estéticos                pode culminar em sérias consequências aos que buscam o modelo ideal.', 'A avidez incessante para se ter         a imagem bela         no meio social pode         acarretar em         efeitos físicos e psicológicos         nos sujeitos         . Um caso recente foi o drama da modelo Andressa Urach, que ficou internada e passou por cirurgias devido a complicações nas coxas por         te         injetado hidrogel, todavia, as marcas não ficaram registradas só no corpo, o seu lado emocional também foi afetado, uma ocorrência que poderia ter sido evitada.', 'Dessa forma, para coibir eventuais casos como o da         vice miss         bumbum, cabe ao governo tomar medidas eficazes que inibam esses acontecimentos, fiscalizando o comércio de produtos para cirurgias plásticas,         a         mídia continuar exercendo sua função social não influenciando         os receptores         ,         a         escola estimular o pensamento crítico dos alunos,         a         família educar os seus membros para que eles se tornem pessoas conscientes de seus atos,         a         sociedade respeitar à diversidade e diante         disso          quem sabe, uma escola de samba não leve para a avenida um          samba enredo          exaltando a beleza como ela é.']",160,160,120,160,200,800
52,Gravidez na adolescência,"['É do conhecimento de todos que a gravidez precoce vem se tornando cada vez mais comum em nossa sociedade. Mas por que isso acontece?', 'No Brasil, a taxa é de 62 adolescentes grávidas, entre 15 e 19 anos, em um grupo de 1000 jovens mulheres . Raramente, a gravidez na adolescência é desejada, pois, na maioria das vezes, essa situação acaba acontecendo por diversos descuidos .', 'Podemos citar,por exemplo, a falta de informação sobre vida sexual e métodos contraceptivos para o grupo juvenil. Usualmente,esses assuntos, ainda são vistos como tabus em diversas famílias, por isso não é muito falado, e as dúvidas recorrentes dos adolescentes não são sanadas.', 'Por esses, e diversos outros motivos, as gravidezes precoces e indesejadas,  acabam chegando causando, muitas vezes, o abandono da criança, risco de saúde para o bebê e para a mãe, e até famílias que não aceitam a gravidez, e acabam expulsando a adolescente de casa..', 'É explicitamente necessária a fundação de ONGs que possam falar sobre vida sexual, gravidez e métodos contraceptivos para o público juvenil, e famílias deixarem a ""vergonha"" de lado para que esses assuntos possam ser discutidos mais abertamente nas casas.']",120,80,80,120,80,480
48,"A saúde como aliada do governo, e não inimiga.","['A Constituição Federal de 1988 - norma de maior hierarquia no sistema jurídico brasileiro- garante a saúde como direito de todos e dever do estado. No entanto, a população se mostra distante da realidade prometida pela norma constitucional, haja vista que a saúde pública no Brasil ainda enfrenta muitos desafios . Nesse contexto, convém analisar a falta de verbas governamentais como impulsionadora do problema, o que causa a queda dos indicadores de saúde da população.', 'É importante ressaltar de que forma a carência de investimentos federais no Sistema Único de Saúde (SUS) se torna um desafio. Isso ocorre porque a falta de verbas ocasiona na incapacidade do sistema em manter leitos de UTI (unidade de terapia intensiva), comprar medicamentos essenciais, entre outros. De acordo com o programa governamental Mais Saúde, mais de 70% dos brasileiros dependem exclusivamente do SUS. Sendo assim, o problema do financiamento é muito grave, tendo em vista que, com a falta de recursos, o país tende a obter uma inversão na curva de mortalidade, devido a alta demanda do sistema.', 'Em face disso, os indicadores de saúde se agravam e geram a diminuição da expectativa de vida do brasileiro. Sob a ótica do filósofo chinês Confúcio,""o homem joga sua saúde fora para conseguir dinheiro, depois usa o dinheiro para reconquistá-la"". Nessa perspectiva, é perceptível a falha no âmbito econômico quando se trata do corte de verbas da saúde, uma vez que, no futuro, os gastos para recuperá-la serão altos, e os desafios serão maiores.', 'Entende-se, portanto, a necessidade em reverter a situação, devendo o Estado prover as condições indispensáveis ao seu pleno exercício. Para tanto, o Ministério da Saúde deve formular um projeto de lei a ser entregue à Câmara dos Deputados que eleve significativamente o percentual mínimo de investimento na saúde pública, a fim de frear a inversão na curva de mortalidade . Tal lei garantirá ao SUS prioridade e irá realçar sua importância no Brasil. Dessa forma, os brasileiros verão o direito garantido pela constituição como uma realidade próxima.']",160,160,160,160,160,800
23,A presença gráfica de produtos transgênicos,"['Ilmo. Senhor Senador', '“O importante não é viver, mas viver bem.” Segundo Platão, A a qualidade de vida é tão importante que supera a própria existência. Entretanto, Essa não é uma condição vivenciada pelos consumidores do mercado brasileiro. Está em transito no senado federal, Um projeto de lei que desobriga os produtores de alimentos de informar aos consumidores sobre a presença de produtos transgênico .', '', 'O projeto de lei (PLC Nº 34), Que desobriga o produtor a mostrar para o consumidor a quantidade de produto transgênico nos produtos comercializados, É uma afronta a saúde publica brasileira. Produtos esses que são manipulados em laboratórios para baratear o custo de produção das grandes empresas, respectivamente,  aumentar os seus lucros. O consumidor tem o direito de saber o que compõe a sua compra, independente da quantidade que esse produto tenha no produto comercializado.', 'Em relação a apresentação da informação, Tem que haver uma mudança no sentido de mudar a percepção da população em relação aos produtos transgênicos. Foram feitos testes em laboratórios, Que provaram que os produtos transgênicos não trazem prejuízos a saúde de quem consome. Então, Não há porque esconder da população se tal produto contem na composição algum tipo de produto transgênico. Peço ao Ilmo. Sr. Senador para que suas posições em relação a esse projeto de lei que feri os direitos dos cidadãos brasileiros.']",80,120,80,80,80,440
91,A volta das Revoltas negacionistas no século XXI,"['Ao afirmar em sua célebre canção, ""O Tempo Não Para"", o poeta Cazuza faz, de certo modo, uma comparação entre o futuro e o passado. De fato, ele estava certo, pois os efeitos do negacionismo científico na sociedade brasileira não são um problema atual. Desde a Revolta da Vacina, o mundo presenciou inúmeros movimentos que negaram fatos científicos, provocados pela desinformação da população. Do mesmo modo, na contemporaneidade, as dificuldades ainda persistem, seja pelas “Fake News”, seja pela ineficiência governamental.', 'Primeiramente, torna-se evidente que a desinformação da população contribui para esse cenário . A esse respeito, Hans Jonas, filósofo alemão, por meio do livro “O Princípio Responsabilidade”, aborda os problemas sociais e éticos criados pelos avanços tecnológicos, demonstrando a necessidade de haver uma nova ética para lidar com alcance sem precedentes do poder tecnológico, uma ética que impõe limites ao processo tecnológico. Nesse viés, com o avanço das novas tecnologias da informação as notícias falsas passaram a representar um grave problema ético, logo, é necessário que se crie um olhar mais crítico da sociedade em relação a certos tipos de notícias, para se evitar a desinformação e, consequentemente, esse tipo de ideologia que nega a veracidade dos fatos científicos . Desse modo, não há como buscar o desenvolvimento científico do país enquanto o Brasil ainda mantiver esse problema.', 'Ademais, é válido destacar que os órgãos públicos não estimulam o desenvolvimento científico. Nesse sentido, a Constituição federal de 1988 assegura, no artigo 218, que o Estado promoverá e incentivará o desenvolvimento científico, a pesquisa, a capacitação científica e tecnológica e a inovação. Todavia, o Poder Público se mostra incapaz de estender o direito constitucional para a nação, visto que, as escolas e universidades não fomentam em seus alunos o desejo pela pesquisa científica, pois muitas vezes não têm recursos suficientes para incentivar esse tipo de iniciativa. Assim, enquanto o silêncio do Estado se mantiver, o Brasil será obrigado a conviver com a negação da ciência.', 'Portanto, medidas são necessárias para mitigar os efeitos dessa problemática no Brasil atual. Para isso, o Ministério da Saúde junto com o governo deve promover campanhas informativas sobre os benefícios que a ciência já trouxe, assim, como deve fomentar a pesquisa científica nas escolas e universidades, por meio de investimentos em infraestrutura para que se possa realizar esse tipo de trabalho. Nesse sentido, será possível formar cidadãos conscientes sobre os benefícios que a ciência já trouxe, e o cenário retratado no século XX com a Revolta da Vacina não voltará a se repetir.']",160,200,160,200,160,880
11,O dilema ecológico,"['Atualmente com o aquecimento global aumentado o aumento do aquecimento global, o ambiente mudou, assim como os animais também, isto também. Isso não só afeta os animais, natureza, animais e a natureza, como também nos afeta de uma forma significativa.', 'Quando usufruirmos usufruímos da natureza, estamos tirando algo que tem que se repor, normalmente este material repor. Normalmente, esse material, como a madeira, por exemplo, vai ser reposto, a árvore cresce, mas reposto: a árvore cresce. Mas não está sendo assim, não desfrutamos, mas abusamos, sem repor e até mesmo algumas empresas sem fiscalização fazem isso de forma totalmente ilegal.', 'A educação básica sobre reciclagem, sustentabilidade e afins é necessária, a necessária. A culpa não é só de quem abusa ilegalmente da estrutura das florestas, entre outros locais. Cidadãos são responsáveis pela saúde do planeta, jogar lixo onde tem que ser jogado deveria ser uma atividade universal. Muitos estão inconscientes não têm consciência sobre o estado atual do planeta e a alienação muda o comportamento de moradores fazendo agravar a situação com ações não saudáveis para à a Terra.', 'Tendo em vista os aspectos observados, deveríamos ter mais fiscais ambientais, fiscalização em empresas que liberam em grandes quantidades de CO2, campanhas para educação de jovens em relação a sustentabilidade e reciclagem. Pois só Pois, quando todo mundo se der conta do que podem pode perder, talvez seja tarde demais.']",120,40,80,80,80,400
62,,"['Durante a Segunda Guerra Mundial, o discurso impulsionado por Adolf Hitler líder do partido nazista na Alemanha levou ao genocídio de cerca de seis milhões de pessoas entre judeus, homossexuais, opositores políticos e entre outros. Na atualidade o nazismo é condenado, porém características como o racismo, xenofobia, homofobia e etc., continuam presentes na sociedade gerando conflitos. Com isso, vários países criam legislações que impedem a disseminação daquilo que ficou conhecido como “discurso de ódio”.', 'No Brasil, apesar de séculos de escravidão vividos no passado, a constante discriminação contra negros ainda persiste, fazendo-se necessário a criação de leis para o amparo dos mesmos . Promulgada em 2010 o Estatuto da Igualdade Racial que busca garantir, principalmente à população negra, a igualdade de oportunidades e combate à diferença, uma série de sanções e punições além da inclusão social de minorias raciais no País se faz presente.', 'Na internet, na tentativa de mitigar o discurso de ódio, empresas de tecnologia se comprometem apagar em menos de 24 horas as mensagens que incitem crime de racismo, xenofobia ou sexismo, exemplo disso foi transmissão de um usuário da rede social “Facebook”  que transmitiu ao vivo um atentado a duas mesquitas na Nova Zelândia, o vídeo e o perfil do usuário foram removidos rapidamente.', 'Visto isso, compete ao Governo e ao Ministério da Ciência, Tecnologia, Inovações e Comunicações (MCTIC) maior vigilância com uso de algoritmos que busquem detectar mensagens de ódio na internet e exclui-los rapidamente, assim como palestras a fim de incentivar a população a denunciar essas mensagens criando assim um “exercito vigilante”, como também a legislação revigorar as leis de amparo às minorias, fazendo assim um país mais inclusivo com diversas etnias.']",120,120,80,120,120,560
122,Crime invisível,"['A intolerância religiosa é um         comportamento, que         atinge o cotidiano de pessoas que pregam ou seguem crenças,         nas         quais são contrárias à maioria aceita pela sociedade brasileira. Essa conduta traz inúmeras consequências, dentre as quais, violência, desrespeito e desmoralização das vítimas do ato.', 'Desde tempos antigos,         onde         o Brasil ainda era escravista, já não se         tolerava         cultos de religiões africanas                 nos engenhos. Os colonos invadiam os          quilombos armados, e          com atos de violência, para devastar qualquer          maneira          de pregação que não fosse a apostólica romana,          aceitada          por eles.', 'Sabe-se         que         hoje, existem leis que         afirmam         sobre a liberdade religiosa no país. Todavia, ainda há pessoas         que         por meio de insultos e intimidações,         acusam         religiões alheias, deixando-as indefesas e humilhadas.', 'A exemplo disso, um fato ocorrido em São Paulo, neste ano, durante a parada gay, despertou a atenção de muitas pessoas, pela desmoralização que ele gerou. Insultos, ofensas e ausência de ética, foram          vistos presentes          durante dias após o ocorrido,          onde pessoas utilizaram de objetos sagrados para muitos religiosos, para quebrá-los e jogá-los ao chão         .', 'Com isso, é inegável afirmar a ausência de intolerância no Brasil                . Deve-se encarar como um problema que não mais é uma exceção.                 Com a prática e desenvolvimento de boas condutas e respeito, desde classes infantis nas escolas do país, o problema diminuiria e quem sabe um dia, o amor e o respeito à diversidade se tornem as maiores armas de todas as nações.']",120,120,80,120,80,520
57,Devemos valoriza-lo.,"['O homem sempre teve o desejo de contar histórias. Desde a época das cavernas, nos as produzimos e com o passar do tempi criamos a necessidade de guarda-las. No Brasil, a setima arte nacional nunca foi dada seu devido valo, entretanto com a invenção e ascensão da internet, a democratização do cinema está cada vez maior.', 'Primeiramente, a invenção dos irmãos Lumirer, transformou a conotação de história . Mesmo sem acreditar no seu invento , o cinema modificou o mundo e autores como Charles Chaplin, nos Eua, e o Mazarropi no Brasil, nao so  revolucionaram, mas também entretaram inúmeras pessoas. Entretanto, com a intensa valorização do que esta fora do país acaba que por gerar uma alienação sobre os conteúdos aqui criados. Deste modo, como o filosofo Marx Weber relata, temos que ter uma ação racional movida a fim de conhecer nosso próprio conteúdo.', 'Em segundo lugar, no Brasil  houve um grande abismo entre a cultura popular e a erudita. O teatro e o cinema eram considerados de cunho mais nobre e graças aos altos valores não eram acessados pelo grande público. Jatualmente, com o advento da internet,  a democratização da sétima arte ganhou força no Brasil . Os programas de streaming, como Netflix, auxiliaram na produção de series nacionais como os 3% e com a opção de inúmeros filmes brasileiros, como o filme Meu passado me condena. Sendo assim, o incentivo para as agências como a ancine é de extrema necessidade e importância.', 'Em suma, o cinema não  só diverte como também pode educar e mudar nossa perspectiva. Com isso, o governo  pode atuar  juntamente com as mídias com a criação de sites com filmes nacionais gratuitos, como foi feito com o Instituto das Artes em Chicago, n qual é disponibilizado um grande acervo artístico. O indivíduo e a sociedade podem também sair de sua bolha social e procurar novos audiovisuais. E por fim os artistas em comunhão com a mídia eo  governo podem divulgar mais seus trabalhos e disponibiliza-los.']",120,80,80,120,40,440
95,RECUPERAÇÃO DAS TERRAS INDÍGENAS,"['Depois em que se passaram tantos anos, os indígenas voltaram a querer ter suas terras que lhe foram tiradas à mais de anos, completando quase que uma década.', 'Várias dessas pessoas se reuniram para que consigam recuperar suas terras de volta, por mais difícil que seja, eles querem sim ter novamente o que os pertence. Algumas pesquisas realizadas informam que os ministros estão tentando recuperar de volta essas terras para que possam entregar aos antigos proprietários sem que haja um conflito maior. Com base em alguns documentos da Constituição federal os originários tem o direito de pegar as terras em que ocupavam em determinado período antes que fossem criados essas novas leis.', 'Provavelmente esses povos irão conseguir suas terras novamente se agirmos conforme as novas leis determinadas pela Constituição e pelo STF .']",160,120,80,120,40,520
92,Como combater o preconceito amarelo!,"['O preconceito é um juízo que se manifesta em atitude discriminatória, perante pessoas, em relação à: sexo, raça, nacionalidade, religião e entre outros, cuja a ideia é formada antecipadamente e não tem fundamento crítico ou lógico. Nesse âmbito, o preconceito amarelo consiste em julgamentos, pré-concebidos, não desarraigados que podem envolver atos de agressões físicas ou psicológicas contra indivíduos com ascendência ou nascência de países asiáticos. À vista disso, o cenário pandêmico atual ilustra tais atitudes descabidas que, ainda, perpetuam na sociedade aos quais faz-se necessário analisar a discriminação encarada pelos asiáticos concernente à Covid-19 e o papel do Estado em combater a problemática.', 'Posto isso, é evidente que a pandemina da Covid-19 disparou o preconceito contra os ascendentes asiáticos. Pois, diante do surto do vírus e da propagação de notícias falsas, tornou-se comum culpar os chineses pela situação mundial, com alegações de que fabricaram a doença e a espalharam. Nesse contexto, a discriminação contra tal grupo aumentou, ao qual incluem: assédio verbal-moral e agressão física em que forçou a necessidade do Instituto Sociocultural Brasil-China (Ibrachina), criar uma central de denúncias para reunir casos, de vítimas, que envolvem violência e preconceito que serão entregues às autoridades. Logo, para reverter a situação é preciso estabelecer debates para evidenciar que o vírus não tem país e que o problema é global, a fim de promover mais informação, respeito e concientização por parte das pessoas.', 'Ademais, cabe analisar o papel do Estado em reduzir a problemática. Sob esse viés, a Constituição federal de 1988 assegura que todos os indivíduos são iguais perante a lei sem distinção de qualquer natureza. Porém, ao contrário do ideal democrático, o aumento de preconceito contra os ascendentes asiáticos denota a pouca participação estatal em combater: o crime, a associação da Covid-19 a tal grupo e as notícias falsas bem como a dificuldade, do órgão, em reforçar leis mais severas contra os agentes responsáveis pelos atos de discriminação. Dessa forma, percebe-se o descumprimento de normativas constituicionais, fundamentais, ao quai exclue indívíduos de medidas socialmente isonômicas e que não contribuem com o progresso social devido à permanência do preconceito e do distanciamento de formar uma sociedade pautada nos aspectos da civilização.', 'Portanto, ações devem ser tomadas para mitigar o preconceito amarelo. Desse modo, compete ao Ministério da Mulher, da Família e dos Direitos Humanos, em parceria com o Poder Legislativo e Ministério da Educação, estipular sanções mais penalizadoras por meio da criação de leis que reforçam multas e senteças mais agravantes para endurecer o julgamento de agentes praticantes de discriminação. Além disso, promover campanhas de debates sobre o assunto nas escolas, afim de contribuir na formação de cidadãos mais conscientes. Assim, todos cidadãos poderão exercer o dereito da cidadania e, finalmente, ultrapassar antigos paradigmas.']",160,160,120,160,160,760
5,O nome é o menos importante,"['A questão do de o atual governo brasileiro liberar mais de 260 (duzentos e sessenta) 260 tipos de pesticídas no cultivo agrícola não é um debate atual, já vem de boas décadas anteriores. O fato é: como vamos lidar com esse alto número liberado, uma vez que vem prejudicando à saúde da população? O Brasil cresceu muito na produção de insumos vegetais, mas, paradoxalmente, não consegue lidar com os fatores negativos do uso dessas substâncias.', 'Em primeiro lugar, é normal a utilização de pesticídas pesticidas para combater às as pragas advindas das das lavouras. E nesse cenário, o mercado brasileiro evoliu  muito, produzindo mais por hectares, o que justifica seu alto índice de emprego dos agrotóxicos nos alimentos plantados.', 'Entretanto, o que não se admite, e isso ocorre cada vez mais, é usá-los sabendo que prejudicam o Meio Ambiente meio ambiente, especialmente o ser humano. Não estamos sabendo lidar com esse aspecto negativo que está manchando a imagem do nosso Estado, trazendo mais conflitos internos de interesses e divisão política, e a população acaba refém da informação mal veiculada, a qual usa nomenclaturas não técnicas.', 'Outro sim Outrossim, é que cada grupo vai defender sua bandeira ideológica. Uns dizem que é em razão de ganhos lucrativos, outros argumentam que sem eles não seriam capazes de produzir em grande escala devido às exingências dos consumidores. De qualquer forma, o posicionamento varia frente ao lado que se luta.', 'Destarte No entanto, a questão do nome é o menos importante nessa seara área. Porém, defensivos agricolas são uma terminologia que não remetem remete negativamente no seio social, devendo ser adotada nesse contexto. Eles foram criados para controlar e combater às as pragas da lavoura. Um controlhe rigoroso desses produtos oriundos daqueles que são nocivos e Punições celeres e  mais severes severas para os infratores que usam sabendo que são universalmente proibidos na no plano nacional e internacinal .']",80,80,80,80,80,400
92,,"['Segundo Albert Einstein ""É mais fácil desintegrar um átomo que um preconceito"", tal frase retrata contemporaneamente a intensificação da discriminação sobre os asiáticos em virtude do surgimento e propagação do vírus Sars-Cov-2, a princípio identificado em território oriental e atualmente propalado para todo o planeta, assim, tendo aproximadamente quatro milhões de vidas cessadas.', 'No entanto, observa-se que tal cenário não foi originado com a pandemia, apenas se intensificou e exteriorizou a aversão ao povo de coloração amarelo, os quais são associados a adventos maléfico desde o século XIX, quando a imigração para o ocidente foi qualificado como destrutiva no processo de embranquecimento da população, por se tratarem de ""negros amarelos"" . Desta forma, se torna evidente que o estereótipo xenofóbico instituído na sociedade brasileira, ocasiona a idealização de um prejulgamento ardiloso, o qual atualmente está sendo propagado de forma inconsequente por inúmeros indivíduos.', 'Entretanto, em paralelo aos fatos descritos, constata-se no momento atual, a inviabilização a problemática de tais acontecimentos, de modo a intensificar o estigma racial criado e camuflar antipatias étnicas, tendo por consequência, o aumento de forma exponencial de ataques contra os orientais, de modo que segundo dados, em um mês mais se 1500 casos de discriminação relacionadas doença forma registrados no Brasil.', 'Portanto, fica evidente a necessidade de medidas que advém a combater o preconceito amarelo. Sendo assim, de suma importância que o governo federal - órgão responsável pelos interesses do Estado - elabore um plano nacional de conscientização à prática e disseminação de conjunturas preconceituosas, por meio de campanhas educacionais com a finalidade de esclarecerem circunstancias disseminadas erroneamente, em conjunto ao judiciário, de forma que pretende-se que o governo efetive de maneira plena as leis existentes, as quais punem quaisquer tipos de discriminação ou preconceitos de raça, cor e etnias. Por conseguinte, assim como a desintegração de um átomo tornou-se simples na modernidade, preconceitos poderão ser quebrados.']",160,160,120,160,200,800
55,Qual importância de valorizar e garantir os direitos dos povos indígenas no Brasil?,"['Em pleno século XXI,  diversos grupos sociais ainda lutam para garantir seus direitos. Não menos importante, os povos indígenas, no Brasil, possuem entraves na garantia dos seus direitos no que tange a sua dignidade humana, apesar de esse grupo social ser um atrimônio histórico e cultural do país. Nesse sentido, valorizar e garantir os direitos do indígenas é de suma importância para a identidade nacional brasileira. Desse modo, cabe analisar esses pontos importantes supracitados e suas entraves , considerando a intervenção do aparato estatal para reverter esse quadro.', 'Em primeira análise, deve-se pontuar que os direitos dos povos indígenas não vêm sendo garantidos em razão da política-estrutural do Brasil. Já que, na formação do Estado brasileiro, do século XVI ao XXI, houve uma invisibilidade sócio-cultural, dos povos indígenas e dos demais grupos sociais, como forma de manipular as pessoas e manter sobre elas. Hoje, esse entrave deixa esses povos sem dignidade humana;e, consequentemente, desprovidos de direitos, haja vista que, embora a Constituição de 1988 afirme que todos são iguais em dignidade e direitos, há brechas no aparato estatal que permitem a ocorrência da invisibilidade sócio-cultural dos índios até então. Sob essa perspectiva, é preciso garantir os direitos desses povos brasileiros frente a notoriedade de não ferir a Constituição no que diz respeito a dignidade humana.', 'Ademais, esse quadro é ainda corroborado pela desvalorização dos índios no Brasil. Tristemente, boa parcela da sociedade brasileira não compreende a importância dos povos indígenas na construção identitária do país devido a resquícios xenofóbicos da era colonial. Em contraste, no livro O triste fim de Policarpo Quaresma, do escritor brasileiro Lima Barreto, o protagonista defende o uso da língua Tupi Guarani como oficial do Brasil - pois ela que realmente seria nosso dialeto materno - com a finalidade da sociedade romper com as visões eurocêntricas e valorizar a cultura originada no Brasil. Dessa forma, uma mudança nos valores da sociedade catalisaria a valorização dos povos indígenas e consolidando, portanto, a identidade nacional.', ""A fim de reverter esse quadro, o Governo Federal, juntamente com a Fundação Nacional do Índio , deverá implementar o centro ''Identidade indígena é nossa identidade nacional'' nas esferas municipais e estaduais do país. Esse centro,  oferecerá palestras e documentários ministrados por representantes indígenas para a sociedade brasileira, como forma de valorizar os índios.""]",120,120,120,120,80,560
85,Voz do Povo,"['A iniciativa popular de lei é a melhor maneira de o povo participar diretamente e ativamente da política de nosso país, uma vez que o sistema adotado é a democracia indireta. Dentro de sua história, o Brasil já realizou um projeto de lei de iniciativa popular que revelou o quanto a participação do povo é fundamental para a democracia. No entanto, a participação direta do povo ainda é insuficiente, o que nos faz refletir se há uma parcela de cidadãos que desconhecem essa parte da Constituição Federal ou simplesmente a ignoram.', 'A Lei da Ficha Limpa foi um projeto de iniciativa popular criado com o intuito de combater a corrupção eleitoral. A lei contou com 1,3 milhão de assinaturas de cidadãos de todos os estados brasileiros e do Distrito Federal, segundo o Tribunal Superior Eleitoral (TSE). Entretanto, o número de assinaturas não representou nem 5% de toda a população nacional. Logo, nota-se que há uma parcela da população que é negligente e não é coautora de sua política, pois renuncia de seus direitos constitucionais.', 'Através da iniciativa popular de lei, a população conquistou uma liberdade política que não é comum dentro do sistema de democracia indireta. Não obstante, o povo brasileiro encontra-se hoje impedido de definir sobre o que ele quer ou não ser consultado, pois apenas os parlamentares estão aptos a determinar isto, violando o princípio da soberania popular. Portanto, é imprescindível que nossos representantes abram mais espaço para a democracia direta e participativa.', 'Em suma, o governo federal deve utilizar os meios de comunicação para informar à população brasileira sobre a democracia participativa existente em nosso país. Além disso, nossos representantes devem ser mais receptivos para ouvir e consultar a o povo sobre questões relevantes para a nação. Tais medidas propiciarão mais adesão às iniciativas populares de lei e promoverão a efetividade da democracia no Brasil.']",200,80,160,200,160,800
75,O livre porte de armas no Brasil,"['É inquestionável que,  em um país com grande histórico de violência, e que registrou no ano de 2016 cerca de 61.619 mortes violentas, a grande parte delas, ocasionadas por arma de fogo, a medida é vista como um retrocesso. Não meramente para os especialistas, mas para o contingente demográfico brasileiro, que segundo pesquisas do Datafolha, mais que a metade da população se mantem contraria a decisão.', ""É incontrovertível que, todo esse debate supracitado é acarretado de uma serie de imbróglios impetuosos que enfrentamos diariamente, seja de conjuntura direta (na nossa família, amigos ou conhecidos) ou de conjuntura indireta (através dos noticiários). Tais atos ocasionam revoltas, fazendo com que a nação brasileira queira tomar posicionamento, fazendo ''justiça com as próprias mãos'', além da necessidade de se sentir seguro e protegido. Todavia, isso acarretaria um retrocesso descomunal, uma vez que,  o cidadão honesto que sai armado, não sabe manejar uma arma de fogo, pondo sua vida e a vida de outras pessoas em risco. Segundo João Paulo II, a violência destrói o que ela pretende defender: a dignidade da vida, a liberdade do ser humano."", 'Por conseguinte, é necessário que a regência brasileira trabalhe para dar segurança aos habitantes, intervindo diariamente em pró dos cidadãos. Os meios de comunicação, precisam trabalhar em meio da conscientização, mostrando que tal decisão seria um retrocesso descomunal, não permitindo tal ato que poderia ser considerado o fim de uma nação.']",120,120,120,120,80,560
1,Avanços tecnológicos,"['No que se refere aos avanços tecnológicos no Brasil, nota-se que, atingiu que atingiram diretamente à população em seu meio social, na qual, trouxe trazendo diversos benefícios e malefícios para os usuários. Em contrapartida, essa realidade impôs novos desafios para a sociedade contemporânea.', 'Nesse contexto, é conveniente destacar, que destacar que muitos indivíduos indivíduos, até mesmo crianças, estão sujeitas sujeitos a manipulações, que pode podem ser inadequadas. Infelizmente, como há pessoas de má conduta que utiliza utilizam a internet para atraí atrair pessoas fragilizados fragilizadas, é de fundamental importância o acompanhamento familiar.', 'Cabe ainda ressaltar, que ressaltar que tal meio se transforma em uma forma de lazer para todos os indivíduos, e com os avanços tecnológicos, irá conduzir mais ainda os telespectadores através dos seus gostos.']",0,0,0,0,0,0
94,A inclusão na contemporaneidade,"['Na Antiguidade Clássica, rejeitar e abandonar crianças portadoras de deficiências físicas ou transtornos mentais era uma prática comum entre os povos gregos e romanos. Atualmente, por mais que esse hábito hediondo tenha desaparecido e a vida dos indivíduos com condições especiais esteja sendo mais valorizada, milhares de autistas ainda enfrentam sérias dificuldades de inclusão social no Brasil. Nesse contexto, é importante analisar a desqualificação dos profissionais e o preconceito como principais aspectos motivadores dessa problemática.', 'Convém ressaltar, a princípio, que a inexperiência, somada à falta de treinamento de muitos professores de Educação Especial, resultam na estagnação social e intelectual dos alunos. Segundo o filósofo Sêneca: “A educação exige os maiores cuidados, pois influi sobre toda a vida”. Nesse sentido, a capacitação de um corpo docente instruído e versado, capaz de assimilar as particularidades de cada sujeito, é indispensável ao desenvolvimento das capacidades cognitivas dos autistas. Tendo em vista os obstáculos na comunicação e interação social dessa parcela da sociedade, cabe aos orientadores auxiliarem e estimularem a socialização para com os colegas de classe, professores e funcionários.', 'Além disso, a utilização do autismo como um adjetivo pejorativo cria concepções discriminatórias que comparam o transtorno a doenças mentais mais graves, como a demência. De acordo com o filósofo Diderot: “A ignorância não fica tão distante da verdade quanto o preconceito”. De maneira análoga, depreende-se que um dos problemas da inclusão não está pautado no desconhecimento dos brasileiros acerca do distúrbio, mas sim em noções equivocadas que, além de denegrirem a imagem dos autistas e levarem muitos deles ao isolamento social, suscitam a difusão de informações falsas sobre o transtorno.', 'Portanto, diante o problema apresentado, faz-se inadiável a execução de medidas estratégicas capazes de promover a integração desses indivíduos na sociedade. Para tal, é papel do Ministério da Educação – órgão responsável pelas políticas educacionais – providenciar a qualificação dos profissionais da Educação Especial e elucidar o conceito de autismo, por meio de palestras e seminários webconferenciados para alunos e professores, a fim de que haja pleno desenvolvimento individual dos autistas e maior compreensão a respeito de todos os fatores que envolvem o distúrbio. Somente assim, ampliando a educação, será possível contrariar a moral greco-romana e valorizar toda e qualquer vida.']",160,200,160,200,200,920
78,A mudança sublime,"['A Reforma do Ensino Médio,  está relacionada com a busca de melhoria na Educação , fazendo com que esse novo método prepare durante 3 anos o aluno para o mercado de trabalho ou o incio de uma faculdade sem muitas dificuldades.', 'Possivelmente pode-se analisar que sim, mudará muitos os conceitos e pensamentos dos alunos que frequentam o Ensino Médio, mais para que essa mudança ocorri de forma satisfátorias, precisam de investir também no Ensino Fundamental trabalhando de forma mais detalhada durante o incio o projeto teria mais sucesso com esse novo ensino, pois obtendo uma base qualificada os resultados são intenso.', 'Entretando  a reforma do ensino, será uma solução para o Brasil, mais para isso essa reforma tem que ser também no maternal e no primário que é o pivo da questão.', 'O Ensino Médio atual tem grande indisponibilidade e é dificultoso para alguns alunos tendo materias muitas vezes desnécessárias . Com o novo ensino médio toda essas negligência está a ser resolvida com novas propostas.']",80,80,80,80,80,400
67,,"['Nas palavras de Oswaldo de Andrade“Quando o português chegou debaixo duma bruta chuva vestiu o índio que pena! Fosse uma manhã de sol o índio tinha despido. Na perspectiva do leitor  ao entrar em contato com o poema torna-se, possível observar que os índios sofreram inúmeras mudanças em sua cultura devido a interação com outros povos. Um exemplo notável foi a chegada dos Jesuítas ao Brasil, e a catequização proporcionada pelos mesmos , como forma de tornar os índios acessíveis aos seus interesses, como intensificação de fis e a exploração de ouro.', 'Segundo os dados da Fundação Nacional do índio (Funai)  existem atualmente, 460 mil índios residindo em aldeias no Brasil. Estima-se que que anteriormente a chegada dos colonizadores haviam de 4 a 5 milhões de índios em terras brasileiras, mas os massacres realizados pelos mesmos e, posteriormente, os conflitos com fazendeiros e garimpeiros que invadiram terras indígenas contribuíram para a decréscimo da população indígena. A diminuição dos alimentos, desmatamento e o avanço das cidades foram fatores que motivaram parte dos povos indígenas a migrarem para os centros urbanos, principalmente na década 50, com a intensificação do desenvolvimento industrial.', 'Logo, a entrada do índio na sociedade é complicada , pois a maior parte dessa população não tem estudo e torna-se difícil sua inserção no mercado de trabalho, sobrevivendo em alguns casos apenas do artesanato, ou da mão de obra barata sem carteira assinada, sendo assim a maioria vive em total pobreza, em áreas de ricos, possuído grandes dificuldades no atendimento de saúde, devido ao forte preconceito e a descriminação como sugere os dados do Instituto Brasileiro de Geografia e Estatística (IBGE) 49% dos indígenas que moram nos centros urbanos por medo de represálias tendem a negar suas origens culturais.', 'Dessa forma, nota-se que mudanças são necessárias para resolver esse empasse. Estratégias governamentais que incluem que os índios possam viver nas cidades e ter os mesmos direitos dos demais. E medidas protetivas que auxiliem na manutenção dessa população, suprindo suas necessidades como incentivos, e acesso a saúde, leis que auxiliem nos processos regulamentação dos direitos trabalhistas para esse público e assistência por meio de funcionários da saúde que promovam ampará-los. Pois, os índios são parte constituinte do Brasil, e precisam ser mais valorizado pela sociedade.']",120,200,160,160,120,760
59,O descaso do investimento no povo brasileiro,"['Desde 1808, quando Dom João VI transferiu corte portuguesa para o Brasil, o país apresenta uma clara classificação social, onde o poder e as riqueza se concentra na posse de poucos e os demais se contentam-se com pouco . Mesmo estando entre os dez países com o maior PIB do mundo, o Brasil também está entre os dez países com a maior desigualdade social. Essa disparidade econômica devesse a dificuldade de acesso aos serviços básicos e aos baixos salários dos trabalhadores.', 'Poucos brasileiros tm acesso a saneamento básico e a transporte, educação e saúde de qualidade. As populações periféricas são as que menos têm acesso aos serviços básicos, elas se concentram em favelas e nas regiões interiores do país, onde os governos investem menos dinheiro. Com o baixo investimento e a grande concentração de pessoas a qualidade desses serviços se torna precária, às vezes são inexistentes, e os habitantes um desfavorecido Índice de Desenvolvimento Humano (IDH).', 'A maioria dos brasileiros vive na condição de trabalhadores, ondem recebem salários que não permitem que eles invistam em melhorias para sua qualidade de vida. O salário mínimo brasileiro é suficiente, apenas, para subsidiar os custos de vida básicos, ou seja, com ele é possível apenas pagar a alimentação e poucos outros gastos necessários para a vida em sociedade. Essa condição impede que a maior parte da população consiga fazer planejamentos para o futuro e investimentos em “luxo” que forneçam uma condição mais igualitária entre empregados e patrões, entre a massa e a elite.', 'Assim a desigualdade no Brasil é um retrato de fatores, como o pouco acesso aos serviços básicos e os baixos salários, que a maior parte da população brasileira sofre. Maiores, e melhores, investimentos dos governos em saneamento, educação e saúde permitirá que as pessoas consigam ter uma melhor qualidade de vida, favorecendo assim o aumento do IDH. Um reajuste mais adequado do salário do trabalhador brasileiro também pode melhorar a condição social das pessoas que possuem renda na classe baixa e média. A desigualdade social é histórica no Brasil, mas o país, atualmente, é uma importante potencia econômica com grande possibilidade de crescimento, para que nosso IDH cresça é necessário que seja feito mais investimentos nos brasileiros.']",120,120,80,120,80,520
84,portes de armas pela população civil,"['Portes de armas pela população civil', 'Como ninguém esta livre de violência, temos que nós defender. Porém como nos defender nos dias de hoje? Uma das bandeiras de Obama é dificultar a venda de armas para pessoas com histórico criminal ou doenças mentais, certo  que com essas condições diminua o índice de morte por armas de fogo. As mulheres são as maiores vitimas do desarmamento. Os bandidos dominam as armas chamando a atenção sem dar oportunidade paras os outros.', 'Com as condições mais rígidas fica melhor, portanto , já sabemos que nem todo cidadão poderá ter o porte legal de armas, somente aqueles que seguirem as instruções e estiver dentro das condições propostas. O que ocorreu nos Estados Unidos foi um verdadeiro massacre, mais isso também nos mostra que muitas pessoas sem ter a posse legal de armas, têm armas. Se as armas não for  para o cidadão, é para os bandidos!  A criminalidade não tem fim.', 'Se o cidadão de bem for proibido de ter a posse legal de armas, ele se torna um alvo fácil para os bandidos; porem, se um cidadão de bem tiver a posse legal de armas será mais difícil, não quero dizer que ele estará livre de ser um alvo mais sim que ele estará mais protegido e seguro. Os bandidos, dominar , tm exclusividade sobre as armas. Isso nós mostrar quer , enquanto o cidadão de bem não pode ter armas, os bandidos tm o caminho livre para, roubar, matar, estrupa , fazer o que eles bem entenderem enquanto o cidadão fica parado sem pode se defender! As mulheres são alvos muito fáceis para os bandidos; tentativas de estupro são consumadas 32% das vezes, mas o índice cai para 3% quando a vitima está armada. A proteção adicional que uma arma de fogo oferece a mulher e enorme.', 'Logo, Todo cidadão tem o direito de se defender, desde que ele saiba como fazer isso para não prejudicar ninguém. Tem que sabe como e quando deve usar a arma, certo que a criminalidade não vai acabar, mas a segurança do cidadão pode aumentar. “bandidos tem mais medo de enfrentar uma vitima armada do que a policia”. O ser humano tem o direito de não ter sua integridade física ameaçada ou violada. Não importa raça, tribo, cor ou religião o importante e ser feliz e viver tranquilo e seguro, sem medo do que pode acontecer.']",80,160,120,120,160,640
6,"Amazonas, um bem de todos nós","['Amazonas, sem ela ele os dias do brasil Brasil estão contados, o presidente jair bolsonaro, devia contados. O presidente Jair Bolsonaro deveria estar fazendo algo para-lhe para mostrar para nos nós, brasileiros, mais eu na verdade mas eu, na verdade, acho ele deve estar brincando com a as nossas caras.', 'Mas e ele nao Mas ele não sente o ar pesado de poluição e desmatamento, à amazonas ela desmatamento. O Amazonas é importante para uma parte do planeta, ou melhor ela melhor, ele gera oxigênio limpo e puro e puro. Mas, com esse incêndio, muitos estados de outros países vizinhos estão sofrendo com a umidade relativa do ar, à amazonas Amazonas e bem da sociedade que se importa com a natureza e também com o planeta, mais mas uma coisa é certa logo esse incêndio ira irá ser controlado e apagado para a felicidade da nacionalidade brasileira...']",0,0,0,0,0,0
25,Procura-se tolerância,"['É notório como notícias envolvendo o homossexualismo inflam as redes sociais e polarizam opiniões. O mais recente exemplo disso foi o novo projeto de lei que defere a terapia para o tratamento de transtornos de orientação sexual. Entre os principais aspectos aflorados pela sociedade pós-projeto há a liberdade de escolha e o possível fortalecimento da homofobia.', 'Primeiro, parte da população demoniza essa terapia, caracterizando-a como desumana e um retrocesso ao nazismo. No entanto, deve-se salientar que tal tratamento, apesar de não ratificada sua eficácia, tem como público heterossexuais, homossexuais ou bissexuais que estejam insatisfeitos, dúbios ou sofrem com sua orientação. Ademais, em parte dos casos, abuso e estupro na infância e na adolescência tem como origem do transtorno desses indivíduos. Logo, esse público, por livre arbítrio e cientes da não garantia de resultados, possuem direitos de buscar uma solução ou compreensão de seus desejos sem haver constrangimento ou censura.', 'Em segunda análise , há aqueles que predizem o aumento da violência contra os homossexuais após a suposta cura. Porém, são notícias sensacionalistas e falaciosas nas redes sociais e em alguns jornais que espalham a ideia de que o Legislativo está tratando o homossexualismo como patologia, o que não pode ser confirmado na litura do projeto. Além disso, apenas o Brasil, Equador e Malta vetam esse tipo de terapia, todavia, mesmo assim, o primeiro é líder em homicídios de pessoas LGBT, de acordo com o Grupo Gay da Bahia. Dessa forma, o que precisa ser combatido é a intolerância e violência contra as minorias, não a censura. .', 'Sendo assim, é de suma importância a placidez da sociedade para lidar com o tema e buscar pela informação em sua origem. Ademais, cabe aos poderes Legislativo, Executivo e Judiciário a garantia da liberdade científica em consonância com os direitos humanos para que a terapia não seja utilizada coercitivamente em crianças e adolescentes que são elucidadas sobre seu ser. Destarte, a sociedade deve compreender o sentido intrínseco ao homem da sua orientação sexual para que haja respeito, mas há fatores externos e internos que podem interferir, o que, nessas situações, também deve haver consideração social ao desejo de mudança. .']",80,80,80,80,0,320
82,Automedicação não!,"['Uma prática muito comum adotada pela grande maioria da população é a automedicação. Tal problema está relacionado ,a   grande impossibilidade de uma boa parte das pessoas terem acesso a atendimento médico, ? e a facilidade de comercialização de remédios são  umas das causas para sua existência , trazendo consequências  graves , como reações alérgicas , intoxicações , dependência e até a morte.', 'O autoconsumo está ligado  a uma questão cultural, em que as pessoas primeiro buscam o remédio na farmácia para depois iniciar um tratamento ,sob orientação de um especialista, e a maioria das pessoas se automedica devido à dificuldade de conseguir atendimento imediato nas unidades de saúde , logo ? vão à drogaria adquirir medicamentos por indicação de amigos ou parentes. Além disso, a compra de fármaco facilitada e a grande variedade de informações disponíveis, sobretudo em sites, blogs e redes sociais , também está  entre os fatores que contribuem para a automedicação.', 'O risco mais frequente a  saúde das pessoas ,? que tem  o hábito de automedicar   está no perigo da intoxicação e resistência aos remédios ,por isso ? uma dose acima da indicada , administrada por via inadequada ou sem uso para fins não indicados , podem  transformar um inofensivo remédio em um tóxico perigoso. Um exemplo disso, ? foi a tragédia com o uso da Talidomida ( medicamento usado como sedativo) na década de 60, onde nasceram milhares de crianças com defeitos de nascença devido o  seu uso por grávidas para diminuir náuseas e vômitos. Além de que,  o uso indiscriminado de fármacos, usado sem uma orientação especializada é um risco de reações indesejadas, como reações alérgicas, como também   pode baixar os níveis de células de defesa encontrados no sangue.', 'Em virtudes  dos fatos mencionados, possíveis soluções para minimizar esse problema seriam o governo melhorar a disponibilidade de atendimentos médico, além de fiscalizar os estabelecimentos de vendas de remédios e controlar a sua compra  através  de receita médica. Ademais, as ONG’S   devem fazer campanhas de conscientização para a população da importância do consumo de medicamentos com responsabilidade.']",120,160,160,120,160,720
43,Tribunal da Internet,"['O ser humano como ser pensante e racional é dotado do pensamento crítico, a internet se transformou em um segundo universo totalmente paralelo ao nosso, faz com que hábitos culturais já existentes sejam transportados para esse mundo virtual e alguns são até reinventados, como é o caso do linchamento que hoje se assemelha a cultura do cancelamento nas redes sociais. O que é o essa cultura e quais são seus motivos e consequências?', 'Em primeiro plano, por muito tempo as pessoas foram linchadas por praticarem atos que destoavam dos demais membros da sociedade, como por exemplo as mulheres acusadas de serem bruxas, apenas porque tinham conhecimento sobre algumas ervas medicinais, eram queimadas em fogueiras, agredidas em praça pública. Esse senso quase que comum, se enraizou na sociedade, e se consolidou na era da internet onde todos estão sob evidência, o filósofo Luiz Felipe Pondé diz que  ""a cultura do cancelamento é a transposição do gosto do linchamento para o ambito das redes sociais"".', 'Em segundo lugar, atualmente esta prática é realizada pelo ""Tribunal da Internet"" que minuciosamente se atenta a temas como violência contra a mulher, racismo, meio ambiente, política e outros temas, as ações humanas principalmente de autoridades ou celebridades que possuem muitos seguidores nas redes sociais podem desagradar uma certa parcela da população e gerar críticas que dado o tamanho da repercussão custa a essas pessoas o próprio emprego, desgasta a imagem, e em alguns casos rendem até ações judiciais.', 'Portanto pode-se inferir que o cancelamento vai muito além da simples punição por práticas vistas como inadequadas na redes, ele tem um cunho de justiça social onde a sociedade se demonstra organizada em defesa de valores em que acredita. O mundo virtual não pode ser interpretado como terra de ninguém, cabe às redes sociais  determinarem normas de convívio e aturem com mais rigidez e garantir a fiscalização dos conflitos para que todos possam explorar ao máximo a vida virtual de maneira segura e respeitosa.']",160,160,160,200,160,840
52,Gravidez,"['Na constituição ederal brasileira de 1988,  são garantidos direitos básicos aos cidadãos, tais como: moradia, alimentação, educação de qualidade, sem contar que segundo ela, todos são iguais em direitos. Entretanto com a gravidez precoce, que é um grande problema de saúde pública e da sociedade, esses direitos muitas vezes não são garantidos. Sendo assim convém analisar as causas, consequências e possíveis soluções para a problemática.', 'A adolescência é uma fase de grande mudança, onde surgem muitas curiosidades, são estas que induzem os jovens muitas das vezes a procurarem o sexo, sendo que a desinformação ou o descaso em relação aos métodos contraceptivos pode levar a uma gravidez indesejada. Os adolescentes precisam ser informados, visto que os índices de gravidez nesta fase está alto, só em 2011, segundo a OMS (organização undial da aúde), ocorreram $533.103 nascimentos entre meninas com idade entre 15 e 19 anos.', 'Quando a gravidez é precoce, há grandes riscos não só para a vida das meninas mas também para a de seus bebês, pois o copo de uma adolescente não está tão bem preparado para dar luz um bebê, como o corpo de uma mulher adulta . É importante salientar ainda que a gravidez precoce na maioria das vezes leva a evasão escolar, que por sua vez promove a manutenção da pobreza, que é contrária a constituição cidadã e isso é inaceitável para uma democracia.', 'Portanto, indubitavelmente, para tal realidade ser modificada, o governo precisa disponibilizar preservativos gratuitamente nos postos de saúde, cujos profissionais devem promover palestras as escolas, expondo a importância dos métodos contraceptivos(principalmente da camisinha) e dizer que o governo disponibiliza preservativos gratuitamente nos postos de saúde. Com isso, espera-se transmitir informações aos jovens, pois, como disse Nelson Mandela, a educação é a arma mais poderosa que se tem para mudar o mundo.', 'Nome: Agnaldo Alves Xavier..']",120,160,80,120,80,560
90,Transfobia em evidência no Brasil,"['Transfobia é aversão a alguém transgênero. Esse sentimento causa disseminação de repugnância e descaso na sociedade, mas como dizia o filósofo e educador, Paulo Freire: “A violência não é força, mas fraqueza, nem nunca poderá ser criadora de coisa alguma, apenas destruidora “. A violência persiste em uma sociedade preconceituosa, sem escrúpulos para lidar com a situação de outra maneira, como é o caso da transfobia que gera preconceito pelo fato da sociedade brasileira não acompanhar as mudanças sociais, políticas e econômicas que perduram há anos, além do temor pelo novo e pela mudança.', 'Primeiramente, é de extrema importância destacar,  o fato que ocorre há anos no Brasil que são as mudanças contextuais. Ao longo do tempo, mudanças políticas, assim como, a economia que muda o tempo todo, são naturais de acontecer, pois essas mudanças são o conceito básico de uma sociedade. Antigamente, transexuais, homossexuais era algo incomum e diferente, que apenas uma parcela da população conhecia e isso gerou um sentimento preconceituoso, mas atualmente isso é normal, essa transformação pessoal ocorre por escolha e preferência, porém, muitos ainda não respeitam, devido à falta de acesso e conhecimento sobre essa classe de informações que mostram o mundo atualizado e promove sabedoria do que acontece hoje com esses grupos que sofrem dessa repressão, ainda que, para eles é mais dificil se aceitar, do que a própria sociedade aceitá-los, justamente por conta dessa intolerância e perseguição.', 'Ademais, essas mudanças são temidas por muitas pessoas que apresentam a visão de um mundo conservado, onde qualquer diferencial se torna motivo de preconceito, porém, para o ex-presidente John Kennedy: “a mudança é a lei da vida. Aqueles que olham apenas para o passado ou para o presente serão esquecidos no futuro"". Entretanto, a transexualidade precisa ser aceita e, principalmente, respeitada, pois assim, futuras gerações vão tornar a sociedade menos preconceituosa e menos desequilibrada, promovendo maior desenvolvimento, empatia e crescimento pessoal dos cidadãos.', 'Concluindo, o principal instrumento que deve ser usado para diminuir e acabar com a transfobia, são as redes sociais onde os influenciadores digitais devem se manifestar sobre o assunto, mostrando dados e histórias de pessoas que sofreram pela transfobia. Além disso, a televisão deve fazer a inclusão de pessoas de sexualidades diferente em propagandas, novelas e outras produções televisivas, assim promovendo respeito e aceitação de todos na sociedade.']",160,120,120,160,160,720
72,,"['O Facebook, criado por Mark Zuckerberg, é uma das principais redes sociais de divulgação de notícias de diversos sites. Não obstante, tais conteúdos nem sempre apresentam veracidade e põe em pauta na atualidade o desafio de se combater as chamadas “ake ews”. Nesse contexto, é preciso enfrentar o fenômeno da propagação de notícias falsas, pois, do contrário, decisões desprovidas de senso crítico irão compor o cenário das eleições presidenciais.', 'Em primeira instância, cabe pontuar que a viralização de informações equivocadas nos meios de comunicação “aprisiona” o indivíduo tal qual a caverna citada pelo filósofo Platão. Aplicando essa didática platônica, isto é, o mito da caverna ao fenômeno das “ake ews”, entende-se que essa metáfora transforma a mídia na caverna pós-moderna, retratando a cegueira intelectual que assola cada vez mais o país. Exemplo disso foi a difusão de uma notícia enganosa e apocalíptica acerca de um suposto planeta, Nibiru, que iria se chocar com a Terra, o qual muitas pessoas acreditaram porque se limitaram a essa informação. Dessa forma, a propagação de conteúdos errôneos corrobora para uma geração de pessoas com visões restritas e preconceituosas .', 'Ademais, vale frisar que a disseminação desses conteúdos equivocados pode ser usado como uma tática para favorecer determinadas ideologias ou mesmo pessoas que visam aos cargos políticos. Isso foi notório durante as eleições do atual presidente dos Estados Unidos, Donald Trump, nas quais se difundiu diversas notícias enaltecedoras do líder, seduzindo os eleitores nas duas decisões, segundo o site de notícia El país. Sendo assim, as notícias midiáticas, se não reguladas podem impactar nas decisões dos eleitores, sobrepondo o pensamento críticos desses.', 'Destarte, urge a necessidade de meios para atenuar a problemática da propagação de conteúdos falsos. É imprescindível, portanto, que órgãos do governo crie projetos de lei no que tange a criminalização de notícias falsas e que haja punição aos propagadores dessas notícias a fim de que as pessoas não tenham mais acesso a elas. Além disso, setores da educação- escolas e universidades- principais meios de instrução, devem instigar os jovens a buscar informações em diferentes fontes de notícias, por meio de indicação de sites confiáveis e diversos, com o fito de fazê-los manter posicionamento crítico e, assim, atuarem melhor nas decisões políticas. Desse modo, a caverna pós-moderna dará lugar a um mundo mais amplo e realista, favorável a democracia.']",160,200,160,200,200,920
101,Sociedade oprimida,"['As páginas policiais têm ganhado ênfase atualmente. Tudo isso graças às batalhas travadas entre policiais e bandidos e o aumento da criminalidade no Brasil, fazendo de vítima a         sociedade,  onde         pessoas inocentes morrem ou ficam         restritas dos         seus direitos, refugiando-se em suas casas com medo de algum mal lhes acontecer.', 'O Brasil está entre os países mais violentos do         mundo         como mostra a pesquisa feita por uma ONG mexicana. Quase trinta por cento das cinquenta cidades mais violentas do mundo estão em nosso país. O                 crime                organizado está sendo comandado pelos chefes do tráfico que estão dentro das cadeias, ordenando aos seus comandados que pratiquem                 crimes                , oprimindo a sociedade que infelizmente perde a cada dia mais vítimas para o                 crime.', 'As cidades de Santa Catarina e São Paulo,         têm sido a ""                 bola da vez""                para os criminosos. Ônibus e carros estão sendo queimados, colocando em risco a vida de cidadãos civis. Assassinatos à mão armada e balas perdidas estão cessando vidas. Além da criminalidade dessas cidades, temos Maceió e Belém do Pará como terceiro e décimo lugares respectivamente entre as 10 cidades mais violentas do ranking divulgado pela ONG, mas que não ganham tanto destaque na mídia brasileira.', 'Diante da gravidade dos fatos apresentados, podemos concluir que a sociedade está perdendo espaço para a criminalidade e que somente medidas coordenadas                 como: investimentos na inteligência da policia; isolamento dos chefes do tráfico nas cadeias; intervenção de uma policia comunitária nas comunidades e combate ao tráfico de armas,                poderão dar um fim aos crimes que estão oprimindo a sociedade.']",160,160,120,160,200,800
13,Posse de armas,"['Segundo Benedetto Croce, a violência não é força, mas fraqueza, nem nunca poderá ser criadora de coisa alguma, apenas destruidora. Com essa frase , Croce leva a crer que a liberação da posse de armas não será capaz de gerar a paz, tampouco, preserva-lá .', 'É indubitável que há um sentimento de insegurança da população Brasileira , sendo que uma parcela acredita que portando armas estará em igualdade com assaltantes e irá poder se defender. Porém, se até policiais são mortos ao reagirem a assaltos, o cidadão comum não está mais seguro com uma arma na mão.', 'Outrossim, mais armas em casa em casa levanta a questão do feminicídio, visto que segundo a ONU, o Brasil é o 5º país no ranking mundial de países que mais matam mulheres. Como a grande parte das vítimas são assassinadas por parceiros dentro da própria residência, a posse de armas teria um efeito catastrófico.', 'Portanto, é notório que para o estado é muito mais cômodo deixar a questão da segurança nas mãos dos cidadãos, do que tentar aperfeiçoa-la . O governo deverá investir em segurança pública, para que o mesmo não se sinta desprotegido caso não porte uma arma, aumentando o número de ações para apreensão de armamentos ilegais. Aumentar o número de armas, mesmo que legais, no Brasil, é um verdadeiro tiro no pé.']",120,120,80,80,80,480
82,"Automedicação, como resolver?","['Ao analisar o tema da automedicação, vê-se que ainda é um grande problema de saúde pública em todo o Brasil. Apesar de muitas vezes ser difundida a ideia de que não é necessário ir ao médico toda vez que se precisa de um remédio, também se debate sobre o quão prejudicial pode ser o uso indiscriminado desses medicamentos por pessoas sem conhecimento de seus efeitos. Em contrapartida, nota-se que vivemos em uma situação em que é inviável marcar uma consulta com um especialista para conseguirmos um medicamento sempre que sentirmos um leve desconforto.', 'Podemos perceber que grande parte da população  quando sente algum problema de saúde ? faz uso de remédios sem prescrição médica, muitas vezes por achar que é um problema simples e de fácil tratamento. Tal atitude pode desencadear uma série de problemas, como intoxicações e complicações que podem até levar ao óbito. ? Além, é claro ? de poder agravar o estado do paciente, devido  ao mau uso dos remédios.', 'Contudo, o problema está longe de ser solucionado. Um grande fator que faz com que aumentem  os casos de automedicação é a dificuldade encontrada pelos cidadãos na hora de marcar uma consulta médica, e também  no  preço elevado dessas consultas. Isso faz com que o paciente tome os remédios por conta própria por não ter condições de frequentar um médico, de certa forma consequência de uma elitização da saúde.', 'Portanto, medidas são necessárias para resolver o impasse. Desse modo, uma alternativa seria oferecer uma primeira análise nos pacientes por meio de farmacêuticos com conhecimento na área, para que estes os forneçam medicamentos para casos mais brandos, ou até encaminhando o paciente ao médico mais especializado ao perceberem que se trata de algo mais delicado. Nesse sentido, o ministério da saúde  poderia colaborar por meio de subsídios às farmácias que prestarem esse serviço de forma gratuita e eficiente, assim democratizando o acesso a saúde e desafogando os hospitais brasileiros de casos mais triviais.']",160,160,160,120,160,760
147,Melhor modelo de votação,"['Política não é o tema mais discutido entre os         brasileiros, esse         desinteresse é devido         à         várias questões,                 como a corrupção,          distância          entre políticos e eleitores e          ao          imenso número de candidatos a serem avaliados numa eleição.                Diante disso, é evidente a grande necessidade de uma reforma política no Brasil.', 'Essa reforma, hoje em discussão no Congresso Nacional, tem um objetivo básico de alterar a realidade negativa do funcionamento do sistema eleitoral atual, a fim de aumentar também a participação da população.                 Dois tipos de votos são colocados em questão: o proporcional misto,         cujo         cada eleitor tem direito a dois votos, um que ele vota numa lista de candidatos do partido de sua escolha e outro o qual ele vota no candidato de sua preferência. Mas quem escolheria essa lista? Os caciques dos partidos, provavelmente.', 'O segundo tipo de voto, seria o         distrital, cujo         país seria dividido em distritos - áreas com limitações geográficas parecidas e número similar de eleitores, no caso do Brasil, 513 distritos, o mesmo número de cadeiras na Câmara. Esse modo de         votar,         aproximaria o representante do representado,                 pois além do eleito ter mais incentivo para lutar pelas demandas do distrito, o eleitor precisaria acompanhar apenas um representante, visto que, em algumas eleições, analisar o perfil de cada um dos candidatos é uma missão quase          impossível, como em São Paulo,          na última eleição, 1131 nomes          concorrendo,          o votante, então, precisaria de no mínimo uns 47 dias ininterruptos para estudar, por uma hora, o currículo de cada candidato.', 'Desse modo,         com o         voto         distrital, facilitará         o eleitor a acompanhar o processo eleitoral e, com esse caminho mais estreito, contribuirá         para         uma decisão bem pensada.']",160,160,120,120,120,680
73,Desafios encontrados pelos negros atualmente,"['Mesmo depois do fim da escravidão no Brasil, a população negra ainda enfrentam desafios e contratempos para conseguirem se designarem na sociedade atual e terem uma vida digna e justa . A educação é um bom exemplo disso, a possibilidade de um negro ser analfabeto é cinco vezes maior que uma pessoa branca.', 'O povo negro são 53% dos habitantes brasileiros, e representam 76% dos brasileiros mais pobres , e somente 17% correspondem a parcela mais rica do povo segundo o  (IBGE). Somente um em cada quatro pessoas com ensino superior é negra  o impacto disso só aumenta quando pensamos fora da sala de aula . Essas estatísticas poderiam decrescer se o governo investir mais nas escolas nas regiões mais pobres. Principalmente em comunidades quilombolas que são muito desvalorizadas pelo governo.', 'A população negra do mesmo modo enfrentam dificuldades nas áreas de trabalho, observa-se que, em alguns aspectos, as desigualdades raciais e a discriminação de gêneros se cruzam e se potencializam . O trabalho de negros  é menos valorizado em várias áreas. Eu tenho um sonho. O sonho de ver meus filhos julgados por sua personalidade, não pela cor de sua pele. (Martin Luther King). Algumas empresas demitem funcionários negros somente por eles mudarem alguma coisa em suas personalidades que fazem referência a cultura negra.', 'Um outro caminho para superar esses desafios, seria a implantação de novas leis rígidas para o racismo, essas leis deveriam ser estabelecidas com participação da população negra, visto que,  o legislativo não sabe o que é sofrer racismo de verdade . O Brasil é um país racista, mesmo não se assumindo como tal, o combate ao racismo é uma luta diária que deveria ser de todos. Racismo não se tolera, racismo se combate.']",120,120,120,120,120,600
91,Maktub,"['Na série americana ""Bridgerton"", o que qualquer donzela mais teme são os boatos. Eles, mesmo que infundados e mentirosos, possuem a capacidade de destruir suas vidas perante a sociedade. Já fora das telas, essas inverdades possuem um peso ainda maior, já que são as principais responsáveis pelo negacionismo científico na sociedade brasileira. Dessa forma, cabe analisar o reaparecimento de doenças já erradicadas e a desvalorização da comunidade científica como efeitos do impasse.', 'Primeiramente, urge analisar como o reaparecimento de algumas enfermidades está diretamente ligado à problemática. Segundo o físico alemão Albert Einstein, ""Informação não é conhecimento"". Sob essa lógica, grupos antivacinação menosprezam ambos, pois usam argumentos baseados em opinião para convencer a massa de que a vacina gera efeitos negativos. Além disso, muitos que não são adeptos à ideologia simplesmente esqueceram a importância da imunização e, também, não a fazem. Logo, isso menospreza o trabalho de quem luta pela segurança nacional porque coloca em risco a saúde pública futura.', 'Outrossim, vale salientar que a comunidade científica é uma das principais vitimas do revés. No contexto atual, na luta contra o coronavírus, pesquisadores e cientistas batalham contra as ""fake news"". A coletividade, que deveria assistí-los na luta por mais investimentos e visibilidade, espalha uma total descrença com o trabalho deles. Esse fato levou a bióloga e geneticista Adriane Waisko, do IBB- Unesp, a usar as redes sociais como forma de divulgar a verdadeira ciência, combatendo, assim, inverdades com informação.', 'Evidencia-se, portanto, a necessidade de medidas para mitigar a problemática. Dessa forma, cabe ao Ministério da Saúde e ao SUS - principais responsáveis pela saúde da população do Brasil - promover uma grande conscientização sobre a importância da vacina, mediante campanhas de vacinação com enfoque na regiões menos adeptas ela, com o fito de prevenir antigas e novas epidemias. Ademais, as mídias sociais precisam ajudar os cientistas a divulgarem as informações verdadeiras, tão rapidamente quanto as falsas, fazendo com que a notícia chegue ao espectador antes do boato.']",160,200,160,200,160,880
1,A era da reinvenção profissional,"['À medida que a humanidade se torna mais consciente em relação às novas mudanças mudanças provocadas em larga escala pelo desenvolvimento de novas tecnologias tecnologias, faz-se necessário que outras formas formas de reinvenção do trabalho sejam discutidas. Vivemos em um estágio crítico onde crítico, em que a mão de obra humana está ameaçada por suas próprias invenções, o que alguns especialistas chamam de revolução tecnológica.', 'Dados oficiais sobre o número de desempregados no Brasil aponta apontam um cenário alarmante, cerca de 12 milhões de desempregados. As modalidades de trabalho visam atualmente cada vez mais aderir à tecnologia automatizada, embora em grande parte não seja sejam completamente, pois ainda se exige a presença de profissionais operando de forma parcial parcial, dividindo assim a força de trabalho, embora já existam ""empresas 100% tecnológicas"".', 'Analisando isso de forma crítica crítica, podemos imaginar um futuro nada otimista para algumas profissões que certamente serão substituídas pelo trabalho inteligente das últimas invenções modernas. Espera-se que profissionais se adequem às novas tendências do mercado.', 'No entanto, ainda é possível possível, segundo especialistas que estudam o mercado mercado, reverter esse quadro com uma atitude simples, reinventar a educação. Para isso isso, alguns passos podem ser adotados algumas medidas podem ser adotadas, como exemplo como, por exemplo, estudar novas formas de negócios voltados para o futuro digital, se adequar à adequar-se às novas tecnologias de educação profissional, visando estar atualizado(a) e/ou capacitado(a) para um futuro no qual o mercado de trabalho será cada vez mais seletivo.']",120,120,80,120,120,560
57,Cinema lazer para poucos,"['Em 2019, o filme Vingadores Ultimato, um recorde de bilheteria, levou milhares de pessoas do mundo inteiro salas de cinema, para juntos se emocionar e torcer por seus heróis. Contudo, na realidade brasileira apenas 17% da população é privilegiada de usufruir desse lazer. Isso ocorre principalmente por causa da desigualdade de renda e concentração territorial do Brasil.', 'Em primeiro plano, é vital abordar a questão econômica dos telespectadores brasileiros, visto que pelo elevado preço dos ingressos, acabam-se excluindo parcelas de classe baixa ao acesso democrático do cinema. Ademais, junto a este fator soma-se a baixa concentração de salas de cinema no Brasil, já que devido ao seu imenso território, elas se concentram em cidades com um número elevado de habitantes, como capitais e cidades grandes.', 'Outrossim, o amor ao cinema, e a dificuldade de acesso, acaba levando o telespectador a maneiras ilegais de fazer uso dessas obras cinematográficas,  como é o caso de filmes piratas, que por serem facilmente encontrados na internet, gratuitamente ou por um preço acessível são adquiridos no lugar do original. O que acaba desvalorizando o trabalho de quem produz e prejudicando os trabalhadores dessas obras. Contudo, por falta de condições para adquirir o ingresso ou se locomover ao cinema, o gasto total é maio que o possível para boa parte da população, o que acaba incentivado a compra desses produtos.', 'Logo, medidas devem ser tomadas para resolver o impasse. O governo em parceria com os cinemas de todo o Brasil fazer promoções diminuindo  o preço dos ingressos, assim como criar uma lei que beneficie as pessoas de baixa renda com um ingresso mais acessível. E a mídia televisiva através de propaganda s deve mostrar os desafios de se gravar uma obra cinematográfica, e como a compra e venda desses prejudica toda uma equipe de trabalhadores que dependem do dinheiro arrecadado com essas obras, para se sustentar. Só assim, o cinema vai deixar de ser um objeto de classificação social e passar a ser um direito de lazer para todos.']",120,120,80,120,80,520
70,Informação ou descuido?,"['Clube de compra dalas  é um filme que, baseados em fatos reais, retrata a vida de um homem que descobre  com AIDS e tem que lidar com o preconceito para levar uma vida normal. Infelizmente, essa realidade está se tornando cada vez mais fato na vida de jovens brasileiros. Seja por vergonha, medo, preconceito, ou desinformação as DST, ou doenças sexualmente transmissíveis, estão ganhando grande notoriedade na sociedade.', 'Os jovens estão mais suscetíveis a contrair as DST, a justificativa mescla falta de preocupação, de informação e descuido. Mesmo com casos famosos como cazuza e Renato Russo, vitimas da AIDS, muitos jovens não tomarão  consciência dos problemas causados por essas doenças . Sendo que a simples utilização de camisinha poderia evitar muitas DST.', 'Vale ressaltar que algumas DST não apresentam sinais físicos , o que facilita sua transmissao aumentando o número de infectados. Por isso, consultas medicas são importantes para descobrir o quanto antes a doença e iniciar o tratamento. Neste caso, a vergonha em conjunto com o preconceito faz com que eles não realizem prevenções.', 'Portanto, medidas são necessárias para resolver o impasse. O ministério da educação  tem que desenvolver programas que trabalhem sexualidade  para adolescentes, falando sobre o valor da vida , mostrando os danos que essas doenças podem causa e formas de evita-las. Também e necessário que o ministérios das comunicações em conjunto do Sistema nico de saúde (SUS) desenvolva campanhas para a conscientização da população em geral, reforçando a prevenção e distribuição de preservativos.']",120,120,120,120,120,600
85,Soberania Popular,"['Iniciativa popular é um instrumento da democracia que torna possível a população apresentar projetos de leis,isso  é assegurado pela constituição brasileira para garantir um governo democrático,contudo poucas são as leis que a população indicou através desse recurso. Porque isso ocorre?', 'Temos uma república democrática representativa na qual escolhemos nossos representantes para tomarem decisões que garantam os direitos da sociedade, (.) ainda assim podemos participar diretamente da política através de  projetos de lei indicados pela própria população,trata-se das leis de iniciativa popular,no entanto esse mecanismo pouco é usado pela população.', 'Isso  nos faz refletir a fragilidade da democracia brasileira pois a falta de participação política,descrença nos  representantes políticos,intensa corrupção nas instituições públicas,tudo isso associado a falta de educação política nas escolas, leva o Brasil a ser classificado como uma democracia falha.', 'Isto posto,temos um aumento da corrupção, e descaso dos governantes com a sociedade,pois se não há participação do processo político os representantes têm maior amplitude para cometer crimes contra a sociedade, há uma retração da democracia,pois há pouca participação política, e pouca confiabilidade nas instituições,fragilizando assim a soberania do povo  que é a principal característica de um governo democrático.', 'Portanto é necessário termos uma cultura política que comece por leis que exijam a educação política nas escolas,maior transparência das instituições públicas, e o controle social que pode ser feito através dos conselhos gestores de políticas públicas que são canais efetivos de participação, que permitem termos uma sociedade na qual a cidadania deixa de ser apenas um direito e passar a ser uma realidade cotidiana,tudo isso para fortalecermos a democracia e garantir a soberania popular.']",120,120,160,120,200,720
88,,"['Promulgada em 1988  a Constituição federal garante além de bem - estar a saúde, seja ela fisica ou psíquica . Entretanto, com o estigma associado a doenças mentais no Brasil, percebe-se que não se cumpre o que diz a mesma, pois vários brasileiros apresentam doenças mentais á muito tempo, devido ao fato de sofrerem alguma violência quando crianças  mas também pela rotina cansativa do trabalho.', 'Destaca-se de início o fato da agressão infantil que é uma das causas de um adulto com doenças mental, seja ansiedade ou até mesmo depressão, a violencia sofrida na infancia certamente fra com que o individuo cresça e leve esse sofrimento para a fase adulta, tornado-se um adulto com problemas psiquicos.', 'Ademais,outro fator que leva um brasileiro a desencader um problema mental é a rotina cansativa do trabalho, ainda mais com a pandemia do covid 19 que fez com que muitos viessem a trabalhar em casa, causando assim mais stresse.', 'Portanto, é necessario que o Ministerio da Saúde, responsavel pelo SUS, ( sistema unico de saúde), atraves de verbas governamentais e juntamente com o hospital de cada cidade crie um projeto que ofereça psicologos e médicos especializados em problemas mentais, para que os brasileiros que tem algum problema antigo sejam atendidos adequedamente e os demais não desenvolvam futuros problemas, garantindo assim a saúde a todos os brasileiros como preve a Constituição federal.']",160,120,120,160,200,760
4,O réu deve ou não ser preso após a condenação em 2ª instância?,"['De acordo com a constituição federal Constituição federal, todos têm o direito à ampla defesa, no defesa. No entanto, todos os réus responderem em liberdade até a última instância, não será benéfica benéfico à sociedade, ou seja, os infratores ficaram ficarão soltos praticando crimes, aumentando o sentimento de insegurança do cidadão.', 'O direito de responder em liberdade é uma garantia que vem expressa na constituição Constituição federal, em da qual um dos artigos determina que nenhuma pessoa será considerada culpada até o trânsito em julgado de sentença penal condenatória, porém, existem casos em que a lei prejudica o cidadão e beneficia ao bandido.', 'Além disso, a sensação é que a impunidade aumenta a cada leis e decretos lei e decreto sancionados, ou seja, a justiça deve beneficiar ao cidadão a não ao bandido, pois, para não ser preso, basta não cometer crimes.', 'Outro ponto a mencionar é a insegurança que as novas leis poderão trazer as às vítimas que foram prejudicadas por tais infratores, isto é, caso eles permanecerem soltos soltos, voltarão a cometer crimes à poderão querer se vigar da pessoa que o os denunciou, acarretando infrações mais sérias.', 'Diante disso, é importante ressaltar o dever de cumprir as leis impostas leis, porém, o supremo tribunal federal Supremo Tribunal Federal deve priorizar o cidadão, criando súmulas que trazem tragam benefícios à sociedade e não ao bandido, com bandido. Com isso, o país se tornará um lugar justo.']",120,80,120,80,80,480
69,,"['ormente no Brasil, o uso de agrotóxicos passou a ser muito utilizado nas lavouras agrícolas, já que ele é um meio de combate pragas que destroem as lavouras, porém, o uso constante desse meio de confronto aos insetos que se alimentam das plantações, se tornou um problema social que merece a atenção de todos, uma vez que, gera prejuízos ao meio ambiente e aos seres que habitam próximo da esses locais.', 'Precipuamente, o uso desse pesticida  é responsável por causar adversidades no solo, impede que a água de rios próximos seja bebível,destrói organismos vivos que não são prejudiciais às lavouras e extingui determinadas espécies fundamentais para o equilíbrio da região ambiental . Ademais, hodiernamente , no Nordeste nova fronteira agrícola , ficou evidente as consequências do uso irregular desses defensivos agrícolas, pois essa região entesta grandes secas e por conta de rios contaminados com agrotóxicos pessoas morrem por falta de água. Além disso,o uso indiscriminado de agrotóxicos causa problemas no solo e reduz a biodiversidade do sistema como um todo.', 'Vale ressaltar que, atualmente no Brasil, o uso desses produtos fito-farmacêuticos são responsáveis por trazerem severos danos saúde de pessoas e a outros organismos vivos que são oriundos de locais próximos a essas plantações. Além do mais, quando um ser humano é contaminado com esse produtos, as consequências são terríveis, bebês nascendo com microcefalia ou até em algumas vezes, anencéfalo. Outrossim, segundo o Sistema Nacional de Informações Tóxico-Farmacêuticos 836 pessoas chegaram a óbito e outro dado do Ministério da Saúde diz que em 7 anos 34.147 notificações foram feitas em centros médicos de todo o país, de pacientes intoxicados pelo uso de agrotóxico.', ""Destarte, Cabe ao Governo Federal e ao Ministério da Agricultura,  iniciar a procura de outro método de defensor agrícola que não seja tão prejudicial saúde e ao meio ambiente como o atual , um meio para isso, seria a utilização do inseto estéril e controle biológico que é uma ''arma'' ecológica usada para combater as pragas que destroem as lavouras, em 1955, Knipling idealizador desse projeto, obteve sucesso no controle da mosca-da-bicheira. Com isso, vários países aderiram à essa técnica de baixo custo e enorme rentabilidade.""]",120,160,160,160,120,720
51,Democratização da educação é a solução,"['A criação de escolas e faculdades no Brasil foi tardia. Os filhos de nobres e senhores de engenho eram mandados para Europa afim de adquirir uma boa formação. Com o passar dos anos, a educação começou a ganhar palco. É fato que as condições de ensino melhoraram, mas é necessário muito investimento e esforço para que este atinja todas as camadas da população.', 'Analfabetismo funcional ocorre quando o indivíduo apesar de conseguir fazer a decodificação das palavras, é incapaz de decifrar o sentido nelas contido. Essa falha ocorre muitas vezes devido à negligência em relação ao ensino de interpretação de texto. Muitas escolas, às vezes por falta de tempo ou investimento e incentivo por parte do governo  não tem o material necessário para que se tenham aulas que ensinem a decodificar, interpretar e compreender aquilo que um texto traz.', 'A relação texto, leitor e autor é muito mais do que uma sequência de códigos e símbolos. Nela é englobada fatores externos como suporte do texto e fatores internos como a intencionalidade daquele autor. As confusões por falta de entendimento podem levar a problemas em provas, como a perca de notas, como podem levar a brigas, desentendimentos e duplas interpretações quando veiculadas na fala do cotidiano.', 'Para ingressar no ensino superior, uma das formas mais usadas no Brasil é a prova do ENEM , que exige de seus participantes não apenas habilidade nas matérias, mas sim interpretar além do que está explícito em seus textos. É necessário que o indivíduo tenha capacidade de entender o implícito e aplicar ali seus conhecimentos sobre determinada disciplina.', 'O problema do analfabetismo funcional persiste pela falta de democratização da educação . Escolas com falta de verbas, de estrutura e de até mesmo profissionais não conseguem construir alunos com uma boa formação. Os estudantes e os profissionais da área de educação tem dever de lutar por seus direitos, indo às ruas, fazendo greves e exigindo melhorias. O ambiente escolar deve ser valorizado para que todas as camadas da população tenham acesso ao ensino de qualidade.']",120,160,120,120,120,640
0,As fantasias no carnaval,"['O carnaval Carnaval é uma das maiores festas no Brasil, e Brasil e nele vemos fantasias tanto conservadoras quanto vulgares. Nos últimos tempos tempos, vemos muitas pessoas a favor ou contra fantasias de índios índio ou as pessoas usarem um simples turbante na cabeça, que pode se resumir em apropriação cultural.', 'Há muitas pessoas que concordam com esse tipo de fantasia, pois pois, para eles, estão ajudando a índios índios ou a pessoas pessoas dentro de uma certa religião, serem religião a serem aceitas pelas outras.', 'Essas mesmas pessoas que pensam que estão ajudando, mas se sentem ofendidos Essas mesmas pessoas, no entanto, sentem-se ofendidas quando índios usam uma roupa ou algum acessório tipicamente usados por pessoas brancas e da cidade, pois pois, para eles, índios deveriam passar suas vidas inteiras dentro das florestas, isso tudo por falta de informações.', 'A maioria das pessoas que são contra o uso da fantasia, acreditam desse tipo de fantasia acredita que o carnaval Carnaval é para diversão, e não para fingir ser uma pessoa cujo você não sabe o que ela passa durante o resto do ano, porque isso é uma ótima maneira de se mostrar um grande hipócrita.', 'Em virtude do que foi mencionado, é um grande erro apropriar-se da cultura dos que sofrem racismo, muitas vezes vinda vindo de você mesmo. Nunca sabemos o que a outra pessoa passa, e passa e, mesmo se soubéssemos, não é uma razão para você dar vida a um simples personagem de que você não irá se lembrar pelo resto do ano, até o próximo carnaval Carnaval.']",80,80,80,80,80,400
91,UMA SOCIEDADE PROGRESSISTA,"['A"" Ordem e progresso "" estampado na bandeira do Brasil faz alusão ao lema do positivismo de Auguste Comte , cuja ideologia tem como objetivo o avanço da sociedade através da soberania da ciência e seus estudos , no entanto ,para que isso ocorra é preciso de uma corporação credora na razão .Sendo esse fato não recorrente no território nacional, pois hodiernamente há um aumento exponencial do negacionismo científico . Tendo como seus principais efeitos colaterais,  o crescimento da proliferação das fake news devido desinformação e ignorância dos indivíduos ,além do enorme prejuízo causado no avanço da ciência e suas tecnologias, tornando a sociedade retrógrada e não progressista .', 'Visto que , o avanço dos sofismas no território nacional é decorrente também da negligência da indústria cultural, pois , tendo ela o seu principal viés o lucro, sobrepõe-se o fornecimento de conhecimento por entretenimento para os indivíduos .Tornando as pessoas intelectualmente inativas , e inertes para o discernimento da veracidade das notícias que constantimente são bombardeadas. Exemplificando , as propagações de fake news em grupos de whatsapp , no qual muitos usuários disseminam falácias sem nenhuma preocupação com sua comprovação científica . Dessa forma , é preciso com urgência que haja o comprometimento da indústria cultural na transmissão do saber ,para que seja forjado o senso crítico no cidadão brasileiro.', 'Além disso, o mau uso dos veículos de comunicação torna ainda mais difícil os trabalhos científicos e os seus avanços tecnológicos . Tais como , a proliferação da conclusão precipitada de que o uso do medicamento cloroquina tinha eficácia no combate ao covid-19, sendo essa notícia já desmistificada pelos cientistas . E a "" Revolta da vacina "" durante a república da espada no Brasil.,  onde obstante a ignorância da população , juntamente com a ausência de empenho governamental no uso de campanhas educativas sobre a profilaxia da doença no momento vigente ,ocasionou um alastre desnecessário na cidade do Rio de Janeiro , podendo ser evitado com o acesso informação.', 'Portanto, para que haja uma melhor execução dos trabalhos científicos sem a interferência inadequada da população, é necessário o auxílio do Ministério da cultura juntamente com o Ministério da educação ,  que através dos meios de comunicação criem campanhas socioeducativas com maior austeridade no combate a propagação das fake news ,requerendo também apoio dos principais elementos da indústria cultural nesta incorporação. Com a finalidade de reduzir o eufemismo social diante da complexidade dos fatos expostos na comunidade brasileira , rompendo assim a utopia ainda vivida por muitas pessoas durante o século XXI.']",160,160,160,160,160,800
45,Abuso de autoridade no serviço público brasileiro,"['O abuso de autoridade é a prática cometida por um profissional que faz uso do seu cargo para fazer prevalecer a sua própria vontade em detrimento do direito do outro. Essa ação é recorrente no setor público e tem ganhado visibilidade na mídia após a ocorrência de seguidos casos de violência física ou verbal cometidos por servidores públicos. Nesse contexto percebe-se a configuração de um grave problema que se opõe ao sistema democrático brasileiro e demonstra o despreparo dos servidores, que quando penalizados recebem penas brandas.', 'Inicialmente, cabe ressaltar que é dever do servidor público respeitar os direitos individuais e coletivos dos cidadãos. Na carreira policial o abuso com violência física é recorrente, em maio de 2020 um policial militar foi filmado pisando em uma mulher negra de 51 anos . Esse é apenas mais um dos muitos casos assistidos pela população brasileira. A constância nos casos de abuso de autoridade demonstra a necessidade da avaliação psicológica periódica dos servidores de carreiras públicas incidentes na prática, para verificar a sua capacidade de cumprir o seu dever profissional sem encobrir os direitos dos cidadãos.', 'Ademais , outro ponto a ser destacado é que as penas aplicadas ao crime de abuso de autoridade são brandas e não afetam de modo significativo a carreira do servidor. Geralmente a penalização para o abuso de autoridade é a realocação do servidor em outro setor ou a aposentadoria, ou seja, são punições leves, que não intimidam o servidor e passam a sensação de impunidade a população. Sendo assim, é necessária a análise do modelo de penalização atual para servidores que cometem essa ação. A partir da aplicação de penas efetivas para tal atitude, o servidor tende a se retrair e não cometê-la e o cidadão se sentirá protegido vendo que quem fere os seus direitos é devidamente penalizado.', 'Diante do exposto, é necessário que o poder legislativo e o poder executivo junto ao Ministério da Justiça e Segurança Pública  estudem propostas que contenham a prática de abuso de autoridade no Brasil. Dentre as medidas adotadas destacam-se a implantação de cursos periódicos de capacitação do servidor público para o aperfeiçoamento da prestação de serviço ao cidadão e avaliações que comprovem a sua aptidão psicológica para o exercício da profissão. Além disso, é necessário averiguar a efetividade das penas aplicadas ao servidor que comete tal prática, a fim de assegurar que os direitos dos cidadãos não sejam violados por quem deveria prestar-lhes serviço.']",200,160,120,200,160,840
56,Mudando a atual situação carcerária Brasileira.,"['Com 726 mil presos, o Brasil tem a terceira maior população carcerária do mundo, atrás apenas dos Estados Unidos e China. Cerca de 40% são presos provisórios (sem condenação judicial), 64% são negros, e mais da metade são jovens de 18 a 29 anos (dados divulgados pelo Departamento penintenciário nacional). Como poderemos reverter este cenário tão alarmante no qual o Brasil se encontra?', 'A criminalidade juntamente com a violência tem crescido sem prescendentes. Segundo o nfopen, a correta aplicação dos recursos financeiros, tanto da união quanto dos estados para o sistema prisional, não tem sido efetivo para que esse criminosos venham a ser ""humanizado"".', 'Porém segundo o direitor-geral, o Depen está investindo em políticas públicas que qualifiquem a porta de entrada, de saída e as vagas do sistema, de forma a propiciar um ""ambiente prisional mais humano"", entretanto é preciso um rigor maior no quisito da ""humanização"" desses presos.', 'Sabemos que há um longo caminho a percorrer, e que a quantidade de presos que constituem o sistema prisional só irão reduzir quando houver intervenção por meio da educação, pois como dizia o poeta Castro Alves:""Bendito é o que semeia, semeia livros a mão cheia"".']",120,120,80,120,80,520
145,O esporte valoriza a vida.,"['O esporte apresenta         elementos favoráveis, ao         desenvolvimento social, econômico e cultural da sociedade. O governo brasileiro com a realização da         copa do mundo         deste ano, 2014,                 procura mostrar à população que o esporte traz benefícios à vida.                  A prática esportiva, tanto no futebol, como no vôlei, ou em qualquer outra modalidade, evidencia grande repercursão num país. Isso favorece o desenvolvimento da nação em diversos aspectos, pois a população procura envolver-se, de forma ativa, seja através das manifestações populares ou até mesmo do lazer proporcionado pelo futebol, esporte preferido da maioria dos brasileiros.', 'Sendo assim, pode-se afirmar que                a mobilização popular ocorrida                 neste ano                , na Copa         da Confederação, teve-se a         concientização e a busca de direitos dos cidadãos brasileiros. Essa         manisfestação         deu-se por parte de alguns brasileiros         descontentes, com         os grandes investimentos governamentais, reivindicando a valorização de diversos setores, que se encontram na precariedade,         como, a         saúde e a educação.', 'Além disso, o entretenimento e o lazer, proporcionado pelo esporte, através do comércio e da propaganda,          expressas          nos mais variados meios de comunicação,          procura          valorizar e incentivar a vida do cidadão brasileiro.', 'Enfim, o esporte pode beneficiar os cidadãos nos aspectos cultural, econômico e social. E, isso só acontecerá quando                 todos buscarem a grande notoriedade do futebol brasileiro                , dentre os grandes campeonatos, trazendo aos seus         torcedores, momentos         de alegria e orgulho.']",120,80,80,80,0,360
9,Educação é para todos,"['De fato, as discussões sobre o corte de verbas das nossas universidades e faculdades públicas tem sido um tema atualmente debatido, que gera diversas opiniões distintas. É compreensível o lado de todas as opiniões: pessoas de alta classe econômica se utilizam da universidade pública, mesmo tendo condições econômicas de pagar mensalidades em uma instituição privada, e os gastos na mesma cujos preços são altíssimos, pois é uma ferramenta que necessita de alto poder econômico. Ao mesmo tempo, temos o lema do que significa ter acesso à educação superior, gratuita e pública, gerando oportunidades para todos.', 'A faculdade é paga com os impostos de todos os brasileiros, então, teoricamente, pessoas de classe alta também tem têm direito ao acesso. O que se discute é que, muitas vezes, as vagas limitadas da universidade são ocupadas em sua maioria pela classe alta, por terem melhores condições de ensino - por exemplo, ter estudado em colégio particular - então acabam sendo melhor mais bem preparados para os vestibulares. Em contrapartida existem as cotas, que tentam amenizar essa desigualdade educacional e social entre nossos estudantes. Ainda assim, universitários de classe alta ainda são majoritários na aquisição obtenção das vagas, e um dado, do Instituto Liberal de São Paulo, que mostra esse desequilíbrio desequilíbrio, constatou que metade dos calouros da USP, uma das melhores universidades públicas do Brasil, correspondem a 20% dos mais ricos do país.', 'Entretanto, como rege estabelece a nossa Constituição Federal, acredito que a educação deveria ser sim gratuita e de qualidade para todos nós brasileiros, que pagamos por ela com nossos tributos. Deveria haver também uma gestão de recursos mais bem organizada nas instituições, a fim de aplicá-los nas áreas certas, que possam garantir a qualidade de ensino dos estudantes. A área da pesquisa também deveria ser explorada, a fim de buscar investimentos de empresas privadas e/ou e instituições que financiam pesquisas e avanços.', 'Infelizmente, o investimento, vindo do governo, na área de pesquisa e educação ainda é pouco valorizada valorizado - o que poderia trazer outros investimentos além do público, como já citados -, pois não é vista como investimento, e sim gasto social, talvez por isso o tamanho descaso com a educação e principalmente com os nossos professores.']",120,120,80,120,120,560
7,Inovação social,"['A nova moeda digital vem tendo um grande conhecimento da vida do ser humano, sendo no mercado geral, atraindo adolescente e adultos do meio econômico. Pouco se conhece de sua finalidade, mas devido a sua comodidade está ganhando espaço. A grande preocupação internacional e nacional é que ela ocorre gradualmente no mercado digital, não ocorrendo de forma legal para os nossos governantes assim não pagando o devido os devidos impostos anual anuais.', 'A moeda virtual não é controlada por nenhum banco central. A maioria das crises econômicas surgem das falhas cometidas por esses bancos. Então, usar Bitcoin bitcoin pode garantir ""segurança"" em qualquer crise econômica.', 'É uma tecnologia não depende de um agente intermediador para realizar as transações, logo uma era autônoma. Criptomoedas ou bi tono rende rendem, com o investimento altos onde todos bancos centrais com moedas tecnologia troca e sua finalidade. Para possui possuir a moeda virtual terá de é preciso adquirir carteira virtual do aplicativo com um código secreto e incontrolável, acesso ao universo é um banco de código é uma operação eletrônica de qualquer lugar do planeta. Porém qualquer um poderá comprar, transferir, efetuar pagamentos através do Bitcoin.', 'Em tempos de incerteza econômica, as criptomoedas podem ser escolhidas como um ativo de segurança, compartilha pois compartilham muitas características do ouro, a mais antiga forma de dinheiro usada no mundo até hoje para a humanidade se protegerem proteger contra crises financeiras.']",40,40,40,40,40,200
73,A diligência pela igualdade,"['No que se refere à diligência pela igualdade, pode perceber em pleno século 21, os negros ainda batalham pelo seu espaço na sociedade, lutando pelos seus direitos e deveres de forma humana, mostrando, que não é a sua cor que faz ser o que é e sim, a maneira de como é apresentado e visto na vida cotidiana, causando consigo o julgamento em ser negro.', 'Visto e bem explicito para qualquer individuo. No artigo 5º da constituição federal , relata,  que todos são iguais perante a lei sem distinção de qualquer natureza. Porém  não é assim que funciona, pois a constante luta pelo seu espaço, e grande ainda o preconceito, por mais argumentos expressivos ele ainda existe, seus direitos sem valorização perante a todos, a dificuldade pela busca do emprego, a paz em sair na rua e não ser confundido com um ladrão só pela sua cor. a dignidade de um ser humano.', 'Aliado a sua liberdade de opinião quando se questionada ao seus valores morais, sendo respeitado pelo que se é, mostrando capacidade sobre estar no mesmo patamar como qualquer outra pessoa, indiferentemente de sua cor, e sim pelo conteúdo da sua bagagem, exibindo com muito orgulho que um negro pode ser o que ele quiser e não o que a sociedade quer que ele seja como mostra muitas das vezes em filmes e novelas em personagens inferiores.', 'egro portanto  com todas as dificuldades,  batalhas, enfrentadas no dia a dia não deixam de ser abalados, lembrando sempre que cada um é quem faz a sua história na sociedade e no seu país, se posicionando todo momento com satisfação, batendo no peito com humildade quando se garante uma vaga em cargos de poder. a diferença toda hora írá ter, más a vitória pela persistência é que muda cada um.']",120,80,80,120,0,400
38,Ceder a  pressão?,"['Relativo à pirula do câncer , é possível afimar que, não só ela deveria ser testada antes da legalização, mas também, que a Dilma foi meio que ""forçada"" a legaliza-la', 'Percebe-se que a ""pílula do câncer"", deveria ter passado por vários testes antes de sua legalização, pois o câncer não é só uma doença, é um conjunto de várias doenças que merecem atenção especial e específica para cada uma delas. Por exemplo, o que faz mal para um doença pode fazer bem para outra, então não se pode generalizar e achar que uma substância ""cura"" várias doenças ao mesmo tempo.', 'Além disso, a Dilma foi meio que ""forçada"" a legalizar a substância. Em meio a tantos problemas, como a crise, pessoas querendo tira-la do poder, ela deve ter se sentido ""forçada"" ou até mesmo comovida pelos protestantes como o caso de uma garota que se pintou de azul e branco e sobre o peito multilado escreveu: ""foi preciso, mas foi necessário?"".', 'Com isso, percebe-se que não se deve ceder a pressões, principalmente quando assunto é ""pílula do câncer"" e quando se é presidente do Brasil.']",120,120,80,80,0,400
83,A prática esportiva e seu legado,"['A Grécia Antiga foi o berço dos eventos esportivos, durante o século VIII. Desde então, tal prática tornou-se frequente por todo o mundo devido a sua capacidade de promover mudanças, principalmente, no âmbito social. Nesse contexto, pode-se afirmar que o esporte fomenta uma série de melhorias à sociedade, dentre elas a inclusão social e benefícios ligados à saúde.', 'Em primeiro lugar, os jogos esportivos permitem a adesão de pessoas com características e necessidades distintas. Há uma gama de modalidades esportivas diferentes que acaba abrangendo e atendendo a todos os grupos de pessoas. Exemplo disso é o vôlei na cadeira de rodas que atende às necessidades de pessoas deficientes e, concomitantemente, oferece a elas a oportunidade de se superar tanto profissionalmente quanto socialmente. Dessa forma, os eventos esportivos têm um papel fundamental no que diz respeito à inclusão e interação social.', 'Em segundo lugar, os exercícios físicos decorrentes do setor esportivo acabam impactando a saúde do atleta de forma positiva. Sabe-se que a rotina diária de um esportista é baseada em uma alimentação saudável, exercícios físicos constantes e horas de sono regulares. Sendo assim, os jogos esportivos acabam oferecendo aos atletas um bom condicionamento físico, coordenação motora e, consequentemente, previne maus hábitos como o sedentarismo e doenças como a obesidade.', 'Pode-se dizer, portanto, que os eventos esportivos deixam como legado o aprendizado que a sociedade pode aplicar na vida dela. No entanto, para tal objetivo é fundamental que o Estado permita uma maior acessibilidade para as camadas menos favorecidas financeiramente, através de investimentos em clubes esportivos nas periferias e nas escolas. Além disso, o quarto setor, isto é, a mídia, deve fomentar ao público campanhas a respeito de hábitos saudáveis, que é possível manter através do esporte. Feito isso, a qualidade de vida e as relações sociais da sociedade melhorarão de forma significativa.']",160,200,160,200,200,920
8,A pós-verdade face aos dogmas da Ciência,"['Em contraponto às conquistas do Renascimento Científico, do científico do século XVI, surgem debates em relação ao movimento que se denomina ""Pós-verdade"". Trata-se da valorização de crenças pessoais em detrimento de algumas afirmações dadas pela Ciência. Nesse contexto, deve-se afirmar que as conquistas histórias históricas dos cientistas não devem ser objeto de questionamentos impertinentes.', 'A Ciência trouxe inegáveis melhorias para a sociedade por meio de estudos, testes e comprovações. Nesse contexto, por exemplo, no que ficou conhecido como Revolta da Vacina, Oswaldo Cruz desenvolveu uma injeção que ajudou a salvar milhares de vidas. Quantidade essa que seria bem maior se não fosse a resistência da ignorante população. Diante disso, não se pode negar que afrontas irracionais às comprovações científicas prejudicam o progresso das condições de vida da humanidade.', 'Outrossim, deve-se saber que argumentos pertinentes, para a Ciência, são aqueles que possuem grandes chances de desmentir ou modificar o já afirmado por ela. Por isso, afirmar que a terra é plena plana, sendo que gênios como Pitágoras e Aristóteles, bem como instituições hodiernas de grande prestígio, como o National Aeronautics and Space Administration (NASA), afirmaram e afirmam a esfericidade do planeta é um exemplo do que não se deve fazer sem um argumento plausível. Isso porque a Ciência não taxa algo de dogma sem a comprovação da sua certeza e indiscutibilidade.', 'Portanto, os questionamentos às afirmações científicas devem ser analisados com criticidade, uma vez que a certeza é uma das bases da Ciência. No entanto, isso precisa ser encarado como estímulo para aperfeiçoamento das teorias existentes e descoberta das descobertas de novas fórmulas para a contribuir com o bem-estar social. Com isso, serão garantidos tanto a liberdade de expressão quanto o desenvolvimento científico, que são protegidos pela Carta Magna.']",80,120,80,120,80,480
89,pandemia,"['“A insatisfação é o primeiro passo para o progresso de um homem ou de uma nação”. A afirmação atribuída ao dramaturgo irlandês Oscar Wilde pode ser facilmente aplicada a falta de conscientização da população sobre o isolamento social, já que é justamente a falta de incômodo social diante dessa vicissitude que a consolida como um regresso para a nação como um todo. Em uma pandemia de escala internacional, vê-se descaço das medidas de saúde tomadas para que aja menores impactos econômicos e socias como um dos fatores para essa problemática. Dado as circunstâncias vê-se a configuração de um problema que emerge devido ao descaço governamental e a falta de consenso social. Que precisa ser revertida de forma eficaz.', 'Em primeira análise, um governo que não promove um progresso coletivo contribui para o declínio de uma nação ou sociedade. As leis que adotam a medida de isolamento social como essencial para diminuição de impactos relacionados a pandemias, tem sido violada frequentemente por meio de bailes funks e festinhas que aumentam as chances de contaminação do vírus covid-19. Em meio a esse ponto de vista, vê-se um governo que tem como pauta a priorização da economia ao invés de colocar as vidas humanas a serem priorizadas. Casos como filas e aglomerações enormes para recebimento de auxilio emergencial se tornaram imagens rotineiras nessa crise pandêmica, que dificulta a resolução do problema.', 'Em paralelo, outra causa consolidação da problemática e a falta de consenso social, que expõem uma sociedade mal instruída sobre medidas de saúde para diminuição de impactos do vírus que já matou mais de 100 mil pessoas no Brasil. Situações como a de Manaus que houve falta de oxigênio, falta leitos e pessoas que são obrigados a entrarem em ônibus lotados para chegar ao trabalho, por não terem opção.  Mostram que na percepção dos estados de Émile Durkheim, sociólogo francês, abrangem-se duas divisões: ""normal e patológico"". Seguindo essa linha de pensamento, observa-se que um ambiente patológico, em crise, rompe com o seu desenvolvimento, visto que um sistema desigual não favorece o progresso coletivo.', 'Depreende-se, portanto a importância do isolamento social para preservação da economia e da vida. Para isso e necessário que o estado promova  campanhas de incentivo ao uso de medidas de saúde adotadas pela OMS , usando o meio digital (o com maior alcance atual) como vinculador da propagação dessa campanha. Esses eventos que ocorrem por meio de publicações que trarão vídeo-relatos de pessoas que já estiveram a covid-19, mostrando como esse vírus pode prejudicar a saúde alguém, e que sem o isolamento social e as medidas de saúde não teremos bons resultados tanto economicamente quanto socialmente. Só assim teremos uma nação estável em tempos de pandemia.']",200,200,160,160,200,920
20,"Pátria amada, Brasil?","['É notório que o interesse dos brasileiros em mudar-se para outros países vem aumentando consideravelmente, principalmente entre os jovens.', 'Dentre tantos fatores relevantes, temos: a maior segurança em países desenvolvidos, a interminável crise em nosso país, com desemprego elevado e a perspectiva de melhor qualidade de vida em outras nações, reconhecidamente melhores para se viver.', 'Sabe-se que o nosso país não passa por momentos de grande segurança, inclusive com uma Intervenção Federal vigente no estado do Rio de Janeiro. Por isso, os brasileiros têm buscado sair do país com medo da violência, que atinge a todos em qualquer lugar, gerando em todos a sensação de medo e insegurança.', 'Ainda quanto ao desejo dos brasileiros em mudar-se para outros países, nos últimos anos o Brasil não atravessa um bom momento, com crise econômica, escândalos e mais escândalos de corrupção, acarretando em aproximadamente treze milhões de desempregados. Com isso, estão buscando oportunidades em outros lugares, com mais oportunidades de emprego, mesmo com salários menores e atribuições mais operacionais em alguns casos.', 'Nesse sentido, o sonho e a meta de mudança aumenta principalmente entre os mais jovens, que são mais corajosos e não veem problemas em arriscar a vida em uma nação desconhecida, buscando uma melhor qualidade de vida com oportunidades de estudos e empregos que não temos por aqui.', 'Como se vê, a insegurança, a crise econômica e a perspectiva de melhores dias para os nossos jovens fazem com que eles busquem novas oportunidades fora do país ou, ao menos tenham esse desejo.', 'Portanto, deve-se melhorar a infraestrutura em todas as áreas aqui no nosso país, a fim de mantê-los nessa terra maravilhosa e que agrega a todos, principalmente os brasileiros.']",80,120,120,0,0,320
83,Esporte venerável ferramenta da humanidade*,"['O esporte é uma prática que desenvolve as habilidades físicas, onde é preciso ter disciplina e dedicação, (.) a escola é um grande espaço para esse exercício, que desde as séries iniciais até o ensino médio, aumenta a capacidade cognitiva dos estudantes, desenvolvendo também determinação e força.', 'A participação dos jovens no esporte é um suporte para a educação, pois ele desenvolve o raciocínio, além de ser um fator sociável. Os esportes, além de melhorarem o condicionamento físico, desempenham um papel emocional, por que aproximam as pessoas, podendo superar a timidez.', 'A prática esportiva é importante para a saúde e bem estar de todos, não é a toa que os jogos olímpicos estão (aí) até hoje. A vida é repleta de desafios e obstáculos que nos ensinam a olhar as coisas com mais clareza, o esporte é um grande mecanismo que ensina que a derrota nada mais é do que aprendizado.', 'Quando as pessoas entram em uma competição, elas agem com o propósito de ganhar, mas a experiência adquirida vale mais a pena, pois nos enobrece intelectualmente. Mas o que podemos realmente aprender com as práticas esportivas? Bom, às práticas esportivas nos ensinam a ter novos pensamentos, comportamentos, força de vontade, disciplina, e contribuem para o trabalho em equipe.', 'Segundo Nelson Mandela, “o esporte tem a força de mudar o mundo”, atividade que vai além de aspectos físicos e psicológicos e que condiciona o caráter. Falar de esporte é falar de um fator transformador de mentes que tem o poder de tirar crianças, jovens e adultos do mundo das drogas e violência. É dever das politicas públicas dar atenção ao esporte, pois quando damos atenção a essas coisas, estamos investindo em mais oportunidades e melhores condições de vida.', 'Com isso, percebe-se a importância do esporte nas casas, nas ruas e comunidades, o mesmo proporciona a realização de sonhos daqueles que, com dedicação, nunca desistiram das suas metas e enxergaram nessa árdua prática um lindo caminho. Com o apoio do governo, com a criação de programas que aproximem os jovens dos esportes e investimentos na educação, o único passo a ser dado é daquele que quer mudar não só a si mesmo, mas o mundo.']",120,200,200,200,200,920
44,Deixe-a correr.,"['No que se concerne, uma mulher ter que provar que realmente é uma mulher na sociedade brasileira é evidente . Isso deve ser freado, pois a maioria das vítimas são mulheres e atletas. Sendo relevante uma análise dos aspectos que corroborem com essa problemática: uso de testosterona e a mulher provar que pertence realmente ao sexo feminino.', 'Além disso, é indubitável que a questão de provar seu sexo e sua aplicação estejam entre os fatores que tornam-se o problema. Ademais, é importante enfatizar que, a sociedade não leva isso a sério, é válido analisar que o desconhecimento acerca de testosterona influi em comportamentos inadequados contra mulheres atletas. A exemplo de Caster Samenya, uma atleta com transtornos de desenvolvimento sexual, que foi punida por testosterona acima do normal, produzida por causa de sua produção hormonal.', 'Dentre outros fatores, é cabível salientar que, segundo a filosofa Émile Durkheim, o egoísmo é, em grande parte, produto da sociedade; entretanto, a sociedade se faz plenamente responsável pela situação atual de tal problemática. Sendo a mídia grande responsável por tal visão da sociedade. Visto que, segundo a Federação Internacional de Atletismo, as mulheres que contem testosterona em grande nível têm grandes vantagens nas competições, e desempenho maior do que a população em geral. Ou seja, as atletas com testosterona acima do normal não são representativas.', 'Portanto, fica evidente a problemática uma mulher ter que provar que realmente é uma mulher no mundo. Tornando assim a importância da própria sociedade mudar o pensamento de tal problemática. Ademais, cabe a mídia  promover campanhas publicitrias e debates em horários nobres, fomentando a conscientização sobre testosterona e sexualidade. Afim de que, essa problemática de cunho social e de educação, seja cada vez menos decorrente na sociedade brasileira']",160,160,120,120,160,720
95,Um país de todos?,"['O artigo 5\uf0b0\uf0b0\uf0b0 da promulgada Constituição federal de 1988, norma regedora do Brasil, declara que todos – sem que haja qualquer distinção – são iguais perante a lei e possuem o direito à propriedade. No entanto, a realidade dos povos indígenas não condiz com o caput no que tange ao marco temporal, pois a tese limita inconstitucionalmente as terras dessas pessoas em todo o país. Nesse sentido, a atuação do marco temporal ganha força não somente pela falta de representatividade política da população indígena, mas também pela ausência de empatia.', 'Logo , em primeira análise, é importante ressaltar que os povos nativos do país não possuem fortes figuras ou em número suficiente que os representem dentro do poder público brasileiro. A esse respeito, o fato histórico do direito ao voto no Brasil ser negado ao grupo indígena por muito tempo, mesmo com a Proclamação da República, demonstra claramente o seu atraso na participação da política brasileira . Desse modo a demora da integração do índio nas escolhas de representantes dificulta a eleição de um candidato que os representem, já que é necessário amplo conhecimento do funcionamento das disputas para vencê-las. Nesse viés, enquanto houver falta de representatividade haverá o descumprimento das leis do país.', 'Além disso, outro fator para a continuidade do problema é a inexistência de empatia. Acerca disso, Thomas Hobbes, filósofo inglês, diz que o homem é conduzido por seus anseios e vontades e tais desejos o impedem de viver harmonicamente em sociedade. Assim, percebe-se uma das raízes da aparição de conflitos envolvendo os povos indígenas, uma vez que não há reflexão sobre o direito do próximo, quando governantes objetivam na prosperidade de grupos que os beneficiam e ignoram as necessidades básicas daqueles menos privilegiados. Em vista disso, a ausência de ajuda ao próximo acaba por gerar maiores embates na sociedade brasileira.', 'Portanto, medidas são necessárias para uma caminhada rumo à solução do problema. Para tanto, o Ministério da Educação em parceria com a Funai, órgão responsável pelo monitoramento de políticas educacionais destinadas às pessoas indígenas, devem promover o conhecimento sobre a política brasileira por meio da implantação de projetos em escolas – sobretudo naquelas de aldeias indígenas – os quais debatam e promovam a educação sobre o sistema político e a importância da representatividade no cenário atual, a fim de que os cidadãos indígenas estejam mais inteirados de seus direitos dentro da sociedade. Dessa forma os direitos, proclamados na Constituição Federal, não serão desfrutados somente por parcelas da população brasileira; mas por todos seus cidadãos.']",160,160,120,200,200,840
72,,"['Atualmente  predomina-se um mundo moderno e tecnológico devido a globalização. Com isso  grande parte das pessoas procuram se manter atualizadas, consequentemente a internet que é o principal meio de acesso informação junto com a mídia ganham forças em suas notícias e informações.', 'No entanto, o que vem crescendo são as ""fakes News"", cujo nome em inglês significa ""falsas notícias"". Elas servem para satisfazer certos órgãos em seus interesses e muitas vezes são feitas com um proposito induzente, pois geralmente quando comunicadas parecem ser verdadeiras. Segundo o filósofo Socrátes: ""Existe um bem, a sabedoria, e um mal, a ignorância"", tendo em vista essa citação conclui-se que se um indivíduo que possua pouco conhecimento em determinado assunto ao se deparar com notícias falsas, logo irá acreditar no que lhe foi informado.', 'Entretanto, desde a Revolução Industrial que foi o maior avanço tecnológico já registrado procrastinava  notícias falsas  no intuito de manipular as pessoas sem conhecimento a acreditar no que lhes foi mencionado. Perante a isso  essa manipulação existe até os dias de hoje.', 'Por fim, o governo pode interferir nisso, tomando medidas administrativas controladoras , as pessoas podem começar a fazer palestras nas escolas e trabalhos, a mídia como grande influenciadora pode começar a chamar a atenção do público, e as pessoas sempre construindo um pensamento crítico.']",120,120,120,120,80,560
78,Uma reforma positiva ou contraditória?,"['Atualmente, se discute muito sobre a situação da educação no Brasil , há diversos problemas na mesma, e, como forma de melhorar a situação  o MEC propôs uma reforma educacional no ensino médio das escolas públicas do país, com propostas que visam o aumento da carga horária de 800 para 1400 horas, uma grade de matérias com foco nas áreas em que o aluno pretende seguir carreira  e a opção de poder substituir as matérias opcionais pelo ensino técnico, porém, até que ponto todas as medidas apresentadas são uma solução ou um problema?', 'De acordo com o artigo 205 da Constituição a educação é direito de todos, sendo dever do estado garantir uma educação de qualidade, mas no atual sistema educacional muitas pessoas acabam sendo excluídas, mais de 1,7 milhão de jovens não estudam nem trabalham, é uma grande quantidade de pessoas que se tornarão membros da sociedade sem o ensino médio completo,  além disso  o ensino médio atual possui como foco o vestibular para a entrada em um ensino superior, não apresentando saídas para quem não o pretende cursar (, o sistema atual é ultrapassado e exclui todos esses jovens da escola e de sua atual metodologia , por isso a reforma apresentada é uma ótima inciativa para a mudança educacional do país.', 'Apesar de todas as melhorias apresentadas, a reforma gera discussões e desconfiança sobre a mesma, principalmente pelo fato de ser uma medida provisória, ou seja, não foi votada e apresentada para a população para depois ser aprovada,e , se o tempo na escola vai aumentar não há lógica em retirar matérias inteiras da grade curricular .', 'Portanto, uma reforma é necessária, pois como o filósofo Immanuel Kant uma vez disse “O homem é aquilo que a educação faz dele”, uma educação de qualidade é a base que possibilita o desenvolvimento das pessoas e às forma para serem cidadãos atuantes em sua sociedade, mas o projeto do MEC possui muitas falhas que poderiam ser minimizadas se fosse explicado o que é o projeto para a população, e, se eles escutassem a opinião e sugestões da mesma,  outra ação que traria resultados é, por ter um aumento significativo no período que o aluno passará na escola, eles deveriam estipular como matérias obrigatórias o básico de cada matéria que já faz parte da grade curricular, pois assim o estudante terá contato com todas, aprenderá os conceitos básicos e saberá escolher em qual ele realmente quer se profundar com base em experiência com as mesmas .']",120,120,120,120,120,600
60,Forças Excludentes,"['""No meio do caminho tinha uma pedra"". Através deste verso do poeta modernista Carlos Drummond de Andrade,  percebe-se que a sociedade ao longo de seu desenvolvimento encontra obstáculos em sua caminhada. Talvez hoje ele percebesse que teria acertado em seu verso: a postura de muitos brasileiros e políticos frente à Previdência Social é um dos caminhos mais difíceis para uma pátria em progresso . Com isso, surge a problemática da reforma que persiste intrinsecamente ligado à realidade do país, seja pelo projeto proposto, seja pela herança cultural.', 'É importante ressaltar, em primeiro plano, que a reforma é necessária, mas que a atual proposta é injusta e cruel, sendo assim necessário discutir sobre . Conforme o filósofo alemão Karl Marx, na obra ""O Capital"", o trabalho no mundo capitalista está funcionando como forma de opressão, proporcionado pela falta de ideias. De maneira análoga, é possível perceber no Brasil, a reforma previdenciária, fortalece esse ideário:  haja vista que, embora esteja previsto na Lei Elói Chaves, marco da previdência social, no qual se garante a sobrevivência do trabalhador e seus dependentes quando da perda de sua capacidade, a proposta política está servindo como meio de exclusão social, privilegiando os mais ricos.', 'Em segundo plano, é inquestionável não afirmar que o passado retoma ao futuro. No período colonial brasileiro, na qual foi promulgada a Lei do Sexagenário, em que consistia a alforria para os escravos maiores de 60 anos, sendo que a maioria não chegava a essa idade. Ao seguir essa linha de pensamento, observa-se que a reforma da previdência caminha com esse comportamento, que tende a adotá-lo também por conta da diminuição da população ativa, além do aumento da expectativa de vida. Assim, a continuação do projeto, funciona com base forte dessa forma de exclusão, perpetuando o problema no Brasil.', 'Portanto, indubitavelmente, medidas são necessárias para resolver esse problema. Portanto, cabe ao Governo federal aliado ao Ministério da Fazenda promover um novo projeto que mescla Estado, iniciativa privada e planos individuais, a fim de atenuar a crueldade do projeto. Apenas sob tal perspectiva, poderemos  caminhar, rumo ao progresso sem uma pedra no caminho.']",120,120,80,120,80,520
43,Cancelamento prejudicial,"['A Constituição ederal brasileira, promulgada em 1988, prevê a todo cidadão o pleno direito à liberdade de expressão, desde que não fira a liberdade do outro. No Brasil, entretanto, é cada vez mais frequente o uso de ofensas e xingamentos, o que está diretamente ligado à ""cultura do cancelamento"" . Dentre tantos aspectos relacionados ao problema, cabe analisar suas causas e consequências.', 'Primeiramente, cabe mencionar que o cancelamento acontece de forma direta nas redes sociais, como Facebook e Twitter. Isso ocorre, principalmente, porque tais meios permitem a interação de inúmeros indivíduos sobre diversos temas, o que gera vários conflitos de ideias e pensamentos. Nesse cenário, percebe-se que quando alguém diverge dos ideais da maioria ou do politicamente correto, há um intenso ataque ao usuário, com graves ameaças. Essa situação, infelizmente, destoa dos ideais liberais de John Locke em relação ao respeito às liberdades individuais, pois evidencia a restrição da opinião do outro na sociedade.', 'Em segundo plano, pode-se destacar o fato de que a cultura do cancelamento tende a inviabilizar a construção do conhecimento, pois não há um diálogo civilizado e respeitoso. Nesse sentido, é importante enfatizar a Teoria da Ação Comunicativa, proposta por Habermas, filósofo alemão, o qual dizia que a linguagem e comunicação efetivas são fundamentais para que transformações positivas aconteçam na sociedade. Sob tal perspectiva, é possível perceber que, atualmente, esse objetivo não será alcançado.', 'Torna-se evidente, portanto, que a mídia deve falar mais sobre o tema, por meio do apoio financeiro do governo federal às grandes emissoras de televisão e rádio. Tal ação deve contar com depoimentos e entrevistas de sociólogos, professores e dos próprios usuários da internet. Espera-se, com isso, que as pessoas compreendam a importância de parar com a cultura do cancelamento.']",160,160,120,200,160,800
72,A falsa rede social,"['A rede social, hoje, é um dos principais meios de comunicação e circulação de informação. ois,  ela consegue alcançar pessoas de toda a idade em diversa parte do mundo. Com isso, há neste meio a denominada “fake ews” – notícias falsas – e como no Brasil, está em ano eleitoral, essas informações podem tanto ajudar um candidato ou denegri-lo.', 'Notícias circundantes em relação a pesquisas eleitorais são comuns de ser vista em rede social, como por exemplo, em facebook. Muitas vezes essas buscas são simuladas e fraudulentas, onde com isso, eles colocam o candidato de sua escolha como sendo o líder entre os outros . Fazendo assim com que parece que ele está à frente dos outros. Além de jogarem informações e fazer uma campanha eleitoral através da internet seja ela direta ou indiretamente.', 'Com isso, além de enaltecer um candidato, ainda denigrem a imagem do outro, para assim ter mais vantagem nas urnas . Desse modo, criam e movimentam informações falsas, muita vezes com fotos ou vídeos para acarretar ao oponente  desvantagem. E com isso, manchar a imagem e reputação do concorrente, fazendo com que ele seja visto como um mal representante. E  geralmente essas notícias circulam de forma totalmente verídicas, fazendo com que milhares de pessoas acreditam no que está sendo exposto em uma simples matéria.', 'Portanto, as notícias circulam a todo o momento e estamos sempre à frente delas. Com isso, seria primordial que antes de compartilhar qualquer informação que enalteça ou denigram a imagem de alguém que vejam a veracidade do conteúdo . Para isso, pesquisando em fontes confiáveis. E não acreditando em tudo que se lê em rede social.']",120,120,120,120,120,600
59,O Brasil e sua agricultura,"['A desigualdade pode ser entendida por aquilo que não é igual, ou pela falta de proporção entre as coisas comparadas. Ela pode se manifestar em diversas situações como, por exemplo: oportunidades de trabalho, gênero, convívio social, e, desumanamente, fome. isso mesmo, vontade de comer! É inconcebível que em um país como o Brasil, de solo fértil, terras agricultáveis e de tecnologias agrícolas desenvolvidas, ainda seja assolado pelo flagelo da fome.', 'Conforme dados da ONU  o Brasil deixou de figurar no ""mapa da fome"", desde 2014, porém, o país deixou de evoluir, está estagnado nesse quesito . A distribuição de renda ajudou o país a melhorar esse quadro, mas ele ainda é existente com ocorrências mais acentuadas na região Nordeste, seguida da região Norte, e o fato de não serem vistas pessoas com aparência esquelética transitando pelas ruas não quer dizer que o infortúnio da fome não exista. Sabe-se que a produção agrícola brasileira é suficiente para alimentar a população, inclusive o país atua como exportador nessa área, o que deve-se ajustar são as deficiências locais na gestão de políticas de distribuição e acesso aos alimentos de forma mais igualitária. Ademais, o aumento do desemprego aliado à má distribuição de renda e a uma política fiscal injusta são fatores que geram redução da renda familiar e crescimento da pobreza.', 'É importante destacar que o direito alimentação está insculpido na Carta Magna de 1988, ou seja, assegurados a todos. Nesse sentido, as políticas públicas devem objetivar a redução das diferenças sociais e tratar os menos favorecidos, isto é, aqueles que se encontram em situação de menor poder aquisitivo, de forma mais benéfica, visando uma menor desigualdade coletiva. Por esse ângulo, cabe salientar o fomento da agricultura familiar (produção de alimentos para sobrevivência do agricultor, sua família e comunidade loca), que, em consonância com dados do Governo Federal, produz cerca de 70% do total de alimentos que chegam à mesa dos brasileiros e ajudam na subsistência do pequeno produtor rural.', 'Diante do exposto, para que o Brasil avance nessa agenda de combate à fome, se faz necessária a participação de todos os setores da sociedade, de forma uníssona, como exemplo do cidadão comum, que evita o desperdício de alimentos, até a colaboração da iniciativa privada em parceria com o Governo implementando políticas públicas de segurança alimentar e agricultura sustentável para o progresso da nação.']",120,160,120,120,120,640
46,Os problemas da privatização do saneamento,"['É notório que o saneamento básico é essencial na vida das pessoas. A privatização desse serviço é importante na economia brasileira, porém, deve-se considerar que o Brasil é um país com diferenças sociais, portanto, diversos cidadãos brasileiros podem ficar sem acesso aos serviços básicos de saneamento, exigindo-se, assim, medidas das autoridades para que os direitos à vida e à saúde sejam assegurados.', 'Segundo o Sistema Nacional de Informações Sobre Saneamento (SNIS), cerca de 17% da população brasileira não tem acesso a água tratada, e apenas 46% do esgoto do país passa por tratamento . Os dados do levantamento mostram um cenário que pode se tornar ainda mais perplexo com a desestatização do saneamento básico, visto que muitas pessoas não possuem renda suficiente para adquirir o acesso a esses serviços.', 'É preciso considerar que o saneamento básico engloba diversos serviços que são fundamentais para a qualidade de vida da população, como no abastecimento de água potável, tratamento de esgoto, limpeza das cidades e recolhimento de lixo. A privatização desses serviços causa a falta de acesso a estes por parte da população de baixa renda , o que pode gerar doenças nessas pessoas, como a febre tifóide e muitas outras, que podem ser fatais.', 'Diante dos fatos expostos, é de suma importância que o Ministério da Saúde (MS) , juntamente com o Ministério da Mulher, da Família e dos Direitos Humanos (MMFDH), reúnam esforços para que esse acesso aos serviços básicos seja garantido, por meio de gratuidade destes a famílias de baixa renda. Espera-se com isso, que toda população brasileira possa viver com a higiene e saúde básicas e que são seu direito por lei.']",160,160,160,160,160,800
65,A volta dos Brasileiros a Escola,"['A base da vida de qualquer pessoa é a educação, na escola é ensinado todos os princípios básicos pra conviver em sociedade.', 'Brasileiro na escola,  é sinônimo de estudantes com um futuro próspero e pessoas no mercado de trabalho futuramente.', 'Jovens de famílias com baixa condição financeira, geralmente, tendem a abandonar os estudos para trabalhar, e muitas vezes não conseguem emprego. Pessoas que não possuem emprego, não tem dinheiro para o básico, como: moradia, alimento e roupas. Como o roubo e tráfico são meios mais ""fáceis"" de conseguir dinheiro, as pessoas seguem esse caminho.', 'Hipoteticamente, uma pessoa que teve acesso educação,  está no mercado de trabalho e consegue se sustentar, não precisa seguir esse caminho.', 'Segundo a Lei de Newton, em específico a terceira, pode ser enunciada da seguinte maneira: para qualquer ação(força) sobre um objeto, ocorre uma reação(força) com o mesmo valor e direção com sentidos opostos.', 'Imagine a situação,  uma pessoa é obrigada pela família a deixar a escola para trabalhar, a ação seria pessoa deixar a escola e a reação a falta de conhecimento da parte do cidadão. Não foi apenas largar os estudos, e sim o que esse erro acarretará no futuro dessa pessoa.', 'Um quarto dos presos volta a cometer crimes, pela falta de oportunidade no mercado de trabalho.', 'A solução do problema é simples: a volta do Brasileiro a escola', 'Para saber os princípios bases de conviver em sociedade, deve frequentar a escola.']",120,40,40,40,0,240
66,Precisa-se de bons exemplos,"['As redes sócias no Brasil se tornaram uma vergonha mundial. Pessoas que, na vida social é uma e na rede virtual é outra, por vezes irreconhecível. Desde junho de 2013 as batalhas sociais virtuais em terras brasileiras se tornaram sangrentas. Falta de respeito, ética, amor, honra e compaixão sumiram da orbita nacional. Famílias se desintegraram, amigos se odiaram e pessoas que nem se conheciam se tornaram inimigos reais. Tudo por causa da inteligência artificial.', 'Mentiras jogadas nas redes como flechas venenosas, envenenaram a paz e dividiram o país entre mortadelas e coxinhas, e o ódio passou a ser a língua mais falada na internet nacional. Um influenciador digital (pessoas que têm muitos seguidores) passou a dirigir a manada de alienados para compartilhar todo tipo de informação sobre Dilma, Lula e o PT sem nem questionar. Simplesmente pelo prazer de fazer parte daquela rede absurda de lobotomizados digitais. Sem filtro, sentimento, curiosidade ou critica para checar a informação, que logo passa a se alastrar como um raio correndo na chuva. Vão sendo manipulados e manuseados ao bel prazer de pessoas sem caráter e sem nada a perder, só pelo ilusório prazer de ter milhões de curtidas.', 'Isso é muito perigoso! Pessoas na maioria das vezes inocentes, são influenciadas por mentes criminosas para fazer o mal. A dona de casa Fabiane Maria de Jesus, morta aos 33 anos em 5 de maio de 2014. Morreu inocente, nunca fez mal a ninguém, por mentiras e boatos foi morta cruelmente, isso não pode ser esquecido . Tem que haver lei e punições severas para quem comete crime virtual. Quanto a influencia de compras, muitas vezes automaticamente a pessoa é direcionada para sites de compras, esses influenciadores não obtém sucesso com quem não tem dinheiro. Esse tipo de negocio se dá melhor no campo sentimental. Pessoas públicas, principalmente políticos são as maiores vitimas de toda persuasão digital no Brasil.', 'A coisa ficou muito séria no país, é de grande urgência que as autoridades competentes tomem providencia com lei e punição para quem comete crime virtual. Ninguém tem o direito de desrespeitar, ferir, denegrir, ofender e mentir sobre pessoas alheia, seja ela,  pessoa pública ou comum. Deve-se usar a net como um meio de socialização e nunca como arma para destruir ninguém. Para isso devemos  quebrar as paredes de crueldade e injustiça. E se fizermos o nosso melhor com o tempo que nos é dado, outros vão ter esperança no nosso exemplo. Só o bom exemplo pode melhorar o mundo! Real ou virtual.']",120,160,120,120,120,640
86,Alto uso das redes sociais,"['O Brasil é um pas com alto uso das redes socias e diante disso vem trazendo alguns problemas,prejudicando a saúde mental o uso excessivo tem sido um desafio diario das pessoas e principalmente dos jovens e adolecentes atualmente.', 'No entanto o grande uso tem se tornado um vicio acarretando serios problemas como depressão afastamento dos pais,das amizades,ocorrendo assim a reclusão,ansiedade,trazendo pressão e tornando assim algo que não é posivel ficar sem, distubios,sidromes de panico. As redes sociais tem grande poder de influenciar as pessoas,impactando de maneiras imperssepitivéis.', 'Portanto logo então é necesssario diminuir o tempo nas redes,estipulando tempo(sendo essa uma função dos aplicativos),fazer day-off,buscar fazer atividades longe das redes,aprender a viver mais os momentos,do que ficar em frente as telas,saber o mal que pode ocasionar sade mental,ONG fazer projetos socias nas comunidades com base nos perigos que as redes causa,e realizar programas que incetivem a um menor tempo gasto e usar a educação como base para reduzir o alto uso das redes socias.']",120,120,120,120,120,600
3,A Mitologênese,"['Na antiguidade, a atribuição de superpoderes a seres mitológicos foi de suma importância para a manutenção de uma ordem social em um contexto religioso, haja vista que o receio desses seres influenciava o comportamento dos indivíduos. Sob tal ótica, é fato que que, no imaginário humano, a ânsia da possibilidade de adquirir habilidades anormais persiste desde os povos antigos. Não obstante, na contemporaneidade, com o avanço científico, a capacidade de alterar genes e permitir tais habilidades se tornou realidade, assim, de que modo a superação dos limites humanos afetaria a sociedade?', 'A priori, deve-se pontuar que, apesar da de a tecnologia ser vista como progressiva e benéfica, uma vez que seu uso está sujeito aos valores de uma sociedade, os seus efeitos podem ocasionar diversos malefícios. Em um episódio da série Black Mirror, o exército de um estado é submetido aos efeitos de um chip implantado nos indivíduos em que, ao distorcer a visão destes sua visão, facilitava a execução de um genocídio. Analogamente, partindo do pressuposto de que a imposição de poder já é recorrente na sociedade, seja pelo capital ou por força bélica, a ausência de limites para a biotecnologia seria capaz de agravar conflitos e ocasionar atrocidades.', 'Em segundo plano, vale ressaltar que a transcendência dos limites humanos intensificaria a desigualdade social. No Manifesto Comunista, Marx e Engels explicitam, através de uma análise histórica, a presença da luta de classes nos diversos períodos, em que a dinâmica de um grupo dominar outro sempre foi vigente. Desta forma, além de já haver uma diferença entre os grupos sociais, a obtenção de atributos para uma parte da sociedade, ou somente para indivíduos com poder aquisitivo, seria determinante para a segregação entre humanos.', 'Em suma, depreende-se que a superação dos limites humanos, por meio das novas tecnologias, afetaria negativamente a sociedade em diversos âmbitos, permitindo a inferiorização de grupos sociais e destilação de violência. Assim, o Ministério da Educação deve incluir no material didático de filosofia atividades de discussão e reflexão acerca da tecnologia e seus limites, visando estimular o senso crítico dos discentes no que tange os efeitos sociais da biotecnologia. Destarte, estas tecnologias tenderão a ser limitadas, e a superação dos limites humanos se manterão, somente, na mitologia e no imaginário humano.']",160,160,160,160,120,760
63,"Desastres ambientais, uma omissão generalizada","['Os impactos ambientais resultantes das ações de grandes empresas precisam de uma intervenção imediata. Em um panorama atual, nunca se percebeu tantos desastres no meio ambiente causados pela ação humana como se tem ocorrido no Brasil. Neste contexto, é preciso que essas grandes corporações sejam responsabilizadas pelos danos causados, sendo que a maior parte deles são irreversíveis para a natureza . Além disso, não basta apenas punição dessas empresas, também se faz necessário a intervenção do Estado, caso contrário também deverá ser responsabilizado pela omissão no controle e fiscalização.', 'Partindo desse princípio, as grandes corporações sempre alegam que os desastres são frutos de desastres naturais, fenômeno da natureza, uma verdadeira forma de se eximir da responsabilidade dos danos causados. Diante desse problema, indubitavelmente, não é um desastre natural, e sim um crime ambiental, sendo a sociedade vítima dessas ações imprudentes e gananciosas. Diante disso, conforme preceitua a Constituição Federal de 1988, a responsabilidade dessas empresas é objetiva, e por isso devem ser responsabilizadas nas esferas penais, cíveis e administrativas.', 'Com efeito, o Estado deve manter uma postura de garantidor dos direitos individuais e coletivos, pois os danos causados violam várias garantias constitucionais . Em razão disso, mantendo uma postura omissiva faz com que o Estado também seja responsabilizado de forma solidária com as grandes corporações. Assim sendo, é preciso os governantes, os quais são representantes do povo, façam cumprir os direitos de todos, agindo de forma efetiva no controle e na fiscalização dessas atividades que violam o meio ambiente, isso porque não é possível mais aceitar tantos desastres provocados com um discurso de desastre da natureza .', 'Portanto, as soluções esperadas nos impactos ambientais se passam por uma ação preventiva e repressiva do Estado, que busque controlar e fiscalizar todas as atividades que levam a grandes impactos no meio ambiente. Mas também, é preciso que as grandes corporações sejam, verdadeiramente, responsabilizadas de forma rigorosa, para que com isso possa evitar que situações desastrosas ocorram com tanta frequência.']",120,160,120,160,120,680
46,A importância do saneamento,"['O saneamento básico é um direito do cidadão e um dever do estado, para com a sociedade. Dessa forma,é nítido que, esse direito não são para todos, já que 17% da população não tem acesso água tratada. (segundo a BRK ambiental)', 'A privatização renova muitos problemas da nação. A exemplo disso temos o Chile que ao privatiza a água teve que encarar problemas como a escassez hídrica. Sendo assim,fica visível que, as grandes cooperativas responsáveis pela distribuição não se importam com os proletariados. Tendo em vista que, 72%da água no Brasil é ultilizada para irrigação de atividades agrícolas. (segunda a agência nacional de água).', 'Logo,fica claro que, o estado por aí só   deve tomar medidas para uma maior distribuição igualitária desse elemento essencial para a vida. Como a contratação de empresas para auxiliar no compartilhamento de infraestrutura para receber o saneamento básico. Especialmente por sua importância']",120,120,120,120,120,600
48,a importância da saúde,"['Promulgada pela ONU  no ano de 1948, a Declaração Universal dos Direitos Humanos garante todos os cidadãos o direito à saúde e aos serviços públicos de seu país. Conquanto, os desafios encontrados no Brasil para o acesso ao Sistema Único de Saúde são demasiados . Nesse sentido, subterfúgios devem ser encontrados a fim de resolver a insuficiência governamental do país,  e o esquecimento das populações mais necessitadas.', 'Deve-se pontuar de início, que a insuficiência das leis governamentais configura-se como um grave empecilho no que diz respeito à importância da saúde pública no Brasil. Em pleno ano de 2020, enfrenta-se uma perigosa pandemia, e cerca de 162 milhões de pessoas dependem unicamente do SUS, o que gera uma sobrecarga no sistema. Nesse contexto, é de suma relevância a cooperação desse governo, que, precisa tomar as devidas providências para engrandecer e fortalecer a saúde pública.', 'Outrossim, e não menos importante, é o desleixo para com os cidadãos em relação ao acesso ao SUS. Conforme indaga Martin Luther King, "" toda hora é hora de fazer o que é certo"". Análogo a isso, observa-se que,  todas as áreas da população precisam ser contempladas, seja em que momento for, pois, ainda há pessoas sem acessibilidade aos seus direitos e principalmente a preservação de seu bemestar . Entretanto, faz se indubitável que medidas sejam tomadas a fim de atender a todos os cidadãos.', 'Diante dos argumentos supracitados, é notória a aplicação de soluções para a melhoria nas leis e acessibilidades. Portanto, é relevante que o governo aplique novas formas de atender todos, instaurando novas instituições de saúde nas regiões mais pobres com difícil acesso, e, consequentemente, os agentes da saúde deem uma maior atenção às minorias . Com essas ações colocadas em prática, os desafios para a importância da saúde pública do Brasil passarão a ser bem menos graves.']",160,160,160,200,160,840
46,Privatizar está longe de ser solução,"['O saneamento básico é definido como um conjunto dos serviços de infraestrutura e instalações operacionais. Nesse âmbito, hodiernamente comenta-se com frequência a respeito de sua privatização no Brasil. Dessa forma, observa-se que tal projeto do Estado deverá acentuar ainda mais a desigualdade nesse setor uma vez que desfavorecerá a parcela pobre da população.', 'A princípio, vale ressaltar a indiferença do Estado como colaborador do problema. Certamente, segundo o filósofo iluminista John Locke a sociedade é formada a partir de um acordo entre a população e o governo, no entanto, ele destaca que o problema desestabiliza, isto é, o fato do Estado não cumprir seu papel. Nessa perspectiva, analogamente é possível entender a privatização do saneamento básico como um ato de não cumprimento de deveres por parte do Estado.', 'Além disso, é relevante salientar que a privatização na prática levará ao aumento das tarifas dos serviços, o que implicará no agravamento da desigualdade de acesso. De fato, segundo a filósofa existencialista Simone de Beauvoir a sociedade apresenta um fenômeno chamado de “Invisibilidade Social”, o qual consiste na negligente ação de valorizar determinados grupos mais que outros. Nesse contexto, constata-se que a parte mais pobre da população torna-se “invisível” a essa medida, sendo assim, não possuem fácil acesso aos serviços de saneamento.', 'Portanto, em virtude dos fatos mencionados faz-se necessário medidas para atenuar essa situação. Logo, cabe ao Estado, como promotor do bem-estar social, desenvolver uma alternativa para a universalização do saneamento básico por meio de sua reestatização, e posteriormente da aplicação de mais investimentos financeiros nesse setor, para que desse modo haja a expansão desses imprescindíveis serviços a toda população brasileira, confirmando assim o pensamento de Abraham Lincoln, ""A democracia é o governo do povo, pelo povo, para o povo"".']",160,160,160,200,160,840
56,Cárcere,"['A população carcerária brasileira tem crescido exponencialmente, as penitenciárias brasileiras são caracterizados por serem locais insalubres e violarem os direitos humanos, sendo vez ou outra cenários de conflitos e mortes. Devido as suas péssimas condições estruturais, o atual cenário da situação carcerária do Brasil é alarmante, necessitando de mudanças. Logo, devem ser realizadas melhorias nas casa de detenção e um abrangente acesso à educação especialmente aos indivíduos desde a infância.', 'Em primeiro lugar, cabe-se analisar a situação estrutural das casas de detenção do Brasil. As brigas entre facções criminosas são recorrentes nos presídios brasileiros já que são favorecidas pela superlotação das celas propiciando o crescimento das facções . Uma vez que, não há funcionários suficientes nem condições mínimas para manter os presos, os detentos passam a criar lideranças e a se autogerenciar . Prova disso,  foram os massacres nos presídios em Manaus, cuja uma rebelião entre facções matou em Maio 55 presidiários. Diante disso, é urgente a realização de melhorias estruturais nas penitenciárias e construções de presídios para a transferência de presos, descongestionando as celas. No entanto, essas são medidas paliativas,  para a mudança do atual cenário é fundamental o investimento na educação.', 'Outrossim, o acesso da educação desde a infância é primordial. Segundo o matemático grego Pitágoras, ao se educarem as crianças não será necessário castigar os homens. De fato, para a reversão da atual situação carcerária deve-se investir na educação em detrimento de penas mais severas, pois punições mais severas não se mostram eficientes frente ao grande aumento de criminosos presos. Assim, aquele que tem acesso a um ensino de qualidade hoje será um cidadão consciente amanhã e com menos chances de recorrer ao crime, pois investir num melhor acesso à educação, principalmente em locais como favelas e subúrbios, apresenta oportunidades de crescimento e novas perspectivas de vida para o indivíduo.', 'É preciso, portanto, reverter o atual cenário do cárcere brasileiro não só por tomar medidas a curto prazo, mas também realizando medidas a longo prazo. Nesse sentido, o Departamento Penitenciário Nacional (DEPEN), deve realizar reformas nas penitenciárias, evitando lotações e condições insalubres, com vistorias periódicas para que os direitos humanos não sejam violados. Além disso, o Ministério da Educação , em conjunto com as ONGs , deve oferecer mais acesso à educação nas favelas e subúrbios através de cursos de informática gratuitos e oficinas de música, teatro ou idiomas, dificultando a criminalidade como uma opção.']",120,160,120,160,120,680
90,Transfobia no Brasil,"['A Declaração Universal dos Direitos Humanos prevê que todo cidadão sem distinção de qualquer natureza tem direito à educação e a cidadania. No Brasil, entretanto, o desafio do combate a transfobia na sociedade é uma realidade devido falta de reconhecimento do direito  cidadania para o público transgênero, que sofre com a discriminação e a exclusão social.', 'Diante desse cenário, esse grupo enfrenta as consequências de uma sociedade preconceituosa, que faz uso da violência e ataque transfóbico segundo a Agência Brasil. Ademais, infelizmente muitos transexuais são assassinados no país devido a sua identidade de gênero.', 'Além disso, de acordo com pesquisas do IBGE , essa minoria sofre com a exclusão educacional e no mercado de trabalho devido a sua identidade de gênero. Desse modo, as empresas deixam de contratar esse público em razão de tabus preconcebido dentro da sociedade. À vista disso, é inaceitável que o tecido social não se informe sobre as pessoas trans', 'Portanto, devido discriminação e exclusão o combate a transfobia é uma necessidade para isso, cabe ao governo federal criar por meio do Ministério da Cidadania campanhas publicitárias que vise o combate ao preconceito por parte da sociedade que marginaliza essa minoria e estabeleça parcerias com empresas público-privadas com o objetivo de acabar com a exclusão dos transgêneros dando direito à educação e ao emprego. Espera-se, com isso, que a Declaração dos Direitos Humanos seja respeitados dando cidadania a esse público..']",160,120,120,160,160,720
46,Saneamento básico,"['Tem sido muito discutido entre os governadores uma lei que priorize o saneamento básico para milhares de brasileiros que se encontra em situações completamente precárias, não tendo a coleta e muito menos o tratamento de esgotos, a água tratada, gás encanado é preciso uma limpeza bairros, um sistema de reciclagem.', 'É super relevante o tratamento de esgoto, pois livraria as populações das bactérias, poluição dos córregos, rios e mares, com a preservação dos recursos hídricos e fontes de abastecimento de água.', 'Á  diversas residências nas periferias que não possui água potável , os moradores acabam usando a água que tem, sem tratamento algum , porque eles não possuem dinheiro pra comprar o liquido, e com isso esses indivíduos acabam sem opção nenhuma colocando suas vidas, saúde em risco.', 'Os governadores  poderiam chegar em um consenso achando uma solução para esses problemas, mas enfim enquanto eles não resolvem os próprios moradores deveriam tomar uma atitude , a diversos vídeos em uma plataforma digital chamada youtube que ensina a aproveitar a água da chuva fazendo um tratamento nela com materiais simples.']",120,120,120,120,120,600
50,Respeito maior ao conhecimento,"['Deve-se compreender, inicialmente, que pesquisa e desenvolvimento científico é algo de extrema importância para que um país não fique mercê de seu próprio futuro. Sabendo que, todos os países hoje considerados bem desenvolvidos exercem enormes investimentos no campo da ciência, e por consequência reagem melhor crises que envolvem a saúde e a economia.', 'Em tempos onde o mundo sofre com um vírus completamente viral, os conhecimentos sobre todos os aspectos da ciências trazem mais facilidade para uma sociedade conseguir impedir o pico de proliferação da doença, descobrir como esse vírus age no sistema imunológico das pessoas, saber se a criação de uma vacina é algo possível faz com que a população do país não seja prejudicada em maneira excessiva, e para que o país possa se recuperar bem em um cenário pós-pandemia . A China é o melhor  exemplo para citar, lá foi onde os primeiros casos foram identificados, várias mortes diárias, mas em questão de dias já se sabia a origem da doença e qual a forma de infecção. Nos dias de hoje, já não há mais registros do coronavírus na maior parte dela.', 'Um ótimo exemplo de país que investe em ciência foi citado acima, diferentemente do Brasil, que após as graves queimadas sofridas pela floresta amazônica retirou verba da área de pesquisa e desenvolvimento , fazendo com que cientistas e estudantes passem por dificuldade para realizar seu  trabalho, além de que o governo brasileiro ignora muitas informações e problemas relatados por esses profissionais, mas ignorá-los não os farão desaparecer . Quando o vírus em questão chegou ao Brasil, sua reprodução foi contida de certa forma, mas com o passar do tempo casos foram se multiplicando  e a falta de investimento em áreas de pesquisas refletiu em uma população com medo e uma alta demanda de exames para poucos profissionais e laboratórios disponíveis.', 'Por tanto, com o momento atual de crise de saúde que o mundo está passando , mostra-se cada vez mais o quanto cada país deve modificar seus programas de pesquisa e para de negligenciar suporte para profissionais que estão dispostos ajudar para a melhoria do país, seja no campo da saúde ou da economia.']",120,120,120,120,40,520
49,Maturidade dos influenciadores digitais,"['A influenciadora Gabriela Pugliesi , que possui milhões de seguidores , publicou em suas redes sociais vídeos de uma festa que estava acontecendo  em sua casa , porém , tal comemoração ocorria em um período delicado , em que o Brasil estava passando por uma pandemia de Coronavírus , logo , o recomendado pelas autoridades de saúde era o isolamento social , o que não foi respeitado por ela . Tal fato traz tona um problema pouco comentado no país : quais são as responsabilidades dos influenciadores digitais ,visto que, eles são para muitos, referência . Assim , para os mesmos entenderem seu papel na sociedade , o Poder Executivo deve implementar leis que fiscalizem tais atos para que a sociedade civil não seja influenciada a ir na contramão das recomendações e regras impostas pelas autoridades . Além disso, as marcas que os patrocinam devem exigir formação em alguma faculdade de comunicação para que eles estejam preparados para lidar com a sociedade e com o nome da empresa.', 'A priori ,as esferas governamentais deve criar leis que fiscalizem os atos dos influenciadores para que os mesmos tenham em mente o seu papel na sociedade . Assim , medidas como punir os que incitarem , aos seus seguidores , o ódio e o não cumprimento das recomendações e regras impostas pelos poderes que regem o país , podem fazer com que tais famosos digitais não descumpram as regras como o que ocorreu com Gabriela Pugliesi que em pleno isolamento social incitou palavras de ódio e foi na contramão das recomendações impostas pela Organização Mundial de Saúde a OMS.', 'Ademais , as marcas que patrocinarem tais influenciadores devem exigir formação em alguma área da comunicação , visto que , os mesmos devem ter o preparo adequado para lidar com a sociedade civil . Além disso o nome da empresa dará força influência de tais , o que aumentará sua responsabilidade perante a população . Segundo o escritos Umberto Eco , a internet deu voz “ à uma legião de imbecis “ . Tal escritor em seu comentário , apesar de soar um pouco agressivo , refere-se ao despreparo de muitos que ,de alguma forma vai , influenciar seus seguidores .', 'Destarte, os influenciadores devem estar mais preparados e também devem ser punidos ao incitarem o ódio ou influenciar o não cumprimento da constituição e as normas impostas pelas autoridades . Portanto, o Poder Executivo deve criar leis que visem tais atos , visto que , seus seguidores podem repetir suas ações . Outrossim , as empresas que forem patrocinar tais famosos das mídias digitais devem exigir alguma formação nas áreas da comunicação para que o mesmo  consigam lidar da forma correta e influenciarem seus fãs a fazerem o certo , visto que os mesmos  , muitas vezes, acatam e repetem seu atos . Enfim , tais medidas irão acabar com os más influenciadores que apenas levam seu seguidores para caminhos errados.']",120,160,120,160,120,680
45,As bases da sociedade brasileira,"['Liberdade, igualdade e fraternidade lema da Revolução Francesa e base dos direitos humanos de uma sociedade democrática . Desse modo a Constituição brasileira se alicerça em tais fundamentos e busca garantir a todos os cidadãos igualdade perante a lei, no entanto, o que vem prevalecendo em meio a sociedade é o abuso de autoridade cometido por pessoas que se julgam superiores as outras.', 'Segundo John Locke é dever do Estado fornecer à população de maneira democrática os mesmos direitos , sendo assim, fatores externos como a renda não podem vir a interferir . Todavia, a sociedade brasileira foi construída a partir de um processo de colonização baseado no poder econômico de cada integrante e na escravidão sendo, dessa forma, estabelecida uma estrutura hierárquica.', 'Da colonização à república observa-se uma alteração na forma de governo, mas não na estrutura hierarquizada da sociedade. Dessa maneira, ainda hoje pessoas bem estabelecidas e que possuem algum cargo de prestígio se julgam melhores do que outras e colocam-se acima da lei . Fato esse que pode ser representado pela conduta do desembargador Eduardo Almeida Prado Rocha de Siqueira que foi flagrado, em julho desse ano, mal tratando um guarda civil que estava apenas cumprindo seu dever.', 'Percebe-se que o abuso de poder é um mal que afeta a sociedade brasileira a tempos. Dessa forma medidas devem ser tomadas para que a Constituição federal não seja ferida. Portanto, para que todos os cidadãos sejam tratados de forma igual perante a lei e para que ações como a do desembargador citado sejam devidamente julgadas é necessário que a Legislação seja reestruturada para que as leis punam a todos independentemente do cargo que a pessoa possui no Estado.']",160,160,120,120,120,680
59,A fome mundial,"['A fome é a realidade de milhões de pessoas. Uma desigualdade social que aterroriza grande parte da população mundial. E isso se deve não pelo fato de que não há alimento, mas sim porque elas não tem condições de pagarem para tê-lo em sua casa. A produção de alimentos é boníssima, tanto que chega a sobrar causando, muitas vezes, desperdício. O grande motivo é o dinheiro.', 'Essas pessoas, normalmente, são desprovidas de saúde, educação e consequentemente de emprego. O que gera então a falta de alimentos em seus lares. Isso é desarmônico, frustrante e vergonhoso, principalmente para países com estrutura e riquezas que poderiam se mover em prol de situações como esta.', 'Mesmo com o mundo produzindo comida suficiente para as 8 milhões de pessoas existentes no mundo , a cada 1 minuto alguém morre de fome . Crianças desnutridas, pais e mães morrendo sem a chance de dar um pedaço de pão ou água para seus filhos. Isso deveria ser inaceitável, deplorável e lastimável. Mas o que se vê cada vez mais é o contrário disso. Os governos fecham seus olhos, se viram para essas situações como se não existissem, ignoram os mais pobres e nos seus chamados por ajuda e só pensam na glória para eles mesmos.', 'A economia do país é muito importante para que isso não venha acontecer, pois assim, empregos são formados, famílias saem das ruas e conseguem se reerguer, saindo da pobreza extrema. Portanto, é relevante que as organizações responsáveis se comovam e se mobilizem facilitando a vida desses seres que são tão humanos quanto qualquer outro. Parte importante deste processo é escutar o povo afetado para compreender os impactos da fome e pobreza na região e, assim, bolar formas e projetos completos e efetivos.']",120,120,120,120,80,560
57,,"[""No filme 'O Auto da Compadecida' , o enredo baseia-se, basicamente, na história de uma família nordestina que, para assistir ao seu filme favorito (Mazarope), viaja para a capital de São Paulo em busca de um cinema que pudesse reproduzí-lo. Fora das artes cinematográfica, o acesso à cultura proporcionada pelo advento do cinema tem sido cada vez mais elitizada pela concentração capital e industrial nos grandes centros urbanos; causando, assim, um déficite no que se refere à infraestrutura de disponibilização desse recurso de lazer e cultura."", 'Divulgado pelo G1.com, nos últimos 5 anos, mesmo com o crescimento de quase 50% , apenas 170 a cada 1000 pessoas frequêntam o cinema; essas, a maioria reside em áreas de maior renda per capita. A Ancine, em consonância, afirma que, das regiões menos favorecidas com esse bem, as principais estão em áreas do Norte, Nordeste e periferias urbanas; dentre outras. Ou seja, mesmo sendo garantido o direito de igualdade a todos, sem restrição de qualquer natureza no artigo V da constituição vigente, nota-se, portanto, que o Estado não é infalível perante todas situações.', 'Ademais, pensar que o problema está a caminho de uma solução é um ledo engano. Problemas que têm, como origem, dinâmicas de outro setor da sociedade, como o industrial, geralmente, não reverbera com o primeiro, visto que esse, no Brasil, por conta da cultura de estatização, é - ainda - arcaico em sua maneira de fazer gestão.', 'Medidas que envolvem boa gestão, portanto, se fazem necessárias para a resolução do impasse. A biologia ensina, com Darwin, que nem sempre o mais forte sobrevive, mas, sim, aquele que tem a capacidade de adaptar-se a novas transformações . Dessa forma, o Governo Federal em parceria com a Ancine e a Receita Federal, deve, com viés, concedeer indultos governamentais para empresas do  ramo cinematográfico que contribuírem com a infraestrutura de disponibilização de acesso ao cinema em áreas menos favorecidas, por meio da abrangência de filiais nessas áreas e por incentivos a outras. Não obstante, estabelecer ppps (parcerias público-privadas) com cinemas virtuais para reprodução de filmes na íntegra para aqueles que mais se identificam com suas TVs em cinemas domiciliares.']",120,80,80,120,80,480
43,paradoxo da cultura do cancelamento,"['A cultura do cancelamento se fortaleceu após o movimento #Metoo, em 2017, daí em diante algumas pessoas utilizam uma corrente de forma negativa para “descartar” o outro . Punitivista e influente. A cultura do cancelamento se encontra em um ponto intermediário entre a justiça e o discurso de ódio, visto que a sociedade cria uma projeção perfeição das pessoas, da mesma forma em que há um paradoxo intríseco nos movimentos de cancelamento em massa. Dessa maneira, essa é usada, muitas vezes, para se autoafirmar e criar uma identidade, ao deixar de lado o real foco do movimento.', 'Vale salientar que a sociedade projeta pessoas perfeitas, visto que elas sofrem com a mercantilização e não podem sequer cometer erros, caso contrário, são descartadas. O que reforça a lógica capitalista: rejeitar o que é “defeituoso”. Em contrapartida, o movimento do cancelamento segue uma corrente de caráter evolutivo, o qual não tolera pensamentos preconceituosos , sexistas; como é o caso da propaganda da skol que reformulou seu posicionamento após várias críticas recebidas ao sugerir que as mulheres deixassem o “não” em casa para curtir o carnaval . Contudo, essa corrente perdeu o real foco a ser pautado, ao se transformar em um movimento de perseguição. Assim, a busca pela perfeição reforça uma cultura do cancelamento contínuo.', 'Paralelamente, há um paradoxo intríseco na cultura do cancelamento , já que essa surgiu como uma forma de inclusão social e barrar comentários preconceituosos e de assédio, porém, algumas pessoas usam a causa para propagar o ódio , ser intolerantes , e que por várias vezes entram por influência; ideia essa, interpretada na teoria do rebanho de Nietzsche. Tal fato seja por não apoiar uma figura política, não gostar de um estilo musical , entre outros . Desse modo, a falta de diálogo sobre o tema abordado e a dificuldade da sociedade em distinguir o que realmente deve ser “cancelado “ gera uma coletividade de ideias discriminatórias.', 'A cultura do cancelamento se encontra em um ponto intermediário entre a justiça e o discurso de ódio. Logo , é responsabilidade do Ministério da educação estimular a abordagem desse tema nas escolas, ao inserir palestras e professores que discutam essa temática, ao mostrar aos alunos a importância em diferenciar justiça social a destilamento de ódio, e o impacto que essa perseguição pode causar nas pessoas. Concomitantemente , é necessário a fiscalização de órgãos governamentais, como o Ministério da comunicação, nas redes sociais, ao monitorar os assuntos levantados e propagados nessas redes.']",160,160,120,120,160,720
75,O direito à autodefesa,"['O aumento da criminalidade no Brasil tem gerado uma crescente preocupação na população, essa tem pleiteado a revogação do estatuto do desarmamento. Porém, será que tal medida favoreceria de fato aos cidadãos? Certamente não. Pois a problemática onda de violência que o Brasil se encontra poderia culminar na sociedade atual em um cenário de mortes gerado pelo armamentismo civil legalizado.', 'A maioria das pessoas anda pelas ruas em alerta, com medo de serem assaltadas, rendida por bandidos ou exposta a situação de risco a qualquer momento  isso sem contar que o armamento civil legalizado potencializaria as mortes por brigas domésticas, no trânsito e outros motivos fúteis . Nesse cenário, segundo os opositores do desarmamento, o porte de arma torna–se imprescindível, pois garante ao cidadão o direito de se defender e anula as diferenças de força e tamanho entre o bandido e a vítima. Isso porque os criminosos terão receio da vítima estar armada e reagir ao crime.', 'Dessa forma, não se pode permitir a liberação do porte de armas no Brasil, pois isso colocaria e sujeitaria em risco os indivíduos inocentes. Para o País avançar é necessário que essa liberação venha acompanhada de outras medidas, tais como desarmamento dos criminosos, melhorias na formação e no pagamento dos policiais, criação de leis mais severas e punição efetiva dos criminosos.']",160,120,120,160,120,680
89,Autorresponsabilidade em tempos de pandemia,"['A crise na saúde ocasionada pela pandemia do covid-19 desestabilizou toda a sociedade gerando impactos significativos na economia mundial. O isolamento social surgiu como uma ação necessária para frear o contágio do vírus. Porém, a conscientização a respeito do mesmo, representa um grande problema para os líderes políticos, o qual está fortemente ligado à negligência da população e a dificuldade de fiscalizar a conformidade das ações de prevenção  contra a doença.', 'Inicialmente, cabe ressaltar que apesar das inúmeras mortes e intenso fluxo de informações a respeito da importância do isolamento social, seja por não apresentarem fatores de riscos, já terem sido infectadas ou por falta de cuidado, uma parcela da população insiste em ignorar as medidas de prevenção contra o coronavírus. Após 1 ano da pandemia, o uso incorreto das máscaras e aglomerações desnecessárias são cenas comuns. A variedade nos números e forma de casos prova o quão resistente o vírus tem sido e renovam a necessidade de seguir as medidas de prevenção enquanto não forem asseguradas ações definitivas de disseminação da doença.', 'Outro ponto de destaque é a importância das ações de prevenção serem fiscalizadas a todo momento para controlar o caos enfrentado na saúde e evitar um caos ainda maior na economia. No momento é essencial que cada cidadão autorresponsabilize-se e siga as medidas preventivas contra a covid-19, já que as prefeituras não são capazes de fiscalizar as centenas de recintos com pessoas circulando diariamente. Essa conscientização é fundamental para diminuição do nível de contágio e consequente permanência do funcionamento das atividades econômicas.', 'Sendo assim é necessário que o Ministério da Saúde  juntamente com o Ministério da Economia providencie por meio de um site cartilhas com procedimentos padrões para os estabelecimentos e empresas públicas e privadas, para que cada empreendedor, funcionário e cidadão esteja ciente de que é seu dever combater o covid-19. Nesse mesmo site deve haver um local aberto para o registro de denúncias de descumprimento das medidas preventivas, que sendo recorrentes deverão ser averiguadas e punidos os responsáveis diretos com pena de multa.']",160,160,120,200,160,800
52,"Gravidez precoce, um milagre indesejado","['Um grande problema muito presente na sociedade brasileira é a gravidez precoce, em sua grande maioria entre adolescentes de baixa renda e pouca expectativa de futuro . Esse tema gera um debate recorrente na nossa sociedade, pois é um problema pertinente, e para que se consiga resolver será necessário uma reforma nas políticas públicas em relação métodos anticoncepcionais e também de educação.', 'A gravidez na adolescência, embora presente em todas as classes sociais no Brasil, afeta em maior nível, as classes mais baixas, onde o acesso educação é escasso e dificilmente completo. Então será de suma importância uma melhora no sistema educacional público e posteriormente incluir nas escolas preferencialmente a partir do Ensino Fundamental 2 aulas de educação sexual, a qual o a instituição informará os alunos sobre métodos contraceptivos.', 'Contudo, apenas ensinar sobre métodos contraceptivos não é eficaz se a população não tem acesso a eles, será necessário entender a questão de gravidez precoce como não apenas uma questão social como uma questão de saúde pública. Ou seja, para que consiga-se uma melhora na situação será necessário que os postos de saúde públicos tenham esses anticoncepcionais para quem for precisar, sem nenhum ou baixo custo.', 'Concluindo, o Brasil sofre com a gravidez precoce pois na conjuntura atual as classes mais baixas não são conscientizadas sobre o assunto , não aprendem a previnir e nem tem acesso a métodos anticoncepcionais . Para resolver o problema, será necessário que os Ministérios de Cultura e Saúde se unam, para que os jovens consigam receber mais escolaridade  e nas escolas aprender métodos preventivos e que em postos de Saúde eles consigam ter acesso a esses métodos e assim estarem mais seguros.']",120,80,80,80,40,400
54,A desconfiança sobre vacinas aumenta à medida que as doenças somem,"['De acordo com o filósofo Byung-Chul Han, cada época possui suas enfermidades fundamentais. Com a descoberta do antibiótico e da vacina, a época bacteriológica e viral chegou ao fim. Nessa perspectiva, estamos na época denominada de neuronal, devido ao aumento de doenças neuronais como a depressão . Em contrapartida, na sociedade pós-moderna, com as metas de vacinação não atingidas e o aparecimento de casos de doenças quase erradicadas como o sarampo, observa-se que é urgente a conscientização da população dos benefícios da vacina a fim de prevenir doenças.', 'Esse fenômeno é provocado pelo movimento antivacina. O seu surgimento pode ser explicado de uma maneira simples: quanto mais o tempo passa que não vemos as mazelas que as vacinas imunizam, mais focamos nos efeitos colaterais delas, que são raros e sempre mais brandos que a doença em si. O mais preocupante são os pais deixarem de vacinar seus filhos, expondo-os às doenças graves que podem levar até a óbito e, também, colocar em risco a saúde de pessoas que não podem ser vacinadas como os imunodeprimidos.', 'Esse movimento antivacina foi alvo de preocupação internacional  em 2019, quando a Organização Mundial de Saúde (OMS) divulgou no começo do ano um relatório dizendo que esse movimento é um dos dez maiores riscos à saúde humana. Ademais, essa situação é potencializada na modernidade líquida descrita por Zygmunt Bauman , haja vista que as pessoas estão expostas a todo momento por fake news e teorias da conspiração nas redes sociais como as de que a vacina do sarampo causa autismo nas crianças.', 'Portanto, diante do exposto, para proteger o direito à saúde, constitucionalmente garantido , é importante a realização de campanhas de vacinação que expliquem para as pessoas sobre os benefícios da vacina e desmistifiquem as fake news sobre o tema. Deve-se ter a consciência de manter o cartão de vacinação atualizado, respeitando as quantidades de doses para se ter a efetiva imunização.']",120,120,120,120,120,600
95,Nossa história não começa em 1988,"['Nas escolas, é comum aprender a história do Brasil a partir da chegada dos colonizadores, ignorando a existência dos povos originários que aqui habitavam, o que perpetua o apagamento de suas etnias . Semelhantemente, o marco temporal; tese em defesa de permitir que os indígenas possam reivindicar apenas a demarcação das áreas, as quais, estivessem estabelecidos até a data da promulgação da Constituição federal; ignora todo o histórico de lutas desses povos por suas terras, desconsiderando os problemas que os fizeram perder territórios, promovendo da mesma forma o desaparecimento da cultura nativa do país.', 'O início desses conflitos que levaram os indígenas a perder as suas terras, foram no século XV, a partir da chegada dos portugueses, os quais vieram da Europa com a intenção de colonizar o “novo mundo” e se apropriar de todo tipo de recurso encontrado aqui. Para tal, eles iniciaram seu processo dizimando milhares de indígenas, a princípio, com doenças, como varíola, gripe e sarampo, trazidas de lá, e, depois, por meio da violência e escravidão. Com isso, um enorme número de culturas fora extinguida, e os grupos que sobraram,afugentavam-se para não serem escravizados, perdendo o acesso a suas próprias regiões.', 'Mais tarde, nos anos 60, com o processo de urbanização, os indígenas passaram a enfrentar problemas por ação das indústrias hidrelétricas, agropecuárias e mineradoras, que, até hoje, desmatam e utilizam de outros artifícios, como a grilagem e assassinatos, para explorar territórios reservados s tribos, desabrigando e destruindo a existência de milhares. Ainda assim, com a Constituição de 1988, houveram alguns avanços em relação a seus direitos, porém, poucos, levando a permanência da luta indígena por moradia e sobrevivência, atualmente, ameaçada pelo marco temporal.', 'Portanto, conclui-se, a partir dos fatos destacados, que o STF  deve tornar ilegal a tese do marco temporal, porque, ela afeta de forma deveras prejudicial toda a população indígena, representando um retrocesso quanto a seus direitos de moradia, já que permite ainda mais liberdade para ruralistas e garimpeiros tomarem seus territórios. Além do mais, é necessário também, que o governo federal,  imponha leis severas contra o desmatamento dessas terras, de modo a acabar com as explorações ilegais. Assim, o país pode passar a entender a importância da história e resistência de seus povos nativos, a fim de tratá-los com o devido respeito.']",120,120,120,160,160,680
117,Eutanásia,"['Quando vamos morrer não somos nós quem decide, não sabemos a hora e nem temos opção de escolha. Neste momento há milhares de pessoas doentes em todo o mundo, muitas delas gostariam de terminar logo com a dor e o sofrimento que as atormentam. Em meio a essa situação, não é só o doente que sofre, mas também os amigos e familiares.', 'A eutanásia poderia ser útil no Brasil                caso fosse         legalizada         ajudaria a muitas pessoas que esperam com medo e ansiosas a sua hora de morrer. Sem a certeza de que um dia         irá         se recuperar, a angústia e a tristeza tomam conta dessas pessoas,         as deixando         com mais vontade de que sua vida tenha um fim. E a maioria delas já tem seu tempo de vida decretado, só precisam esperar para partir.', 'Essa maneira de morrer pode ser vista por muitos com maus olhos, mas cada um deveria sim decidir sua hora, pois quem melhor do que a própria pessoa para optar se ela quer ou não viver? Quando a mesma está consciente, deveria ter o direito de escolher o que ela deseja para sua vida,                 ser dada a ela opções                .', 'Mas poderia haver uma exceção com relação         a         eutanásia: caso a                 pessoa                esteja em coma         ou         estado vegetativo, ninguém deve ter o direito de decidir por ela, se vai viver ou não. Pois nesses casos         a pessoa não está apta para         decidir o que quer, e muitas vezes         estão         lutando para sobreviver e retornar         a          vida                . E em alguns casos, há         pessoas         que se recuperam e depois de anos despertam do coma,         com algum tempo,         voltam a ter uma                 vida                normal.', 'Sabemos que a                 vida                é a maior preciosidade que temos, e enquanto temos saúde devemos aproveitar cada minuto. Ninguém deve decidir o tempo de                 vida                de outra                 pessoa                , a não ser ela mesma, porque não sabemos o que o futuro pode estar reservando a                 ela                . Pode ser que para uns a                 pessoa                não tenha mais chances, mas                 ela                pode estar lutando para sobreviver.']",120,160,160,120,120,680
5,Agrotóxicos são polêmicos,"['Agrotóxicos são polêmicos, alguns polêmicos: alguns falam que é são um mal necessário para defender os campos agrículas , outros que são compostos carcicogênicos que são totalmente desnecessários para a presevervação do meio agrícola agrícola.', 'E realmente existem produtos sem pesticidas artificiais, que são chamados de orgânicos e para identificar esses produtos tem um selo em todos os produtos orgânicos, existem produtos com uma menor adição de agrotóxicos que são menos prejudiciais. Mas mesmo assim contém Mas, mesmo assim, contêm agrotóxicos, e tanto os produtos orgânicos quanto os com menos adição de agrotóxicos possuem uma melhor qualidade para a comida e o paladar, e uma qualidade bem melhor para a saúde. Principalmente os orgânicos que não tem têm a capacidade de causar câncer por causa de não terem a adição de pesticidas, por pesticidas. Por outro lado lado, vendo pela economia economia, os agrotóxicos são ótimos, pois eles conservam e protegem o campo agrícola e são baratos, já fazendo uma plantação orgânica o custo é muito mais alto. E o tempo para produzir os campos agrícolas sem pesticidas demora muito mais.', 'Então Então, é algo muito complicado, pois para a saúde saúde, os pesticidas são péssimos, já para a economia são muito benéficos, o benéficos. O melhor jeito de criar um consenso entre a economia e a saúde saúde, seria diminuir o uso de agrotóxicos, usar agrotóxicos cientificamente comprovados que fazem menos mal, ou usar um jeito de conservar o meio agrícula de uma forma orgânica e barata.']",80,80,40,40,80,320
51,a mente preguiçosa,"['A tecnologia trouxe coisas inovadoras para a vida dos brasileiros  porém trouxe também problemas novos um deles sendo o analfabetismo funcional, a incapacidade de compreender e fazer interpretações dos textos apresentados', 'Os casos aumentaram extraordinariamente depois da chegada do Smartphone, telefone celular, e sua fácil acessibilidade que faz com os portadores do mesmo não tenha que trabalhar a mente, assim esforçando se para compreender o mundo ao seu redor ,trazendo conforto para o cérebro. Essa facilidade atrapalha o desenvolvimento mental e social das pessoas que utilizam o aparelho, causando problemas como: antissociabilidade, ansiedade, depressão e analfabetismo funcional que é muito comum em salas de aula no seculo 21 por causa do fácil acesso dado aos alunos,nos séculos anteriores pré-chegada da tecnologia os alunos haveriam de procurar interpretar o livro, ou o texto que foi lhe dado, fazer uma tese e entregá-la ao responsável por seus estudo, assim exercitando o cérebro trazendo mais facilidade ao dia-a-dia sem prejudicar a saúde.', 'Para ajudar a diminuir o diagnostico da deficiência o Ministério da Educação deve utilizar ações de propaganda e marketing, para divulgar a porcentagem e assim dar motivação aos novos alunos e às pessoas, seguido por locais públicos de leitura e eventos onde todos possam compartilhar suas opiniões e ideias sobre o que leram. Pois a única coisa que nos difere dos animais é a racionalidade. Perdendo ela, o que nos sobra?']",120,80,80,120,0,400
122,Intolerância zero,"['Herança cultural. Intolerância. Violência religiosa.                Estes são fatores que fazem parte da atualidade         brasileira         . A população do                 país tropical                cresce num local onde ainda         existe         preconceitos encravados na mentalidade humana. Fato este que acontece em menores proporções, porém, ainda percorre         pelo         cotidiano do         brasileiro         .', 'O         Brasil         possui uma grande                 bagagem cultural                que acompanha os cidadãos desde o         nascimentos         . O fundamentalismo religioso existe em minoria na realidade         brasileira         , mas este                 pensamento alienado                ainda gera violência em diferentes territórios         brasileiros         . Essa triste herança constrói pessoas egoístas que                 espalham o terror em diferentes Estados                , causando revolta na maioria da população.', 'É importante também perceber que                 a mídia          influência          a intolerância religiosa no país laico da América do Sul                . Ao divulgar notícias de outros países em que há mais desrespeito às diferentes religiões, os meios de comunicação reforçam os preconceitos e aumentam o número de                 alienados                que possuem uma personalidade fraca e não conseguem superar a falsa ideia da existência de uma         pseudo superioridade         sobre outras pessoas diferentes religiosamente.                 Estes ""heróis sem          caráter""          segundo Mário de Andrade, preferem agir de maneira individualista para exterminar tudo que para eles está ""errado"".', 'É notório, portanto, que                 esta alienação                é consequência de pensamentos pré-existentes e que precisa ser combatida. Para isso, é primordial que haja, por parte do governo, maior rigor e punição com crimes relacionados à intolerância; cabe à família explicar e dar ideias do que é um verdadeiro país laico e respeitador; ao         indivíduo          agir propagando solidariedade na mídia à todos que ali estão                . Assim é possível o Brasil atingir a solidariedade e tolerância plena sem deixar que                 o passado                interfira nas relações cotidianas.']",120,120,80,120,80,520
58,Até que ponto a ganância irá nos consumir?,"['A floresta Amazônica cuja maior floresta tropical do mundo está frequentemente sendo alvo de desmatamento devido sua grade riqueza em recursos.', 'Este que é um dos maiores biomas do mundo, com uma abundante quantidade de plantas usadas para fins medicinais, grande reservatório de agua doce, diversidade exorbitante na fauna e flora e ainda uma grande armazenadora de carbono ajudando no equilíbrio climático.', 'Porém, a Amazônia anda sendo foco de muitos indícios de desmatamento , podendo ser mostrado através do INPE (Instituto Nacional de Pesquisa Espacial) dados apostando 4,6 KM2 de área com desmatamento em 2018.', 'Por motivos como esse o Brasil perdeu acordos com países como Alemanha e Berlim que visavam fundos para Amazônia. E ainda havendo a exoneração do diretor do INPE após expor dador que evidenciavam números alarmantes sobre as queimadas.', 'Assim, devendo ser mais rigorosas as leis protetivas do Código Florestal, busca pelos direitos através de protesto e abaixo assinado , reivindicação por uma cultura que se proponha mais a buscar a preservação ao meio ambiente ao invés das ganancia pelo dinheiro, na qual será uma busca fútil visando que daqui alguns anos se não houver mais recursos não teremos como viver, e assim colocando em pratica todas as ideias e lutando por um mundo melhor..']",120,160,80,120,80,560
82,A necessidade da consciencia da automedicação,"['Um resfriado ou uma dor de cabeça são decorrentes  de vez em quando  na  rotina de algum cidadão. Automedicar-se é uma rápida solução para isso, todavia  há casos  que podem ser errônea esta  decisão.', 'A rotina cansativa que boa parte dos brasileiros possuem  é um fator que ocasionalmente abaixa a imunidade  permitindo uma fácil contração de vírus, sendo na maioria das vezes uma gripe leve. Para ganhar tempo, muitos se automedicam, algo que a OMS é a favor, pois sabe-se que muitos hospitais apresentam uma alta demanda de atendimento. Para um primeiro sinal do sintoma pode ser válido tomar um certo remédio por conta própria, porque ainda não há evidências que possa se tornar uma forte doença.', 'Entretanto, dependendo do tipo de vírus que foi contraído, o medicamento tomado pode ser fatal. Há quem acredite que pelo sintomas não ter desaparecido deve-se tomar mais doses, uma grande erro cometido. Até mesmo em comerciais de diversas marcas de analgésico indicam procurar um médico caso aconteça o inesperado, porém é tão breve a mensagem que provavelmente poucos se dão conta dela.', 'Diante dos fatos mencionados, a automedicação não deve ser combatida,  pelos profissionais da saúde e cidadãos por meio de protestos, para reformular a lei que avisa aos consumidores a indicação no fim do comercial de remédios, para algo com maior tempo de duração e chamativo, com o intuito de conscientizar a população que se automedica.']",120,120,120,120,120,600
90,Combate à Transfobia,"['""Ser trans não me faz ser menos mulher do que ninguém"", afirma Thiessa, mais conhecida como Thiessita  em seu canal no YouTube onde a mesma aborda sua vivência enquanto mulher trans no Brasil. Em um de seus vídeos, a influencer relata a agressão física que sofrera do pai após conversar com o mesmo sobre ter se descoberto transgênero. Tal agressão é o reflexo de uma sociedade resultante de conceitos ultrapassados enraizados no país que mais mata transexuais no mundo, de acordo com a ONG Transgender Europe (TGEU). A desmoralização de personagens transexuais e travestis em programas de TV e seriados onde são satirizados  contribui para a desmoralização da imagem de pessoas trans e silenciamento de causas, uma vez que, ao invés de serem ouvidos, acabam por serem ridicularizados. Tal imagem enraizada na mente da população proveniente da desinformação e da escassez de leis punitivas influencia diretamente na falta de oportunidades para transexuais no mercado de trabalho, o que resulta em se verem obrigados a se voltar para a prostituição. O Brasil registrou 175 assassinatos em 2020, sendo todas as vítimas mulheres trans/travestis, em sua maioria negras e na prostituição.', 'Deve-se destacar a influência - não punida - de programas televisivos, piadas e até mesmo figuras de poder na normalização da transfobia, banalizando o assunto e silenciando as problemáticas apontadas, minimizando vivências de pessoas trans, impactando diretamente na marginalização de tais pessoas que recorrem para as ruas como única opção, dada a falta de transexuais inseridos no mercado de trabalho, uma vez que empresas e afins, em sua maioria, não abrem espaço para empregar transexuais e travestis . A crescente desinformação e relutância em se informar sobre pautas da causa trans aumenta a escassez de ações em pró de acolher, ouvir e ajudar, visto que é notório as mobilizações serem majoritariamente realizadas por próprias pessoas trans que não contam com ajuda externa tampouco auxílio por parte do governo.', 'Dito isso, afim de combater a transfobia no Brasil, cabe ao governo, a autoridade governante, implementar medidas mais rigorosas para punir queles que cometem a transfobia. Além disso, torna-se crucial a realização de palestras educacionais voltadas para crianças e adolescentes em ambiente escolar sobre a temática LGBTQ+  com o intuito de promover o respeito, a tolerância e o autoconhecimento. Sobre este último, se faz necessário a inclusão de psicológos escolares focados no autoconhecimento do jovem para que, assim, caso o mesmo venha a se descobrir LGBTQ+, possa obter acolhimento ao invés de represália. Ademais, cabe ao governo o auxílio na reintegração de transgêneros na sociedade de maneira digna, com a realização de projetos cujo intuito seja retirá-los das situações de rua e reintegrá-los no mercado de trabalho, estabelecendo uma norma de que cada empresa deverá possuir ao menos duas pessoas transexuais/travestis em sua equipe de funcionários, onde as mesmas serão tratadas com o mesmo respeito que seus colegas de trabalho. Por fim, torna-se claro que somente com mais respeito e inclusão pode-se haver uma verdadeira transformação no Brasil.']",160,160,120,200,160,800
138,As duas faces da moeda,"['Vivemos em um mundo onde o covarde e o valente encontram-se                 ""juntos e misturados""                em situações do nosso cotidiano. Os grandes guerreiros medievais, consagrados pelos seus atos heroicos,         ressurgem-se         hoje em pessoas comuns que sofrem, choram, temem e perdem batalhas ao longo da vida.', 'A incoerência e a falta de ética aparecem de acordo com a situação. Somos humanos e falhos, sujeitos ao erro ou ao acerto,         a         glória ou ao declínio e, nesse caso,                 chega-se ao fundo do poço, onde se é impiedosamente julgado e castigado por um ato impensado.']",120,80,0,120,0,320
66,,"['O romance “1984”, do autor George Orwell, conta a história de um Estado totalitário fictício, cuja população sofre uma lavagem cerebral, mediante o uso de propagandas televisivas e de cartazes intimidadores. Fora da esfera literária, porém, a manipulação dos comportamentos individuais é uma triste realidade, a qual é corroborada principalmente pela internet. Desse contexto, infere-se que tal problemática advém da globalização e resulta na alienação social.', 'Em primeiro ângulo, convém ressaltar o processo de diminuição de distâncias, propiciado pela internet, como impulsionador do impasse. Prova disso é a ascendente influência que a mídia internacional exerce sobre os brasileiros, ora pelo controle de dados, ora pela individualização das notícias veiculadas . Consequentemente, essas práticas possibilitam a revoltante manipulação dos usuários que, por sua vez, têm suas vidas e as suas rotinas invadidas.', 'Ademais, outra lastimável consequência do problema é a alienação dos cidadãos, que perdem o seu senso crítico posteriormente. Nesse sentido, já dizia Karl Marx que o controle da informação diária e da burocracia é uma peça fundamental na alienação de uma sociedade pós-industrial . Logo, é inaceitável que exista um “absolutismo informacional” nos jornais, nos rádios e, especialmente, nas redes sociais, porquanto um dos direitos fundamentais da Constituição Federal é a liberdade de pensamento.', 'Destarte, faz-se necessário que o governo fomente a lucidez populacional quanto aos riscos da manipulação na internet. Para isso, o Ministério Público deve alertar a população sobre os perigos da exposição excessiva nesse âmbito, por meio de publicações nas redes sociais do órgão, as quais deverão contemplar “memes”, charges lúdicas e estatísticas tangentes à problemática, visando a abrangir todos os extratos sociais. Por conseguinte, a alienação social tornar-se-á sujeita ao fim e a globalização terá seus impactos amenizados, afastando, assim, o Brasil da assustadora ficção escrita por George Orwell.']",160,160,120,160,120,720
47,Entraves educacionais,"['O avanço significativo da tecnologia, aliado à popularização do uso da internet, tem sido de grande valia para diversos campos do conhecimento. Entretanto, na área educacional, os desafios do ensino à distância ainda são vastos, há diversas barreiras a serem superadas, como exemplo da falta de acesso a equipamentos básicos por parte dos alunos de baixa renda e a falta de capacitação de educadores.', 'Conforme disposição constitucional, a educação é direito de todos e dever do Estado, porém, com o advento da pandemia d covid-19, vê-se que o estado não tem conseguido desempenhar o seu papel de forma eficaz, aliás, isso não é de hoje . Boa parte dos estudantes brasileiros é de baixa renda e não tem acesso às aulas do ensino à distância por falta de computador ou por falta de acesso à internet. Desse modo, o ensino público no Brasil, que já não era desempenhado a contento, mostra-se ainda mais defasado quando comparado ao ensino particular. Este, disponível a famílias abastadas as quais dispõem dos mais variados recursos tecnológicos, que vão desde o uso de um simples smartphone até um computador de última geração, munido da mais potente banda larga.', 'Outro fator não menos importante, diz respeito a capacitação dos professores nesse novo cenário educacional. O ensino à distância é utilizado em alguns cursos de formação superior há certo tempo, todavia,  esse método não teve espaço na educação básica, por exemplo, o qual tem enfrentado diversos entraves na sua implementação. Professores relatam a falta de habilidade para lidarem com as ferramentas virtuais, isso faz com que se crie um distanciamento na relação professor aluno, pois os educadores devem saber explorar os recursos tecnológicos disponíveis para conseguirem falar na mesma língua das crianças e adolescentes dos dias atuais . Logo, ao corpo docente é recomendado que se atente às inovações da sua área, por meio de cursos de capacitação técnica educacional, a fim de estreitar o vínculo com os educandos.', 'Portanto, diante desses desafios do ensino à distância no Brasil, seria pertinente adotar-se medidas como a destinação de computadores ociosos da Administração Pública – de todas as esferas: União, Estados e Municípios -, e destiná-los aos alunos de baixa renda; unindo-se a isso, uma parceria entre Governo e empresas de telecomunicação  para o oferecimento de internet gratuita a esses estudantes. Além disso, a implementação, por parte do Estado, de centros de capacitação para os professores, para que haja constante atualização dos conteúdos de sua área de atuação. Assim, o equilíbrio de uma sociedade justa respeitará a dignidade da pessoa humana']",160,160,120,160,160,760
69,,"['É controvertível a força econômica e política que o agronegócio historicamente tem no Brasil, onde o tornou o maior consumidor de agrotóxicos do mundo. Contudo, tal compostos químicos estão sendo utilizados inadequadamente gerando riscos à saúde da população e ao meio ambiente. Como é abordado no documentário O Veneno está na Mesa do cineastra Silvio Tendler, onde mostra como estamos  nos alimentando mal por conta de um modelo agrário baseado no agronegócio, onde o perigo é direcionado à trabalhadores pela manipulação de venenos, quanto para toda a população do campo e das cidades,  que consomem os produtos agrícolas com agrotóxicos . Neste aspecto, convém analisar as principais consequências e possível modelo de solução para esta inercial problemática.', 'Primeiramente, as mortes e intoxicações pelo o uso destes produtos químicos acabaram tornando-se um grande problema de saúde pública. Segundo o Ministério da Saúde  em 2017 foram registrados 4.003 casos de intoxicação por exposição a agrotóxicos em todo o país. No ano passado, 164 pessoas após entrar em contato com o veneno, e 157 ficaram incapacitados para o trabalho agrícola, sem contar intoxicações que evoluíram para doenças crônicas, como o câncer. Logo, percebemos  a precariedade dos efeitos destes produtos no organismo humano.', 'Tangente ao meio ambiente, a prática destes compostos químicos gera impactos ambientais causados pela superexploração da biodiversidade. Desmatamento que direcionou o Cerrado e a Mata Atlântica serem introduzidas na busca imediata por biomas ameaçados de extinção, contaminação do solo pelo uso indiscriminado de fertilizantes e antibióticos. São alguns dos exemplos dos efeitos ambientais, mostrando a necessidade em amenizar cada vez mais esta técnica agrícola.', 'Pode-se dizer, portanto, que é preciso intensificar a produção de alimentos orgânicos, com projetos governamentais de investimentos na agricultura familiar para que futuramente seja suficiente ao consumo e importação. Tais medidas associadas ao controle da produção alimentícia agrícola,  tornará benéfica ao meio ambiente. Afinal, assim será possível ao menos garantir a saúde e o desenvolvimento de uma nação mais prolongada.']",120,160,120,160,120,680
138,Homens e meninos,"['Os seres humanos são dotados de diversos comportamentos. Em determinados momentos da sua trajetória de vida esses comportamentos são observados com maior frequência.                 Muitas mulheres, quando mães, por exemplo, por muitas vezes viram “leoas” para defender a sua prole.                Essa conduta de coragem é o que, por muitas vezes, faz a humanidade evoluir.', 'A coragem humana é datada desde a Antiguidade. Durante o Primeiro Triunvirato, em Roma, foi possível ver a coragem de Júlio César. Após perder o poder e ser obrigado a voltar a Roma, César se encorajou diante do novo governo, prosseguiu com seu exército. Anexou vários territórios a Roma e, por fim, conseguiu tornar-se imperador. Como consequência da sua bravura, Roma teve sua economia reestabelecida e uma população menos         revoltosa. Dessa         forma ajudando a formação de um Estado mais justo.', 'Em         contra partida a         coragem, existe a         covardia.                   Um         dos comportamentos que mais deprecia a figura do ser humano. Um recente caso         de um ato de         covardia foi mostrado ao         mundo. O         capitão do navio Costa Concordia abandonou o navio no momento em que         o mesmo         afundava com milhares de pessoas a bordo.                 Muitos o recriminaram por essa atitude, que, nesse caso,          uma das únicas coisas que trouxe de positivo foi a reflexão das         atitudes humanas em situações extremas.', 'Um ato de coragem e bravura pode mudar vidas e até mudar a situação de um Estado e um ato de covardia pode dizimar centenas de vidas. Talvez, nunca se saiba o que levou o capitão do navio que naufragou na costa da Itália, o Costa Concordia, a ter essa atitude.                 Mas é de conhecimento de todos que a coragem separa os homens dos meninos.']",160,200,160,120,80,720
85,vamos juntos concretizar,"['Nosso sistema de leis hoje e bastante grandioso,mas não satisfatório,pois nem sempre as leis fazem a  justiça acontecer. Entao com isso o poder judiciário tem de tomer as devidas precausoes e providências para que tudo se concretize de forma correta sem desmerecer ninguém. No brasil , quase em todas as vezes os mais pobres sempre levam a culpa, devemos mudar esse padrão horroroso e pôr em fim (a) esse modo ridículo de julgar. Devemos ser corretos,ter a consciência de que todos somos iguais. Lembrando do artigo número 1 da declaraçao dos direitos humanos,todo homem nasce livre e com direitos.']",0,0,0,0,0,0
48,Saúde  em pânico,"['Saúde em crise', 'A constituição ederal criou em 1988  o SUS e no artigo N° 196 diz: :saúde é direito de todos"", ciente de que mais de 50% dos habitantes precisam desse serviço, o governo deveria ter mais sensibilidade . Quando o povo se depara com essas leis ficam animados e imaginam um atendimento eficaz. Todavia no entra e sai de governo o que se tem mesmo é um serviço precário. A classe mais carente enfrenta muitas dificuldades, desde: atendimento básico, que são as consultas médicas, burocracia para realização de exames e até filas gigantesca de doentes esperando por uma cirurgia  e em alguns casos o quadro clínico se agrava levando a óbito.', 'As instituições governamentais deveriam se o reorganizar e reunir os empresários para que juntos possam criar meios de oferecer saúde preventiva, pois prevenindo  teriam o menor números de doentes. No entanto isso não é interessante, pois o povo doente fica  mercê do governo, fica dependente de auxlio políticos, para que assim sejam comprados no período eleitoral.', 'No entanto, a população tem que reagir e lutar pelos seus direitos e o governo encarar a situação e melhorar o sistema, incluindo atividades físicas como plano de medicina preventiva,para todos.']",160,160,80,120,40,560
72,Fake news,"['Em 1937,General Góes Monteiro  General do Exercito Brasileiro noticiou um plano chamado Plano Cohen, cujo o objetivo era derrubar o atual Presidente da República, Getúlio Vargas. Segundo o General  o plano foi arquitetado pelo partido comunista e organizações comunistas internacionais e gerava caos e medo população. Anos mais tarde ficaria comprovado que o documento foi falsificado e tinha intenção de justificar a instauração do Estado Novo.', 'A reforma eleitoral por meio da lei 13.488 de 2017  possibilitou o uso mais amplo de ferramentas disponíveis na internet com mecanismos para fomentar propaganda eleitoral nas próximas eleições. O mundo virtual é de extrema relevância na atualidade para propagação de informações, compartilhamento de ideias e opiniões que são acompanhadas e compartilhadas, visualizadas de forma instantânea pelos usuários de forma imensurável. Este ambiente é o próprio para proliferação de notícias falsas, um vilão capaz de macular a imagem de candidatos e partidos políticos nas eleições de 2018.', 'Mesmo com as sanções previstas na legislação eleitoral para prevenir  os responsáveis pela propagação de notícias falsas ainda encontram dificuldades para monitorar e minimizar o alcance delas. A partir do momento que a notícia falsa é visualizada pelos eleitores o objetivo do autor da fake news foi atingido.', 'Para vencer a divulgação é necessário haver cooperação entre órgãos de segurança, empresas responsáveis por tornar públicas as notícias falsas, a Justiça Eleitoral precisa agir de forma ágil e unificada, afim  de levar notícias verídicas em forma de propaganda eleitoral para que o cidadão venha a exercer o direito de escolha, um dos pilares da nossa democracia para que erros do passado  como o Plano Cohen não voltem a acontecer no futuro.']",120,120,120,120,120,600
88,Modernidade Líquida,"['No livro ""Modernidade Líquida"", Bauman critica os relacionamentos transitórios e superficiais da atualidade pós-moderna. Faz parte dessa sociedade analisada pelo sociólogo uma constante demanda por exibição de uma felicidade irrealista, além da não aceitação das patologias mentais como parte natural do ser humano. Portanto, faz-se necessária uma transformação social para que as doenças mentais possam ser mais facilmente identificadas, tratadas e até evitadas.', 'Tanto nas publicidades, como nos ambientes virtuais, sociais e de trabalho, modelos socialmente aceitos de relações interpessoais são socialmente construídos, como defende a teoria construtivista, nos quais não há espaço para a verbalização de frustrações e sentimentos considerados negativos. Nesse contexto, relacionamentos mais íntimos, que permitem o abandono das ""mascaras"", das estratégias de manutenção da aparência, são menos frequentes por exigirem tempo e dedicação mútua, o que nem sempre é possível com as demandas da rotina e do trabalho.', 'Consequentemente, a pressão social a manutenção da aparência constante de felicidade provoca a supressão dos outros sentimentos humanos, o que é apontado por Freud como uma dos fatores que mais contribuem para o desenvolvimento de patologias psicológicas comuns, como a ansiedade e a depressão. Assim, o comportamento social de defender a manutenção da aparência de um ambiente ""feliz"" e ""pacífico"" é uma das causas da diminuição da produtividade de estudantes nos ambientes de ensino e trabalhadores nos ambientes de trabalho.', 'Da mesma maneira, a percepção social sobre a patologia mental e sobre a busca por aconselhamento psicológico é outro fator que facilita o desenvolvimento de doenças mentais. Isso ocorre porque o acompanhamento psicológico é comumente visto como uma futilidade ou uma demonstração de fraqueza, impedindo diversas pessoas, principalmente homens, de buscar ajuda ou mesmo de identificar em si algum sinal de trauma, ansiedade ou depressão.', 'A fim de combater esse padrão social que é um obstáculo para a saúde mental, o Ministério da Saúde deve campanhas de esclarecimento sobre patologias psicológicas e desfazer tabus sobre a importância do autoconhecimento. Além disso, pais, educadores e a sociedade em geral deve contribuir fortalecendo as discussões sobre o tema e incentivando a mudança de comportamento social.']",200,120,120,160,120,720
102,"Água, um tesouro desvalorizado","['Há cerca de duas décadas, já         éramos         informados                que a água doce é um recurso escasso e         esgotável, e a          mais de um ano                , o Brasil comprova isso com a crise hídrica do Sudeste.                 Fato de algumas pessoas acharem que esse problema só existia no Nordeste, e que não tinha possibilidades de ter em outras regiões, mas agora estão vendo que esse pensamento é totalmente errado.', 'O grande período de seca não é o único motivo que justifica essa         crise, e sim         um conjunto de razões, como desperdícios, a má gestão dos reservatórios e a falta de preservação das nascentes dos rios, que nos fez chegar aonde estamos, com reservatórios quase secos, como o Cantareira que chegou                ficar com 5% de sua capacidade.', 'A crise veio para nos dar uma lição, foi um ""se liga!"" aos          humanos.  Pois         se não usarmos a água da maneira correta, ela irá desaparecer. De certa forma aprendemos muito,                 porém algumas pessoas só          tem esse          aprendizagem por enquanto, porque quando o problema começar a aliviar, irão voltar a agir como antes, mas é errado fazer isso, devemos executar o que é certo independentemente da situação.', 'Para que isso não mais aconteça, é correto que as escolas incentivem as crianças à preservação da água, para que cresçam com         o ideal de pessoas ecológicas         .         Entretanto         somente isso não seria suficiente, é preciso preservar as nascentes dos rios, repondo vegetação ao redor, para que elas possam reter melhor a água das chuvas.', 'Também precisamos evitar o desperdícios nas moradias e o governo deve fazer manutenção dos encanamentos, para reduzir os vazamentos. Enfim se executássemos todos esses pontos,         iriamos         melhorar muito a situação em que         vivemos, e         evitar vários problemas futuros, com a nossa preciosa fonte de vida, a água.']",120,120,120,120,120,600
102,Água é vida,"['Muito além de ser apenas o solvente universal, a água é um composto inorgânico essencial a todos os seres vivos no planeta         e         sem tal substância, não existiria vida.                 Esse fato parece ser insignificante para muitas pessoas no Brasil.                O país se encontra com níveis de reservatórios cada vez mais precários, por conta não só do baixo índice de chuva, mas também da irresponsabilidade de indivíduos                 com alguns hábitos do cotidiano.', 'Não         da pra negar, que         a falta de chuva colabora com         escacez         que se vive no país. Nos últimos meses de 2014 choveu bem menos que o esperado.         O mês de Janeiro, em 2015,          que normalmente é o mais chuvoso, não atingiu 50% do esperado.', 'Aliado a         falta de chuva, hábitos dos brasileiros         deixa         a situação ainda mais precária.                 O que deveria ser simples, como escovar os dentes e tomar banho, causa um grande impacto na falta d’água.                Grande parte da população não se preocupa com o desperdício de água e         faz dessas atividades longas         , gastando muito mais do que deveria. Além disso, lavar carro e calçada com a mangueira jorrando é outra mania dos brasileiros,         agravando         o problema.', 'Sendo assim,                 cabe          a          mídia conscientizar a todos sobre a falta de água                que o país vem enfrentando, e         a         população, mudar hábitos simples, como varrer a         calçada ao invés de lavar         e demorar menos no banho.                 Afinal, um país sem água é um país sem vida.']",120,120,120,120,120,600
78,A verdadeira necessidade da educação,"['O Governo Federal lançou, recentemente, uma proposta na área da educação de realizar uma reforma na grade curricular do ensino médio. Tal modificação pretende unificar determinadas matérias numa só área, além de manter outras- sociologia e filosofia, por exemplo- , como opção do aluno. Sendo assim, pode-se dizer que tal reformulação pode estagnar ainda mais o principal objetivo da educação- que é proporcionar uma preparação ampla ao aluno para o seu convívio social -, além de que também pode acarretar num desvio de atenção sobre o principal impasse que impede a melhora da educação .', 'Em primeiro lugar, a tentativa de modificar o ensino médio estaria  transformando a educação numa ferramenta exclusiva para preparar os estudantes ao mercado de trabalho. A partir do momento que determinadas matérias educativas, tais como Sociologia, Filosofia e Arte, tornam-se optativas, ao mesmo tempo a agregação de importantes valores também perdem sua  importância, tais como a criticidade dos fenômenos que ocorrem no dia a dia, principalmente no campo da política, a capacidade de questionar e filosofar sobre qualquer coisa , como também desenvolver potenciais ligadas as artes e ao talento, proporcionadas  pela disciplina de Arte. Dessa forma, a educação vai tomando outros rumos e objetivos, deixando de desempenhar o papel de formar cidadãos críticos para indivíduos preparados unicamente para o trabalho.', 'Em segundo lugar, sabe-se que as necessidades da educação estão além do que simplesmente reformular as grades curriculares. Há um abismo social e econômico perceptível entre escolas públicas e particulares, o qual se torna evidente na avaliação de ensino entre essas duas. Tal diferença de desempenho se deve também as diferenças de infraestruturas, preparação dos docentes  e melhores condições condicionadas pelo investimento. Enquanto a maioria das escolas de povoados e interiores está submetida a condições precárias, como falta de merenda, transportes e professores preparados , escolas de capitais se mostram em  realidades bem diferentes, como bons docentes, boa infraestrutura e condições que favorecem no bom aprendizado do aluno. Diante disso, é notória que a principal necessidade da educação não é uma reforma no ensino médio e sim na maneira que se dá essa educação , ou seja, nas instituições abandonadas que acabam atrasando o ideal da educação .', 'Dado o  exposto, percebe-se que, portanto, tal reforma não seria a necessidade principal para melhorar a educação . Ao invés disso, deve-se recorrer ao governo federal para chamar atenção as instituições abandonadas que necessitam de investimentos para proporcionar uma educação decente e equitativa . Para tal, seria necessário a distribuição de investimentos na infraestrutura interna e externa das escolas, como áreas recreativas maiores, carteiras e lousas decentes, bibliotecas, merenda e uma boa preparação dos docentes. Além disso, poderia prolongar os horários de estadia  dos alunos nas escolas, de forma integral a fim de obter um resultado mais satisfatório do aprendizado, incluindo horários de lazer. Feito isso, a educação do país estaria contribuindo de forma eficaz no futuro dos cidadãos.']",80,120,120,120,120,560
11,A evolução para a destruição,"['O período Neolítico ou Idade da Pedra Lascada Polida (12 mil a 4 mil a.c.) é considerado o início do sedentarismo humano, confrontado Homem x Natureza, permitindo a destruição da vegetação local para criar gados e uso da agricultura. Hodiernamente, o avanço tecnológico proporcionou maiores danos ao ambiente, por parte das indústrias, propiciado aos dilemas ecológicos, que ocorrem não só pela quebra de acordos mundiais de controle da poluição, mas também pela deficiente formação de seres ecológicos na educação básica.', 'Promulgado em 1997, o Protocolo de Kyoto é um acordo entre países desenvolvidos, subdesenvolvidos e emergentes que garante a redução na emissão de gases poluentes, todavia nações como os Estados Unidos, por exemplo, não cumpriram suas responsabilidades com o tratado, liberando dióxido de carbono (CO2). Segundo dados da ONU em 2015, apenas 37 dos 189 Estados conseguiram alcançar a meta estabelecida, logo se verifica a negligências dos Territórios países quanto a à questão ambiental, que afeta diretamente ecossistemas.', 'Outrossim, a falta de debates sobre esse dilema em escolas de educação básica corrobora para a manutenção da poluição. Consoante L. Kohlberg, as discussões de problemas geram um conflito cognitivo que leva ao amadurecimento do raciocínio moral. Assim, seres conscientes deixariam de comprar mercadorias de países poluidores, como a China. Desta forma, ocorre uma valorização de mercadorias das nações ecológicas, tornando essa luta mais forte.', 'Portanto, indubitavelmente, medidas são necessárias para resolver esse problema. Cabe ao Ministério das Relações Exteriores incentivar países altamente poluidores a aderir as mudanças, até mesmo acordos de taxamento coletivo entre nações nas mercadorias, para que ocorra a desvalorização comercial e por conseguinte, à diminuição de sua produção. O Ministério da Educação deve proporcionar condições adequadas para a inclusão de rodas de conversa entre alunos e profissionais da área, objetivando a formação de seres mais ecológicos, que reduzirão o consumo de matérias produtores produtoras de CO2. Desse modo, a sociedade distancia-se-á de um fim próximo, ocasionado pelo descuido com nosso maior bem, a Natureza!']",80,80,80,80,80,400
83,"Esporte,sinônimo de aprendizado e oportunidade","['Ao analisarmos comentários relacionados as Olimpíadas Rio 2016, vemos que grande parte da população atribui caráter negativo ao evento, esquecendo que por trás de toda essa comemoração, o que realmente importa é o esporte. Apesar de muitas pessoas considerarem a prática esportiva apenas um passa tempo passatempo, de certo modo ela pode nos trazer grandes aprendizados e oportunidades.', 'Muitos especialistas recomendam a prática de esporte para crianças em fase de formação, pois colabora na construção de valores sociais e éticos, como a honestidade e lealdade, e também na socialização com os demais, fazendo com que desenvolva - se a personalidade e o caráter.', 'Não sendo um fato atual, o esporte é visto como oportunidade para crianças e adolescentes de baixa renda, tendo como espelho vários atletas, como NeyMar que, quando pequeno, vivia nas periferias e hoje ocupa os gramados da seleção brasileira, além disso, muitos podem ter acesso a bolsa esporte, n a qual incentiva financeiramente o atleta de baixa renda.', 'Contudo, em meio ao caos diário, grande parte da sociedade faz com que o esporte seja deixado de lado, como medida para resolver este impasse, é necessário que o poder municipal das diversas cidades brasileiras realizem um evento que demonstre a importância da prática esportiva e os benefícios que ela pode agregar, tanto a saúde quanto a vida social. Além de enfatizar a importância, o evento deve dar a oportunidade da própria prática esportiva, como método de ensino que levará as pessoas a se interessarem e quererem manter em seu dia a dia.']",120,160,160,200,200,840
6,A falsa posse sob  a natureza,"['É de conhecimento geral, que geral que é dever de todos cuidar do ambiente em que se vive. Visto que, a vive, visto que a falta de cuidado e preservação, pode preservação pode nos levar à ruína. No entanto, o número de queimadas e desmatamento no território amazônico, cresceu amazônico cresceu absurdamente devido a à falta de conscientização e à negligência governamental.', 'A priori, não se pode tomar posse total da natureza, posto que é por meio dela que o oxigênio passa a ser mais purificado e nos dá ar fresco. Contudo, passaram-se mais de 10 dias de queima contínua no território da Amazônia, tal ato fizera Amazônia. Isso fez animais serem mortos, indígenas mortos e indígenas terem reservas atingidas, causando grande problema ambiental. Por conseguinte, tal celeuma tornou-se assunto internacional.', 'Outrossim Além disso, os recursos usados pelo governo brasileiro foram mínimas mínimos. Entretanto, não faltou ajuda, o presidente da França propôs a ideia da Amazônia ganhar status internacional, tal atitude traria grande ajuda de preservação. Sobretudo, não há alguém que possa comprar a natureza, visto que sua vida independe da nossa, porém poderíamos prolongar seus dias recebendo ajuda até mesmo internacional.', 'Depreende-se, portanto, que é necessário abrir mão de posses territoriais para salvar nossa fonte de vida. Logo, faz-se mister, que mister que o governo brasileiro brasileiro, por meio do Ministério do Meio Ambiente, entre em acordo com o Governo da França, para receber os recursos necessários, com o fito de nos tornamos um país mais empático e humanitário.']",80,120,120,80,80,480
48,"""A IMPORTÂNCIA DO SUS""","['segundo o ministro, Luis Henrique Mandetta,""Brasil terá um colapso na saúde no final de abril deste ano, por conta do novo coronavírus"". Com isso, o sistema nico de saúde , se torna indispensável pois a maior parte dos infectados , dependem exclusivamente desse sistema.', 'Visto que essa é uma das maiores pandemias já vista nesse século, o órgão , se torna indispensável. Mesmo com um sistema de saúde gratuito, para pessoas que não dispõem de um plano de saúde, muitas optam por instituições privadas, pois com uti e medicamentos limitados, pacientes em zona de risco se veem vulnereis diante dessa crise.', 'om 162 milhões de brasileiros dependendo exclusivamente do , o governo se ver pressionado a criar novas medidas para combater esse vírus. om o números de casos aumentando diariamente a demanda por novos postos de atendimento e testes para diagnostica a doença, se torna essencial, pois quanto mais rápido é identificado o vírus, mais chances a pessoa tem de ser curada.', 'Assim o governo , através do ministério da saúde, deve busca recursos e infraestrutura para atender as necessidades das pessoas infectados por covid 19, e incentiva e apoiar pesquisas que estão sendo feitas para desenvolver a cura para essa doença, tanto no Brasil quanto no mundo.']",120,120,80,120,120,560
124,"Responsabilidade com o lixo, dever do cidadão","['O Brasil vem enfrentando a frenética produção de lixo causada pelo consumo desenfreado. Com isso, chegou-se a uma                 situação de desconforto                com relação ao destino final dos resíduos                 sólidos                , acarretando desequilíbrios ecológicos,                 além de pôr em risco a dinâmica natural do planeta                .', 'É importante ressaltar que o limite físico dos depósitos         adequados, está         se esgotando. Logo, precisa-se de medidas                 paliativas. Nota-se que                a reciclagem é uma delas, no entanto não existem empresas suficientes para suprir                 a demanda de lixo                . Por isso, o cidadão                 deve                reeducar-se,                 afinal é seu dever                .', 'Por um lado existem pessoas que sobrevivem reaproveitando o que é despejado nos lixões. Por outro, há organizações governamentais e não governamentais, a fim de acabar com                 essa posição de miséria                .         Estes         órgãos empenham-se para         propôr         soluções, tais como o fechamento dos lixões e redução de                 resíduos orgânicos                .', 'Essa situação só diminuirá quando a população perceber que o lixo não é apenas responsabilidade do poder público. Portanto, deve-se planejar desde as compras, até o seu descarte. O reaproveitamento de resíduos proporciona economia, gera empregos, além de reduzir os impactos causados no meio ambiente.']",120,120,120,120,120,600
71,Suicídio o mau do milênio,"['No  contexto social vigente, é anunciado em jornais  tantos locais como nacionais, jovens de ambos idade, sexo e classe social, se cortando, se jogando de sacada e a fim de acabar com um sofrimento. Nota-se qie dese a segunda geração romantica (1850/60) isso comum, onde Álvares de aze vedo se mata por não conseguir tocar em uma mulher.', 'Em primeiro plano, em todos os tipos de midía social o foco vem sendo assuntos voltados para o suicídio , em uma pesquisa feita pelo socilogo Jacobo , entre 2000 e 2015, 65% dos casos envolviam pessoas de 10 a 14 anos e os outros 45% jovens de 15 a 19 anos, o que preocupa a populacao por se um numero muito grande, mais o suicidio ocorre em adutos por exemplo Chester Benington vocalista da banda link park, que tinha seu dia a dia normal até se matar sem nenhuna desconfiança.', 'É revelante abordar, primeiramente que o indice de morte por suicídio muito grande, e vem aumentando cada vez mais. Entre os fatores que mais influenciam estão o sofrimento, agressoes e transtono emocional, onde um dos principais contribuentes o bullying, como ficar bem exposto na sérir America da netflix, 13 poquês onde annar sofria agressão de seis colegas de turma sem demostrar a ninguem, até comente suicídio.', 'Fica claro dessa forma que o suicídio é sim um dos mau do século XXI e que jovens tem buscado essa pratica para se livra de dores emocionais . Para reverter essa problematica deve ser criado campanhas, palestras e açoes voluntarias, ajudando pessoas com palestras, psicanalistas, psicologos e medicos proficionais, cabe ao governo madar esses proficionais para as escolas, zonas de risco para estudar a pessoa, j que elas não tem vontande de falar o qie ta se passando no momento com ninguem, e alerta as pessoas que influenciam outras pessoas a se matar que isso e crime segundo o art 122 cp, a fim de diminuir o índice de morte por suicidio.']",120,120,120,120,120,600
73,,"['Desde o iluminismo, entende-se que uma sociedade só progride quando um se mobiliza com o problema do outro. No entanto, quando se observa os desafios encontrados pelos negros, no Brasil, hodiernamente, verifica-se que esse ideal iluminista é constatado na teoria e não desejavelmente na prática e a problemática persiste intrisecamente ligada à realidade do país, seja pelo preconceito, seja pela dificuldade que os negros encontram para adentrar no mercado de trabalho.', 'Essa conjuntura, de acordo com as ideias do contratrualista John Locke, configura-se uma violação do “contrato social”, já que o Estado não cumpre sua função de garantir que tais cidadãos gozem de direitos imprescindíveis (como direito ao emprego) para a manutenção da igualdade entre os membros da sociedade, o que expõe os negros a uma condição de ainda maior desigualdade.', 'Outrossim, o preconceito da sociedade ainda é um grande impasse aos negros . Tristemente , a existência da discriminação contra negros é reflexo da valorização dos padrões criados pela consciência coletiva. No entanto, segundo o pensador e ativista francês Michel Foucault, é preciso mostrar às pessoas que elas são mais livres do que pensam para quebrar pensamentos errôneos construídos em outros momentos históricos. Assim, uma mudança nos valores da sociedade é fundamental para transpor as barreiras encontradas pelos negros atualmente.', 'Dada a complexidade do assunto, é fundamental, portanto, que o Ministério da Educação  insira a disciplina de história afro-brasileira na base curricular comum, promovendo o conhecimento acerca da importância desta raça para nossa nação. Soma-se a isso, o Estado deve criar políticas públicas de inserção do negro no mercado de trabalho, na tentativa de igualar o acesso ao emprego para todas as raças. Por mais complicado que seja o problema, faz-se necessária a aplicação de tais medidas a fim de que o tecido social se desprenda de certos tabus para que não viva a realidade das sombras, assim como na alegoria da caverna de Platão.']",120,160,160,160,120,720
71,Suicídio,"['Suicídio, quem imaginaria que seria uma discussão cada vez mais pautada entre as rodas de conversa de milhares de pessoas, cada uma delas imaginando, porque  os jovens estão tirando sua própria vida, sem deixar uma explicação ou um por quê.', 'Será que a população já prestou atenção nos seus filhos, seus amigos e seus parentes, da forma que eles precisavam . Prestaram atenção no que eles estavam ouvindo, assistindo ou passando em meio ao seu convívio social .', 'Suicídio não é uma bobagem que os adolescentes estão cometendo por futilidades e frescura de crianças mimadas, suicídio é muito mais que isso, é uma depressão, que cada vez mais te mata por dentro e você não consegue mais sair, até alguém te ajudar ou você tirar sua própria vida.', 'A hipocrisia do governo é colocar palestras falando sobre ela, pois quem ta sofrendo só vai guardar cada vez mais para si mesmo, pois os que estão sofrendo continuam calados sentados em uma cadeira, vendo a melhor forma para se matar.', 'O dever de ajudar é de toda a população, prestando atenção nos filhos, amigos e parentes, conversando diariamente, levando os casos mais graves a especialistas, e principalmente repare nos sinais, tente ver além das entrelinhas . Observe até mesmo aquela pessoa que você nem conheça, ela pode estar devastada por dentro e com sua ajuda e sua sincera amizade pode conseguir salva-lá  de cometer um grande erro.']",80,40,40,40,0,200
78,Utopia do Ensino Médio,"['No Brasil, o ensino tem se depreciado a cada ano, conforme observa- se as provas que medem o desenvolvimento escolar . Visto isso, em razão deste decaimento o MEC criou a reforma do Ensino Médio. Que é uma medida precipitada e pode gerar um problema bem maior na educação brasileira, o aumento da evasão escolar e pouca infraestrutura .', 'Em primeiro lugar, como nos lembra o sociólogo Darcy Ribeiro, a crise da educação no Brasil não é crise, e sim um projeto. Ou seja, ela não funciona propositalmente, pois ao fazer a reforma do ensino médio não foi pensada a melhoria da infraestrutura escolar . Nem se haverá vaga para todos se em um período as escolas já estão lotadas. Por outro lado, provavelmente a evasão aumentará, pois há pessoas que trabalham e estudam e a reforma não os manterão na escola, pois a escola não é atrativa, os professores não são bons, muitos nem planejam as aulas e atividades, possuem péssimo humor, não há materiais para todos os alunos .', 'Segundo a alegoria da caverna do filósofo Platão, tem como objetivo nos mostrar que temos que compreender a verdade por trás das coisas . Pois enquanto o ensino médio estadual não funciona corretamente e piora o desenvolvimento dos alunos públicos , os que estudam no particular saem em disparada nos melhores vestibulares do país. Ou seja, esta ideia utópica de ensino médio em período integral  apenas aumentará o caos que é a educação brasileira .', 'Logo, para que o Brasil possa ter uma educação verdadeiramente libertadora  segundo, o educador Paulo Freire.  É necessário que se tenha infraestrutura escolar e profissional. Isso seria possível com a ajuda do Ministério da Educação garantindo aos estudantes materias escolares. Além disso, também é necessário melhorar a formação dos professores como o modo como eles apresentam as aulas e as prepararam e coloca-la em prática nas universidades. Ademais, o período integral deveria ser aderido tanto pelo ensino público quanto o ensino particular.']",120,120,120,120,80,560
8,"Geração de ""Pós-Verdadeiros""","['Recentemente, vêm sendo levantados questionamentos sobre a credibilidade de informações fornecidas pela ciência. Grupos que questionam a forma da Terra e até mesmo a periculosidade das vacinas ganham espaço na internet expandindo internet, difundindo suas críticas, questionamentos e pontos de vista. O caso dos Antivacinas antivacina tem sido preocupantes preocupante, pois o número de doentes têm tem aumentado significativamente. Por conta do movimento, muitos acreditam que estamos entrando em uma era de pós-verdade, onde em que só acreditamos em um fato se ele está em acordo com a nossa moral e crença.', 'Entretanto, muitas das críticas às informações científicas estão sendo feitas com base em observações limitadas. Nem todas essas observações estão sendo colocadas à prova ou sendo aprofundadas. Muitas pessoas estão aderindo às ideias sem pesquisar sobre a confiabilidade dessas informações. Estamos nos tornando uma geração que acredita no que se lê no Facebook sem questionar, em outras fontes, a veracidade do que está sendo compartilhado.', 'Portanto, uma informação vinda de um órgão especializado em um determinado assunto, que pesquisa e gasta milhões, por ano, com equipamento adequado para correr atrás de buscar provas do que será passado para a população população, não deveria ter menos créditos crédito que informações tiradas de teorias com rasas justificativas, provas ou de ou notícias publicadas por diversão no meio virtual.', 'Todos temos o direito de expormos nossas opiniões, mas a melhor maneira de acreditar em um novo ponto de vista é fazer prova do mesmo comprová-lo, como no Iluminismo, quando os estudiosos não faziam apenas teorias, mas tentavam prová-las de diversas formas diferentes. Não podemos voltar aos tempos de trevas e acreditar apenas no que nos falam. Temos que correr atrás e pesquisar, procurar saber se o que lemos na internet é verdadeiro e se posso podemos confiar naquilo. Isso serve para fake news, montagens e teorias da pós-verdade.', 'Diante do que foi citado mencionado, uma das medidas cabíveis para resolver a falta de credibilidade dos fatos científicos divulgados seria a maior valorização e apoio aos órgão responsáveis pelos estudos e pesquisas dentro dos países, por exemplo, ao Ministério da Ciência, Tecnologia, Inovação e Comunicações, no Brasil. E, como ""o ser humano é aquilo que a educação faz dele"", segundo Immanuel Kant, o Ministério da Educação também poderia promover campanhas nas escolas e comunidade comunidades, incentivando pesquisas e a busca por informação em meios confiáveis, esse confiáveis. Esse incentivo também pode ajudar na redução de compartilhamentos de fake news, não só de teorias vazias.']",160,160,160,160,160,800
46,privatização do saneamento básico,"['Usasse de exemplo o país do Chile, onde o saneamento básico é privatizado, por conta disso, traz consequências diretas para a população . ais como empresas e indústrias possuem 90% dos direitos de aproveitamento da água, as indústrias não recebem sanções pela contaminação da água, dessa forma comunidades na quais há exploração de recursos hídricos são obrigadas a utilizar água contaminada.', 'Dessa maneira grande parte da população, especialmente famílias de baixa renda  sofrem com as causas que a água contaminada afeta na saúde, trazendo grandes chances de encadeamento de novas doenças, por conta dos produtos químicos depositados na água . Sendo assim, causando superlotação no SUS e gerando um novo problema.', 'Um exemplo real é a peste negra, pelo fato de no Rio de Janeiro não se ter saneamento básico, ruas e esgotos eram cobertos de lixo. Desse modo, roedores transmissores de doenças encadearam uma epidemia. Percebe-se que o saneamento básico é essencial tanto para a saúde quanto para atividades domésticas diárias, porém maioria da população não possui renda suficiente para sustentar o uso da água privatizada.', 'Portanto medidas são necessárias para resolver o impasse. O governo deve exigir a sanções das indústrias pela contaminação da água, E  assim investir o valor das sanções em tratamento de esgotos,  Para melhores resultados indústrias devem adquirir projetos sustentáveis para assim evitar poluição de rios e mares. Dessa forma, teremos um Brasil com mais qualidade de vida.']",160,120,120,120,120,640
75,Legalização do porte de armas,"['Relativo ao livre porte de armas no Brasil, é possível destacar tantos pontos positivos como negativos. Se por um lado,  permite que a população defenda-se da violência que assola o país;  por outro,  pode ser uma ameaça a mais, já que são poucos o que tem o devido treinamento para o manuseio apropriado.', 'Segundo dados da Anuário Brasileiro de segurança publica, foram registrados 61,6 mil mortes violentas no país. Diante disso, surge nos indivíduos o desejo pela própria segurança e, como o estado não consegue manter a ordem, sente-se na necessidade de prevenir-se, encontrando nas armas de fogo refúgio.', 'No entanto, são poucos os que têm a devida preparação para o manuseio de armas de fogo, haja vista que os cursos de capacitação são caros. Logo, o objeto de defesa vira mais uma ameaça, já que pode ser surrupiada e ser usado contra aquele que a comprou com forma de defesa.', 'Sendo assim, mais do que liberar o livre porte, é necessário que o Estado aumente o investimento na segurança pública  a fim de conseguir manter a integridade do cidadão. Além disso, o Ministério da Educação  em parceria com agentes de segurança devem realizar palestas com a intenção de mostra a população dos riscos do porte de armas. E, assim, a sociedade não caía nos Estado de natureza de Thomas Hobbes, em que são todos contra todos.']",120,120,120,120,120,600
73,,"['Apesar de saber que a grande parte da população brasileira é de pessoas negras, dados recentes do Instituto Brasileiro de Geografia e Estatística (IBGE) confirmam que já passou da metade, chegando a 54%. São pessoas marcadas pelo simples fato de terem a pele escura (negra).', 'Os negros carregam um passado que os atormentam desde sempre, já se passando décadas e décadas da abolição da escravatura e os sofrimentos vividos por muitos naquela época são refletidos até os dias de hoje . Estudos e pesquisas mostram que é altíssimo o número de pessoas negras sofrendo com o preconceito que vem de todos os lados, mesmo depois de ser criado o Estatuto de Igualdade Racial no Brasil, este, rege a lei 12288, de 20 de julho de 2010. Apesar da criação desta lei  não foi visto nenhuma melhora com relação aos preconceitos, a desigualdade e o desrespeito .', 'O que se vê é racismo, é alguns negros sendo confundidos e tratados como marginais e os sofrimentos de muitos por serem ignorados e malvistos o tempo todo. No entanto para exterminar de vez este mal  é preciso colocar em prática a lei que foi criada e reeducar as pessoas de todas as idades e níveis sociais  e assim zerar o número de vidas perdidas por minuto, dias e anos.', 'Contudo é preciso investir mais em campanhas para acabar com a prática de qualquer tipo de preconceito, além disso investir mais em educação, em emprego para todos de forma igual, sem valorizar a cor e sim o caráter de cada um.']",120,120,120,120,120,600
60,Reforma da Previdência,"['A PEC (Proposta de Emenda à Constituição) do momento; reforma da previdência já vem sendo discutida há tempos sobre sua real finalidade na sociedade brasileira. No entanto, ela se torna imprescindível para o país se reerguer e estabilizar economicamente .Traz consigo a proporcionalidade de colaboração com a previdência de acordo com seu salário,sendo justa com os trabalhadores mais pobre.', 'De acordo com especialistas, da econômia brasileira, não dá para o país ter progresso econômico da forma atual que está ,pois a expectativa de vida vem aumentando e consequentemente a população de idosos,no Brasil, também. Segundo o IBGE(Instituto Brasileiro de Gerografia e Estatística) a taxa de natalidade diminui com passar dos anos e a geração idosa aumenta. Assim causando desiquilíbrio na base da prirmide econômica do Estado brasileiro.', 'Segundo Paulo Roberto Nunes Guedes,atual ministro da econômia, a PEC 06/2019 vem para oferecer um igualitarismo no país, que já sofre com desigualdades sociais e regionais. Não é difícil nos depararmos com essa realidade apenas ao darmos um passeio nas ruas brasileiras .A proposta vai mudar para melhor a vida dos trabalhadores que recebem pouco quando adotarem uma contribuição proporcional à sua renda', ""Portanto,concluí-se que a reforma seja para estabilizar a ecônomia e atuar de forma benéfica adotando ás medidas de proporcão na contribuição previdenciária,assim dando um ''ar'' de igualdade aos trabalhadores com renda mais baixa.""]",120,160,120,160,120,680
62,Discurso de ódio,"['Numa democracia é importante o uso irrestrito da liberdade de expressão. Mas,  essa liberdade de se manifestar sem limites está sendo utilizada para “atacar” grupos sociais minorizados. Atualmente, algumas pessoas promovem discurso de ódio nas redes sociais alegando que fazem “humor”.', 'As redes sociais estão inundadas de manifestações de ódio explícitas. Mas,  nem sempre esses discursos são “visíveis a olho nu”. A comédia consegue dar “invisibilidade” ao racismo, homofobia, misoginia, gordofobia, xenofobia e diversos tipos de preconceitos. O humor é um tipo de arte, logo, alega-se que a arte jamais pode ser criticada e muito menos censurada. No entanto, a arte de fazer comédia está refém de algumas pessoas intencionalmente dispostas a viralizar ódio e rancor. Cabe censura nesses casos? Não. Mas cabe tomada de responsabilidade.', 'O comediante Danilo Gentili, dias atrás, foi condenado a seis meses de prisão em regime semiaberto por praticar injúria contra a deputada Maria do Rosário. Gentili é notório nas redes sociais por fazer humor “politicamente incorreto”. Faz anos que ele é notícia nas redes sociais com piadas preconceituosas alegando direito de expressão irrestrita. Danilo Gentili não está só. Diversos comediantes escolheram o humor negro para impulsionarem suas postagens. E o alvo sempre são grupos minorizados: negros, mulheres, gays, lésbicas, travestis, índios, gordos, imigrantes e portadores de necessidades especiais.', 'Portanto, o discurso de ódio nas redes sociais não é somente aquele conteúdo explícito postado por grupos extremistas. Esse ódio está na maioria das oportunidades travestido de humor. Por isso, a dificuldade em tornar “visíveis” essas manifestações e denunciá-las.', 'Afinal o humor é arte, e a arte não deve ser censurada.']",120,120,80,120,0,440
71,Suicídio,"['Atualmente, a internet é um meio de comunicação utilizado por milhares de jovens do mundo inteiro. Ela é uma ferramenta para aqueles que sabem usar, e por consequência, alguns jovens a tornam como um mal uso. Mas, convém observar,  que o que mais afeta esses jovens é o suicídio, algo grave que vem acompanhado na maioria das vezes, pelo sofrimento, falta de atenção e brincadeiras virtuais . A princípio disso, tendo em vista esses fatos, é possível dizer que entre 100 jovens, 99 se suicidam por uma doença chamada depressão.', 'Talvez, a depressão seja um dos motivos que acarretam ao suicídio, e o maior problema disso,  é que os mesmos se sentem acoados e incapazes de viver. Lembrando que muitos sofrem com a ausência de seus pais e familiares, se comportam como um estranho e sofrem calados. Alguns, se manifestam se auto mutilando até chegar a morte (que também pode ser considerado como um suposto suicídio) . Outros, simplesmente resolvem se matar na frente de um caminhão ou pulando de uma ponte. Mas será que há solução? De fato, há.', 'O suicídio entre os jovens é um assunto de suma importância que deve ser visto como uma prioridade social . Jovens que se suicidam tendem a levar seus sonhos e conquistas por água a baixo, e em principal, os pais dos mesmos devem sempre acompanhá-los sejam onde for, o que estiver fazendo e o que estiverem acessando em redes sociais. A atenção e carinho é a chave para este problema.']",120,120,120,120,120,600
13,Posse de armas,"['O atual presidente do Brasil, Jair Bolsonaro, no seu primeiro mês de mandato, assinou um Decreto que facilita a posse de armas no Brasil. A atitude foi criticada por parte da sociedade que não foi consultada previamente e que não contempla benefícios ao se armar a população. Por outro lado, tem-se outra parte da população que aprova a atitude do presidente, vendo positividade no assunto.', 'O primeiro fator, refere-se a falta de consulta prévia à sociedade envolvida. Um assunto extremamente sério, não poderia ser decidido apenas nas instâncias superiores, sendo mais prudente haver um plebiscito sobre o assunto. O atual presidente usou como indagação o plebiscito que ocorreu à época do governo Lula, em 2005, em que se discutia o comércio de armas e não sua posse. O que mostra-se ser irrelevante, visto que os assuntos são diferentes. Além disso, armas em casa coloca em risco à vida de crianças do lugar ou suicídios.', 'O segundo fator contempla uma parte da população que aprovou a atitude do atual presidente. Como argumento tem-se o fato de o indivíduo se sentir mais protegido dentro de sua casa ou trabalho, mais facilidade na compra de armas, legalização do comércio de armas.', 'Conclui-se, então, que o documento liberando a posse de armas não tira do Estado a obrigação de proteger o cidadão. A polução não foi consultada sobre a questão, cabendo fazer o controle posterior sobre o assunto a fim de que se minimize possíveis fraudes na efetivação do documento de posse, comprovando a idoneidade do solicitante.']",120,120,80,80,80,480
76,,"['Conforme argumentou a escritora francesa,  Olímpia de Gouges, no documento ""Declaração dos direitos da cidadã e da mulher"", há uma grande necessidade de equiparação dos direitos entre os gêneros. Entretanto, ainda há muitas desigualdades, uma vez que, a participação feminina no mercado de trabalho, por exemplo, é bastante reduzida. Nesse contexto, devem-se analisar como a herança histórico-cultural e a participação no mercado de trabalho causam tal problema e como combatê-lo.', 'A herança histórico-cultural é a principal responsável pela desigualdade entre homens e mulheres. Isso acontece porque, ao longo dos séculos a mulher era vista como inferior ao homem. Por consequência, surgiu no século XVIII, durante as revoluções liberais, o feminismo - movimento que lutava pela igualdade dos gêneros no seio familiar e nos locais de trabalho -. Em decorrência disso, as mulheres conquistaram ao longo do século XX, algumas importantes marcas, dentre elas o direito ao voto.', 'Atrelada a herança histórico-cultural, o mercado de trabalho também contribui para essa desigualdade. Isso decorre, muitas vezes, por falta de confiança dos chefes em contratar mulheres . Segundo pesquisa realizada pela Amcham, a igualdade entre homens e mulheres é desafiadora para 76% das empresas brasileiras. Consequentemente, os salários e número de cargos ocupado por mulheres é bastante inferior.', 'Torna-se evidente, portanto, que aja medidas necessárias para resolver essa problemática. O governo deve introduzir nas escolas do país, uma reeducação do quão é indispensável a valorização da mulher nos meios mais diversificados da sociedade. Ademais, o ministério do trabalho em parceria com as empresas, a fim de garantir a equidade, disseminar ofertas de emprego igualitária para todos .']",120,160,120,160,120,680
29,"Internação compulsória, ajudara o povo e a sociedade.","['É de conhecimento geral que o número de dependentes químicos aumenta a cada ano mais e se nós o povo não aproveitarmos essa proposta, chance que o governo esta dando, aqueles dependentes morreram e o número de drogados aumentara .', 'Nenhuma pessoa fica viciada nas drogas por escolha própria, o vicio ele vem sem a pessoa perceber, o traficante oferece um, depois dois, e quando a pessoa se vê, olha que passou dos limites, e para sair dessa situação será difícil, e por esse e outros motivos que a internação deve ser feita, ajudar as essas pessoas a saírem dos seus vícios fara bem não só a eles como também a sociedade, será muito menor o numero de pessoas que vivem nas ruas, muito menor o numero de dependentes químicos, aumentara o numero de trabalhadores e pessoas que contribuirão para uma sociedade melhor.', 'Portanto medidas necessárias já foram tomadas para resolver o impasse, o que falta só é que a sociedade concorde, e com isso não estaremos mudando só a vida daquelas da pessoas mas também da sociedade futura.']",80,80,0,0,0,160
46,Saneamento básico,"['A epidemia da Peste Negra no século XIV  que matou mais de 70 milhões de pessoas, teve como principal causa do alastramento da doença a precariedade de saneamento básico das cidades. Atualmente o problema ainda se faz presente na sociedade brasileira, dividindo opiniões favoráveis ou contrárias à privatização desse setor.', 'Segundo a Constituição Federal brasileira, o saneamento básico é um direito assegurado pelo Estado de todo cidadão brasileiro . Todavia, em regiões periféricas esse direito torna-se somente uma falácia. Segundo o Sistema Nacional de Informações sobre o Saneamento (SNIS), cerca de 17% da população ainda não usufrui o benefício da água tratada, e 54% do esgoto nacional não passa pelo tratamento adequado. Estes fatos revelam a deficiência do Estado em propagar este serviço. A principal razão é a carência de recursos e de ineficiência estatal.', 'A privatização desse setor tornaria o sistema mais eficiente e seguro, pois levando em consideração de que haveria uma empresa própria fazendo o serviço, a população poderia cobrar soluções para o problema, bem como já foi feito com as rodovias brasileiras privatizadas, que tiveram aumento na eficiência e diminuição do custo . Além disso, seria um orçamento cortado das finanças públicas, podendo ser destinado a outros setores, como educação ou segurança.', 'De nada adianta haver um sistema eficiente e caro que não seja do alcance de todos . Portanto, o saneamento básico deve ser privatizado contendo uma série de regras a serem impostas para o funcionamento. Indubitavelmente, deve ser um preço relativo pela localização, sendo de maior valor nos bairros nobres e de menor nas áreas periféricas. Para a população mais humilde, o Estado deve cobrir essa despesa criando um projeto semelhante ao bolsa família. As empresas devem investir em soluções tecnológicas com objetivo de reembolsá-las no futuro, fazendo com que não resulte em prejuízo e que previna doenças como foi a Peste Negra.']",160,160,120,160,120,720
74,,"['A violência contra a mulher é todo ato que resulta em morte ou lesão física, sexual ou psicológica de mulheres, tanto na esfera pública quanto na privada. Em alguns casos é considerado como um crime de ódio, essas violências contra as mulheres não reconhece barreiras geográficas, econômicas e sociais, elas acontece cotidianamente. Este tipo de violência é baseada em gênero, o que significa que os atos de violência são cometidos contra as mulheres simplesmente porque são mulheres. No Brasil vivemos com uma lacuna histórica na produção de dados nacionais capazes de revelar as dimensões da violência contra as mulheres, segundo a Central de Atendimento à mulher n o 1° semestre de 2016, 12,23% (67.962,00) casos corresponderam à atos de violência contra à mulher ou seja, 3 em 5 mulheres jovens já sofreram violência. Essa violência baseada no gênero está intimamente relacionada com a visão histórica das mulheres como propriedade e um papel de subserviência de gênero.', 'Dizer que o feminicídio é um fato social desagradável à imagem da mulher que foi enraizada devido a uma cultura discriminatória trazida pelos colonos , isso é frustante , pois não resulta em melhor forma atenuada de convívio social e pacífico, contudo, é necessário em nosso País:', '- Adote um novo modelo de ensino nas escolas para que assim promovam uma maior conscientização quando estes chegarem a fase adulta.', '- Adote um modelo social de colaboração para que ambos encontrem uma solução adequada sem violência.', '- Adote um modelo político, os três poderes Legislativo, Executivo e Judiciário façam reformas na lei com o intuito de combater de maneira eficaz as injustiças praticadas por ambos.']",120,40,40,40,40,280
88,,"['Na série ""Os 13 porquês"" do catálogo da Netflix, narra a historia de Hanna Backer, uma jovem que sofre de depressão, e que passa por inúmeros conflitos que acarretam em seu suicídio. O que infelizmente é uma realidade no Brasil. De acordo com a OMS , o Brasil é o país mais depressivo da América Latina, e cerca de 11,5 milhões de brasileiros sofrem desse transtorno, tendo hoje como maiores vítimas os jovens.', 'Nota-se que o aumento dos casos de depressão entre os jovens tem como maior fator as redes sociais, que influenciam constantemente suas vidas e escolhas, fazendo com que muitos tentem se encaixar em padrões, buscando a aceitação externa, e a viverem acreditando que existe uma vida perfeita atrás dos holofotes. Outro fator existente é a pressão nos estudos, nas notas e no futuro, imposta pelos pais.', 'Em consequência disso, encontra-se jovens psicologicamente abalados que se frustram ao tentarem se manter dentro dos padrões, que não sabem agir nas dificuldades vividas no meio familiar, escolar e social, e que não encontram ajuda sócio-emocional em suas casas e muitas das vezes não buscam ajuda médica, por falta de informação dos familiares que, em grande parte, consideram ""frescura"" o comportamento dos jovens, que se vem sozinhos em meio aos conflitos internos.', 'Levando em consideração os fatos apresentados, cabe ao ministério da saúde propagar por meio de campanhas, em postos de saúde e escolas, a conscientização das causas da depressão, e outros transtornos, e de que forma afetam os jovens, buscando, assim, informar os primeiros sinais e sintomas que, com atendimento psicológico antecipado, podem evitar que se transforme em um problema maior. Reduzindo, assim, o número elevado de pessoas afetadas por doenças mentais.']",160,160,160,160,160,800
45,Abuso de autoridade no Brasil,"['Em consonância com a Declaração Universal dos Direitos Humanos, DUDH, a Constituição Federal postula a importância do respeito para o bem-estar social. Todavia, nota-se uma divergência entre garantia e direito, haja vista os casos de abuso de poder e autoridade no Brasil. Nesse sentido, seja pela negligência do Estado, seja pela vontade pessoal, o excesso do uso de poderio é um desafio e merece um olhar mais crítico de enfrentamento.', 'Em primeiro lugar, vale ressaltar que a indolência estatal impulsiona a problemática. Segundo Aristóteles, a política deve ser utilizada de modo que, pela justiça, o equilíbrio seja alcançado na sociedade. Analogamente, a falta de políticas que limitam e fiscalizam o exercício da autoridade abre brechas para a ocorrência de crimes. Dessa forma, observa-se casos de humilhação a cidadãos, causando danos mentais e psicológicos na vítima e, consequentemente, contrariando a DUDH.', 'Outrossim, o uso do poder para fazer valer vontades pessoais corrobora para a permanência do impasse. Na saga “Jogos Vorazes”, é retratada a invasão de privacidade dos competidores Katniss e Peeta, para satisfazer os interesses do presidente Snow, o qual viola o direito dos jovens. Fora da ficção, essa violação de direitos para satisfazer uma vontade superior é a realidade de muitos brasileiros, que têm não só sua privacidade comprometida, mas também sua integridade moral e física . Nessa perspectiva, vivencia-se a injustiça e a desigualdade no cenário brasileiro, fortalecendo a existência da mazela social em questão.', 'Portanto, conclui-se que a permanência do problema é fruto da negligência estatal e do cumprimento das vontades pessoais. Assim, para reverter a atual conjuntura, urge que o Governo, como instância máxima de administração executiva,  fiscalize, por meio do Ministério da Justiça, o exercício da soberania por parte das entidades públicas e privadas, a fim de que casos de injustiça e humilhação sejam atenuados, bem como a satisfação dos interesses próprios. Somente assim, com base no equilíbrio proposto por Aristóteles, tal fato deixará de ser, efetivamente, um desafio no Brasil.']",160,200,160,200,160,880
24,As drogas e suas consequências,"['No início do ano de 2017 foram encadeadas diversas rebeliões em vários presídios do Brasil entre facções rivais, causando centenas de mortes. Uma das causas dessa rivalidade é o comando dos presídios e das regiões de pontos estratégicos para o tráfico de drogas, que é um dos principais meios de sustendo e financiamento dessas gangues.', 'O tráfico de drogas é um crime equiparado ao hediondo, com penas mais rigorosas; já para o usuário, a pena é mais branda, cuja lei “das drogas” é cominada apenas medidas alternativas, despenalizando o crime de consumo próprio (quem consome para si próprio).', 'Esses produtos químicos em certas ocasiões causam', 'Com o objetivo de retirar e tratar os dependentes químicos da Cracolândia (maior centro de usuários de drogas de São Paulo), O Governo de São Paulo ofereceu ajuda e tratamento para aqueles que quisessem sair do vício das drogas. Essa medida causou repercussão nas mídias devido ao uso de forças policiais, desmanche de barracos e prisões de armas e drogas.', 'Sem o usuário final, o consumidor, o tráfico tendi a não existir, pois são eles os principais clientes das mercadorias; há quem diga que legalizando as drogas, tornaria o tráfico insubsistente, mas isso tem que ser debatido e estudado, e quem sabe no futuro ser aceita pela maior parte da sociedade, assim como o álcool.']",120,80,0,0,0,200
100,Trânsito sem violência,"['O trânsito nas grades cidades brasileiras         torna-se         , progressivamente,         caóticos         e violento. Os quilométricos congestionamentos deixam os motoristas estressados, antes mesmo de saírem de casa. Também         não deve-se esquecer, dos         irresponsáveis que insistem em dirigir alcoolizados.', 'Uma medida eficaz para melhorar o tráfego urbano, e consequentemente o         animo         dos condutores,                 seria                o investimento no transporte público, como foi feito em países mais desenvolvidos. Dessa forma, grande parte dos automóveis particulares         poderão         ser deixados em casa.                 Assim, as pessoas          poderá          ter o mesmo conforto sem aborrecer-se com os outros motoristas. Este é um dos principais motivos de briga no trânsito: o estresse ao qual os motoristas são submetidos.', 'Outra medida importante no combate à violência         de trânsito,         será o aumento das fiscalizações e punições         com aqueles         que dirigem alcoolizados. Raramente         os motoristas, sob o efeito do álcool, que se envolvem em acidentes,         são punidos de acordo com a lei. Provavelmente, será paga a fiança e os motoristas responsáveis pelas         fatalidades, ganham         o direito de responder o processo em liberdade.                 A fiscalização          brasileira,          deve ser mais eficaz, a fim de se          evitar          os altos índices de acidentes verificados nos dias atuais.', 'Portanto,                é possível diminuir a violência no trânsito. Desde que o governo tome certas atitudes como investir no transporte público, tendo por finalidade aliviar o trânsito e, por conseguinte, diminuir o estresse dos motoristas e as brigas de trânsito. Entretanto, deve-se, também, intensificar as fiscalizações e aumentar as punições aos motoristas embriagados.']",160,120,120,120,160,680
149,Os Verdadeiros Marcianos,"['Parece mais um roteiro de filme de ficção científica, porém, é         verdadeira, a notícia         de que uma empresa estaria recrutando pessoas para ir ao planeta Marte e não voltar mais. A         maior parte         das pessoas não teria coragem de abandonar tudo para ir         à         uma aventura         com esta         , mesmo assim,                 o projeto                teve um número substancial de voluntários dispostos a embarcar                 nesta empreitada                . A ideia é interessante, além da possibilidade de criar uma sociedade nova, do zero, o projeto também poderá explorar um lugar que é somente conhecido por nós através de observações e teorias não comprovadas.', 'Um ponto muito interessante sobre a nova sociedade será a liderança.                Os novos membros, antes de tudo, têm que se informar e         estarem         cientes de como será exercida a liderança, uma vez em terra firme. Um sistema         onde, os membros         teriam que seguir ordens de um único         lider nao         funcionaria, provocando, com certeza, em algum ponto, a revolta dos subordinados. Quem estiver         emcumbido         de escolher um método de liderança, terá que estudar muito para não cometer erros já cometidos por nossa sociedade no passado.', 'Os erros         velhos  poderão ser evitados          , os problemas mais graves que sofremos hoje em nossa sociedade,          poderiam ter sido evitados se fossemos          avisados sobre eles no passado. Violência, drogas, pobreza, destruição do          meio-ambiente          [meio ambiente], todos          poderão ser evitados          para não terem chance de acontencer no futuro dessa nova sociedade.                As novas gerações já nascidas ali, terão influência zero de problemas graves do nosso planeta, não terão motivos para entrar em caminhos                que infelizmente as crianças daqui acabam entrando. É claro que problemas         haverão         , o ser humano, mesmo sem influência alguma, pode vir a fazer o mal e prejudicar o seu         próximo, quando         isso acontecer,         caberá         a novas medidas de punição, diferentes das         terraquias         , que         visão         punir e não [a] ensinar e recuperar o cidadão.', 'O projeto ainda é         muito utópico         , há diversos pontos que devem ser refletidos friamente para concluirmos se ele tem futuro ou não. Com certeza, ele enfrentá muitas barreiras e a dúvida de muita gente, porém, com a sua conclusão, a nossa sociedade avançará assustadoramente, chegando aonde apenas criadores de         histórias fictícias         imaginaram.']",160,120,160,160,160,760
59,,"['No filme “O Auto da Compadecida” os personagens João Grilo e Chicó sofrem com a fome que desola o sertão da Paraíba. Diante disso, compreende-se que desde os anos 1930 a fome no território brasileiro é tema indubitavelmente efetivo . Portanto, intervenções se fazem necessárias para resolver a questão. Assim como na obra, a fome se dissemina não apenas por falta de alimentos, mas, principalmente  por falta de abastecimento e distribuição de alimentos. A negação de políticas públicas é uma causa.', 'Ademais, a extrema pobreza – reflexo de uma sociedade excludente e resultado de uma imensa desigualdade – é empecilho para que a problemática da fome tenha uma resolução plena. Posto que, apesar da diminuição substancial da fome – em meados dos anos 2000 cerca de 10,7% da população constava na taxa de desnutrição  e já a partir de 2004 estavam menos de 5%, segundo a ONU – o número de pessoas que passam fome no Brasil ainda é alto. As consequências não cessam a partir de uma pequena renda mensal, pois, a falta de informação e educação nutricional implica a ingestão de alimentos insalubres e de pouco ou nenhum valor nutritivo.', 'Portanto, medidas devem ser tomadas para resolver o impasse. Cabe ao Ministério da Cidadania aprimorar os serviços do Cadastro Único para que os programas sociais de transferência de renda alcancem o maior número de famílias em situação de extrema pobreza, que sejam devidamente efetuados e reajustados de acordo com a inflação. Do mesmo modo que a Secretaria de Agricultura Familiar atue nos campos agrícolas brasileiros para realizar distribuição de alimentos e refeições em restaurantes populares, podendo agir em parceria com o setor privado porque a fome não beneficia ninguém. Finalmente, com tais implementações a fome no Brasil virá a ser uma mazela passada na histria de nosso  país.']",120,120,120,120,120,600
84,Armas,"['Todos sabem que em nosso país ,há tempos observa-se , o crescente aumento de violência,ocasionando uma discursão , à respeito do porte de armas pela populaçao civil,como meio de proteção pessoal e coletivo.', 'Alguns argumentam que , é possivel que as armas tenham um efeito ambivalente  -aumentem e ao mesmo tempo diminuam a violência , (.) um maior  porte de armas talvez faça crescer os casos de homicídio e suicídio , mas reduza a taxa de furto,latrocínio e violência contra a mulher, justificam-se pela insegurança presente nas grandes metrópoles.', 'Ao se examinarem o histórico de mortes ocasionadas por armas de fogo,verifica-se que entre 1979 e 2003,acima de 550 mil pessoas morreram no país,num ritmo crescente e constante ao longo do tempo. Entre a população jovem, o Brasil apresenta a 3ª mais elevada taxa de óbitos relacionados a homicídios, (.) desse modo em um país como, o Brasil que apresenta índices tão alarmantes de violência relacionadas à armas de fogo ,deve-se repensar a possibilidade de porte para civis. Deve-se exigir que o Estado cumpra o que está no texto constitucional e garanta a segurança pública ,o bem-estar e a justiça sociais .', 'Em virtude dos fatos mencionados é inadmissivel que um cidadão de bem tenha que adquirir uma arma de fogo para garantir sua integridade ,a de seus familiares e patrimônio.']",160,160,160,200,200,880
91,Negacionismo no Brasil,"['O negacionismo científico consiste em um modelo de alienação comportamental no qual busca-se negar os fatos como fulga de uma determinada situação. Tal premissa está relacionada ao grau de conhecimento da população, ocasionando na falta desse, o reaparecimento de doenças erradicadas e o surgimento de formas mais agravantes das doenças. Assim, faz-se necessário medidas governamentais que amenize essa problemática.', 'Inicialmente, vale destacar que o reaparecimento de doenças que haviam sido erradicadas, como o sarampo, de acordo com pesquisas científicas publicadas na revista Radis, voltaram a ocorrer. Isso, pois, as pessoas pararam de tomar vacina em função de informações falsas provenientes de indivíduos desqualificados cientificamente. Sendo assim, nota-se a importância de combater à alienação informacional.', 'Ademais, é notório que essa manipulação contribui para o surgimento de formas mais graves de doenças, visto que,  impede o tratamento precoce delas. A exemplo dessa situação, destaca-se que o presidente da África do Sul negligenciou o surto de Aids no país, fato que,  contribuiu para aumentar o número de infectados na região. De maneira semelhante, no Brasil, o negacionismo tem afetado a saúde da população, sendo necessário, medidas que solucione este problema.', 'Logo, através do Ministério da Saúde, o governo deve implementar uma política pública publicitária - no horário nobre de televisão - objetivando a conscientização da sociedade referente a veracidade dos conhecimentos científicos.']",160,200,120,200,120,800
71,Suicídio no Brasil,"['O suicídio vem ganhando maior ênfase na atualidade devido as constantes ocorrências entre jovens. No Brasil, entre 2000 a 2015, os suicídios aumentaram 65% dos 10 aos 14 anos e 45% dos 15 aos 19 anos, segundo levantamento do sociólogo Julio Jacobo Waiselfisz, coordenador do Mapa da Violência no Brasil. Nesse contexto  devem ser analisado a interação entre escola e família  e também a influência da mídia e da tecnologia na problemática em questão.', 'Desde a chegada da família real ao Brasil que a família passou a possuir um papel primordial no desenvolvimento da educação no país. Ao decorrer dos anos ela foi passando por diversas transformações como a inversão de papeis entre mãe e pai que  infelizmente  não foram capazes de valorizar a relação entre família e escola . No entanto, os pais se preocupam apenas em atender as necessidades básicas do filho e esquecem-se de acompanhar os mesmos no âmbito escolar gerando sentimentos de negligência e abandono.', 'A influência da mídia e da tecnologia começaram a se destacar a partir da Revolução Industrial e desde então vem ditando o modo de vida que as pessoas devem seguir. A população se tornou refém do modelo estabelecido pelas grandes empresas multimídias e aqueles indivíduos principalmente adolescentes que não aderem às tendências acabem se sentindo excluídos e muitas vezes viram vítimas de comentários abusivos e até mesmo de bullying  gerando sentimentos de ansiedade, depressão e pânico.', 'Torna-se evidente que a questão de suicídio entre jovens precisa ser revista. Assim, torna-se notório que as famílias devem se tornar mais presentes nas instituições escolares por meio de palestras e projetos e que a escola deve preparar o aluno para enfrentar as diversas situações e se tornar mais crítico e não apenas decorar grafemas pois, assim como Paulo Freire disse  a leitura do mundo precede a leitura da palavra . É necessário também que a influência da mídia e da tecnologia sejam trabalhadas principalmente em casa e na escola para que as crianças entendam que qualquer ser humano tem direito de ser aquilo que deseja independentemente do que a atualidade transmita ser o melhor . Dessa forma, o país será mais igualitário e as pessoas viverão melhor.']",120,120,120,120,120,600
76,A EVOLUÇÃO DAS MULHERES,"['Ao longo dos séculos, as mulheres vem sofrendo com o preconceito, nos tempos antigos,  elas não tinham o direito minimo de um cidadão, como o voto. Onde mulheres eram consideradas como uma maquina de reproduzir crianças, não tinha o direito si quer de fazer a escolha de um marido, teria que ser do gosto de seu pai.', 'Nos dias em que vivemos é outra realidade, é possível ver a evolução das mulheres, lutando sempre a favor dos seus direitos, para elas não existe limites onde não podem cegar, mostrando que a diferença da mulher para o homem não esta apenas na força física, provando que a força não consegue dominar o raciocínio e a sabedoria, que pode ser desenvolvida por qualquer um de nos, mais facilmente na mulher.', 'Atualmente é comum ver mulheres trabalhando na área civil, onde era considerado trabalho para homem, e requer força e resistência. Para um homem, hoje é comum ver uma mulher liderando uma equipe de homens . Isso vem provando que acabou essa indiferença.  mulher não foi feita para cuidar da casa, lavar roupa, fazer comida, e cuidar dos filhos, tarefa essa que também não é fácil.', 'O homem de atualmente, quer uma mulher do seu lado que trabalhe, estude, faça a mesma coisa que ele faz, pois os dois lutando, existe ai um futuro brilhante, deixando de lado qualquer preconceito. Temos que ter em nossas mentes que endependente de raça, credo e sexo, todos somos iguais, e juntos somos mais fortes para enfrentar as batalhas do dia-a-dia,.']",120,80,120,120,80,520
89,Isolamento,"['O ano de 2020 foi marcado pela disseminação mundial do vírus da Covid-19, este que causou milhões de mortes em diversos países, como tentativa de diminuir o agravamento no número de casos várias nações adquiriram o isolamento social. Embora tal medida tenha contribuído significativamente, no Brasil houve a problemática do impacto econômico que foi gerado para todo o comércio e famílias de baixa renda: o desemprego. No entanto, tal adversidade gerou rejeição por parte dos trabalhadores para com as medidas protetivas, configurando um grave problema de saúde pública.', 'Em abordagem inicial, nota-se que o Brasil foi um dos maiores alvos da pandemia: mais de 200 mil mortes em menos de um ano, como foi noticiado por diversos veículos de comunicação. É notório que,  o crescente número de pessoas infectadas se deu por inúmeros fatores, principalmente o desrespeito ao isolamento, tal fato que ocorre inevitavelmente com a busca por renda  já que todos os setores econômicos foram de alguma forma prejudicados resultando em falta de empregos. Nesse sentido, percebe-se que os índices de rompimento da quarentena se tornaram elevados.', 'Adicionalmente, de acordo com o artigo 196 da Constituição federal do Brasil: “A saúde é direito de todos e dever do estado, garantido mediante políticas sociais e econômicas que visem a redução do risco de doenças e de outros agravos (...)"", esclarecendo o compromisso do governo brasileiro de lidar com a pandemia, garantindo a segurança e sustento da sociedade. Dessa forma, se faz necessário um planejamento governamental que vise amparar as necessidades da população de modo a inteirar os cidadãos a manterem o isolamento enquanto recebem auxílio das políticas públicas.', 'Por certo, fica evidente a necessidade de conscientização acerca das medidas protetivas em meio à crise econômica. Para tanto, é dever do governo federal juntamente com o Ministério a Saúde do Brasil elaborar políticas públicas que contribuam para menores índices de pessoas infectadas. Isso seria efetivado por meio da criação de um novo auxílio emergencial assim como imposição de medidas mais rígidas de distanciamento. Essa proposta tem por finalidade assegurar o controle da pandemia, de maneira a anular obstáculos econômicos e dar origem à consciência popular sobre a importância desta estratégia política.']",160,160,160,200,160,840
55,Dizimação dos povos indígenas brasileiros,"['Segundo a Constituição de 1988, são reconhecidos aos índios sua organização social, costumes, crenças e tradições, direitos sobre suas terras e proteção de todos os seus bens. Entretanto, os direitos indígenas conquistados na Constituição não têm sido garantidos , e dessa forma, colaborado para a redução da população de índios no Brasil. Sendo assim, cabe analisarmos  os fatores que favorecem esse quadro.', 'Primordialmente, convém ressaltar que a falta de proteção de leis indígenas colabora para a invasão de suas terras. Segundo a ONU , o Brasil fracassa em proteger os direitos dos seus povos indígenas, pois é nítido que o número de invasões aumentou consideravelmente. E inaceitável que em um país proclamador de tantos direitos tenha permitido que o fracasso do Estado em a chegado ser motivo de preocupação da Oganização das Nações Unidas.', 'Além disso, sem a proteção das terras desses povos, consequentemente ocasionará a perda de sua cultura. No dizer do indianista Orlando villa Boas,  ""o índio só pode sobreviver dentro da sua própria cultura ""  .De maneira análoga ,ao analisar esse pensamento ,percebe-se que a desocupação dos índios de suas terras levar à perda de suas tradições, pois sua cultura entrará em extinção . É inadmissível que o Estado permita a existência da dizimação indígena, principalmente por essa representa a origem brasileira.', 'Sendo assim, torna-se necessário que a Funai -órgão responsável por manter os direitos e bem-estar indígena, em parceria com o Governo Federal, promova diariamente a identificação e demarcação das terras indígenas, aliada com punição mais rigorosa aos invasores, através de estudos e averiguação das terras ocupadas ilegalmente, com ajuda de denúncias e investimentos do Estado. Dessa forma, será garantida a proteção das terras e cultura dos índios, obtendo assim sua permanência.']",120,120,120,120,120,600
94,,"['O transtorno do espectro do autismo  ainda não é um assunto muito disseminado na sociedade, como ocorre com outras deficiências também . Muitas pessoas ainda não possuem conhecimento deste tema, muito menos como lidar com o mesmo.', 'Acredita-se que para maior inclusão é necessário maior propriedade e domínio do assunto. Que seja falado sobre a necessidade de inclusão dos deficientes autistas, cadeirantes, deficientes auditivos. Que seja divulgado em jornais no que se refere a pessoas com necessidades especiais querendo ter mais voz ativa e podendo participar.', 'Para que se tenha mais inclusão é necessário que haja introdução, incorporação. O autismo não deve ser algo à parte, mas se tornar parte de um todo, nas escolas, na TV, no teatro. Deve-se ser introduzido nas escolas a maneira como se deve lidar com uma pessoa portadora deste transtorno (e de todos os outros também). Sabemos que a educação especial ainda passa por desafios para que se possa ter uma garantia de qualidade, mas este problema pode ser lapido com investimento no aprimoramento dos professores ao conhecimento de novas táticas para melhorar a condição de estudo desses alunos e aumentar o rendimento de educação de cada um.', 'Quando se há propriedade e domínio de um assunto, se torna mais fácil encontrar uma resolução quando surge um desafio. Para que haja a inclusão de pessoas com transtorno do espectro do autismo e demais deficiências é fundamental que se tenha a incorporação de pessoas aptas e empáticas para aprender como lidar com as mesmas nas escolas, no ambiente de trabalho, nos shoppings e todos os possíveis âmbitos sociais.']",160,120,120,120,80,600
84,,"['Em qualquer país os seus cidadãos têm direitos e deveres, o mesmo ocorre com o uso de armas de fogo pela população civil. Esse fato possui suas causas e consequências.', 'Nos últimos anos, os noticiários possuem diariamente alguma manchete sobre a violência, o que ela gera nas vítimas e em suas famílias, amigos. Um argumento para o uso de armas de fogo pela população é o crescimento dos atos de violências e o uso desse instrumento que pode matar como uma forma de segurança. No Brasil, por exemplo, existe uma lei que é rígida para o porte de armas de fogo, mas há um projeto de lei no Congresso Nacional que deixa mais branda (a aquisição) do porte dessas armas, em tal projeto uma pessoa que responde por homicídio pode ter legalmente uma arma.', 'Como consequência, em um contexto em que parte da população está chocada com o aumento da violência, principalmente dos atos terroristas, que está em pauta restringir ou não o uso de revólveres, espingardas, escopetas pelos civis. No Brasil, como já citado, o novo projeto de lei pode deixar mais branda o acesso legal as armas de fogo, mesmo para quem possui antecedentes criminais, mas será que esse indivíduo possui psicológico para ter tal objeto mortífero¿ No mês passado um homem nos EUA invadiu uma boate gay em Orlando e provocou o maior número de vítimas em um atentado com arma de fogo, esse sujeito tinha a posse legal da arma. É notável que os EUA apresentem muitos casos de mortes por armas de fogo, nesse país andar armado é um direito constitucional, podendo o cidadão comprar esse objeto em supermercados, por exemplo. Também, em tal país é comum crianças conviverem com armas de fogo, elas podem ter aulas de tiros, jogos que ensinam isso.', 'É evidente; portanto, cada nação tem sua lei sobre o uso de armas de fogo, mas o crescimento da violência gera um aumento no debate de leis mais brandas sobre o porte de armamentos pela população civil. Entretanto, o porte de armas pode gerar mais atos de violência, existe também, a falta de preparação psicológica para seus usos. Por isso, o Estado deve investir mais em segurança pública, deixando assim, o cidadão mais protegido e zelado. A escola deve desde os primeiros anos das vidas das crianças, ensinar a elas sobre as responsabilidades do uso de armas de fogos, o que elas podem trazer como consequências se mal usadas.']",120,160,120,160,160,720
63,Impactos Ambientais,"[""O treco da música O sal da terra de Beto Guedes diz: ''Terra, és o mais bonito dos planetas, estão te maltratando por dinheiro''. Seguindo sua linhagem de pensamentos podemos ver notoriamente que existe uma grande necessidade de irmos ao encontro do assunto impactos ambientais, pois a ganância do homem esta degradando o meio ambiente. Então quais as soluções para os impactos ambientais resultantes da ação de grandes corporações?"", 'A Política Nacional do Meio Ambiente (PNMA) Lei nº 6.938/81  foi recepcionada pela Constituição Cidadã de 1988, com o objetivo de preservar e melhorar o Meio Ambiente. Diante disso podemos  ver que os impactos ambientais podem ser solucionados ou diminuídos através de ações, sendo por meio de políticas públicas, individuais ou coletivas como por exemplo: a prática de separação de resíduos no intuito de auxiliar o processo adequado de reciclagem e também controle do consumo de energia afim de reduzir os impactos causados pelo uso continuo das maquinas em grandes corporações. São essas ações nas grande corporações que fazem a diferença do meio ambiente.', 'Em Maio de 2016, o programa da Organização das Nações Unidas (ONU) alertou que a degradação ambiental causa 12 milhões de mortes por ano. Tendo isso em vista  podemos  ver que os impactos ambientais são causados pela ação do homem na natureza. Os maiores exemplos de impacto ambiental são: A mineração, a poluição dos solos pelo descarte errôneo de resíduos, descarte de dejetos agrícolas em rios e lagos, a contaminação dos solos por elementos tóxicos na mineração...', ""Diante dos fatos supracitados  faz-se necessário que o Poder Legislativo insira na grade curricular disciplinas como Educação Ambiental, contando com palestras, seminários e oficinas voltadas a preservação do meio ambiente. Outrossim, compete a mídia juntamente com ONG'S trabalhar com a realização de projetos e campanhas voltadas a mostrar ao público as consequência dos impactos ambientais tanto na natureza como nos seres humanos, tornando-se assim,  um canal de denuncias e promoção de debates.""]",120,160,120,160,120,680
95,,"['Segundo o artigo da constituição 231, cabe à União demarcar e proteger todos os bens dos índios, incluindo nesse campo suas tradições, línguas, religião, costumes e suas terras. Embora seja uma conquista, os direitos conquistados pelos índios estão sendo ameaçados com a este do marco temporal, que apenas reconhece terras indígenas já existentes na data da constituição de 5 de outubro de 1988, tal ação ignoraria índios que foram obrigados a sair de suas terras devido expansão branca no meio rural e urbano ou sob violência, além de terras em processo de demarcação não serem mais reconhecidas, ferindo a cultura de um povo. Assim vê-se a configuração de um problema de contornos específicos que emerge devido insuficiência de leis e a priorização de interesses mercadológicos.', 'Em primeira análise, a insuficiência de leis é um desafio presente no problema. Segundo Dante Alighieri, as leis existem, mas quem as aplica? Tal frase do pensador pode ser aplicada à tese do marco temporal, que infringe completamente o artigo 231 que assegura vários direitos aos índios. Mostrando que a existência da lei não impediu para que a ação no Supremo Tribunal Federal fosse barrada. Sendo as leis nesse cenário não aplicadas para assegurar para esses povos os seus territórios, que é não só um forma de sobrevivência, mas de conexão com seus antepassados e suas tradições.', 'Em paralelo, a priorização de interesses mercadológicos é uma entrave no tange ao problema. Para Bauman, os valores da sociedade estão sendo colonizados pela lógica do mercado. Tal constatação é nítida no debate sobre o marco temporal, onde os defensores são ruralistas,  que causaram em grande parte a expulsão de índios de suas terras para dar vazão a plantações de arroz, trigos e outros cereais ou violação de áreas indígenas para a extração de matéria-prima. Assim, inverter a lógica e colocar os valores humanos em primeiro lugar é urgente.', 'Portanto, uma intervenção faz-se necessária. Para isso, o poder legislativo deve criar leis que assegurem aos índios o direito à sua terra e o respeito a sua cultura, que existia muito antes dos colonizadores portugueses chegaram em solo brasileiro, a fim de reverter a supremacia de violação e interesses mercadológicos sobre uma classe oprimida desde os tempos coloniais. Além disso, o Estado deverá investir na proteção de áreas indígenas, para que se dê fim à violação sem autorização das mesmas, fazendo valer o artigo 231 da constituição, que compete à União demarcá-las, proteger e fazer respeitar todos os seus bens..']",120,160,120,160,160,720
83,O esporte e seus benefícios,"['Desde o século XIX que as Olimpíadas estimulam o companheirismo entre cinco continentes, além de evidenciar os atletas que mais se destacam. Os jogos olímpicos fazem com que as pessoas conheçam todos os tipos de esportes, despertando também a vontade de querer praticar alguma coisa, com o intuito de levar uma vida melhor.', 'São vários os benefícios que as pessoas podem adquirir com a prática do esporte, como melhoramento na capacidade mental, melhor condicionamento físico, tratamento de algumas doenças crônicas, entre outros. É recomendável que se inicie a prática desses esportes quando ainda criança, pois faz com que elas deem mais valor ao crescerem, além ajudar elas a encontrarem um esporte com que se identifiquem e, em alguns casos, levem como profissão.', 'Nas escolas, desde o ensino fundamental até o ensino médio é praticado aulas de educação física,onde traz de forma mais leve um meio das crianças se encontrarem neste mundo, ensinando os exercícios e as regras praticadas em determinados modelos de esportes, além de desenvolver competências e habilidades sociais, psicológicas, motoras e cognitivas.', 'Um grande problema é que as pessoas podem desenvolver demais o espírito competitivo, esquecendo-se da função do esporte na vida delas e focando em ganhar e ter algum reconhecimento através dele, muitos atletas “trapaceiam” em competições devido a este fator, que muitas vezes é colocado através dos pais e do próprio treinador. Outro problema é a falta de preparação antes dos exercícios, que feitos de forma errada podem trazer prejuízos.', 'Mesmo sendo um assunto bastante tratado e incentivado, as pessoas não têm o costume de praticar exercícios , mas mesmo assim é preciso levar os esportes para a vida delas, mas de forma certa, incentivar desde pequeno que o importante não é ganhar uma competição e sim praticá-la ,para que possa receber os benefícios, e não se esquecendo dos alongamentos que ajudam no aumento da temperatura corporal e na melhora da flexibilidade, evitando lesões nas regiões a serem estimuladas pelo exercício.']",120,160,200,200,200,880
17,"Menos Brás Cubas, mais patamares de Roma!","['Com um valor histórico e cultural reconhecido mundialmente, o Coliseu de Roma, principal patrimônio da Itália, ganha um grande investimento anualmente para sua manutenção, além de uma conscientização forte para a sua preservação. Todavia, essa situação de valorização não é frequente no Brasil, fazendo com que patrimônios sofram incêndios, pichações e entre outros problemas cotidianamente. Nessa perspectiva, cabe analisar as más politicas publicas do governo e o desprovimento de virtudes do homem.', 'Em primeiro instante , observa-se a precariedade de investimentos em relação aos patrimônios. Segundo noticias do site “Veja” e diretores de museus do país, a cada ano há a redução de verbas publicas e o detrimento a deterioração de pelo menos uma instituição nacional de importância histórica, social e cultural, nesse ano, o Museu Nacional do Rio de Janeiro foi o escolhido, mas, enquanto o governo não aumentar as verbas governamentais, muitos outros tornarão-se também alvo dessa problemática.', 'Outrossim, é importante enfatizar que o homem também foge da responsabilidade de cuidar e fiscalizar o bem publico , que faz parte da sua identidade nacional e colabora para a sua formação pessoal. Essa postura do homem representa para Machado de Assis o desprovimento de virtudes, que pode ser vista em diversos personagens do autor, como, por exemplo, Brás Cubas, que não reconhece os seus erros e a todo momento julga e culpa as situações que vivencia, não transformando elas , mas agravando-as.', 'Destarte, são necessárias intervenções para inibir a problemática. Primeiramente, o Governo Federal precisa fornecer recursos financeiros suficientes para a manutenção e a segurança desses estabelecimentos, contando com o apoio das secretarias, ministérios e instituições de ensino superior relacionados a cultura e a historia nacional. Ademais, as escolas devem adotar aulas semanalmente voltadas as virtudes como: autonomia, responsabilidade e cidadania, afim de conscientizar e adotar uma participação da população em problemas sociais. Com essas medidas, fica claro, que as pessoas deixaram de atuar como Brás Cubas e as nossas riquezas também ganharam patamares como as do Coliseu de Roma.']",80,120,80,120,120,520
75,Somos Violência,"['A violência no Brasil tem sido um assunto bastante discutido pela mídia nos últimos tempos, pois cada vez mais é do interesse da população que esse problema alarmante, chegue pelo menos aos ouvidos das autoridades, que estão aparentemente mais preocupados em assistir “o circo pegar fogo”.', 'Ainda mais recentemente, deputados da “bancada da bala”, iniciaram um debate em relação a uma flexibilidade no texto do Estatuto de Controle de Armas de Fogo, n qual, existe a possibilidade de que todos os cidadãos brasileiros possam ter livre porte de armas de fogo. É importante deixar claro, a diferença entre “posse” (ter uma arma de fogo dentro de local empresarial, residencial, por motivos de extrema necessidade, seguindo critérios) e “porte” ( transportar a arma de fogo consigo para lugares públicos e etc. ).', 'O argumento de que uma arma pode ajudar na defesa pessoal ou de um grupo é completamente inválido, pois umas das razões óbvias, é que a maioria dos brasileiros não tem preparo psicológico para portar uma arma. Seguindo essa linha de raciocínio, é difícil imaginar uma situação na qual, um indivíduo sem preparo,  possa se defender, sem que haja a mínima violência possível. A partir do momento que a arma é sacada, já está sendo usada de forma ofensiva, não defensiva. Acrescentando ainda,  que a pessoa que está na mira, além de estar perdendo o direito de vida e liberdade, na melhor das hipóteses, estará agindo sob coação, sob chantagem psicológica. Não há razão para ter mais violência do que já temos.', 'Portanto, diante dessa possível possibilidade imoral no texto do Estatuto, é de extrema necessidade que tomemos  um posicionamento contrário ao de nossos deputados. Vamos mobilizar as redes sociais, os meios de comunicação, as ruas, avenidas e praças com a campanha #NãoSomosViolência; façamos palestras de conscientização aos jovens nas escolas, nos transportes, em nossos lares. Essa luta, a nossa luta, começa hoje.']",120,80,120,120,80,520
140,País ativo e integrado,"['A história do Brasil é marcada pela discrição e mesquinhez quanto         a         participação dos cidadãos na política. Mas evidências históricas mostram que os jovens         tem-se         mostrado, em alguns casos, participativos,                 como nas Diretas Já, em          1983 até          os caras-pintadas, em 1992                . O jovem vem se mobilizando,                 porém com causas singulares e construtivas.', 'Nos últimos meses, foi divulgado um protesto dos estudantes da Universidade de São Paulo, USP, em que eles exigiam a desocupação da Polícia Militar do prédio,depois que a PM apreendeu três universitários fumando droga.                 A manifestação foi alastrada e transformou-se em uma verdadeira guerra.                A Marcha da Maconha também é defendida pelos jovens, os quais vão até ruas lutar pela legalização         da mesma         .', 'Influenciado         pelas redes sociais, os jovens brasileiros organizaram uma manifestação contra a corrupção nas principais cidades do país. Sob                 forte luta                e vontade, eles         reinvidicaram          as condições em que o Brasil se encontra                , exageros dos governantes com gastos públicos, aumento desenfreado de impostos, uso do dinheiro do povo para fins pessoais, enfim,                 interesses comuns diante da situação caótica do país.', 'O jovem brasileiro                tem se preparado e adquirido conhecimento ao longo do tempo.         Desejam         obter uma educação e formação acadêmica para         conseguirem         um futuro competente. Com isso a vitalidade em lutar pelos seus direitos e por um país mais justo engrandece,                 quando a oportunidade e a capacidade deles se restringem ao Estado.', 'O futuro do Brasil é espelhado e diretamente ligado         as         atitudes dos jovens atualmente, são eles que estarão em um papel de destaque na sociedade controlando o poder e rumo do país.                 Com alguns lutando pela legalização da droga e outros contra a corrupção, mesmo com objetivos opostos,o Brasil caminha para um lugar ativo e integrado em seus valores sociais. “O que me preocupa não é o grito dos maus.É o silêncio dos bons.”,Martin Luther King.']",120,160,120,80,80,560
145,Mundial,"['Legado da         copa         : frustração, vergonha e vexame. Uma oportunidade         do brasil         se mostrar ao mundo, evidenciar nossa falta de organização, corrupção e a ignorância dos governantes.', 'visibilidade          mundial, expor ao mundo a falta de educação, sistema de saúde, transporte público e violência; deveriam ser prioritário.         Está sendo gasto         milhões de reais em         estádio         , dinheiro da população.', 'Nós queremos, precisamos e         requeremos; hospital         , educação e economia. Dizer que a         copa         vai acelerar o crescimento do         Brasil; ignorância         . É melhor investir nos jovens, mostrando o caminho, oferecendo condições para que eles         acelere         o ""país do futebol"".', 'As manifestações que         ocorreu         durante a         copa das confederações, comprova         a insatisfação da sociedade. Nós não somos bobos, temos conhecimento                que esse         avento         é para benefícios de uma minoria.']",80,80,80,80,80,400
55,Direito dos indígenas no Brasil,"['Hoje a população indígena está cada vez menor, a maior causa disso é a perda de suas reas para o desmatamento ou para outros meios de exploração, como na época da exploração européia que pegaram seus recursos e suas vidas, trouxeram muitas doenças que os indios não tinha anticorpos.', 'Os indígenas que ainda persistem e ficam nas suas florestas,  tem o mesmo direito que nós ""civilizados"" e nós temos o dever de preservar suas reas de vivencia tanto de moradia, quanto de caça e plantação, preservar a cultura deles, já que de certa formar também é a nossa, porém isso cabe ao governo aumentar suas reas de proteção e de restrição, fiscalizar as reas e locais de cortes de arvores, para que não invadam as terras pertecentes aos índios.']",120,80,40,80,0,320
73,Um caminho para todos,"['O passado histórico brasileiro  demarcado pela opressão étnica, o racismo, gerador de violência, ódio e discórdia, tornou-se um fator cultural de extrema prevalência no país e, por isso, deve ser urgentemente enfrentado, combatido e destruído para sempre . Por que ele só causa dor. Já estar mais do que comprovado de que a grande questão do preconceito é que valores de aversão à diversidade são doutrinados na sociedade e, para reverter a atual situação, é necessária uma mudança educacional que promova a igualdade e a harmonia.', 'É lamentável que a escravidão brasileira mesmo banida haja um século e três décadas , ainda hoje esteja ligada as algemas invisíveis do preconceito, do racismo e da intolerância. A sociedade brasileira não pode nem deve compactuar com isso. Não mais! E muito menos os governantes e educadores. É necessário uma politica de igualdade todos os nativos desta terra são brasileiros. E não só os brancos, os ricos, os poderosos e os perfeitos. No campo onde o talento é soberano tem lugar para todos, porque o talento não escolhe cor. Como nos esportes, na miscaa e na dança.', 'Toda criança nasce livre de preconceito, racismo e intolerância!  Ela não se julga melhor nem pior que ninguém, ela só quer ser igual. São os adultos que vão doutrinando e moldando aquele pequenino ser de bondade no extremista quando crescer. Quem disse para o branco que um negro vale menos? Quem disse pra Hitler que um judeu vale menos que um alemão? Quanto vale um homem? Uma vida tem preço? Aprendemos a voar como os pássaros e a nadar como os peixes, mas não aprendemos a conviver como irmãos. Disse Martin Luther King.', 'A injustiça num lugar qualquer é uma ameaça à justiça em todo o lugar. Para que o caminho da superação seja para todos uma das coisas importantes da caminhada, é não buscar julgar a pessoa injusta, mas transformá-la. E isso só será possível com a educação. Por meio de enfrentar o problema, não aceitação de ser julgado pela cor. Denunciando ações de racismo. Só a educação pode transformar uma pessoa, um lugar, um país e o mundo. Já que a boa educação vem de berço. Eduque os pais que os filhos aprendem. A igualdade é um exercício que deve ser praticado por todos cotidianamente por dever moral e cívico. Se quisermos uma nação civilizada e harmônica deve começar por nós a mudança. Igualdade e oportunidade para todos é o único caminho que levará a superação da raça humana.']",120,80,80,120,80,480
3,Os perigos da uniformidade,"['A revolução transumanista é a alteração ou estabilização de características da espécie humana por meios externos. Dentre os diversos aspectos dos pelos quais podem ser analisados essa mudanças analisadas essas mudanças, alguns merecem destaque, tais como a retirada da individualidade humana, assim como, um segregarismos  ainda mais forte do que temos hoje. Dito isso, é imprescindível analisar essa questão.', 'A principio princípio, pode ser dito que essa revolução poderia trazer uma potencialização de características consideradas boas e a exclusão de características vistas como ruins. Desta Dessa maneira, podemos imaginar uma sociedade sem individualismo, uniforme em todos os sentidos. O fortalecimento físico, a ausência de doenças e a estabilidades de emoções são algumas de suas promessas. Ou seja, a perda do que nos torna únicos e diferentes uns dos outros.', 'Além disso, é importante ressaltar que esse tipo de tecnologia, não tecnologia não estaria disponível a à população em geral, devido o ao seu auto alto custo. O seu uso estaria restrito a uma pequena parcela que se tornaria mais forte e com totais condições de domínio sobre os considerados inferiores. O mundo já passou por algo semelhante como a escravidão dos negros no Brasil ou o nazismo na Alemanha.', 'Logo, é evidente o problema da revolução transumanista merece maior atenção por parte da sociedade, que ainda não a compreende. Desse modo, uma das alternativas a serem tomadas é a união de especialistas e do poder público no sentido de proteger a população e elucidar essa questão.']",120,120,120,160,80,600
65,O valor do jovem na sociedade brasileira,"['Na cidade de Gotham, universo fictício dos quadrinhos do Batman, a alta criminalidade e violência são as suas características mais marcantes. Analagomente, a realidade de muitos jovens brasileiros, público alvo dos quadrinhos, tem entrado na linha do crime, visto que a evasão escolar crescente e a negligência do governo para com a educação básica de qualidade, além das poucas e cada vez mais concorridas oportunidades de emprego são umas das principais causas desta problemática. Portanto, convém analisar as principais consequências de tais posturas na sociedade.', 'O aprendizado estudantil na fase escolar é uma das principais bases para um país desenvolvido e livre de transgressões à lei . Contudo, de acordo com uma pesquisa realizada em 2013 pelo Programa das Nacões Unidas para o Desenvolvimento, o Brasil teve, naquele ano, a terceira maior taxa de abandono escolar dentre os cem países de maior desenvolvimento humano, denunciando que o território brasileiro está longe de alcançar a realidade utópica de uma nação sem crime , devido ao números de jovens fora do ambiente acadêmico, o que os torna mais propensos ao mundo do crime.', 'Faz-se mister, ainda salientar que a baixa qualidade educacional brasileira e a rara visão do estudo como agente transformador são impulsionadores da evasão escolar e consequentemente do aumento da criminalidade entre os jovens. Segundo o filósofo Pitágoras, é necessário educar as crianças para que não seja preciso castigar os homens . Neste contexto, jovens que não veem o mundo acadêmico como opção acabam não tendo outra alternativa a não ser o dinheiro rápido através do crime presente no tráfico de drogas, roubos e furtos — sendo essas as atividades criminosas mais comuns dentre jovens nesse cenário.', 'Assim sendo, medidas são necessárias para resolver este impasse. Primeiramente, o Ministério da Educação , junto ao governo, deve criar e intensificar programas de difusão escolar que visem levar a educação básica ao áreas de maior criminalidade do país. Ademais, o Ministério de Trabalho também pode participar implantando escolas de capacitação gratuitas visando dar oportunidade ao jovem de concorrer no mercado de trabalho com a devida preparação exigida . Em suma, com esses dois projetos, a juventude marginalizada que antes via o mundo do crime como saída poderá escolher um futuro digno, baseado na formação acadêmica e profissional, o que beneficará não só eles, mas também ao país, que irá colher o valor do jovem na sociedade.']",120,160,120,160,160,720
91,Os efeitos do negacionismo no movimento antivacinação,"['A Organização Mundial da Saúde (OMS) incluiu, recentemente, o movimento antivacinação como um grande problema para a saúde global por conta da baixa procura por imunização e descrença no reconhecimento científico. Nesse contexto, a possibilidade do retorno de doenças consideradas erradicadas, como: sarampo e caxumba tornam-se uma ameaça já que a cobertura vacinal caiu, esse cenário reflete no surgimento de novos casos de infecção que sobrecarrega o sistema público de saúde. Diante disso, torna-se fundamental analisar as notícias falsas como armadilhas que alimentam tal organização e o perigo da baixa taxa de vacinação para o corpo social.', 'Posto isso, é evidente que as notícias falsas são mecanismos que contribuem com o movimento antivacinação. Nessa âmbito, o Instituto Reuters da Universidade de Oxford, apontou que o Brasil está entre os países que mais consome notícias falsas. Assim sendo, a propagação irresponsável de conteúdos enganosos, nos meios digitais, fortalece a organização que intenta obstruir o papel da ciência na transmissão de informações, sem respaldo técnico, a respeito dos efeitos negativos de vacinas no organismo, a fim de gerar debates controversos e polêmicos. Com isso, a divulgação de materiais inverídicos tendem a reverter o progresso alcançado no combate às doenças evitáveis através de imunizações, por falta de retorno da população induzida pelas matérias infundadas.', 'Ademais, cabe observar o perigo da baixa taxa de vacinação para a população. Sob esse viés, os dados do Programa Nacional de Imunização (PNI), mostram que, nos últimos dois anos, a meta de 95% de imunização do grupo alvo não foi alcançada. Dessa forma, a queda na procura provocou o surgimento de novos surtos de infecções, como: sarampo e caxumba os quais podem agravar a estrutura do sistema público de saúde com a alta demanda, de serviços, por parte de indíviduos desprotegidos que propagam a doença novamente e causam mais vítimas. Logo, o quadro atual ilustra que doenças consideradas erradicadas, no passado, tendem a voltar devido a menor taxa de procura por vacina, na qual tal situação atrela-se à desconfiança no campo científico por parte dos cidadãos.', 'Portanto, a imunização é a única forma de prevenção para diversas doenças contudo, o movimento antivacinação impacta de forma negativa na saúde pública. Desse modo, compete ao Ministério da Saúde mitigar os efeitos do negacionismo no movimento por meio de campanhas publicitárias que envolvam especialistas da área da saúde, a fim de divulgar a importância e o benefício de vacinas para o combate de doenças infecciosas bem como orientar o cidadão a estar em ordem com a carteira de vacinação. Enfim, os brasileiros terão mais discernimento sobre o assunto e ultrapassarão falsos paradigmas.']",200,120,120,200,120,760
131,Tempo bem gasto,"['As propagandas  eleitorais tem como intenção         informar e fazer os eleitores se interessarem pelos candidatos, porém é necessário que                 haja dedicação da população                .', 'O intuito dos partidos em formular as propagandas pode                 até ser de atrair                a atenção         populacional         , fazendo-as com base em pesquisas e estatísticas para                 atingir a região                em que seus candidatos         tem         mais chances de voto, e é                 esse tipo de pensamento                que faz uma parte da população                recusar a assistir                 tais programações.', 'Entretanto         mesmo que essa seja a         realidade         é possível a utilização do meio de comunicação sendo essa a televisão ou o         radio         para uma escolha mais certeira do         candidato, já         que as propostas de mudança e realizações são apresentadas nos         programas         é de interesse do eleitor se certificar se realmente é possível que tais propostas aconteçam e qual o histórico do candidato no meio político, e isso requer uma dedicação da população.', 'Contudo         é notável que os programas políticos são de certa maneira entediantes e uma perda de tempo, porém qual perda será maior a de minutos, horas ou anos?']",80,120,80,80,0,360
86,ameaças,"['Na obra ""Utopia"", do escritor britânico Thomas ore, é retratada uma sociedade perfeita, na qual o corpo social padroniza-se pela ausência de conflitos e problemas. Infelizmente, fora da literatura, é o oposto do que autor prega, uma vez que os impactos negativos das redes sociais na saúde mental dos brasileiros apresenta obstáculos. Esse cenário antagônico é fruto tanto do uso excessivo das redes sociais quanto da negligência familiar com os adolescentes. Nesse sentido, é válido analisar as questões que envolvem e potencializam essa realidade.', ""A priori, destaca-se o uso demasiado das redes sociais como impulsionador do problema. Em meados do século XX, com o advento da terceira evolução industrial, a internet alcançou uma proporção mundial obtendo vários navegantes, principalmente nas mídias sociais. Consequentemente, o entretenimento fornecido por tal meio faz com que seus usuários passem horas em frente das telas de celulares e computadores, especialmente, as pessoas que buscam um ''refúgio'' nos meios digitais. Desse modo, auxiliando com o isolamento social que, por sua vez, causa danos à saúde mental, como possíveis casos de ansiedade e depressão."", ""Ademais, é fulcral pontuar que os impactos das redes sociais sobre os adolescentes derivam da baixa atuação familiar. Segundo o filósofo chinês Confúcio '' Não corrigir nossas falhas é o mesmo que cometer novos erros''. Sob tal ótica, é fato que isso não ocorre no Brasil, tendo em vista que as famílias apresentam uma não preocupação, no que concerne a criação de medidas de monitoramento sobre o que está sendo acessado pelos adolescentes. Por conseguinte, milhares de jovens acabam prejudicando-se com o uso inadequado de tal meio, a exemplo o jogo da ''Baleia azul'', um jogo composto por 50 desafios, na qual o último é o suicídio. Tudo isso retarda a resolução do empecilho, já que a negligência familiar contribui para a perpetuação desse quadro deletério."", 'Portanto, diante do problema exposto, faz-se importante a criação de uma medida para conter o avanço dos impactos das redes sociais na saúde mental dos brasileiros. Por isso, a fim de solucionar o uso excessivo das redes sociais e a negligência familiar, é preciso que o Estado, no papel do Ministério da Educação e da Saúde, crie projetos , em parceria com psicólogos e escolas. Essa ação deverá ser realiza através de palestras para alunos e pais, com o intuito de alertar sobre os riscos das redes sociais na saúde mental, e pela disponibilização de psicólogos nos postos de saúde e nas escolas para as pessoas que estejam com algum dano psicológico. Destarte, as redes sociais não serão mais uma impacto negativo na saúde metal dos brasileiros e se aproximará da sociedade perfeita de More.']",160,160,120,200,160,800
5,Pesticida,"['No mundo de hoje a nossa agricultura está bem avançada. Com a produção aumentado as pragas e outros insetos também. poriso , eles começaram a usar agrotóxicos q previne e mata que previnem e matam as pragas. mais Mas, a cada dia que passa passa, as pessoas estão querendo evoluir. e acaba E acabam aumentado as substâncias e produto produtos, para q que os alimentos cresça cresçam mais rápido e q e as frutas fica fiquem mais bonita bonitas, para eles está colhendo colherem o mais rápido possível para por pôr no mercado. Mais Mas eles esquece q isso n só tá esquecem que isso não só está matando as pragas e inseto e sim insetos, mas também os seres humanos. Esta Está cada dia acabando com a nossa saúde. Temos de ficar mais atento atentos com isso. A palavra para pesticida é agrotóxico.']",0,0,0,0,0,0
95,A luta indígena contra o Marco Temporal,"['Na quarta-feira dia 1 de setembro, o Supremo Tribunal Federal (STF) irá retomar o julgamento sobre a tese do ""marco temporal"". A tese diz que indígenas só poderiam revindicar terras já ocupadas no dia 5 de se outubro de 1988, época da promulgação da Constituição. Porém a tese não se encontra de acordo com o artigo 231 da Constituição que não fala nada de datas, e a respeito das terras diz que é reconhecido aos índios os direitos originários sobre as terras que tradicionalmente ocupam. O marco temporal representa uma ameaça sobre os direitos indígenas em áreas que estão em processo de demarcação.', 'Uma vez que é posto em prática a tese do ""marco temporal"", os indígenas temem perder direitos sobre áreas que ainda estão em porcesso de demarcação,pois a tese ignora a situação de povos']",160,80,40,80,0,360
87,Um dever dos adultos com as crianças,"['A erotização de mulheres é muito comum, o que é um grave problema no mundo, mas um problema ainda mais grave quando essa erotização começa na infância e adolescência, de acordo com o Psicanalista Freud é onde se é desenvolvido o caráter, afeições e construções psicológicas para um adulto emocionalmente e psicologicamente saudável.', 'No livro Lolita de Vladimir Nabokov, é nos apresentado um homem que está interessado em uma menina de 12 anos de idade, onde ele relata os desejos e paixões pela jovem, a crítica da obra para algumas pessoas seria muito simples, considerar a paixão de um adulto por uma criança é errado e crime, porém surgem outras interpretações da obra.', 'Esse fato nos faz refletir em como a criança sofre objetificação, e a forma como o narrador descreve-a traz essa erotização do corpo infantil, o livro apesar de ser de 1955 é muito atual, pois, ainda hoje é possível acessar em redes sociais, posts feitos em sua maioria por homens, comentando em fotos com tom sexual, pejorativo e em alguns casos acediosos de meninas muitas vezes menores de idade, o que contribui para essa cultura de erotização do corpo infantil.', 'Contudo, alguns meios podem ser tomados para a diminuição desses casos, como o acesso à internet controlado por pais de menores de idades, controle maior de redes sociais para menores, mas acima de tudo uma maior fiscalização e denúncia dessas pessoas que comentam e incentivam crianças e adolescentes a postarem fotos de biquíni, em poses sexualizadas, entre outras.', 'Deste modo, com a conscientização e colaboração de pais e responsáveis  e a maior fiscalização e punição de adultos com esse comportamento, é possível criar um ambiente seguro para as crianças e adolescentes na internet, diminuindo assim a cultura da erotização infantil.']",160,120,120,160,120,680
95,JXP - As guerras do marco temporal,"['O Humanitismo, filosofia adotada por Quincas Borba, personagem fictício de Machado de Assis, tem a ideia de que só é possível se chegar a paz por meio de guerras. Segundo a concepção do protagonista, é necessário combater a problemática, uma vez que todos deveriam estar em “guerra” contra os óbices do debate sobre o marco temporal, mas o imbróglio permanece por causa do não combate ao falho poder estatal e a ineficiência do sistema educacional.', 'Primeiramente, é notório que as autoridades não tratam o marco temporal como deveriam. Conforme o filósofo Nicolau Maquiavel, na sua obra “O Príncipe”, mesmo as melhores leis são frívolas diante dos costumes gananciosos. Isso é provado pelo não cumprimento do artigo 3° da Constituição federal, que garante moradia a todos, principalmente nativos indígenas. Tais eventos são visíveis seja pela insuficiência de campanhas públicas, seja pelo pouco espaço destinado ao tema em discussões políticas. Logo, percebe-se que nem mesmo o poder jurídico é capaz de garantir os direitos à população.', 'Ademais, é necessário entender que o sistema educacional é outro contribuinte para a continuidade da disputa de terras. No livro “Adeus professor, Adeus professora?”, do escritor José Carlos Libâneo, o autor destaca a importância das escolas buscarem o estímulo discente não só para o conhecimento técnico-científico, mas também para habilidades socioculturais, como o direito de moradia e preservação de territórios . Perante o exposto, pode-se ver que muitas instituições de ensino brasileiras são conteudistas, e pouco ajudam ou quase nada no combate às barreiras do marco temporal e, por conseguinte não formam cidadãos com autonomia e profissionalismo como Libâneo idealiza.', 'Portanto, urge-se medidas para acabar com a contenda em relação aos espaços indígenas. Para tanto, deve o Ministério Público garantir a ordem judiciária à defesa dos interesses sociais e individuais indisponíveis, como é garantido de acordo com o artigo 127 da “Carta Magna”, cobrar do Estado a parceria com plataformas midiáticas, nas quais propagandas de apelo emocional, por meio de depoimento de vítimas da pera de território nativo, deverão buscar a conscientização acerca da sua vivenda. Além disso, é essencial evoluir o complexo pedagógico, baseando-se no fomento à preservação de florestas e matas, mediante palestras e debates sobre temas socioculturais. Assim, as guerras do Humanitismo serão efetivas e farão uma sociedade unida.']",160,160,120,200,160,800
58,A Importância da Amazônia,"['A Floresta Amazônica é um ambiente muito importante para o Brasil, tem enorme variedade animal,vegetal e cultural, por esse fator é importante proteger tal patrimnio natural.', 'O filme de animação `` Rio 2``.  retrata, a beleza e o desmatamento da amazônia, duas ararazinhas-azuis que foram procurar seus donos na floresta e acabam se encantando com o lugar, porém mostra lugares que foram desmatados. desmatamento pode ser através das queimadas ou arvores cortadas.', 'Segundo a geógrafa e diretora de ciência do IPAM , Ane Alencar, o aumento de incêndios deste ano não esta relacionado a periodos de seca mais intensos, os apoios de ONG´s , fiscalização de queimadas e os ensinamentos nas escolas, contribuem para a preservação.', 'É importante a preservação da floresta amazônica para que ela não seja extinta, não perca inúmeros recursos, como a biodiversidade, pesquisas de medicamentos e os inúmeros recursos ainda não descobertos.']",120,80,80,120,40,440
45,Abuso de autoridade-_,"['O abuso de autoridade está fortemente presente na sociedade atual, tendo em maior quantidade ou menor, tal ato é repudiado pela grande parte da população, mas assustadoramente é aceito e cometido por exceções, que passam impunes sem punições, o que não ocorre com a vitima, pois esta recebe não só agressões verbais que podem danificar seu perfil profissional por meio da hierarquia da empresa ou instituição, mas também problemas psicológicos que irão agravar em sequelas futuras. Para entender esse crime é necessário compreender como ele ganhou forças e onde está o seu meio de maior propagação.', 'Primeiro, é certo dizer que com o avanço do capitalismo a obtenção de lucros e a busca pelo dinheiro se tornou algo comum no dia a dia das pessoas, pequenas e grandes empresas se ergueram junto com a criação de cargos e serviços. Infelizmente  junto com tal crescimento econômico, tais lucros e ganhos monetários tiveram um significado maléfico nas camadas mais pobres da sociedade onde o abuso é claramente mais usado, em empresas com funcionários em cargos mais baixos, ou até mesmo fora do ambiente profissional . O status social é atualmente relacionado ao quanto essa pessoa é bem sucedida monetariamente, sendo assim usam e abusam deste status para humilhar e comandar aqueles inferiores a ela. Uma frase que explica este abuso é a de Maquiavel: ""Dê poder ao homem, e descobrirá quem ele realmente é"".', 'Segundo, é necessário afirmar que muitas ocorrências não tem suas devidas medidas administrativas, como ocorreu com o caso do desembargador, onde, de acordo com o site ""UOL"" mesmo com o afastamento do desembargador feito pelo conselho nacional de justiça o mesmo continuará recebendo o salário do cargo. Diferente mas similar com este caso, ocorreu também nos E.U.A onde um policial matou um negro em uma abordagem asfixiando-se nos joelhos. policial foi afastado e responderá judicialmente pelo seu ato, assim um movimento aconteceu em protesto a atitude do policial, chamado de ""Black lives matter"".', 'Em finalização, é importante uma conscientização por meio de protestos e campanhas contra o abuso de autoridade, com histórias de acontecimentos das vitimas e a exposição dos criminosos ao meio público, em outra parte, é correto a punição por meio de órgãos judiciais e empresariais a indenizar, afastar e até em casos mais graves a prisão aos agressores, por meio da constituição federal, amenizando ou obliterando totalmente as ocorrências do ato.']",120,160,120,160,120,680
57,Uma questão de cultura,"['Em um país onde todos tem o acesso as sessões de cinemas, a população é mais informada e possui um âmbito cultural grandioso, contribuição para o acesso de globalização e também na interação uma com as outras . Entretanto, a atual situação do Brasil, consiste na seleção de regiões com maior desenvolvimento para as construções de cinemas. Deste modo a democratização do acesso ao cinema no brasileira  não tem o acesso por falta de estrutura e pela privatização dos cinemas que contribui para a seleção dos habitantes destes locais.', 'Muitos destes locais estão em condições precárias, não atendendo a todas as necessidades exigidas pelos frequentadores, como por exemplo os deficientes, contribuindo para a diminuição destes . Por outro lado, lugares como na região norte e cidades do interior não possuem nem se quer o local propriamente dito, assim caso queiram assistir a um filme de lançamento precisam se deslocar para áreas privilegiadas, pelo fato de o local não ter verba suficiente para construir e manter essa estrutura.', 'Com a revolução industrial, aos poucos tudo vem ficando mais “fácil”, hoje é possível comprou um ingresso, para ver um filme, pelo celular, contudo, nem todos tem condição de ir ao cinema, já que hoje o cinema é privatizado cobrando preços altíssimos, para permanecer aproximadamente 3 horas assistindo um filme, como mais que a metade da população do Brasil é classe baixa, dados apontados pelo IBGE, o acesso a esse tipo de cultura é mais dificultoso e o jeito é esperar o filme diminuir sua popularidade e ser transmitido na “sessão da tarde”.', 'A democratização deste acesso tem de ser resolvido rapidamente, pois segundo a fala de Platão “só sei que nada sei” expressa ignorância e sede de conhecimento, pois ao assistir o filme Harry Potter sabendo que é fictício – ignorância – despertamos a curiosidade de saber o que acontece com os personagens durante a saga – sede de conhecimento- obtendo conhecimento cultural e novas formas de ver o mundo.', 'Por tanto para que o país possa obter esse conhecimento cultural é necessário implantar uma campanha que consiste em um cinema solidário, onde o governo com a parceria das prefeituras e das empresas cinematográficas, implante em todas as cidades brasileiras que não possuem cinemas, um cinema gratuito em um local publico e de fácil acesso para todos incluindo os deficientes onde por meio de arrecadações dos patrocinadores possam levar filmes em lançamento e de boa qualidade para regiões mais pobres do Brasil.']",120,80,80,80,80,440
85,As Iniciativas Populares.*,"['O Brasil é (um) dos países que adota o sistema democrático  representativo ou também conhecido como democracia indireta ou seja, a população elege seus representantes que decidam pelas grandes questões de interesse público no Brasil. No entanto nossa constituição prevê a participação direta da população no processo democrático. Ou seja, através de instrumentoss por lei.', 'Mesmo amparados por lei, ainda encontra-se problemas derivados da falta de estrutura do nosso sistema eleitoral. Dados disponibilizados pelo site: JusBrasil identificam que até hoje cerca de cinco propostas foram aprovadas por iniciativas populares, sendo que esses projetos para serem aprovados como lei, tiveram que ter um parlamentar a frente para ser aprovado como lei(.) é o caso da ficha limpa.   Que é um projeto de autoria popular na qual identificando o candidato com pendências na situação eleitoral não permite o mesmo se candidantar para qualquer cargo.', 'Segundo os parlamentares os projetos de iniciativa popular na sua totalidade não são aprovados pela falta de autenticidade das assinaturas, segundo eles não é possível autenticar todas as assinaturas.', 'A melhor solução seria investimentos em estrutura tecnólogica na implantação de sistemas de autenticidade de asssinaturas para que fossem de vez resolvidos (os) problemas de autenticação. Além do investimento nos tribunais regionais eleitorais de cada estado possibilitando a criação de um órgão responsável para que fossem atendidos todos os pedidos de iniciativa populares , além de consultas públicas sobre as iniciativas em andamento.']",120,120,160,200,200,800
2,Órgão Máximo,"['O Supremo Tribunal Federal (STF) encontra-se no topo da hierarquia do poder judiciário Poder Judiciário e, nesse sentido, ele pode ser entendido como a lei máxima do país, ou seja, é o grande guardião da constituição Constituição federal. Nesse contexto, é indubitável que as decisões tomadas pelo STF envolvem a população brasileira. Sendo assim, a opinião pública e a maior instância do poder judiciário são estão diretamente ligadas.', 'Primeiramente, é importante ressaltar que que, nos últimos anos anos, a Suprema Corte teve protagonismo no cenário político brasileiro. A intensa divulgação das atividades do Supremo pela mídia tradicional e pelas redes sociais fizeram com que as decisões tomadas pelo por esse Tribunal ganhassem audiência global. Ademais, a cúpula do poder judiciário Poder Judiciário brasileiro tomou medidas que não envolvem questões processuais baseadas na lei (fato que gera impunidade).', 'Em uma segunda análise, constata-se que a maioria da população - segundo pesquisa Datafolha - não aprova o trabalho do STF. Essa situação se configura porque o público está mais atento às decisões tomadas pelo Supremo. Pois muitas das vezes Supremo, que, muitas vezes, parecem julgamentos de advogados de corruptos ""graúdos"" e não de ministros cuja função é preservar a constituição Constituição.', 'É evidente, portanto, que é necessário e incontestável a ação da Suprema Corte. Porém, com o intuito de ter aceitação geral da nação e defender a carta magna Carta Magna, é fundamental rever como estão sendo feitas as definições nomeações dos ministros. Outrossim Outrossim, é importante verificar os erros cometidos para que os mesmos não sejam repetidos.']",120,120,120,120,120,600
1,O emprego do futuro,"['Atualmente, o desemprego atinge grande parte da população, principalmente os jovens, que não possuem a qualificação exigida pelo mercado de trabalho. Com o avanço da tecnologia, a maioria das tarefas são executadas por equipamentos eletrônicos. Assim, os postos de trabalho estão sendo substituídos por máquinas.', 'As vagas disponíveis exigem qualificação profissional altíssima, qualificação que na maioria das vezes o jovem que acabou de sair do ensino médio não possui. Seja pela falta de oportunidade, seja pela falta de condições financeiras.', 'Não obstante, em um mundo onde as mudanças estão cada vez mais rápidas, é essencial que a sociedade crie e aceite as novas dinâmicas de trabalho e fomente o desenvolvimento de outras habilidades.', 'Um exemplo dessa nova dinâmica de trabalho são os motoristas e entregadores de aplicativo que vem vêm ganhando cada vez mais adeptos e mais força.', 'Assim, para seguir e manter a empregabilidade é necessário que as empresas em conjunto com a sociedade e o Estado quebrem paradigmas e ampliem opções de trabalho, desenvolvendo novas competências e habilidades.', 'Nesse sentido, é necessário haver um incentivo por parte tanto do Estado quanto das grandes empresas em ensino, educação de jovens e adultos, desenvolvimento de habilidades, competências, modernização dos postos de trabalho, modernização das legislações trabalhistas a fim de que as vagas de emprego do futuro sejam preenchidas e o desemprego cai caia significativamente.']",120,80,80,160,80,520
138,"Responsabilidade, caráter e coragem","['""Coragem é resistência ao medo, domínio do medo, e não ausência do medo”, essa frase de Mark Twain define o termo coragem muitíssimo bem, mas não podemos esquecer que a covardia é um dos sentimentos que estão presentes na vida de cada ser humano, seja nas atitudes, nos relacionamentos, enfim na vida.', 'A negligência cometida pelo capitão Francesco Schettino,                do Costa Concórdia, é uma amostra recente de covardia, do                 medo                de assumir o seu próprio erro,                 medo                de ser criticado,                 medo                da culpa. Na nossa sociedade atual,         o                   medo                  está presente em tudo, perder         a estabilidade num emprego ou num relacionamento,         sempre está fora de questão e         muitas pessoas se utilizam de atos covardes para não colocarem em risco o que consideram importante.', 'Num mundo como o nosso, o caráter deveria ser contado como questão principal.                A coragem não                 é                muito incentivada na nossa sociedade e a covardia                 é                um ato que não                 é                punido.                 É                muito mais         fácil,         colocar a culpa em alguém, desistir de uma coisa mais difícil, fugir de decisões e verdades do que assumi-las.', 'A coragem também está contida em pequenos atos, não somente em         se tornar herói por ter arriscado         a vida para salvar algo ou alguém, mas também evitando mentiras do dia a dia, agindo com responsabilidade e comprometimento,         é ter         maturidade e senso critico.         Não         é enfrentar os problemas de qualquer jeito, mas avaliar os riscos         e         ser ousado e fazer o novo.', 'Portanto só nos resta esperar que a sociedade tenha mais coragem nas suas atitudes,                que construa pessoas com caráter, que assumam seus erros e não fujam de suas responsabilidades.                 Um mundo onde a verdade seja valorizada, onde soluções ousadas apareçam no lugar de grandes problemas.']",160,160,120,120,120,680
88,12080,"['Black mirror, uma série britânica, na qual no episódio “Black museum” retrata o esgotamento mental em personagens submetidos a situações complexas até mentes armazenadas em artefatos lúdicos, criando esse cenário reflexivo de como essa caixinha reúne todos os aspectos e formações da individualidade de alguém. Apesar desse viés, a saúde mental ainda não é prezada como deveria, um tema recebido como “frescura” para muitos, porém é um tópico que frequentemente deixa cicatrizes na sociedade.', 'Convém ressaltar a gravidade do problema, tendo em vista os conflitos causados: afastamento de trabalhadores dos seus respectivos cargos, a elevação da taxa de mortalidade por suicídio, a maneira que interfere no bem-estar do indivíduo, entre outros casos. Por conseguinte, na teoria da modernidade liquida, de Bauman, na qual faz referência a uma sociedade sem forma, instável; ao contrário da realidade passada, vista como “sólida”, essa evolução seria um dos estopins para o aumento da suscetividade ao adoecimento mental.', 'Sobretudo, além do empecilho da invalidade do assunto por muitos, a preocupação dessa enfermidade, só foi aclamada após a teoria “multicausal”, na qual considerou que o estilo de vida, fatores comportamentais e individuais influenciavam no aparecimento de doenças, evidenciando o tratamento tardio dos diagnosticados. Além disso, a existência de bolhas sociais de uma vida perfeita, como a idealização de correntes positivas, pode provocar a ignorância na presença de distúrbios mentais, algumas até originadas por um motivo anômico.', 'Logo, o ministério da saúde e canais televisivos de grande apego , devem coexistir nessa área, no sistema unico de saúde, o cumprimento de profissionais presentes é essencial, como também a ampliação de clinicas voltadas a essas atividades;  enquanto as grandes emissoras poderão exibir comercias e programas que evidenciam a face real do problema. Ações com a finalidade de criar um ambiente com âmbito para receber e acolher os atingidos, como diria Sêneca: “É parte da cura o desejo de ser curado”.']",160,160,120,200,160,800
45,O AUTORITARISMO AINDA PERSISTE,"['A Ditadura Militar no Brasil, em 1964, foi um período autoritário que se propagou diversos discursos hegemônicos e estabeleceu ações de coerção, tais como censura, restrição de direitos políticos e perseguição aos opositores do regime. Análogo a isso, nota-se que mesmo depois de anos o abuso de autoridade ainda persiste na sociedade brasileira, visto que a negligência governamental e a omissão social contribuem para esse cenário nefasto. Assim, entende-se uma anomia no meio social, o que pressupõe uma discussão acerca da problemática.', 'Em primeira análise, é evidente que a passividade pública contribui para a consolidação do problema abordado. Conforme John Locke, filósofo iluminista, esse fato configura uma quebra no contrato social, pois ao revogar o “Estado de Natureza”- momento em que o homem não é obrigado a seguir leis- com o objetivo de ser governado pelo Estado, os cidadãos esperam que esse amenize as mazelas e promova a igualdade de todos, porém não acontece no Brasil. Nesse sentido, o contrato é constantemente quebrado devido a falta de políticas públicas que promovam uma maior fiscalização dessas práticas e realizem o exercício de cidadania, pois como autoridade máxima do país, o governo deve zelar pela integridade física e moral das pessoas bem como assegurar-lhes os direitos elencados na Magna Carta. Dessa forma, é inegável que essa conjuntura tende a intensificação desses efeitos, já que o governo não age em prol da resolução dela.', 'Ademais, outra causa responsável pela deficiência desse panorama é o individualismo propagado pela coletividade. Segundo Michel Focault, filósofo francês, o poder articula-se em uma linguagem que cria mecanismos de controle, os quais aumentam a subordinação. Sob esse viés, os indivíduos quando prezam por seus interesses particulares em detrimento dos coletivos, através de um sentimento de superioridade realizam atos que rompem com os preceitos éticos que norteiam o convívio social harmônio, uma vez que exercem uma autoridade no outro para se beneficiar. Desse modo, a violação desses atos torna-se nocivo para o corpo social, o qual configura uma situação preocupante que deve ser revertida.', 'Depreende-se, portanto, que medidas são necessárias para mitigar e superar o impasse. Urge que o Poder Judiciário, junto ao Executivo, por meio de verbas governamentais, criem um programa de fiscalização em todos os estados brasileiros, que contenha profissionais para exercer ações através das redes sociais e também por um disque denúncia, a fim de combater qualquer tipo de abuso de autoridade. Além disso, devem produzir campanhas socioeducativas veiculadas nos meios midiáticos, que mostrem como esses atos são praticados, com o fito de disseminar conhecimento sobre esse assunto e evitar que ainda continue acontecendo. Espera-se, com isso, que o evento de 1964 seja visto somente como memória e no presente esse marco não volte mais a acontecer.']",160,200,160,200,200,920
84,Porte de armas,"['Em ""O Contrato Social"", Russeau disserta sobre o acordo entre o cidadão e o Estado pela renúncia de direitos pelo bem comum, que inclui a segurança de todos. Porém, quando aquele é falho nesse sentido, faz-se necessário que a população tenha condições de preservá-la e isso inclui o porte de armas. Contudo, isso deve ser feito com cautela.', 'O artigo 144 da Constituição Federal cita que a segurança pública é dever do Estado e direito de todos; porém, na prática, não é bem assim. O Brasil é um dos países mais perigosos do mundo. Segundo o Relatório Global de Homicídios do mundo, foram cometidos no país 11% dos homicídios do mundo e o Brasil ocupa o 7º lugar no ranking dos países com o maior número de assassinatos.', 'Nessas condições, o porte de armas serviria para assegurar o direito à legítima defesa contra ataques ao patrimônio como invasão de domicílio e à própria vida do cidadão e de seus familiares, pois são ataques que ocorrem frequentemente e deixam o indivíduo a mercê de criminosos.', 'Portanto, para atender essa necessidade, é preciso que se tomem medidas rígidas no acesso ao porte de armas para se evitar possíveis tragédias, como o que consta no Projeto de Lei 3772/2012, que inclui comprovação de aptidão mental e participação do candidato ao porte de curso de capacitação para técnica no manuseio das armas, algo que concederia ao cidadão o direito de se defender em segurança. Entretanto, a longo prazo, é preciso que o Estado cumpra com sua obrigação de oferecer segurança ampla e de qualidade, por meio do aumento da frota de policiais nas ruas e o pagamento de salários dignos a eles, para que se melhore a qualidade do serviço. Pois somente com esse direito atendido, o Brasil será, de fato um, país de todos.']",160,200,200,200,160,920
89,,"['A pandemia da gripe espanhola no século XX,obrigou a população mundial a manter o isolamento social,os números de mortes poderiam ser piores,haja vista que a quarentena foi um dos fatores determinantes na redução dos óbitos. Nos tempos hodiernos,a pandemia de -19 está colocando a população confinada em seus lares,mas a população enfrenta resistências devido a crise econômica. Nessa problemática,vários fatores contribuem para essa falta de consciência da população acerca do isolamento social em meio a crise econômica como não acreditar que a pandemia é verdadeira defendida por grupos como os anti-vacinas e a necessidade da população de manter uma fonte de renda,visto que o Brasil é subdesenvolvido.', 'Em primeiro plano,muitas outras doenças como a dengue e gripe foram plano de fundo para descrenças para diversos grupos,essas pessoas que não são poucas não respeitam o isolamento social e não usam máscaras .Os brasileiros sempre foram um povo de difícil obediência,mas as punições para quem desrespeita a quarentena ainda é nula. Corroborando com essa tese está as superlotações das praias de Copacana no Rio de Janeiro.', 'Outrossim,em 2019 o Brasil vivia um ""boom""econômico com elevado grau de crescimento do PIB(Produto Interno Bruto).Em 2020 houve uma terrivel queda na economia,apartir de março devido ao começo do isolamento. O Brasil se situa entre os países com maiores números de mortos,no entanto a população ainda insiste em dar importância a economia,mas apenas as famílias que perderam um membro para a doença sabem da importância da quarentena, a falta de campanhas mais incisivas nos meios de comunicação,colaboram com essa visão materialista.', 'Em virtude do exposto,cabe ao governo federal,instância máxima de poder encarregada de tomar decisões públicas, por meio do Poder Legislativo,responsável por criar e votar leis,endurecer as penas para quem desobedecer o isolamento com multas e em casos de reincidência a prisão ou pagamento de ajuda a comunidade como doação de alimentos famílias carentes,com o fito de aumentar o temor da população quanto a quebra do isolamento. Ademais Ademais,o governo federal e estaduais, podem através das diversas mídias, criar campanhas mais incisivas com relatos de famílias que perderam parentes,com o efeito de uma consciência emocional nas pessoas,só assim a pandemia de COVID-19,assim como a da gripe espanhola será vencida o mais rápido possivel.']",160,200,160,200,200,920
60,Reforma da Previdência,"['Tal como a maior parte dos países desenvolvidos, o Brasil passou a encarar na última década um novo desafio, conhecido como “transição demográfica”. É o que acontece quando a expectativa de vida de uma nação passa a ser maior que a taxa de natalidade anual, ocasionando assim um gradiente envelhecimento da população que, apesar de ser vantajoso individualmente, acarreta uma significativa mudança estrutural no Estado.', 'Foi com base nessas mudanças que o atual governo propôs em abril do ano passado a “Reforma da Previdência Social” que após algumas reformulações determinou um tempo de contribuição de 40 anos, com idade mínima para se aposentar de 62 para as mulheres e 65 para os homens. Esses números, no entanto, mesmo com a crise político-econômica que o país vem encarando, podem ser radicais se for levado em consideração diversos fatores que tornam incomparável a situação do Brasil com os demais países desenvolvidos que já enfrentam tal problemática. Um deles é a qualidade de vida. Em boa parte da Europa a saúde e a educação pública são de qualidade, algo que o Brasil deixa a desejar. A Noruega, por exemplo, de acordo com a ONU , em 2015  apresentava um IDH (Índice de Desenvolvimento Humano) de 0,949, enquanto que o Brasil se mantinha com 0,754, mas caía o indicador para 0,561 devido as desigualdades sociais. Ou seja, a média da longevidade nacional hoje pode ser de 72,5 anos, porém, em alguns estados esse índice não chega a alcançar 65 anos.', 'Além disso, é preciso preservar a equidade. Ainda que o feminismo pregue a igualdade de gêneros isso não se reflete igualando o tempo de contribuição de homens e mulheres (tal como foi proposto no texto original) . Isso porque o Brasil ainda é consequência direta de uma sociedade patriarcal, que se reflete em mulheres com dupla jornada de trabalho, por ainda serem majoritariamente as responsáveis pelo “cuidado da casa e da família”.', 'Dessa forma, é necessário que uma mudança deste teor seja planejada com cuidado. Ainda que o futuro do país clame por uma reforma da previdência  essa não pode acontecer antes de uma reforma da política, da saúde e da educação. É preciso se atentar as pequenas e grandes corrupções,  antes de condenar a vida dos menos favorecidos. O Estado precisa atuar no presente de forma sábia e justa, ao invés de usar em primeira circunstância, a válvula designada para o último caso.']",120,120,80,120,80,520
105,Até onde vai a liberdade.,"['As biografias não autorizadas são, sem dúvida, uma “pedra no sapato” de diversas personalidades brasileiras, pois diversas vezes acabam divulgando para o público fatos que o biografado não estava com a intenção de revelar. Ou pior, não raro as informações passadas ao leitor são irreais, mas passam a ser encaradas como “verdades absolutas” por fãs e pela mídia.', 'Tais situações ocorrem principalmente porque muitos biógrafos mal preparados e sedentos por informações “bombásticas” acabam consultando fontes não confiáveis. Muitas vezes chegam ao absurdo de basearem-se em informações da imprensa, que costuma impor o sensacionalismo acima da informação. Em biografias autorizadas isso não ocorre, pelo fato de a fonte da informação ser a própria personalidade. Quando não, parentes e amigos próximos, que poderão passar informações mais fiéis à realidade.', 'Muitos artistas consagrados na música popular brasileira como Erasmo Carlos, Gilberto Gil e Caetano Veloso foram duramente criticados por serem contra a publicação de biografias não autorizadas, sendo que, na época da ditadura militar foram ativos na luta a favor da liberdade de expressão. Tais críticas não devem ser levadas em conta, pois o direito implícito a cada cidadão de se         expressar acaba         a partir do momento em que este fere a integridade moral de outro cidadão.', 'As biografias sem autorização desrespeitam o direito à privacidade.         Pois         apesar de serem “pessoas públicas”(como são conhecidas pela maioria da população), os artistas são, acima de tudo, cidadãos brasileiros, e desse modo estão sujeitos aos mesmos direitos e deveres de todos.', 'Uma alternativa que pode ser adotada para tentar resolver essa situação é a publicação de biografias não autorizadas contendo uma nota esclarecendo que, por se tratar de uma obra não autorizada, não deverá ser levado em conta tudo o que será lido na mesma . Assim, os biógrafos sem autorização não sairão completamente prejudicados e os direitos dos artistas serão respeitados.']",200,160,160,200,200,920
88,,"['Na telenovela: ""Haja Coração"", a personagem Tamara interpretada pela atriz Cleo Pires foi diagnosticada com transtorno bipolar  sendo que foi necessário a utilização de medicamentos e sessões para tratamento do problema,porém devido a isso ela acaba sendo alvo de preconceito por parte dos familiares e por parte de outras pessoas. Fora da ficção, essa é uma realidade brasileira vivida pela população que sofre com algum tipo de transtorno mental. Logo,as adversidades acerca do problema ainda persistem seja pela deficiência lacunar seja pela insuficiência legislativa.', 'Em primeira análise, convém ressaltar que o primeiro fator que contribui para que essa adversidade ainda persista na sociedade brasileira é a base educacional deficitária. Em conformidade com o filósofo alemão Immanuel Kant diz que  o ser humano é resultado do que a educação faz dele. Sob esse viés, nota-se que a educação forma o indivíduo como um ser pensante e critico e quando o ser apresenta essa carência influencia na sua visão de mundo implicando muitas vezes a não enxergar aspectos que os afetam. Assim,é notório que a educação é um elemento essencial na vida de todo e qualquer ser.', 'Além disso, o segundo fator contribuinte para que as pessoas com transtornos mentais sofram é a ineficiência legislativa. De acordo com o filósofo inglês John Locke as leis foram criadas com o intuito de ajudar população e não para funcionarem somente no papel. Paralelamente a isso que foi dito observa-se que apesar das leis terem sido formuladas para promover o bem-estar do povo ela só funciona no papel,uma vez que nota-se que as pessoas que tem algum tipo de transtorno sofre diariamente preconceito seja no ambiente de trabalho, em casa, na escola, etc. Assim sendo ,é necessário que sejam tomadas medidas,pois senão o problema ainda persistirá por muito tempo.', 'Portanto, faz-se necessário que o Ministério da Justiça, órgão responsável por promover a garantia dos direitos constitucionais, crie uma lei através de uma medida provisória que obriguem as escolas a discutirem de uma a duas vezes na semana sobre os problemas relacionados a saúde mental a fim de levar informações aos estudantes que muitas vezes desconhecem sobre o assunto. A partir dessa iniciativa o Brasil se tornara um pais melhor de viver.']",160,200,160,200,160,880
54,,"['Atualmente com a popularização dos movimentos anti-vacinas pelas mídias virtuais tem-se uma “versão moderna” da revolta das vacinas ocorrida no Rio De janeiro em 1904, onde a população questiona este método de controle de doenças e se recusa a fazer parte disto . Este movimento já vem trazendo riscos ao bemestar da população como a volta de doenças que a alguns anos já eram consideradas erradicadas, como o sarampo.', 'O principal ponto em análise é uma falta de informação da população em relação à saúde publica. Ainda utilizando como exemplo o sarampo, uma parte considerável do povo desconhece a doença em prol da vacinação que já ocorreu e , portanto não vê razão para a prevenção nas futuras gerações, entretanto com o sistema imunológico sem a preparação provinda da vacinação o corpo se torna propenso a contração.', 'Ainda vale salientar  a hesitação dos indivíduos quanto aos efeitos adversos das vacinas, sem o conhecimento em relação a estes e sem fontes seguras para buscar informações acabam por optar o risco acreditando ser o mais seguro a se fazer.', 'Portanto, cabe as gestões governamentais a capacitação de profissionais que possam instruir os cidadãos e uma melhora considerável na cobertura de saúde do país, buscando o bemestar do povo . Em complemento a busca da conscientização ainda se pode intensificar as campanhas de vacinação e prevenção de doenças trazendo uma informação que se faz de extrema necessidade para a sociedade.']",120,160,120,120,80,600
83,Respeitar as diferenças para atingir a igualdade,"['No que se refere ao que podemos aprender com a prática do esporte, é possível afirmar que a prática esportiva promove a inclusão, bem como, a formação de valores e o próprio desenvolvimento humano. Isso se evidencia não apenas por possibilitar que qualquer segmento da sociedade possa praticar tal modalidade e tornar esta uma promoção para sua vida, mas também por ser um meio de mobilização de inclusão ao reunir pessoas de diferentes crenças, culturas e etnias.', 'Atletas como, a brasileira Rafaela Silva e, a estadunidense Simone Biles sofreram com o preconceito e tiveram dificuldades tanto financeiras quanto familiares, mas encontraram no esporte uma motivação para continuar tentando e servirem de inspiração para tantas outras pessoas que passam por dificuldades semelhantes. Evidenciando a importância do esporte na formação da autoestima, da superação de problemas, e também como um instrumento de reabilitação dos jovens e adolescentes que através dele saem das ruas e se tornam pessoas melhores.', 'Além disso, o esporte é uma ferramenta de cooperação, socialização, de formação de respeito ao próximo, enfocando a construção da cultura de paz e o combate à discriminação de gênero. As olimpíadas mostram essa ideologia, onde reúnem pessoas com diferentes culturas, crenças, origens etno-raciaisem ideia primária de unir todas as nações do mundo por meio dos esportes, e dessa forma promover a união dos povos. Assegurando o ato constitutivo da UNESCO (1945) que diz, “se a guerra nasce na mente dos homens, é na mente dos homens que devem ser construídas as defesas da paz”.', 'Desse modo, todas as nações devem amplamente continuar e aprimorar o investimento na educação, tendo como enfoque a promoção do esporte. As instituições educativas devem promover modalidades esportivas que suscitem o convívio de socialização e respeito de seus integrantes. Para que enfim seja construída uma sociedade mundial que repeite as diferenças para atingir uma igualdade.']",120,160,160,160,200,800
86,REDAÇÃO,"['De acordo com a estimativa da Organização mundial de Saúde (OMS) em 2017, o Brasil é o país que lidera o ranking mundial de transtornos mentais considerados como as ""doenças do século xxi"", tais como: depressão e ansiedade, em grande parte desses casos estão ligados ao uso excessivo das redes sociais.', 'Com a constante busca por inserção em padrão de beleza é imposto pela sociedade atual; a cultura do cancelamento  nas redes sociais;  a alienação de mostrar uma vida perfeita que é de fato inexistente, são fatores que mais influenciam no devido aumento de casos de transtornos mentais, visto que as pessoas buscam por encaixar em algo inalcançável.', 'Contudo, é extremamente perceptível o papel de influência que essas plataformas apresentam as crianças, adolescentes e adultos, ou seja, pessoas de todas as idades são afetadas, algo que é bem alarmante, já que cada vez mais os cidadãos estão imersos nesse mundo digital, de um certo modo que não conseguem libertar-se desse “vício”.', 'Como já disse o poeta Paulo Leminski: “Em mim, eu vejo o outro”. Dessa forma o Ministério de Educação deve implantar medidas empáticas, por meio de palestras em escolas e faculdades; campanhas publicitárias, que visam alertar sobre a melhor forma de uso das ferramentas digitais, com isso espera-se que o Brasil possa perder a liderança desse ranking.']",160,120,120,120,160,680
59,Fome no Brasil?,"['A questão da fome é algo que voltou a ser bastante discutido no Brasil , principalmente,  após a fala polêmica do presidente Jair Bolsonaro, que afirmou: “Passar fome no Brasil é uma grande mentira”. Essa frase foi considerada apática por muitos, além de ter revelado a falta de conhecimento do presidente em relação a situação no país. É preciso que se discutam maneiras de combater esse grave problema, além de fazer com que a população saiba da realidade.', 'Primeiramente, é preciso compreender que aproximadamente 5,2 milhões de pessoas passam fome no Brasil, de acordo com o relatório “O Estado da Segurança Alimentar e Nutrição no Mundo 2018”, da Organização das Nações Unidas para a Alimentação e a Agricultura (FAO). Esse número representa cerca de 2,5% da população brasileira e é considerado relativamente pequeno por algumas pessoas, mas só quem passa por seus sintomas, como cansaço, tontura e fraqueza, sabe da gravidade que é o problema da fome.', 'A fome e a negação sobre sua existência são o retrato da desinformação e da desigualdade social no Brasil;  enquanto a maioria das pessoas de classe média e alta não sabem do problema por não serem afetadas por ele, já que conseguem ter fácil acesso aos alimentos, muitas por serem pobres não possuem condições financeiras para comprar ou produzir alimentos, o que revela uma forte desigualdade e diferença na concentração de renda entre as classes sociais da sociedade brasileira.', 'Dessa forma, pode-se concluir que medidas como a criação e ampliação de restaurantes populares nos centros urbanos seja uma forma de facilitar a alimentação daqueles que não possuem acesso direto aos alimentos; além disso, a criação de empregos é fundamental para que muitos consigam ter acesso aos alimentos básicos. Por fim, a sociedade deve estar informada sobre a realidade no Brasil e isso deve ser feito através dos grandes veículos de comunicação (TV, jornal, rádio e internet), procurando atingir o maior número de pessoas possível, a fim de pressionarem os políticos para que essas medidas sejam efetivamente cumpridas.']",160,160,120,120,120,680
46,Brasil e as privatizações,"['Desde 1980, o Brasil iniciou lentamente a privatização de alguns serviços estatais e a partir de 1990 esta prática se intensificou, sendo as rodovias, telecomunicações e mineradoras exemplos desse processo. Do mesmo modo, atualmente, o país está estudando a possibilidade de privatizar o saneamento básico, já que este serviço é precário e prejudica uma grande parcela da população. Diante dessa perspectiva, a privatização se apresenta como um caminho para melhorar esse cenário, pois a insuficiência legislativa e a carência de investimento governamental contribu para a permanência do problema.', 'Em primeiro plano, a insuficiência legislativa caracteriza- se como um complexo dificultador para a questão no país. Conforme John Locke, filósofo e pensador ""as leis se fizeram para os homens e não para as leis"". Sob esta ótica, percebe-se que ao criar uma lei é preciso que ela seja planejada para melhorar a vida das pessoas em sua aplicação. Porém, a lei vigente que estabelece diretrizes para o saneamento básico teve menos da metade de sua meta prevista realizada, deixando parte da população sem esse serviço. Dessa forma, verifica-se a existência de entraves que dificultam a situação.', 'Além disso, a carência de investimentos do governo é outro fator que impossibilita a resolução da questão. Segundo a filósofa Hannah Arendt,"" a essência do direito humano é o direito a ter direitos"". Entretanto, no que concerne o cenário do saneamento básico, este direito não está sendo respeitado, uma vez que a falta de investimento financeiros do governo, impossibilita que uma parte da sociedade não tenha acesso ao tratamento de esgoto. De acordo com dados do Sistema Nacional de Informações sobre Saneamento (SNIS), 54% do esgoto não recebe um procedimento adequado, agravando a problemática. Assim, a privatização, se mostra como uma possibilidade, desde que esta faça investimentos para aumentar o percentual de tratamento de esgoto para 100%.', 'Portanto, a privatização do saneamento básico é necessária para o Brasil. Para isso, o Governo Federal deve fazer a transferência dos serviço de saneamento básico para uma empresa privada, por meio de um contrato de concessão, estabelecendo prazos para execução do esgoto não tratado, a fim de que mais pessoas tenham acesso a esse serviço. Nesta ação, seria pertinente que no contrato ficasse estabelecido o não encarecimento do preço já pago pela população. Somente assim, será possível melhorar as condições de vida da sociedade.']",160,200,160,200,160,880
98,Educação Alimentar,"['O Ministério da Saúde pede ajuda          a justiça          para que indústrias de alimento e refrigerantes tenham nas receitas de seus produtos, ingredientes mais saudáveis.                É                 verídico                que a alimentação saudável também seja influenciada em casa, pelos pais, e com limites, nunca proibindo.                 Na visão das “casas de delícias” a lei de propaganda de elevados índices de açúcar, sódio e gorduras, com advertência sobre os riscos a saúde em caso de consumo em excesso, só valerá se o Congresso aprovar a lei.', 'A obesidade infantil aumentou         em cinco         vezes mais nos últimos vinte anos, atingindo cinco milhões de crianças, hoje. Apesar de o governo querer mudar essa situação, a força de vontade de querer mudar deve partir do jovem. Mesmo que não deva proibir de comer algo gorduroso, os familiares devem por                limites         para que não fique abusivo e levar a doenças         .                 Os maiores problemas em relação a peso são: diabetes, doenças do coração, fraqueza, entre outros que vão aparecendo ao decorrer do tempo.', 'São necessárias campanhas alimentares,         onde traga         informações sobre         conseqüências         e o que se pode fazer para reverter esse processo. Além         de         crianças, os pais também devem estar presentes acompanhando e orientando os seus filhos. A         Obesidade         é um problema sério e o Brasil deve enfrentar essa doença que afeta o futuro da sociedade. Alimentar-se bem não é difícil. Use saladas, sucos de frutas e grelhados         ao         seu favor. Exercícios físicos são ótimos aliados se praticados diariamente com apoio de especialista.']",160,80,80,80,80,480
70,A desinformação sobre as DSTs,"['Doenças sexualmente transmissíveis, ou DST, são aquelas doenças transmitidas, principalmente, pelo contato sexual sem uso de camisinha com uma pessoa infectada. AIDS, sífilis, gonorreia são exemplos de doenças que devem ser tratadas com ênfase na sociedade, tendo em vista que seus números crescem dia após dia, e a desinformação dos jovens, é o fator preponderante para o aumento desses números. Assim sendo, é indubitável medidas provindas do Ministério da Saúde e do Ministério da Educação para combater o aumento das DSTs entre os jovens brasileiros.', 'Segundo pesquisa divulgada em 2013 pelo PCAP (Pesquisa de Conhecimento, Atitudes e Práticas na população), seis em cada dez jovens entre 15 e 24 anos fez sexo sem preservativo no último ano, sendo que 43,4% não se protegeu durante o sexo casual, ou seja,teve relações sexuais com parceiro não fixo. Diante disso, é visível o nível desinformação da população jovem, pois se envolvem com alguém momentaneamente, e de maneira inconsequente . Uma medida viável é esclarecer aos jovens que o uso da camisinha vai muito além da prevenção à gravidez indesejada, o uso da mesma é prevenção de doenças posteriores, doenças até mesmo sem cura, como é o caso da Aids.', 'Todavia, cabe frisar, que somente aconselhar, dizer que o uso da camisinha é importante, não é o bastante, é necessário o contato com pessoas que convivem com tais doenças, para que possam entender que as DSTs são tão devastadora como qualquer outras enfermidades. Prova dessa distração com esse assunto é o fato que ainda hoje aproximadamente 75% dos jovens não fizeram teste de HIV. Sendo assim, certamente, há um grande número de portadores sem o devido conhecimento da doença, o que reforça ainda mais a importância da informação.', 'Levando em consideração os fatos expostos, é necessário que o Ministério da Educação, proponha debates com psicólogos que possam discutir a respeito desse impasse para a saúde brasileira, afim de alertar aos jovens que a prevenção é importante, que a Aids não tem cura, e que essas doenças não estão distante da realidade como eles pensam. Nessa mesma perspectiva, é importante que o Ministério da Saúde,  intensifique o número de campanhas de prevenção, por meio dos meios de comunicação, afim de tornar o assunto comum aos jovens. Só assim, com essa parceria governamental  funcionará os esforços para o combate das DSTs entre os jovens.']",120,160,120,160,160,720
71,,"['Segundo os pensadores Goethe, Kant, Sartre e Russeau o suicídio tem definições que se alternam, se complementam e que se contradizem. Esse cenário faz com que familiares, amigos e órgãos do governo tomem medidas eficientes para que os jovens possam confiar e ter alguém para pedir ajuda nesses momentos de angustia.', 'De fato, os jovens que estão passando por um período difícil não encontra um amigo para lhe socorrer e não encontram um grupo de ajuda que é oferecido pelo governo, então eles não conseguem segurar esse momento sozinho e quando ver já estão cometendo um erro, eles estão recorrendo ao suicídio . Isso acontece quando os jovens não tem o apoio da família, não se relacionam muito bem com as pessoas e não tem um bom diálogo para se expressar e mostrar o seu ponto de vista referente as coisas que estão acontecendo no mundo e ao seu redor.', 'Outrossim, a população brasileira está cada vez menos preocupada em ajudar uns aos outros e não procuram textos que motivam ou até mesmo vídeos que possam ajudar alguém a sair da tristeza, não chamam para conversar ou sair,  para que a pessoa se distraia um pouco e se sinta mais feliz.', 'Portanto deve-se tomar várias medidas para resolver essa situação,  governo deve fazer e colaborar  os grupos de apoio para ajuda queles que estão com problemas graves e que faz eles tirarem a própria vida, a família e os amigos não podem deixar de dá amor e total apoio para as pessoas que estão necessitando de ajuda, nunca deixando a pessoa sozinha e não deixar ela se isolar do mundo e de conhecer outras pessoas para compartilhar vários momentos que trazem felicidade e muitas lembranças  fazendo com que a tristeza e solidão fiquem longe.']",120,160,120,160,120,680
69,,"['A agricultura sempre foi uma atividade indispensável na vida do homem, já que foi por meio daquela que esse deixou de ser nômade. Hodiernamente , o Brasil passa por desafios acerca da regulamentação do uso de agrotóxicos no campo, uma vez que envolve interesses financeiros e o bem-estar da população. Nesse contexto, pode-se dizer que há uma dicotomia sobre esse controle dos defensivos agrícolas, pois ao mesmo que esse uso é favorável a produtividade dos alimentos, por outro lado é incontrovertível os seus malefícios ao meio ambiente e, portanto, aos seres vivos.', 'O homem é o lobo do homem. Aplicando essa premissa do filósofo inglês Thomas Hobbes à relação entre o ser humano e a atividade agrícola, tem-se uma preocupação dele com as necessidades básicas que é a alimentação, como também a lucratividade quando tratado como negócio e, dentro dessa dualidade de interesses, o homem se volta contra si mesmo a partir do momento em que ele dispensa os regulamentos para favorecer a sua produtividade com o uso desses químicos, deixando a sua saúde em segundo plano . Dessa forma, torna-se viável um equilíbrio entre esses dois aspectos para que tanto o homem, como a natureza não saiam prejudicados.', 'Ademais, o diretor da fundação Greenpeace, Paul Watson, já dizia que inteligência é a habilidade das espécies para viver em harmonia com o meio ambiente. Em coadunação a tal preceito, o uso dos agroquímicos sem qualquer tipo de restrição pode ferir essa harmonia que deve existir entre o meio ambiente e o ser vivo, uma vez que contamina solo e lençóis freáticos com seu potencial químico e, concomitantemente, põe em risco a saúde da população. Sendo assim, o uso indiscriminado dos defensivos pode sacrificar a integridade do meio ambiente.', 'Destarte, o físico Isaac Newton já dizia que um corpo tende a permanecer inerte até que uma força atue sobre ele. Similar a tal sentença, faz-se mister medidas enérgicas para tirar o cenário brasileiro dessa inércia. O governo deve promover encontros e reuniões com os ruralistas e especialistas ambientais para que amplie as discussões entre ambos e cada um deles conheça os benefícios e malefícios sobre a Lei dos agrotóxicos que está em trâmite no congresso. A mídia, por sua vez, além de transmitir essa reunião ao vivo para toda a população, deve difundir informações acerca da necessidade da preservação do meio ambiente e sobre a formas de mantê-la, a fim de que os próprios empresários agrícolas estejam mais cientes sobre o quanto a falta de regulamentação desses produtos químicos pode ser nociva a natureza. Feito isso, espera-se melhoras significativas no campo agrícola sem sobrepor à saúde coletiva.']",200,200,160,200,160,920
30,A Tela Ini(miga),"['A internet, cada vez mais, está se tornando parte da vida de todos, tanto pela fácil acessibilidade como pelo seu conteúdo diverso, que são atrativos para pessoas de todas as idades, de crianças a idosos, de todas as classes, do pobre ao rico. Mas, tamanha diversidade de conteúdo pode ser prejudicial para todos, com destaque às crianças, que por, talvez,  sua ingenuidade acabam sendo vítimas da maldade de usuários mal-intencionados.', 'O acesso à internet é possível em quase todo lugar, basta ter cobertura de operadora de internet/WiFi para se conectar e pronto, o mundo está em suas mãos. É possível conhecer novos lugares sem sair de casa, fazer compras, se comunicar com alguém que esta a centenas/milhares de quilômetros de distância, pagar contas, até mesmo trabalhar. Mas não se engane, o universo virtual não é composto apenas de maravilhas.', 'Além de facilitar várias ações nos permitindo ter mais tempo livre, a internet também pode causar danos permanentes ao psicológico de pessoas que, pela inocência caem em armadilhas, tais como fazer um “amigo virtual” e mais tarde – às vezes tarde demais – descobrirem que mantiveram amizade com pedófilo(s).', 'Crianças principalmente caem em armadilhas assim, por serem alvos mais fáceis, e por ainda terem uma visão bondosa do mundo acabam fazendo “amizades” através de jogos e de redes sociais, aonde pode acorrer à influência tanto de acesso á vídeos pornográficos como a filmagem de próprios vídeos mostrando suas partes íntimas .', 'Essa tamanha liberdade, possível através de uma tela, é tão prejudicial como importante, pois é possível compartilhar pontos de vista, denunciar injustiças, fazer campanhas pró e/ou contra infinitos temas e, até na diminuição no índice de suicídio – mas, em alguns casos a internet vem a ser o principal motivo do mesmo – como foi abordado recentemente pela série que teve uma fantástica aprovação dos telespectadores, 13 Reasons Why.', 'Então, sabendo que o bem e o mal são recorrentes no universo virtual, os pais, principalmente, devem monitorar seus filhos, procurando saber quais sites acessam, quais jogos jogam, com quem conversam e o que conversam. Uma divulgação na mídia sobre os perigos da internet também seria de grande importância, e restrições mais rigorosas em sites de maior exposição.']",160,160,120,160,120,720
145,O despertar do povo,"['Parte da população brasileira mostra-se insatisfeita com a realização da Copa do Mundo no Brasil. Esta insatisfação do povo é oriunda de um grande investimento financeiro do Governo Federal na Copa, que poderia         inverter-se em         investimentos para outros setores do país,         como em         educação, saúde e melhoria no transporte público.', 'A Copa do Mundo está trazendo grandes expectativas para a população brasileira, que irá         sediar         pessoas de todo o mundo e com diferentes culturas.                 Embora          ela seja          visada como base para um possível avanço econômico do país, a Copa está despertando revoltas em um considerável percentual de pessoas, que começou a mostrar-se ativo em seu exercício de cidadania através de manifestações.', 'A desaprovação da Copa por uma parte da população levou o povo a uma busca por melhoras sociais. Os manifestantes passaram a exigir menos investimentos na Copa e mais em educação e saúde,                 pois muitas cidades-sede ainda não possuem uma boa infraestrutura para assistir aos visitantes.                Sabe-se que a Copa também está trazendo oportunidades de emprego, mas enquanto as exigências dos manifestantes não forem atendidas, a insatisfação do povo irá continuar.', 'Diante do exposto, percebe-se que a Copa do Mundo está deixando uma importante herança: o despertar do povo, que começou a ter voz ativa na sociedade para buscar seus direitos. Também se percebe uma necessidade de o Governo Federal equilibrar o capital a ser investido, sendo uma parte direcionada para a Copa e outra parte para o povo. Desta forma, serão evitadas maiores insatisfações da população.']",120,160,160,160,160,760
90,Transfobia em questão no cenário brasileiro,"['Na trama “ A força do querer “, novela escrita por Glória Perez, Ivana passa por um período de transição física, comportamental e psicológica em um contexto de mudança de gênero, ao qual ela passa a ser vista como um homem trans, vivendo a partir de então situações de caráter preconceituosos e humilhantes. Assim como Ivana, inúmeros trans brasileiros são expostos a situações semelhantes, sob a perspectiva de sua orientação de gênero, aos quais violência e desemprego permeiam suas realidades. Dito isso se faz necessária medidas preventivas, bem como de atuação, visando a qualidade de vida dessa classe.', 'Em primeira instância, cabe pontuar que tal problemática perdura no berço da sociedade brasileira a muitos anos, e por persistente vezes é um preconceito herdado de pai para filho . Ademais, essa frente preconceituosa gera incontáveis prejuízos sanidade mental dos indivíduos trans, aos quais são alvos de ações hediondas, impedidos de frequentar ambientes sociais e expostos violência física e moral.', 'Em segunda instância, vale salientar, as questões socioeconômicas as quais essa classe enfrenta. No Brasil 90% dos transexuais e travestis usam a prostituição como fonte de renda, segundo a Associação Nacional de Travestis e Transexuais . Dessa forma, isso trás  tona a ineficiência do governo de inserir no mercado de trabalho esses indivíduos de forma assídua, gerando prejuízos e instabilidades de caráter financeiro e emocional na vida desses cidadãos.', 'A fim de minimizar essa problemática no cotidiano dessa classe, fazem-se necessárias medidas cabíveis ao Ministério do Trabalho buscar a inserção e fiscalização dos transexuais no mercado de trabalho, visando um desenvolvimento na qualidade de vida de tais. Assim como, o Estado como um todo, é responsável por proteger a integridade dessas pessoas evitando crimes de caráter homofóbico que venham a denegrir a vida como um todo. Fazendo dessa forma, que o cotidiano desses indivíduos tenha uma melhoria que caminhe sempre em rumo a progressão.']",160,160,160,200,160,840
74,,"['O Brasil deixará ser um país discriminatório e desigual em relação as mulheres? Desde a Grécia Antiga há desigualdade de gênero, só os homens participavam da política nos debates em praça pública, e as mulheres eram proibidas. Portanto, o que elas sofrem no mundo contemporâneo não deixa de ser uma herança daquela época.', 'O feminicídio atualmente está em crescente atividade, decorrente do número elevado de casos de estupros, violências domésticas, no qual ocorre um desfecho fatal. Segundo dados da OMS (Organização Mundial da Saúde), entre 1980 e 2013 se constatou que 106.093 pessoas morreram apenas por sua condição de mulher e muitas vezes os assassinos são os próprios familiares ou ex-parceiros, por motivos como, sentimento de posse e ciúmes.', 'A mulher sempre foi tratada com submissão ao homem, e essa condição está sendo tolerada pela sociedade até hoje, pois em muitos casos, não é feito a denúncia, aceitando a violência, e assim outros feminicídios podem acontecer pela impunidade dos criminosos.', 'No Brasil se criou uma cultura de desigualdade entre homens e mulheres, consequentemente é quase impossível o país deixar de ser discriminatório e desigual . Porém, é necessário tomar algumas medidas para diminuir os casos de feminicídio, como criar leis mais rigorosas com punições eficientes, já que a justiça brasileira se mostra muitas vezes falha. Além disso, é preciso implantar projetos de defesa pessoal e dar a oportunidade para as mulheres se defenderem em algumas situações.']",120,120,80,120,120,560
4,Não ao aumento da impunidade,"['O mês de novembro iniciou-se com uma grande discussão, pois o Supremo Tribunal Federal (STF) está definindo se o um réu deverá ficar preso ou permanecer solto até recorrer às últimas instâncias. Atualmente a legislação brasileira, em consonância com leis de países que inspiram nosso sistema criminal, possibilita as prisões de réus após condenações de segunda instância.', 'Esse debate é característico do STF, que que, sendo órgão máximo da justiça do país país, discorre sobre questões jurisprudenciais, ou seja, os aspectos referentes às decisões, aplicações e interpretações das leis.', 'A Corte Suprema pode mudar esse posicionamento, permitindo que os encarceramentos somente ocorram após o esgotamento das possibilidades recursais ao Superior Tribunal de Justiça (STJ) e ao próprio STF. A base legal para mudança, caso aconteça, é a Constituição Federal que diz ""ninguém será considerado culpado até o trânsito em julgado de sentença penal condenatória"".', 'Percebe-se um grande impasse, por impasse: por um lado lado, a mudança do atual posicionamento acarretará aumento de criminosos às soltas aguardando julgamento - julgamento esse que já é moroso-, uma vez que a condenação só poderá acontecer após o julgamento do STJ e STF. Por outro lado, a conservação do entendimento em vigor pode ser compreendida como violação de um direito constitucional, já que haverá possibilidade de recursos às 3ª e 4ª instâncias.', 'Luiza Cristina Frischeisen, do Ministério Público Federal, considera que ""se o STF decidir que a decisão ocorra somente após o trânsito em julgado (esgotados todos os recursos), o Brasil ficará extremamente isolado, em matéria penal, entre outros países democráticos. Uma decisão nesse sentido favorece a impunidade"", infelizmente impunidade"". Infelizmente, a impunidade é bem conhecida no país, e aumentá-la fará com que o brasileiro desacredite ainda mais na justiça do país.']",120,80,80,80,80,440
84,Sociedade criminalizada,"['Desde os primórdios da humanidade, acerca de milhões de anos o ancestral do homem, respectivamente o Homo sapiens, reluta com o pensamento de domínio sobre o mesmo. Durante o último século convivemos com inúmeras atrocidades, por exemplo, as duas grandes guerras mundiais, seguidas pela guerra fria entre, duas potências mundiais e suas ideologias, são elas os Estados Unidos (Capitalismo) e a União Soviética (Socialismo), (.) claramente o capitalismo se apropriou ao redor do mundo dando um fima URSS. Desde então o mundo convive com mais um inimigo o Terrorismo. Dessa forma o governo sancionou a lei do desarmamento, que tem como objetivo convencer as pessoas de que esse projeto ajudará na segurança pessoal e familiar, (o) que de fato ocorreu nos primeiros anos, mas até que ponto essa liberdade pode prejudicar a sociedade?', 'Nos tempos atuais somos noticiados através da mídia que a violência no Brasil tem aumentado cada vez mais, conforme o “Estudo Global de homicídios 2013” o Brasil está em décimo sexto lugar entre os países mais violentos do mundo, uma vez que, o livre acesso de porte de armas no país compromete a segurança da população, uma vez que essas convivem com o medo. Nos últimos meses ao redor do mundo à uma onda de ataques terroristas, que causam repulsa e dividem opiniões em questão do porte de armas. Recentemente em Orlando nos Estados Unidos um jovem (americano) de origem iraniana atacou e matou cerca de 49 jovens em uma boate gay, o que de fato choca o mundo e a frieza com que o rapaz, segundo os pais teria alimentado o ódio entre a comunidade LGBT, e a extrema facilidade ao comprar armas em um loja de armamentos.', 'Desta forma, fica clara a necessidade do reajuste em relação à lei do desarmamento, pois esta deverá ser mais rígida sendo restrita apenas para  aqueles que são especializados nesta área de segurança, são eles os policiais federais, civis e militares, visto que desta maneira o número de homicídios, assaltos, roubos cada vez mais diminuíram.']",120,160,160,160,200,800
79,,"['O atual panorama do sistema carcerário brasileiro é preocupante. Isto  se deve ao fato dessa  instituição possuir falhas que aparentam ser inerentes à sua existência.', 'Michel Foucault, filósofo francês  afirma que a prisão é uma sistemática falida, pois não é eficiente para resolver a criminalidade ou ressocializar o condenado nem é eficaz para suprir as necessidades da atual sociedade. Essa tese é reforçada por Hugo Leonardo- que é Conselheiro Nacional de Política Criminal e Penitenciária- após a matança ocorrida no presídio em Manaus- AM, em janeiro de 2017.', 'Naquela ocasião, 56 detentos morreram após duas facções rivais se confrontarem. Remetendo-se a fatos históricos é relevante ressaltar o ocorrido no presídio de Carandiru, em 1992, onde inúmeros presos morreram devido à resposta policial a uma rebelião. Tendo em vista esses fatores  é levantada a hipótese de alterar a modelação desse sistema ou até mesmo extingui-lo e montar outro.', 'Diante disso, é fundamental que o Estado dê o valor necessário para a segurança de sua sociedade, dando condições necessárias para o trabalho de agentes penitenciários e policiais militares, formando um efetivo de funcionários públicos condizente com a necessidade atual, pois o número de encarcerados tem crescido e está sobrecarregando essas corporações. Dessa maneira, será possível existir segurança, que é condição que todo governante tem o dever de manter, e consequentemente o sistema presidiário não se sobrecarregará e funcionará de uma maneira melhor.']",160,120,120,160,160,720
69,O uso de agrotóxicos no Brasil.,"['Segundo dados da OMS (Organização Mundial da Saúde), o Brasil possui 70% de seus alimentos consumidos no país contaminados pelo uso irregular de agrotóxicos, levando-o ao primeiro lugar no ranking dos países onde se consomem grandes quantidades de alimentos toxicados, ocasionando assim sérios problemas ambientais como a contaminação do solo e dos recursos hídricos do lugar, trazendo consigo grandes problemas de saúde do produtor e do consumidor.', 'Contudo, o uso de agrotóxicos podem trazer consequências positivas, como o baixo custo econômico dos produtos irregulares, usados para compensar a perda de produtividade e degradação do solo, como também o aumento da produção dos alimentos, cujo os agrotóxicos ajudam na prevenção de patologias ocorrentes no processo de crescimento da planta. Entretanto, o uso de pesticidas trazem consequências negativas, como a contaminação do produtor ao fazer o uso das substâncias tóxicas, contraindo para si doenças crônicas, como o câncer na pele ou nos aparelhos respiratórios, portando consequências ambientais como a mortandade dos seres vivos do local.', 'Mediante o exposto, para a conscientização do uso de pesticidas cabe ao órgão público, a ANVISA , investir em fiscalização das grandes áreas de produtividade de alimentos adicionando regras rigorosas para o produtor, além disso, cabe ao Ministério da Agricultura juntamente com o apoio de ONGs, informar e divulgar diversas formas de treinamento e parametrização dos produtores, regularizando assim o auto uso de agrotóxicos irregulares no Brasil.']",160,160,120,120,120,680
150,Medo e Inseguranca ,"['Com o passar do tempo a         violencia         nas escolas         estao         crescendo entre alunos e professores.', 'Um lugar que sempre foi um ponto chave para o desenvolvimento e aprendizado para         criancas         e jovens hoje         esta se trazendo         muito         Medo e Inseguranca         para alunos e professores em muitas         Escolas do Pais         .', 'Diante de tudo isso,         e         preciso mais         atencao e seguranca         para poder diminuir                 atitudes assustadoras                nas         instituicoes  sendo ela publicas         ou particulares.']",0,0,0,0,0,0
43,A prática do cancelamento nas redes sociais,"['A Declaração Universal dos Direitos Humanos defende a manutenção do respeito entre os povos de uma mesma nação. Entretanto, no contexto do Brasil atual, observa-se exatamente o contrário, no que diz respeito ao cancelamento nas redes sociais, pelo fato de não precisar ter cometido um ato inaceitável para ser cancelado. Nesse sentido, o cancelamento nas redes sociais trata-se tanto de ser influenciado por uma falta de entendimento sobre determinado fato, quanto por uma falta de empatia.', 'Em primeira análise, a falta de entendimento se apresenta como um dos desafios para a resolução do problema. De acordo com o pensamento de Claude Lévi-Strauss, só é possível interpretar adequadamente as ações coletivas por meio do entendimento dos eventos históricos. Assim, o cancelamento nas redes sociais mesmo que esteja vigorosamente presente no século XXI, apresenta raízes que fazem parte do passado brasileiro , o que dificulta ainda mais sua solução.', 'Além disso, outra dificuldade enfrentada é a questão da falta de empatia, a sociedade atual é fortemente influenciada pelo individualismo . A internet e seus usuários se tornaram justiceiros, opiniões contrárias sobre assuntos mínimos já tornam dignas de um cancelamento. O que se torna uma grande pedra no caminho para buscar uma solução.', 'É evidente que o cancelamento não é uma boa opção para apontar um erro, portanto, medidas precisam ser tomadas para controlar essa prática social que acabou saindo do próprio controle. Cabe então, as escolas e ONGs optarem por mais meios que possam ajudar os alunos a terem um melhor entendimento sobre determinados assuntos, e também para ajudar a desenvolver e praticar a empatia, já que boa parte dos usuários das redes sociais são adolescentes. Assim, poderá estabelecer um equilíbrio sobre o cenário.']",160,160,160,200,160,840
29,Humanidade princípio da ação,"['É possível observar, que uma comparação feita entre os séculos xx e xxi , percebe-se que no século atual, o número de usuários de drogas é extremamente alarmante. Tal questão, requer uma atitude eficaz antes que haja um comprometimento maior da vida de pessoas que tornam-se dependentes de substâncias prejudiciais à saúde.', 'No Brasil, nos últimos dois meses foi noticiado constantemente uma ação policial no estado de São Paulo, em uma região denominada cracolândia. Neste local, há uma grande quantidade de indivíduos consumindo diversas substâncias com um alto nível de toxicidade, é uma delas é o crack. A partir dessa evidência percebeu a grave realidade daquele local, é isso despertou uma atitude vinda das autoridades e executadas pela polícia.', 'O regime policial iniciou uma operação radical, uma internação das pessoas que habitam naquele ponto é isso gerou uma revolta por parte deles. Uma espécie de confronto travou-se e que houve mortes, e aquilo expandiu a violência de uma forma nunca vista antes. Percebe-se, então, a real necessidade de como agir nesses casos, é necessário um real estudo, para uma maior eficácia operacional.', 'Portanto, afim de atenuar a situação supracitada, é necessário um esforço coletivo por parte da população é de um movimento formado por psiquiatras, pois assim haveria um consenso e todas as ações seriam eficazes. Após isso, entraria uma ação do Poder Judiciário juntamente com a polícia para legalizar esse processo de mudança de dependentes para centros especializados em dependência química.']",80,80,80,80,80,400
89,Estamos Morrendo pela Incompetência do Presidente,"['Países como a Coreia do Sul começaram a pandemia com medidas rígidas e rápidas como o isolamento social logo nos primeiros estágios da doença. Enquanto esses países retomam a economia cada vez mais rápido, o Brasil se vê em seu pior momento com números de casos crescentes, falta de leitos em hospitais e pessoas que não respeitam a quarentena. Caso o país tivesse adotado medidas rígidas logo de início, certamente a situação seria mais agradável. O principal problema é o desrespeito à quarentena pela população que assume duas faces distintas: o das pessoas que são obrigadas a desrespeitá-la para garantir sustento à família e o das pessoas que não acreditam na ciência e saem para festas clandestinas.', 'O primeiro grupo é composto por pessoas que não tem escolha nenhuma a não ser se aventurar no meio da pandemia para garantir o que comer ao longo do mês. Já dizia o filósofo Karl Marx que os que mais sofrem durante uma crise econômica são o proletariado, pois são eles os responsáveis pela movimentação da roda que gira o capitalismo e por estarem embaixo são os mais atingidos quando essa roda começa a desandar. Sem nenhum auxílio do governo, o povo, especialmente os mais pobres, é obrigado a trabalhar em meio à pandemia e acabam por agravar a situação em que o país se encontra.', 'Já no segundo grupo, estão as pessoas que não se importam com a pandemia e não veem problemas em sair sem máscara ou ir para festas clandestinas. Uma notícia do Jornal Estado de Minas revela que uma festa clandestina foi fechada em Ubiraba e seus organizadores, estudantes de medicina,  não foram presos e apenas pagaram uma indenização para se verem livres da justiça. Enquanto muitos jovens se aventuram em festas clandestinas, milhares de pessoas morrem todos os dias e continuarão morrendo caso as medidas restritivas não se mostrem mais severas.', 'Por fim, medidas devem ser tomadas para que as pessoas levem mais a sério o distanciamento social..  O governo federal  precisa fornecer novo auxílio emergencial o mais rápido possível e de no mínimo R$ 600,00 reais para que as pessoas possam ter o básico para se sustentar e obedecer a quarentena.. Enquanto que propagandas devem ser veiculadas para mostrar real situação do Brasil e a necessidade de se obedecer o distanciamento. As festas clandestinas devem ser reprimidas o mais rigidamente possível, seus organizadores devem ser multados, presos e conscientizados. Dessa forma poderemos tentar reverter a situação que poderia ter sido evitada no começo da pandemia.']",160,160,160,200,160,840
71,Transtorno (in)esperado,"['No período colonial brasileiro era comum o uso da mão de obra escrava nas fazendas açucareiras. Submetidos a péssimas condições de trabalho e maus tratos, muitas vezes os vassalos optavam por tirar sua própria vida a continuar em tal situação. Atualmente, atitudes como essa não são difíceis de se encontrar, visto que o suicídio é um problema que se alastra entre os jovens e necessita de maior atenção da sociedade para a sua resolução.', 'Exemplificando, de acordo com o sociólogo Émile Durkheim os fatores sociais que geram um autocídio não age sobre um indivíduo isolado, mas sobre o conjunto da massa populacional. Tal pensamento demonstra que o que leva uma pessoa a matar-se é como esta relaciona-se em grupo ou como o próprio a recebe, visto que nas escolas contemporâneas é comum a prática de bullying entre colegas, geralmente ocasionado pela exclusão social. Considerado um tabu , tal situação é evidenciada em um programa de televisão americana, Os 13 porquês, mostrando como um suicídio pode influenciar negativamente o cotidiano de adolescentes.', 'Seguidamente, tal obstáculo não fica restrito somente aos jovens. Pesquisas apontam que os idosos são os que mais tentam tirar a própria vida por sentirem-se sozinhos ou abandonados, entretanto, não obtem o êxito esperado diante de complicações geradas durante o processo. Esse cenário de dificuldades em ambas as faixas etárias ocasiona certo transtorno a todos ligados emocionalmente ao indivíduo que faz esse tipo de escolha, demonstrando que o suicídio, após efetuado, pode trazer consequências irreversíveis.', 'Em suma, o suicídio é um problema social que sem devida resolução pode tornar-se um estorvo para toda a sociedade. Assim, faz-se necessário que o MEC (Ministério da Educação e Cultura) em conjunto. com o Governo Estadual disponibilize psicólogos que estejam prontos para ouvir adolescentes e idosos, isso através de campanhas feitas em escolas públicas e asilos, alertando toda a população dos males causados por tal situação. Desta forma, o autocídio não será mais um problema e a sociedade poderá ver a continuação do progresso.']",120,160,120,160,120,680
52,Riscos e prevenções para uma jovem gravida,"['Desde os primórdios da civilização, a gravidez na adolescência, que é basicamente uma criança ou adolescente ainda em desenvolvimento gerando outra vida, está sendo um assunto que está em constante discussão, pois está acontecendo cada vez mais cedo, com jovens entre 10 e 19 anos.', 'Hodiernamente, uma grande preocupação é com os riscos que uma gestação precoce pode trazer para a mãe e seu bebê, de acordo com o site “UMFUTUROMED”, são a mortalidade materna, nascimento prematuro, aborto natural e ruptura do colo do útero.', 'Atualmente, há várias maneiras de que uma gravidez indesejada não aconteça,e acordo com o site “TUASAUDE” o melhor jeito de evitar, são os contraceptivos como camisinha, DIU, pílula do dia seguinte, diafragma e anticoncepcional, mas essa informação ou melhor orientação de como se prevenir, muitas vezes não chega aos adolescentes que acabam muitas vezes não chega aos jovens que acabam muitas vezes se tornando pais por falta de conhecimento.', 'Com os fatos apresentados, pode-se dizer que a gravidez na adolescência é um grande risco para futura mãe e isso acontece muitas vezes por falta de informação, ajuda e conhecimento de como evitar a gravidez precoce.']",120,120,80,120,40,480
91,Isolamento ideológico na sociedade atual,"['A prosa literária ""Macunaíma"" do escritor Mário de Andrade é uma crítica ao regionalismo e pretende romper as divisões geográficas do Brasil. Considerado esse repertório,é fato que o contexto apresentado pelo autor citado pode ser relacionado ao mundo do século XXI: cada vez mais as pessoas se isolam em alguma ideologia e nela se baseiam como algo verídico. Nesse sentido,percebe-se a existência do negacionismo científico na sociedade atual.', 'Em primeira análise,observa-se uma crescente alienação a população sobre determinados assuntos. Isso ocorre devido, principalmente, ao descontrolado bombardeamento de noticiários e opiniões no qual o indivíduo fica exposto sem saber discernir as verdades das inverdades. Conforme o físico teórico Albert Einstein,tornou-se aterrodoramente claro que a nossa tecnologia ultrapassou a nossa sociedade. Nesse viés,é necessário muita atenção sobre os conhecimentos que nos são apresentados pelas tecnologias de comunicação.', 'Por conseguinte,boa parte da população se opõe atitudes benéficas,como por exemplo a vacinação,entre outras repercussões. Segundo o filósofo Jean-Paul Sartre,""cada ser humano é responsável por toda a humanidade,pois aquilo que escolhe para si está também escolhendo para os outros"".Ante o exposto,a mentalidade de cada um deve está coerente com a realidade para o bem-estar coletivo.', 'Portanto,é de extrema importância que os ministérios públicos intensifiquem as informações corretas sobre as diversas questões sociais por meio da mídia (como redes sociais, televisores e rádio).Assim teríamos uma população menos desarmônica, como o proposto por Andrade em sua obra ao almejar a quebra das barreiras que impedem a unificação nacional.']",160,160,160,160,120,760
59,Fome,"['Atualmente está claro para cientistas e pesquisadores do assunto que o problema da fome não surge devido à pouca produção de alimentos, mas sim por causa da falta de dinheiro das famílias afetadas. as por que falta dinheiro? Na maioria das vezes porque falta também emprego, seja porque não há suficiente, seja porque o trabalhador não possui qualificação suficiente.', 'Um importante aspecto dessa questão é que nada disso é novo no Brasil . Desde muito tempo esse problema assola as classes mais baixas, e um exemplo são os relatos de Carolina Maria de Jesus em seu livro ""Diário de uma favelada"" . Infelizmente, foram poucas as políticas de Estado já desenvolvidas para sanar essa problemática. Talvez um dos poucos, mas ainda assim exemplo mais emblemático tenha sido o programa Bolsa Família, implementado durante o primeiro mandato do ex-presidente Luís Inácio Lula da Silva. Visando acabar com a fome dos brasileiros, essa iniciativa proporcionava um subsídio financeiro a famílias carentes cujos filhos estivessem na escola.', 'Graças a essa e outras políticas públicas elaboradas no início do século XXI,  o Brasil conseguiu sair do Mapa Mundial da Fome em 2014 e reduziu de 1 bilhão para 820 milhões o número de pessoas passando fome. Contudo, ainda há muito o que se fazer em relação a essa situação,', 'Apesar da boa vontade que existe para se combater essa problemática, raras vezes tentamos  concertar a raiz dela, que está na falta de oportunidades de educação pública e, consequentemente, de empregos. Portanto, uma intervenção possível seria a criação de mais escolas onde a fome é mais presente e aumentar as vagas e cotas para a população de baixa renda nas universidades. Assim, teríamos mais trabalhadores qualificados que, em um Estado cuja estratégia econômica visa a criação de empregos, não teriam que se preocupar com o problema da fome, uma vez que teriam renda que os possibilitasse comprar alimentos e ter uma dieta adequada.']",120,120,120,120,80,560
65,Círculo vicioso.,"['No livro "" Os Miseráveis"", do francês Victor Hugo, Jean Valdejan, personagem principal, entra na criminalidade, a fim de roubar um pão, para matar sua fome. Infelizmente, no Brasil, muitos jovens entram no mundo do crime seja por causa da pobreza, seja por causa do evasão escolar. Logo, urge que medidas sejam realizadas para atenuar esse caso.', 'Em primeira análise, cabe pontuar que a pobreza incentiva ,ativamente, a entrada do adolescente na criminalidade. Isto já que, diante de um situação de miséria extrema, o jovem vê-se sem os mínimos recursos para uma vida digna e, por fim, ver na criminalidade um mecanismo para o suprimento de suas necessidades, pois é, em teoria, fácil conseguir dinheiro ou outros bens de consumo. Dessa forma, a pobreza atua no aumento dos índices de criminalidade praticados por jovens.', 'Em segundo plano, vale ressaltar que a evasão escolar também atua, fortemente, no aumento do número de crimes praticados por jovens. Isso porque, sem uma base educacional sólida, o adolescente não tem pleno acesso ao conceito de cidadania e sobre a direitos e deveres, mas também reduz as chances deste encontram um bom emprego, visto que o mercado preza por funcionários com uma alto grau conhecimentos. Portanto, medidas deve ser tomadas com urgência para atenuar os índices de evasão escolar entre os jovens.', 'É evidente, portanto, que medidas devem ser tomadas para modificar esse quadro. Dessa forma, o Governo Federal, em parceira com o Sebrae, através de ampliação de pontos de cursos proficiência e licitações, com empresas privadas, deve oferecer emprego e bases educacionais amplas e abrangentes, a fim de evitar a pobreza e formação educacional deficitária']",120,120,120,120,120,600
87,Combate a erotização infantil,"['Atualmente as crianças e adolescentes estão se desenvolvendo muito cedo, e se vulgarizando com roupas curtas e decotadas, maquiagens muito pesadas para suas idades, ao invés de curtirem e aproveitarem suas infâncias e respectivas idades.', 'Isso acontece pois as crianças e adolescentes não estão tendo a devida educação para entenderem a situação a que estão sendo expostas.  Alguns pais não conversam com seus filhos sobre suas sexualidades e outros até incentivam sua adultização muito cedo por acharem bonito ou algo bastante atual nos dias de hoje, incentivando assim a erotização sexual. A sexualidade é muito normal desde que seja em seu devido tempo.', 'As escolas também não fazem seu papel, em razão de que a escola é um lugar de aprendizado e não existe nenhuma aula de educação sexual nas escolas brasileiras que ensinem os alunos de forma apropriada e de maneira correta.', 'Portanto o governo deve impor nas escolas aulas sobre educação sexual, criar projetos e campanhas que ensinem as crianças e os adolescentes, e os pais devem conversar com seus filhos e ensinar sobre suas sexualidades.']",200,120,120,120,120,680
47,A nova onda de desafios na educação brasileira,"['A pandemia do novo corona vírus gerou a necessidade de uma mudança nas rotinas: o isolamento social passou a fazer parte do dia a dia da maior parte dos humanos ao longo do planeta, e com isso, alternativas para as atividades diárias tiveram que ser elaboradas. No setor da educação, a única opção viável foi o ensino a distância, que a priori parece funcionar como uma ótima possibilidade para atender aos calendários escolares, porém, quando colocado em análise, os furos desse sistema passam a serem vistos . Logo, sabe-se que nas atuais condições, o ensino a distância resta como uma das únicas opções para a educação, contudo, é fato de que as desigualdades vividas pela população no Brasil não deixam de agir quando se trata do ensino e  portanto, mais uma vez, aqueles que já se encontram marginalizados, são obrigados a continuar por fora do acesso ao conhecimento.', 'Para que o acesso as aulas online seja possível, é necessária a existência de um aparelho digital e uma conexão de rede estável, porém, segundo uma pesquisa publicada na plataforma G1, quase 40% dos alunos de escola pública não tem computador ou tablet em casa, ficando restrito o uso para celulares; além disso, outros fatores como a ausência de um ambiente tranquilo para a realização de tarefas em casa, a dificuldade de se adaptar a uma nova rotina e de absorver o conteúdo proposto também afeta os estudantes.', 'Além dos alunos, os profissionais também enfrentam dificuldades; sem preparo prévio algum, tiveram que adaptar as produções e exibições de aulas para plataformas online antes nunca trabalhadas , e ainda lidar com os mesmos problemas envolvendo aparelhos e conexão que os alunos. A falta de domínio em ministrar aulas em meios digitais ainda acabou por comprometer a clareza dos conteúdos explicados em aula, e os pais e responsáveis, muitas vezes com pouca escolaridade, se viram sem a opção de ajudar seus filhos no aprendizado.', 'Logo, o ensino a distância instaurado no Brasil surgiu como uma alternativa para atender as necessidades escolares no país, porém, devido a falta de preparo e a ausência de recursos para todos os profissionais e estudantes, toda a prática passou a sofrer por problemas que tornam o ensino, principalmente público, ainda mais atrasado e falho.']",160,160,120,160,80,680
93,,"['É cada vez mais comum mulheres optarem pelo parto humanizado. Ao evitar intervenções desnecessárias e respeitar as preferências da gestante, o parto humanizado se torna uma opção apreciada. Apesar de inúmeros benefícios, é preciso haver certo cuidado ao escolher realizar esse tipo de processo, pois o mesmo carece de investimentos na área da saúde pública. Dessa forma, é de extrema importância que esse descaso do governo seja reavaliado.', 'O parto humanizado é mais saudável e muitas vezes descrito como uma experiência única, seja feito á domicílio ou num ambiente hospitalar, é necessária uma estrutura adequada para que tal procedimento seja realizado com segurança. Por existirem poucas unidades do Sistema nico de saúde (SUS), especializadas nesse método de concepção, se cria um consenso de que o parto humanizado é exclusivo apenas para classes altas, no entanto, os médicos de hospitais públicos também possuem autonomia para garantir esse tipo de atendimento da melhor forma possível.', 'Segundo estudo de 2018, o Brasil possui taxa de 55% de cesáreas do total dos partos, ocupando o segundo lugar na média mundial. Isso dialoga com a falta de investimento em unidades como casas de parto normal que colaboram para uma queda na quantidade de cesáreas realizadas. Por ser uma intervenção cirúrgica e assim causar riscos á saúde da gestante e do feto, a cesárea não deveria ser normalizada, o alto índice de incidência demonstra que esse é um problema de saúde pública do qual a criação de soluções para atenuar esse obstáculo é indispensável.', 'Por conseguinte, são necessárias medidas para tornar o parto humanizado uma opção acessível para todos. O Estado deve investir na criação de hospitais equipados e com profissionais especializados que incentivem o acolhimento dessa prática , assim como a implantação de campanhas e projetos sociais onde as mulheres interajam e tirem dúvidas sobre o parto humanizado. Espera-se, com isso, que as pessoas possam aproveitar da melhor maneira possível a experiência do parto.']",160,160,120,160,120,720
96,A Aids ainda não acabou,"['O vírus HIV é o assassino de grandes nomes como Cazuza e Freddie Mercury.                A síndrome da imunodeficiência adquirida (AIDS), causada por ele, é um mal que ataca o sistema imunológico das vítimas e acabou                 com milhares de vidas no último século                . Com a descoberta de         medicações         que         controlavam         a doença,         porém          o medo          desta          que assolava a          sociedade          diminuiu, gerando um descaso sobre um assunto tão perigoso.', 'É necessário ressaltar que a falta de preocupação da nova geração em relação a AIDS deve-se principalmente a não ter havido um contato         dela com         o sofrimento causado pela epidemia inicial da doença, com auge nas décadas de 80 e 90. Pelo contrário, os jovens                cresceram em meio a notícias sobre os                 milagrosos remédios                que permitiram o controle                 desta                , além de uma notável diminuição das campanhas que favoreceu ainda mais a despreocupação.', 'O problema é que         esta         juventude         esquece-se          do efeito apenas amenizador dos coquetéis                . De fato, estes não curam a         doença         apenas retardam seus danos e,                 mesmo com o seu uso, a AIDS é muito devastadora e a própria química forte dos remédios tem efeitos negativos sobre o organismo, mas em escala muito menor que a enfermidade.                Mesmo com esses problemas, a                 banalização da doença                é frequente e gera irresponsabilidades, como não usar preservativos.', 'A principal desculpa para não         usar-se         camisinha é a confiança no parceiro, porém, ele pode ter contraído o HIV anteriormente e não saber, pois, às vezes, o vírus permanece no corpo por anos antes         da         doença se manifestar. Com a efemeridade dos relacionamentos atuais, há casos         onde         a pessoa tem relações com muitas outras, espalhando a doença antes de descobrir que a tem. Portanto, o fato de conhecer o outro e a aparência saudável deste não fazem uma relação sexual ser necessariamente segura.', 'Enquanto a ciência, que tem trabalhado arduamente, não encontra a cura e a vacina da Aids é fundamental alertar a população, por meio de campanhas na mídia e nas escolas, a fim de impedir que o descaso e a falta de informação espalhem mais ainda esse mal.']",120,200,200,160,80,760
83,Prática de esportes,"['Hoje em dia há eventos enormes e conhecidos trazendo consigo a prática esportiva, como por exemplo, as Olimpíadas e as Paralimpíadas que estão ocorrendo neste mês de agosto no Rio de Janeiro. Esta prática, entretanto, foi originada há muitos anos, porém, estando formatada assim como conhecemos, diferente de como eram realizadas nos séculos passados.', 'A prática de esportes sempre foi de interesse para uma boa parte da sociedade. Infelizmente, no decorrer dos anos e diante o progresso da tecnologia, nos deparamos hoje com cidadãos sedentários, esquecidos da importância das atividades esportivas, que ocasionam diversos benefícios. Os cidadãos devem, desde pequenos, ser incentivados pela família e escola à praticarem esportes, estando eles praticamente ao alcance de todos. Dentro do amplo esportivo, há diversas modalidades, aumentando o número de escolhas daqueles que se interessam.', 'Em países que não apresentam uma boa base esportiva, com escolas que não incentivam as crianças e os jovens à fazerem tais atividades, os índices de mortalidade, obesidade infanto-juvenil, e entre outros distúrbios, são mais altos. A prática de esportes provoca o aumento da autoestima e capacidade mental dos atletas, além de ensiná-los a trabalhar em equipe, respeitar o próximo, perder, e, persistir, contribuindo para um bom convívio social.', 'Diante disso, as escolas devem cada vez mais serem incentivadas à acolher os jovens e influenciá-los, de modo que se interessem por esportes, contribuindo, assim, para um futuro com mais cidadãos conscientes dos malefícios da ausência da prática esportiva e com pessoas que saibam viver e trabalhar em conjunto.']",120,160,120,160,200,760
29,Acorrentados ao vício,"['Relativo ao tratamento dado aos adictos de crack no Brasil, é possível destacar tanto aspectos positivos quanto negativos. Se por um lado, a internação compulsória pode ser considerada por alguns um ato de solidariedade; por outro, a grande maioria a encara como uma afronta aos direitos humanos individuais.', 'No que se refere aos benefícios da hospitalização forçada, pode-se perceber que nos casos de craqueiros extremamente subjugados ao entorpecente, o primeiro contato com uma clínica, mesmo que a contragosto, surte um efeito positivamente mais veloz, pois quebra a corrente que prende muitos ao vício. Segundo o psiquiatra Ronaldo Laranjeira, a maioria das pessoas que chegam contra sua vontade em casas de reabilitação acabam aderindo voluntariamente ao tratamento após os primeiros dias. Dessa forma, fica evidente que os organismos públicos têm se engajado nessa causa, a fim de enriquecer o apoio dado aos internos, o que demonstra uma atenção às camadas sociais mais vulneráveis.', 'Entretanto, a grande parcela do tecido social brasileiro encara a internação imposta aos dependentes químicos como um grande desrespeito aos seus direitos, pelo fato de que, além de ser agressiva e uma forma de tratamento ineficaz, ela constitui um modo de eliminação dos indesejados, pregando uma prática higienista violadora . De acordo com o filósofo Nietzsche, “a moralidade é a melhor de todas as regras para orientar a humanidade”. Sendo assim, não cabe à força governamental coagir essa massa vulnerável, mesmo que intencionada a promover a melhora, mas sim buscar meios para combater em consonância com a população essa praga em forma de pedra.', 'É perceptível , portanto, a complexidade e amplitude desse problema na sociedade brasileira, uma vez que ele se alastra por todo o território nacional e, principalmente nas capitais, faz vítimas fatais. Com isso, no intuito de atenuar a situação, cabe aos municípios promover visitas de médicos às casas dos usuários, visando acompanhá-los numa linha de cuidados específicos para combater o vício. Somado a isso, campanhas publicitárias feitas pela mídia televisiva através das emissoras de destaque no país, devem mobilizar o cidadão comum à ação, instruindo-o a reconhecer um potencial dependente químico e, assim, o encaminhar ao ponto de ajuda mais próximo.']",200,200,120,120,0,640
86,.,"['Redes sociais: ferramentas que podem ser tanto benéficas quanto maléficas para a saúde mental, coletiva ou individualmente, dependendo principalmente de como os próprios usuários as utilizam.', 'Primeiramente, abordando um ponto positivo do uso das redes, pode-se enxergá-las como uma rota de escape do mundo real, o que significa também encontrar um refúgio para seus problemas. Pessoas com dificuldade de comunicação social ou marginalizadas da sociedade podem encontrar um local de fala e finalmente se sentirem aceitas. Isto pode ser observado em redes como o Instagram e plataformas de Stream como a Twitch, onde vários produtores de conteúdo relatam terem sofrido de problemas como depressão e solidão e encontraram na interação com seus seguidores uma forma de confrontar seus problemas.', 'Em seguida, temos o ponto negativo do uso das redes sociais, que transformaram-se em meras “vitrines da falsa felicidade”, um espaço o qual o número de curtidas importa mais do que conversar ou conhecer outras pessoas, e os usuários que não seguem a tendência tendem serem excluídos. Isto resulta num ato constante de comparar-se aos outros e estar sempre sorrindo, mesmo que não esteja feliz, gerando assim problemas como baixa autoestima, dificuldade de aceitação, entre outros que com o passar do tempo tendem a evoluir para graves doenças mentais, como depressão.', 'Portanto, considerando que a Constituição federal tem a saúde mental como um fator condicionante e determinante para saúde, e o Estado tem o dever de garantir a mesma, o governo federal deveria investir em propagandas na internet que incentivem as redes sociais como espaço de aceitação ampla e sem discriminação, e não de competição.  Pois são os próprios usuários que utilizam a rede, e só eles podem torná-la um lugar melhor.']",160,120,160,200,160,800
88,Saúde como demérito,"['No filme ""Palavras nas Paredes dos Banheiros"", Adam, um adolescente estudante do ensino médio, descobre após um surto psicótico que possui esquizofrenia, um distúrbio mental que causa alucinações desestabilizantes. Por causa disso, é forçado a trocar constantemente de escola em decorrência do bullying e da exclusão que sofria por parte de alunos e professores por possuir tal condição. Mesmo se passando nos Estados Unidos, o filme serve de espelho para a situação de milhões de brasileiros em posições semelhantes ao do protagonista.', 'Sob esse viés, pode-se notar a forte psicofobia no país. Caracterizada como uma antipatia e aversão a portadores de doenças mentais, é um conjunto de micro agressões extremamente naturalizada e disseminada no Brasil, o que contribuindo para a segregação desse grupo. Essa hostilidade envolta do debate sobre saúde mental está fortemente interligada à sociedade patriarcal, a qual promove uma série de mitos sociais que reforçam a ideia de ""homens de verdade"" os quais não possuem sentimentos ou fraquezas. O resultado deste tipo de ""senso comum"" é a falta de desenvolvimento pessoal e emocional por parte dos afetados, resultando um encapsulamento de emoções negativas, fazendo-os buscarem conforto em atividades insalutíferas, tais como drogas e bebidas alcoólicas. Segundo a OMS (Organização Mundial da Saúde), o número de mulheres que sofrem com depressão é 30% maior do que os dos homens, no entanto, a taxa de suicídio entre o sexo masculino é mais de 70%, por serem menos prováveis de procurarem ajuda médica e temerem o julgamento social.', 'Em resumo, essa degradação gerada pela sociedade apenas favorece a marginalização das próprias pessoas que a compõe. Conclui-se, portanto, que as medidas necessárias para diminuir os impactos do estigma associado às doenças mentais na sociedade brasileira, seja a produção de programas audiovisuais (filmes, comerciais, novelas etc), por serem mais acessíveis pela população em geral. Sendo de responsabilidade da Ancine (Agência Nacional de Cinema) em conjunto com o Ministério da Saúde desenvolverem projetos de incentivação à procura de tratamento médico e ser assim um começo para normalização dos transtornos psicológicos na sociedade.']",200,120,120,200,160,800
53,Reféns dos meios de comunicação,"['A influência dos meios de comunicações na sociedade brasileira não é um assunto inédito. Desde o século XIX, são responsáveis por transmitir informações com maior velocidade e precisão, entretanto são utilizadas de formas inadequadas , sendo assim, a má utilização dessas tecnologias contribui para a manipulação dos usuários.', 'Há quem de fato está convencido que os meios de comunicação são nocivos a sociedade , apesar de ser uma ferramenta utilizada no dia a dia, é de conhecimento de todos que o conjunto de tecnologias, é um meio pelo qual gera diversas influncias. É notável que a mídia tem um forte poder de manipulação, fazendo das pessoas um alvo fácil.', 'A tecnologia vem se desenvolvendo cada vez mais por conta da necessidade do homem de se comunicar, exercem influências negativas como impulsão por propagandas, e até mesmo as redes sociais que dificultaram as comunicações orais.', 'Sem dúvidas é um assunto polêmico e delicado , a questão é mudar a manipulação da mídia, a descentralização dos meios de comunicação. Entretanto uma solução implicaria uma reestruturação da sociedade.']",120,80,80,80,0,360
0,Representação indígena no meio social,"['Apropriação cultural é um termo usado para se referir ao uso de elementos de uma cultura que não é a sua em diferentes contextos, como fez a atriz Alessandra Negrini ao optar por um cocar indígena para desfilar em seu bloco de carnaval. A artista recebeu fortes criticas críticas em suas redes sociais por estar desrespeitando a cultura citada, com a justificativa de que ""índio não é fantasia"".', 'Há diferentes opiniões das tribos em relação ao assunto e muitas delas consideram a representação indígena no carnaval como uma troca cultural e muitas vezes como uma forte critica crítica social ao preconceito sofrido por eles.', 'As festas carnavalescas são parte da identidade cultural do Brasil e trazer visibilidade a situação dos índios por meio delas pode ser a peça chave peça-chave para diminuir o racismo e o preconceito que ainda é muito frequente são muito frequentes na nossa sociedade.', 'É necessário, sobretudo sobretudo, que haja o respeito com as diferentes etnias e que a representação do índio no meio social não seja feita de forma ofensiva e sim como um apoio as às suas necessidades, pois uma identidade cultural não deve ser desvalorizada ou ridicularizada.']",120,120,120,120,120,600
94,,"['No período do Realismo brasileiro, os poetas se concentravam em abordar, nas suas obras, com objetividade, as mazelas na sociedade da época. Hodiernamente, é perceptível que caso essa escola literária ainda marcasse presença no corpo social, possivelmente, seus poetas não deixariam de abordar temas maléficos, sendo um desses: o autismo e seus desafios de inclusão, visto que essa questão se faz intrínseca na temática de discussão do Realismo, pois constitui um problema social. Desse modo, com o objetivo de continuar o legado desse grande marco na literatura brasileira, há de se discutir sobre as causas do problema, sendo elas: a insuficiência legislativa e a lenta mudança da mentalidade social.', 'A princípio, é de suma importância destacar que a deficiência legislativa constitui a permanência da problemática. No livro ""cidadão de papel"", de Gilberto Diminstein, é dissertado sobre s leis e prerrogativas as quais não possuem funcionalidade no meio social. Analogamente, faz-se possível encaixar tal alusão às legislativas de inclusão das pessoas autistas, tendo como exemplo a lei de educação especial prorrogada em 2015, visto que, apesar de essas leis estarem fazendo parte da legislação brasileira, não são realizadas em exercício real, dado que a grande problemática que reverbera as dificuldades de inclusão de autistas ainda serem um estorvo nos tempos atuais, como comprovado com dados do INEP , autarquia federal, os quais dizem que o número de cidadãos autistas matriculados nas escolas aumenta de maneira vagorosa.', 'Ademais, observa-se que a gradativa mudança de mentalidade corrobora para a perpetuação do problema. Na série ""The Good Doctor"", um médico autista, é impedido de examinar um paciente pelos seus pais, devido esses não desejarem um médico com (TEA), transtorno do espectro do autismo, atendendo seu filho. Dessa maneira, infere-se, que o seriado retrata um contexto fictício, contudo, remetente à realidade, uma vez que as dificuldades de interação de sujeitos sociais autistas se deverem muito ao fato de sofrerem uma espécie de preconceito por parte da sociedade, evidenciado uma estagnação do pensamento social em relação ao autismo, como é visto pelos pais do paciente na série ""The Good Doctor"".', 'Portanto, medidas são necessárias para neutralizar essas dificuldades. Nessa perspectiva, o governo federal, deve realizar, por meio de investimentos fiscais, campanhas publicitárias, em todo o Brasil, -que mostrem a discriminação e os desafios dos indivíduos autistas no seu dia a dia-, com o objetivo de conscientizar toda a população a respeitá-los e os ajudarem nas suas interações sociais . Somente assim, as leis que defendem os direitos de pessoas com deficit na comunicação social serão exercidas.']",160,160,120,160,160,760
83,Pressão vs Benefícios,"['No mês de agosto de 2016 o Rio de Janeiro está sediando as Olimpíadas e as Paralímpiadas. Com esse grande evento, algumas questões vem sendo levantadas, sobre por exemplo os benefícios que praticar esportes trás , (.) numa sociedade em que hoje em dia há muitos sedentários, o esporte vem para incentivar isso e mostrar o tanto de coisas que isso pode acarretar para a saúde, entre outras coisas.', 'Contudo, há um lado obscuro no mundo dos esportes, a grande pressão que eles vivem e que prejudica muito. Apesar de muitos manterem a pose de “vencer não é tão importante, o importante é participar”, nem sempre isso é verdade, muitos sofrem com a pressão da mídia, fãs, treinadores, pais etc... para vencer, e acabam muitas vezes usando de métodos errados para conseguir de qualquer modo chegar ao pódio.', 'Além disso, muitos atletas sofrem várias contusões ao longo da carreira, e isso fragiliza o corpo, o que causa muitos problemas de saúde. Ao mesmo tempo que o esporte faz bem para a saúde, ele também faz mal se usado de forma indevida e exagerada.', 'Existe também um acesso muito dificultado ás  olimpíadas por parte dos países pequenos e pobres, e muito preconceito com alguns atletas.', 'Concluímos, então, que o esporte feito de maneira correta trás muitos benefíciosa  saúde e ao corpo, porém também a muitas coisas obscuras por trás do mundo do esporte. Uma forma de melhorar seria reforçando os exames antidopings e uma maior vigilância, e também ter uma maior atenção com os treinadores e colegas dos atletas, para que assim se consiga evitar ou diminuir essa pressão exarcebada. Poderiam ser criados também projetos de inclusão aos países menos desenvolvidos, dando mais oportunidades a esses atletas.']",120,160,160,160,200,800
146,"Não basta legislar, tem que civilizar","['Racismo: triste página de nossa história que tão cedo não conseguiremos virar. Por quê? Porque, em vez de parecer com                metafórica banana que o jogador Daniel Alves deu a um torcedor racista         espanheiro         , o modo de lidar com o problema no Brasil de hoje         ainda agrava mais ele         . Procurar compensar os crimes do passado com medidas injustas, de caráter supostamente positivo, como as cotas raciais,         resultam         em mais tensão e menos união entre brancos e negros. Simples assim.', 'É a maneira típica de o governo brasileiro tratar seus problemas que está         errado         . Soluções por decreto só soluciona                a consciência culpada de quem as         produzem         . O                 tesão                de legislar e a dificuldade de perceber que a sociedade                 fatalmente         têm         grande probabilidade de fugir das legislações, ainda mais no país         do jeitinho brasileiro, acaba          fatalmente                seguindo a lei de Murphy.', 'Exemplos? Já criaram uma lei obrigando a vender banana a quilo, em vez de dúzia, como era costume nacional desde os tempos de dom Pedro. Outra lei         determinaram         o nível de álcool         proibida         no sangue dos motoristas, mas         possibilitaram-lhes         ao mesmo tempo fugir ao bafômetro. Resultado: tiveram que mudar a lei pouco depois,         pra         criar um jeito de         fragar         os bebuns.', 'Na minha opinião, a política de cotas é capaz de fazer o Brasil ser o primeiro país no mundo a ter um travesti na presidência da República. E daí? Mesmo assim os homossexuais         continuará a serem         espancados e assasinados noite         a fora         . A ""presidenta"" da República e                lei Maria da Penha         está         aí para provar a tese. Não basta legislar: tem que fiscalizar, educar, civilizar.']",120,200,160,160,160,800
83,Um gol para o desenvolvimento,"['O século XX ficou marcado com a popularização dos grandes eventos esportivos, como as Olímpiadas e Copa do Mundo. No contexto brasileiro, o futebol ganhou significativo destaque, pois permitiu que diversas pessoas, de distintas classes sociais e etnias, pudessem seguir uma carreira de sucesso, além de promover a geração de milhares de empregos de forma direta e indireta.', 'O futebol é o esporte que mais colaborou para a ascenção social neste país. Jogadores como Ronaldo Fenômeno e Dada Maravilha, saíram da periferia do Rio de Janeiro para se tornarem ídolos do esporte. Ademais, o futebol movimenta milhões de reais todos os anos, por meio de transmissões televisivas, venda de produtos esportivos e ingressos, n os quais, geram uma quantidade significativa de empregos. Desse modo, conclui-se que este esporte merece receber uma atenção maior, por parte de nossas autoridades.', 'Entretanto, a popularização do futebol trouxe para a sociedade um novo problema : A briga entre algumas torcidas organizadas ! A situação chegou em um grau de risco elevado, visto que em algumas cidades, clássicos regionais ficaram temporiariamente proibidos de serem realizados com a presença de duas torcidas, vide o clássico mineiro entre Atlético e Cruzeiro. Isto implica em consequências negativas para o mercado, pois afasta dos estádios, uma grande parcela do público consumidor.', 'Portanto, para o aperfeiçoamento deste esporte, é necessário que o governo, em parceria com a iniciativa privada, promovam novos investimentos, em regiões, onde o futebol ainda é praticado de forma amadora. Além disso, é importante que se crie uma delegacia especializada em grandes eventos esportivos, para que os problemas relativos à violência sejam amenizados de forma mais eficiente, excluindo os baderneiros. O futebol já nos ensinou que desenvolvimento econômico e social, podem sim, andar juntos.']",0,0,0,0,0,0
47,Escola em Casa,"['Isaac Asimov foi um escritor russo que previu em suas obras de ficção científica vários avanços tecnológicos e sociais, dentre esses, o ensino à distância. Em contrapartida, atualmente, o mundo está diante de uma pandemia viral, e essa situação propõe medidas preventivas como o isolamento social. Diante disso, a educação enfrenta diversos desafios para se manter presente na vida dos brasileiros. Nessa perspectiva, vale avaliar a importância da educação, e as dificuldades que os estudantes encontram para se adequarem a essa nova situação pandêmica.', 'A priori, a educação é um elemento fundamental para o desenvolvimento humano. Sendo assim, ela assegura que o indivíduo consiga evoluir no campo das ideias e, por consequência, ele conseguirá ascender profissional e pessoalmente. A exemplo disso, o filme “Escritores da Liberdade”, que foi baseado em fatos reais, traz como enredo uma professora que é desafiada a lidar com alunos rebeldes e que sofrem com a segregação social. Ademais, o filme retrata que a educação não só transforma a vida daqueles jovens como, também, exprime sentido vida da professora. Por isso, a educação é de extrema relevância na vida de todas as pessoas que compõem o núcleo escolar, sobretudo, a dos alunos.', 'A posteriori, diante do impacto social do novo coronavírus, a educação está sendo gravemente afetada. Por consequência, os alunos enfrentam muitas dificuldades para lidarem com essa problemática. Segundo o portal de notícias UOL, cerca de 48,5 milhões de brasileiros estão sem acesso s aulas presenciais. No entanto, esses números refletem uma discrepância socioeconômica entre esses indivíduos, pois muitos deles não possuem acesso à internet e materiais básicos para terem aulas à distância . Porém, os fatores de ansiedade e incerteza os englobam na mesma categoria nociva dessa pandemia e que, também, agravam os seus estudos. Dessa maneira, medidas devem ser tomadas para remediar esses aspectos prejudiciais.', 'Percebe-se, portanto, que a educação é fundamental para as pessoas e que o ensino à distância necessita de mecanismos para ser eficaz para a população. Dessarte, é necessário que o Ministério da Educação  crie um projeto intitulado “Escola em Casa”, que visa a unificação do acesso ao ensino à distância. Neste projeto, valerá a proposta de distribuir materiais didáticos como livros, videoaulas de professores e psicólogos em formato de mídias de DVD. Também, faz-se necessário a elaboração de aplicativos com o mesmo intuito educacional para aqueles que possuem acesso à internet. Assim, será possível agregar a todos em igualdade e superar a instabilidade emocional e, com isso, unificar o ensino à distância já previsto pelo escritor Isaac Asimov.']",160,160,160,200,160,840
89,pandemia,"['“A insatisfação é o primeiro passo para o progresso de um homem ou de uma nação”. A afirmação atribuída ao dramaturgo irlandês Oscar Wilde pode ser facilmente aplicada a falta de conscientização da população sobre o isolamento social, já que é justamente a falta de incômodo social diante dessa vicissitude que a consolida como um regresso para a nação brasileira. Nesse sentido, essa situação de indiferença tem como origem inegável a falta de conhecimento populacional. Assim, não só a insuficiência legislativa como também a neutralização de rompimento de isolamento contribui para a problemática se neutralizar.', 'Em primeira análise, a falta de incomodo populacional se torna uma das causas para criação do caso clinico que vem gerado grande instabilidade tanto social como econômica diante de uma das maiores crises pandêmicas do século, quem tem a insuficiência legislativa como fator principal. As leis que entram em vigor por meio do poder legislativo só se configuram como uma falácia nesse grande caderno de leis que o Brasil possui. Que não tem poder eficaz, já que os números de transmissão da doença covid-19 e o numero de aglomeração que aumentam ainda mais o contagio tem aumentado significantemente.', 'Em paralelo, um governo que não visa o progresso coletivo está fadado ao fracasso, não há uma campanha que vise de forma eficaz diminuir o número de casos transmissíveis, fazendo assim que a saúde se desestruture . Caso como o de Manaus  que teve falta de oxigênio, expõem as vísceras uma sociedade que não se importa com o progresso populacional e nem como festinhas e bailes funks podem prejudicar não só eles, como também a população como um todo.', 'Depreende-se, portanto.  A importância do isolamento social, como algo essencial para a diminuição do aumento de contagio. Para isso o Estado precisar criar uma campanha de conscientização da importância do uso de mascara que diminuem a contagio viral e o evitamento de aglomerações, esses eventos podem ocorre por meio de lives, com a presença de infectologistas, utilizando como forma de enganchar a hashtag #eumeimporto. Além disso o Estado devera promover ainda o incentivo de medidas pragmáticas por meio da mídia que irá exibir as consequências da banalização desses tipos de medidas. Assim caso como falta de leitos e de oxigênio como o de Manaus não irão se repetir.']",160,160,160,200,160,840
45,O excesso de poder e o desvio de finalidade,"['No século XXI, diversos temas frequentes na política tem sido expostas pela máquina midiática no Brasil Não menos importante, uma delas é o abuso de autoridade. Entretanto, ao evidenciar esse cenário, é preciso aferir algumas manifestações que a caracteriza, como o excesso de poder e o desvio de finalidade de seus representantes . Por fim, cabe também considerar a atuaço do próprio aparato estatal no combate da problemática.', ""A priori, pode-se afirmar que o exercício da administração pública para ferir a dignidade humana de outrem incorpora a pauta em questão. Assim, esses agentes cometem atos de cunho autocrático sustentados pela sua posição na ordem social, e muitas vezes até preconceituosos como é o caso dos excesso de autoridade policial perante à população negra . Em paralelo, o evento polêmico da deputada Marielle Franco retrata tal realidade, visto que seu homicídio por milicianos para ''queima de arquivo'' denuncia essa postura arbitrária no Brasil . Desse modo, torna-se imprescindível uma manuntenção nos valores comportamentais dos que regem a democracia brasileira sob pena de deslegitimar o princípio isonômico da Constituição Cidadã, a qual proíbe que tal dignidade sofra abuso de poder."", 'Outrossim, o desvio de finalidade dos representantes políticos ainda marca esse quadro desafiador. Lamentavelmente, a maioria deles utiliza-se de sua posição para obter determinadas vantagens seja para realização pessoal, seja para impor sua ideologia. Esta pode ser esclarecida com o exemplo do governo Jânio Quadros em 1961.Com um mandato moralista, censurou uso de biquíni na praia, jogos de galinha e até o carnaval de rua sem consultar o povo. Logo o episódio revela uma circunstância que foge do ideal de uma política para o bem comum, já que se conduz de pensamentos individuais. Portanto, tangenciando o intuito democrático de respeitar o povo e governar para todos, conforme defende o presidente Luís Inácio Lula da Silva.', ""Em suma, no Brasil, o abuso de autoridade marca o seu cotidiano até então. Para mudar esse panorama, o Governo Federal, juntamente com o Ministério Público, deve implementar o projeto ''Erros de Conduta'' destinado aos agentes públicos das esferas políticas do país . Esse sarau acontecerá mensalmente nos centros administrativos federais. Através de palestras e apresentação de documentários, o objetivo é sensibilizar esses sujeitos como forma de coibir que futuramente cometam excesso de autoridade. Além do mais, com uma formação política durante o mandato, o ideal democrático será atingido com mais vigor. Feito isso, a premissa de Rosseau ''a vontade geral deve emanar de todos para ser aplicada a todos'' será efetivada por meio da superação do tema.""]",160,120,120,160,120,680
56,A educação fecha prisões!,"['Atualmente, o Brasil possui o terceiro maior número de presos do mundo, extrapolando 800 mil, de acordo com a projeção da organização não-governamental ""Human Rights Watch"". Nesse contexto, verifica-se que o atual sistema carcerário brasileiro se encontra falido, uma vez que, por um lado, há um descaso com a educação no país, por outro lado, uma ausência de recursos públicos destinados à construção e à manutenção de unidades prisionais.', 'Em primeira análise, a negligência com a educação no país reflete, de certa forma, na atual situação carcerária brasileira, pois um sistema educacional precário e deficitário – no qual os professores não são devidamente valorizados, as escolas com péssimas condições físicas e financeiras e os alunos sem o incentivo aos estudos  – expõe diretamente os cidadão às desordens e à vida desonesta. Nesse sentido, o mundo do crime, pelo caminho mais rápido e fácil, torna-se mais atrativo, à primeira vista, posto que não se enxerga na educação um futuro promissor para o desenvolvimento pleno da pessoas humana. Com isso, infelizmente, a população carcerária tende aumentar cada vez.', 'Em segunda análise, muitas vezes, os presos são submetidos a insalubres condições de sobrevivência nas cadeias, tendo que dividir a cela com dezenas de pessoas, quando, na verdade, apenas poucos são permitidos. Este quadro aterrador é possível graças à incompetência do Estado, já que não existe projetos que venham ampliar os cárceres, dada à exorbitante superpopulação, nem políticas de manutenção nas unidades. Com efeito, tais empecilhos, segundo o sociólogo francês Émile Durkheim, retarda a lei restitutiva, segundo a qual indivíduo na prisão aprenderia a restaurar as antigas relações sociais.', 'Portanto, em face ao falido sistema carcerário brasileiro, antes de tudo, o governo deveria ampliar os investimentos destinados para educação, visando a proporcionar um sistema educacional eficiente no qual as pessoas tenham, além de uma educação de qualidade, uma escola com boas infraestrutura e os professores reconhecidos. Dessa forma, teríamos , certamente, um reduzido número de presos no Brasil.']",160,160,160,200,120,800
149,Medo de pisar? Não Andarás!,"['Com a necessidade de exploração do espaço pelo seres humanos, diante das incertezas sobre as condições de vida futura na         terra         , surgem cada vez mais pesquisas e excursões para                 fora da terra                . Dentre elas, o projeto de colonização de         marte         , previsto para 2023, que sem dúvida será um ousado e importante passo para o homem.', '“Este é um pequeno passo para um homem, e um salto gigante para a humanidade”.         Esta         foi a frase de Neil Armstrong, após pisar pela primeira vez na         lua         em 1969.         Neste          satélite, as temperaturas chegam cerca de 100 ºC durante o dia e -175 ºC a noite.                Após 53 anos, os participantes do empreendimento para         marte         , irão enfrentar uma temperatura média de -63 ºC, com melhor tecnologia disponível.', 'Quando                 os tripulantes                instalarem-se no “planeta vermelho”,                 poderão ser utilizados                para pesquisas e envio de         informações. Pois         terão capacidade de fazer tarefas mais complexas do que os robôs, que atualmente possuem limitações para tais atividades. O envio constante de         suplementos         e material de apoio será o diferencial para prosseguirem.', 'Além do mais, este feito vai gerar reações positivas em âmbito internacional em relação          a          exploração da galáxia. Ele poderá difundir o assunto para todo o mundo atingindo pessoas pouco informadas. Além disso                , servir de influência e parâmetro para outras pesquisas e investimentos na área.', 'Diante disso, o plano de colonização de         marte         mostra que o homem precisa agir de forma mais incisiva na exploração do espaço.         Deve-se         haver maior direcionamento de capital e maior conhecimento da população para esses projetos e pesquisas, mesmo que sejam muito ousados. A mídia, empresas e o governo podem trabalhar em conjunto neste sentido.                 “Quem nunca errou, nunca experimentou algo novo”, Albert Einstein.']",160,160,120,120,120,680
51,Precariedade da educação,"['Não há como negar que o analfabetismo funcional no Brasil é um tema reincidente . O analfabetismo funcional mostra em grande clareza a retrocedencia e os resultados de uma educação precária que ainda se faz presente nos meios educacionais brasileiros.', 'Em uma primeira análise, verifica-se que o assunto em questão atinge em grande maioria adultos e adolescentes , que apesar de apresentarem formação básica não conseguem compreender e fazer discernimento correto sobre os meios textuais e outros.', 'Pode-se visualizar nessa temática quê, o principal motivo do analfabetismo ainda persistir na sociedade é porque a educação básica não é regida de forma correta, e que o modelo de ensino é vago e desatento.', 'Podemos perceber isso de modo prático quando uma parcela de indivíduos demonstra baixo ou total desconhecimento ou compreensão daquilo que lê, Isto é apesar de saberem ler não conseguem entender aquilo que é proposto pelo meio.', 'Sendo assim, o Ministério da Educação  deve tomar medidas efetivas que se façam presentes principalmente na educação básica. Como exemplo a melhora da capacitação de profissionais do ramo educacional . ara que esses profissionais sejam mais atentos e promovam educação de qualidade, atendendo de modo mais efetivo a dificuldade de compreensão e sendo mais aptos a visualização do problema.']",120,120,120,120,120,600
51,Analfabetismo funcional,"['O analfabetismo funcional é a incapacidade que pessoas possuem para interpretar textos e realizar operações matemáticas, muitos, se formaram ou concluíram o ensino superior. Parece bizarro, mas é a realidade do nosso país que tende aumentar ao longo dos anos se não for resolvido quanto antes.', 'O índice de analfabetismo no Brasil é grande, e suas consequências são maiores ainda . A falta de interpretação de textos pode atrapalhar a vida pessoal e profissional do indivíduo, e os levam a cair em golpes e nas famosas fake news, tanto quanto a dificuldade em realizar operações matemáticas, já que são elementos básicos usados no nosso cotidiano.', 'Podemos considerar esse problema como um ciclo vicioso, pois se um adulto não possui a prática da leitura, não irá influenciar os mais jovens, e assim sucessivamente . Pode parecer “loucura”, mas existem professores que também possuem as mesmas dificuldades , e consequentemente,  não irão motivar seus alunos essa prática, aumentando cada vez mais o índice de analfabetismo no Brasil.', 'Todo esse acontecimento é resultado da falta de investimento na educação do nosso país, o governo “empurra com barriga” esse obstáculo, agem como se o mínimo que fazem fosse o suficiente, mas sabemos  que não, nosso povo precisa mais do que isso.', 'Investir nas bibliotecas será um ótimo começo para o avanço dessa causa, alunos ou não, terão acompanhamento adequado para suas leituras com bons livros que despertam suas imaginações, os ajudando no desempenho na interpretação de textos . Escolas integrais também são uma ótima solução, onde os alunos terão um aproveitamento maior das aulas para aprender corretamente a fazer cálculos e praticar sua leitura.']",160,160,120,160,120,720
43,A Necessidade de Discutir o Cancelamento,"['Com o aumento do uso das redes sociais, notamos que os internautas se sentem a vontade para manifestar suas opiniões, sobre os mais variados temas. Esse grande fluxo de pensamentos divergentes, vem causando a ""cultura do cancelamento"" que consiste em julgar as pessoas por seus posicionamentos quando são considerados ofensivos e errados, deixar de consumir seus produtos e serviços, até que este melhore. O filósofo Zigmunt Bauman  em obras e entrevistas, nos abre reflexão sobre como apesar de úteis, as redes podem servir como armadilhas e para cair nelas  neste caso, basta um ato indevido.', 'Acontecimentos recentes podem exemplificar as proporções que essa mobilização em massa pode ter, como no caso da escritora da famosa saga de livros e filmes ""Harry Potter"". J. K. Rowling foi atacada após comentários transfóbicos, que resultaram em posicionamentos de atores do elenco dos filmes e dos fãs. É complicado para as celebridades se redimirem diante das mídias sociais, quando se envolve algum tipo de preconceito disfarçado de opinião, para tal seria necessário mostrar uma mudança de atitude real para aqueles que se magoaram e se ofenderam, para a internet simples desculpas não bastam.', 'A tese de Bauman sobre uma era de relacionamentos líquidos, se enquadra bem nesse contexto do cancelamento, pois assim como os relacionamentos, os cancelados são rapidamente descartados . Apesar de ser necessário apontar os erros para que o indivduo melhore como ser humano, ofender e insultar coloca quem está julgando na mesma condição do julgado. A abordagem da conduta inadequada de alguém deve ser feita em forma de debates e argumentação, afim de ensinar essa pessoa uma postura mais respeitosa. É importante que a evolução seja valorizada, sem ataques a todo instante pelo erro, a segunda chance deve ser verdadeira.', 'Para que tenhamos interações sociais nas redes de forma mais saudável, será imprescindível o trabalho da mídia , seja ele através da internet, televisão, jornal ou rádio. O fato é que quanto mais se debate e se mostram pontos de vistas sobre alguma temática, melhores as chances para a conscientização, e conversar sobre interações na redes sociais no ambiente escolar será essencial nessa busca para que as pessoas tentem educar antes de se decidir cancelar.']",120,160,120,120,120,640
73,"Desafios sociais enfrentados pelos negros, uma discussão sociológica","['Pelas palavras do cientista Albert Einstein,  “o importante é não parar de questionar”. Então, sabe-se que os desafios encontrados pelos negros frente à sociedade capitalista, desigual socioeconomicamente e preconceituosa, enquadram-se em explicações históricas e culturais, n qua logo após a abolição da escravatura em 1888, os negros foram deixados à margem da sociedade, sem amparo civilizatório. Dessa forma, a construção social numa configuração de âmbito educacional é crucial para delimitar novos caminhos éticos à população, bem como as instituições sociais defendidas pelo sociólogo francês Émile Durkheim precisam assegurar qualidade e ação efetiva.', 'Com base nessas considerações, percebe-se  quão emergencial algumas resoluções precisam engendrar a construção social, ou seja, a sociedade carece entender que culturalmente a formação social de uma civilização é precedida por inúmeros fatores étnicos, políticos, econômicos e religiosos. Mas, para tal perpetuação consolidar tais reflexões sociológicas o âmbito escolar deve se fazer protagonista e, desta forma, propiciar novos parâmetros socioculturais frente uma ética nacional ainda repleta de antagonismos como preconceito, exclusão e desigualdade.', 'Nesse contexto, e relevando as palavras do sociólogo, antropólogo e cientista político Émile Durlkheim tocante à importância das instituições sociais – família, escola, sistema judiciário e o Estado, são exemplos que congregam elementos e sustentam a permanência cívica em condições democráticas justas. Todavia, é preciso que tais forças sociais tenham ações eficazes e efetivas. Pois quando inexistem  todos perdem e o caos ganha espaço na violência cotidiana, passando pelas dificuldades já discutidas pelos povos afrodescendentes da América do Sul.', 'Esse direcionamento mostrou que há uma necessidade em discutir a relação dos negros e seus desafios atuais, porque embora a contemporaneidade mostre ascensão social dessa população, cotas nas universidades e políticas públicas de inclusão, ainda os impasses são existentes. Portanto, é imprescindível que o Ministério da Educação junto à grande média brasileira , construa um projeto pedagógico de propaganda assistida que fomente a precisão de frequentar estudos éticos, colocando a sociologia e a história como quadro aderente a esta ação conjunto. Para tanto, seria desenvolvido nas escolas públicas e privadas os espaços de ensinamentos constitucionais, respeito e cidadania. De forma que integrem currículo obrigatório nas academias de educação. No mais, essas premissas serão implacáveis para um país promissor e democraticamente correto.']",120,160,160,160,120,720
55,Povos indígenas e seus desafios,"['Nos dias de hoje é evidente que vemos várias ações que desrespeitam os direitos aos povos indígenas como a demarcação de terras , o extrativismo ilegal e o desmatamento. Mesmo tendo seus direitos garantidos pela constituição ederal.', 'Aqui no Brasil podemos dizer que os problemas em relação aos povos indígenas não surgiram apenas nas últimas décadas mas vem se alastrando desde a chegada dos europeus, quando os mesmos chegaram ao território brasileiro no século XV , tivemos o que podemos  chamar de etnocídio  ou seja os índios foram submetidos a cultura portuguesa, os índios serviam como mão de obra para a extração do pau-brasil e para construir feitorias pelo litoral.', 'Segundo dados do IBGE em 2010 existiam 896,9 mil indígenas com presença em todos os estados do país, são 305 etnias, que falam 274 línguas, e atualmente existem 462 terras indígenas regularizadas que representam 12,2% do território nacional. Porém temos relatos de invasão a essas áreas muitas das vezes por fazendeiros e posseiros com o objetivo de retirar a madeira e até para a criação de gado.', 'Para começar temos um obstáculo a ser enfrentado aqui no país que é a falta de valorização dos povos indígenas , poucos sabem de sua importância para a formação e consolidação do pas, e a invasão das terras poderia ser impedida por uma fiscalização mais eficiente  utilizando tecnologias para localizar as áreas invadidas com mais precisão e realizar um monitoramento frequente nas áreas demarcadas.']",120,120,80,120,80,520
86,Redes sociais e sua vertente dúbia,"['A cibercultura, termo utilizado por Pierre Levy para descrever o processo de troca de dados na sociedade da informação, retrata como que o avanço tecnológico tem permitido uma maior interligação entre os diversos países acarretando transformações econômicas, políticas e sociais. No âmbito social é possível observar mudanças significativas, especialmente com o advento das redes sociais, as quais podem ser analisadas tanto pelo aspecto positivo quanto negativo.', 'Em primeiro lugar, a contribuição das redes sociais perpassa pela questão do capital cultural, pontuado por Pierre Bourdieu, uma vez que as mesmas, ao facilitar o acesso ao acontecimento de outros povos e outros costumes, possibilita o alargamento desse capital, de maneira a enriquecê-lo com outros saberes e outras perspectivas. Desse modo, essas plataformas além de favorecer essa troca de informação estimula também um espaço de debate, onde temáticas de diversas modalidades são discutidas. Portanto, as redes sociais atua como um instrumento relevante para a construção do conhecimento entre as pessoas.', 'Ademais, deve ser considerado nesse percurso os efeitos negativos desse canal de comunicação, principalmente no que se refere ao seu impacto na saúde mental. Nesse parâmetro, como ressaltado pelos textos norteadores, as redes sociais pode levar as pessoas a uma certa dependência, já que ela pode vir a atuar como uma fonte de escape, de fuga das adversidades do mundo real. Nesse sentido, as redes acabam evidenciando o seu paradoxo, pois ao invés de promover a socialização do sujeito, o leva ao isolamento, restringindo sua vida ao ambiente virtual.', 'Sendo assim, faz-se necessário medidas que possam amenizar esse tipo de impacto na saúde das pessoas. Para tanto, as próprias plataformas sociais como o instagram, o twitter e o Facebook devem alertar os usuários sobre o excesso que seu uso pode causar a saúde dos mesmos. Paralelamente, os Ministérios da saúde e da comunicação devem realizar campanhas publicitárias para conscientizar a população sobre a utilização adequada das redes sociais com o objetivo de evitar possíveis danos a saúde psíquica dos sujeitos.']",160,160,120,200,160,800
69,Os Efeitos Dos Agrotóxicos No Brasil,"['Na atualidade, o Brasil continua sendo um dos países que mais consomem agrotóxicos anualmente, cerca de 5,2 litros por habitantes. Tais agrotóxicos que possuem uma forte importância na agricultura,  também acarretam vários efeitos negativos.', 'Em primeira instância, cabe citar o caso do DDT, um pesticida altamente perigoso ecologicamente, onde no Brasil já foi proibido sua fabricação, bem como sua exportacão e importação, pois sua aplicação não matavam apenas s pragas (insetos, fungos, etc.) as também várias outras espécies consideradas predadores naturais dessas pragas, como, por exemplo: s minhocas.', 'Além disso, vale lembrar que: e o uso dos agrotóxicos podem comprometer os lagos, várias espécies de animais, saúde humana, e ecologia natural, então, consequentmente, seu uso vai contra à Constituição Federal de 1988, que assegura o direito de todos ao meio ambiente ecologicamente equilibrado.', 'Assim, fica evidente, que baseado em tais fatores mencionados, o uso dos agrotóxicos, em geral, causam péssimos efeitos ecológicos, e, seu uso deve ser minimizado ao possível, então, cabe ao sistema legislativo federal criar leis,  que regulem e fiscalizem quantidade máxima de agrotóxicos que podem ser usada pelas empregas agrícolas. Além disso, toda a participação dos órgãos públicos é valida, uma vez que s escolas podem criar eventos com palestras interativas que, possam informar aos defensores de seu uso sobre seus efeitos negativos.']",120,120,120,120,120,600
52,Gravidez na adolescência,"['A taxa de fertilidade entre jovens continua crescendo a cada ano,sempre afetando principalmente aqueles com a falta de acesso a informação e aos mais vulneráveis. Mais da metade dessa população em seu ensino médio, possui uma vida sexualmente ativa,o que entra em outra questão,a educação sexual nas escolas . Visto que, esse assunto se tornou um tabu na sociedade, as mídias sociais vem trazendo novas formas de conscientização, já que esse tema tem sido pouco discutido entre pais e os jovens.', 'A série ""Sex education"" da Netflix, aborda todos esses fatores , principalmente a gravidez precoce. A personagem ""Maeve"" encara essa realidade de forma transparente,obtendo como caminho o aborto.', ""É necessário, além das mídias, a ampliação de recursos para os mais escassos de informação,como palestras,depoimentos e a inclusão da matéria ' educação sexual', como parte da grade escolar.""]",120,80,40,80,80,400
19,A importância do conhecimento no combate à manipulação política,"['Após a eleição do empresário Donald Trump à presidência dos Estados Unidos da América pelo Partido Republicano, a discussão ao redor do mundo sobre as redes sociais como instrumento de manipulação política tornou-se mais frequente e mais importante. Com a proximidade das eleições presidenciais no Brasil, surge a seguinte questão: como os brasileiros podem enfrentar a manipulação política nas redes sociais e exercer o direito ao voto de modo consciente?', 'Os especialistas em educação tendem a convergir para a ideia de só ser possível não ser vítima de qualquer tipo de manipulação, em especial a de natureza política, por meio do desenvolvimento apurado de um senso crítico, o que só ocorrerá, segundo esses estudiosos, através da busca por conhecimento e da reflexão (sendo aquela uma condição essencial para esta ) constantes sobre vários temas socialmente relevantes, como educação, saúde, segurança, economia, direitos humanos, entre outros.', 'É de conhecimento geral, entretanto, que uma das mais seguras fontes de conhecimento (e, portanto, uma ótima ferramenta para auxiliar no desenvolvimento da capacidade de reflexão), a leitura, não está entre os hábitos culturais do brasileiro médio, fato possível de ser comprovado com o auxílio de pesquisas como a publicada em 2015 pela agência Nop World, segundo a qual o Brasil perde em horas de leitura por pessoa até para países vizinhos também considerados em desenvolvimento, como Argentina, Venezuela e México.', 'Mesmo assim, seria possível argumentar que há outros meios válidos além da leitura para a obtenção de conhecimento, como a audiência a programas culturais nos meios de comunicação audiovisuais de massa (televisão e internet), mas o fato é que, segundo o mesmo levantamento de 2015, apesar de o brasileiro passar muitas horas a mais em frente a esses veículos do que as que passa lendo, esses momentos são dedicados justamente a conteúdos não atrelados à cultura, invalidando, pois, essa linha de argumentação, e mantendo o eleitor médio à mercê da manipulação política por diversos meios.', 'É possível concluir, portanto, que a única maneira pela qual os brasileiros podem enfrentar a manipulação política pelas redes sociais, ou por quaisquer outros meios, e exercer o voto consciente é com a mudança radical de seus hábitos culturais no sentido de ampliar a busca pelo conhecimento para o desenvolvimento do senso crítico necessário à participação política efetiva, com essa transformação passando, necessariamente, pela ação governamental com a formulação e o aperfeiçoamento frequentes de novos projetos de incentivo à educação e à cultura de modo a, primeiro, conscientizar a população da importância do conhecimento nas mais diferentes áreas da vida e, depois, tornar cada vez mais acessíveis esses conhecimentos.']",200,200,200,200,200,1000
83,O esporte na superação das diferenças,"['A prática dos esportes sempre esteve junto com os hábitos para manter uma vida saudável, junto com um alimentação correta. O imenso ponto positivo de tudo, é que ele não se resume a saúde do indivíduo e, sim, a saúde da sociedade.', 'É possível ver os benefícios do esporte na vida das pessoas que praticam. Desde o físico até o psicológico do indivíduo, a melhoria é perceptível. Vê-se os efeitos junto com a nova moda ""fitness"".', 'Não só no indivíduo, mas também na sociedade. Como por exemplo, nas favelas e um outros meios, o esporte serve como uma aliança, ensinando na prática a união e, por consequência, a superar as diferenças uns com os outros. Assim, o esporte pode ser um bom meio para o entrosamento entre os diferentes grupos sociais.', 'Na outra forma, o esporte pode mostrar para cada um ensinamentos para lidar na vida toda. A participação pode ser um  meio positivo nos aprendizados de saber perder, ganhar, se importar com o outro. Esse pode ser um prêmio muito maior que uma medalha. Colabora na formação do indivíduo de forma positiva e essencial.', 'Dessa forma, a escola pode ser um bom meio para iniciar o uso do esporte para esse propósito. As prefeituras, junto com as secretarias de educação, podem usar suas as escolas como palco para superar as diferenças de cada um.']",160,160,120,120,200,760
49,Os malefícios causados pelos influenciadores digitais,"['Sócrates dizia ""Só sei que nada sei"", assim concluía que somente reconhecendo sua ignorância,  buscaria mais conhecimentos. Esse pensamento é o oposto do que a sociedade atual segue, na qual não há busca por conhecimentos , acredita-se no que os outros dizem. Nessa esfera, os influenciadores digitais atuam como verdadeiros manipuladores de seu público, ocasionando várias consequências .', 'A priori, com o advento da tecnologia, as redes sociais passaram a ocupar maior parte do tempo das pessoas. Assim, famosos servem como ""modelos físico-comportamentais"" dessa nova geração. Nesse contexto, esses manipuladores influenciam também quanto ao isolamento social,  durante essa época de pandemia , levando muitas vezes, pessoas consideradas grupo de risco a serem contra o isolamento . Dessa maneira, ""vendem"" suas opiniões, persuadindo seus seguidores.', 'Ademais, de acordo com Karl Marx, o ser humano é alienado pelo trabalho, como ocorre com pessoas que não param de trabalhar . Nesse panorama, é notável a alienação dos indivíduos pelas redes sociais, seguindo  a corrente obscurantista . Por conseguinte, há o fomento das fake news, consumismo, a busca pelo ""corpo perfeito"", xenofobia, entre outros problemas que comprometem o bemestar social.', 'Diante do exposto, é necessário que o Ministério da Educação e da Cultura alertem a população sobre os influencers digitais, por meio de redes sociais, jornais, revistas, televisões, rádios . Nesse sentido, é crucial convencer a população de sempre verificar dados, pesquisar a veracidade da fonte . Desse modo, a população seguirá o pensamento de Sócrates e se libertará da alienação social discutida por Marx.']",160,160,120,160,120,720
68,valorizar é necessario,"['O Museu Nacional Brasileiro é um dos maiores do mundo, com cerca de 20 milhões de itens, entrementes  com o incêndio ocorrido no dia dois de setembro, houve uma perda de acervos irrecuperáveis para a humanidade. Demonstrando assim, a irresponsabilidade e a ineficácia de políticas públicas além da desvalorização de um patrimônio histórico de suma importância.', 'Sabe-se que os museus abrigam uma ampla e grande variedade de objetos histórico que, por conseguinte, perpassam à inúmeras gerações conhecimento e cultura, pois nestes é possível entender a história de um modo divertido e lúdico, pode-se ter a oportunidade de observar artefatos de milhares de anos atrás de diversas tribos extintas, o que promove uma maior interação aos que visitam um museu, porém, com o incêndio ocorrido, denuncia-se, a falta de cuidado e proteção ao museu.', 'É notório salientar que, outro fator existente que surge do acontecimento decorrido,  é a desvalorização do patrimônio histórico, visto que, acerca dessa problemática  não há a devida importância aos fatos de um local que serviu até mesmo de residência para a Família Real no século XIX.  e que perdeu cerca de 90 % de seus itens e relíquias existentes devido ao incêndio.', 'Em virtude dos fatos mencionados, faz-se necessário que o Governo invista em mais segurança e proteção aos museus e seus semelhantes, por meio de um aumento nas verbas, para que assim evite futuros acontecimentos de igual nível. Além disso a mídia deve atuar seja por meio de campanhas ou exibições alternadas nos mais variados meios de comunicação, como, por exemplo, no rádio, na televisão e em redes sociais  contribuindo assim para a conscientização da população acerca da importância de valorizar o que é do aís, ou seja, do que pertence aos próprios cidadãos em geral.']",120,160,120,160,120,680
71,,"['O suicídio é uma das principais causas de morte entre os jovens e a adoção de medidas para modificar essa situação se faz necessária. Muitos fatores podem contribuir para que um adolescente opte por se matar. Dentre eles, a insegurança gerada pela busca de se encaixar nos padrões impostos pela sociedade – incluindo familiares e pessoas próximas – e a dificuldade em buscar ajuda.', 'Deve-se levar em consideração que, ao ditar a forma com a qual uma pessoa deve se vestir, o corte de cabelo a usar e o corpo bonito e ideal que ela deve ter, a sociedade gera uma dificuldade de autoaceitação que culmina num nível de insegurança que muitos jovens não conseguem suportar. As pessoas próximas devem sempre apoiar os jovens e permitirem – de uma forma saudável- que eles descubram que não precisam atender a essas exigências superficiais impostas para serem felizes, importantes e amados.', 'Um outro fator importante é que os adolescentes, muitas das vezes, não têm coragem de procurar ajuda, visto que grande parte nem sabe que esse sofrimento pode ser amenizado com tratamento adequado. O papel do governo e órgãos de saúde se faz importante nesse quadro, pois a divulgação do assunto, a orientação de como buscar ajuda e a oferta de ajuda especializada nos espaços de convívio desses adolescentes e nos canais de comunicação, poderiam contribuir para a diminuição de mortes por suicídio.', 'Portanto, atitudes para baixar os índices de suicídio entre os jovens devem ser tomadas. Cabe à sociedade e ao governo uma maior conscientização sobre o assunto para que ao agirem, juntos, consigam evitar esse tipo de morte comum entre pessoas jovens.']",120,120,120,120,120,600
97,Atos de Selvageria,"['No meio         do ano de 2013, até hoje, no início de 2014, o Brasil, principalmente         as         capitais dos estados, está sendo                 muito marcado                por manifestações e protestos que buscam reivindicar                 diversos problemas                que permeiam         nessa         sociedade. Entretanto, o que era para ocorrer de maneira         pacífica, está         sendo substituído pela violência entre baderneiros, infiltrados nesses protestos, e a polícia.', 'A polícia existe para manter a sociedade                 em          harmonia  , e         quando algo acontece que muda esse cenário, ela é chamada para controlá-lo. E         esses cenários         de violência,         depredamento         de bens públicos e privados, que ocorrem em algumas dessas manifestacões, vão         de encontro ao         que a polícia deve combater para assegurar os direitos de outros cidadãos que não provocaram os atos de selvageria, mas que estão sendo atingidos por eles.', 'Mesmo que a polícia necessite agir com severidade para controlar o                 tumulto                , ela também não pode infringir os direitos dos                 tumultuadores                que devem ser tratados como                 rege a          constituição         .', 'Nesses casos de manifestações que                 afloram a pacificidade                , a polícia cumpre o seu papel, tentando manter a sociedade em ordem.']",120,120,120,120,0,480
86,"Impacto do uso das redes sociais na saúde mental, uma discussão social","['Segundo o sociólogo polonês Zygmunt Bauman: “as redes sociais são uma armadilha”. tal concepção é pautada num cenário globalizado, cuja sociabilidade entre indivíduos vem sendo atrelada às redes sociais e as negativas pelas quais podem vir a sofrerem por não distinguirem virtualidade de realidade de vida. Dessa forma, a utilização dessas plataformas digitais precisa de atenção, respeito e, acima de tudo, responsabilidade. Então, as problemáticas envolvendo discurso de ódio nas redes e o dito cancelamento na internet , equacionam uma sociedade desequilibrada, da qual a saúde humana pode ser mais afetada.', 'Nesse contexto, o escritor italiano Umberto Eco já afirma: “a internet deu voz aos ignorantes”. Em visto disso, a polarização do discurso de ódio pela internet por disseminar racismo, ofensas e desrespeito ao gênero ou orientação sexual reflete um ideal antiético e só agrava mais os descasos em sociedade – desigualdade, homofobia, machismo e outros. Então, isso representa uma anomalia social e pode prejudicar a fisiologia humana, seja mental ou fisicamente, pois nem todos possuem condições mentais de lidar com essas intolerâncias . Sendo assim, é perceptível uma liberdade perpetuada pela internet que, muitas vezes, pode levar alguns cometerem atos ruins e maldosos. E como afirma a filósofa brasileira Marilena Chauí: “a liberdade é um limite quando se tem respeito e empatia ao próximo”', 'Por conseguinte, infere-se a questão do dito cancelamento na internet como sinônimo de rebaixamento, exclusão e xingamentos dentro dos ambientes virtuais. Isto posto, por significar algo existencial até na realidade das sociedades contemporâneas, por exemplo, quando alguém é excluído só por ser de baixa renda ou não possuir diploma superior. Por isso, cancelar alguém nas redes  só porque emitiu um posicionamento diferente da maioria, não dá o direito de repreendê-lo, mas responder e pontuar críticas respeitadoras.', 'Com base nessas considerações, tangencia-se um certame social pela qual pode agravar a saúde do indivíduo. Logo, soluções precisam perfectibilizar resultados. Cabe ao Ministério da Cultura fomentar uma PEC – Proposta de Emenda Constitucional, na qual posso melhorar a divulgação (em horário nobre e páginas principais) de informações referente os perigos das redes sociais à saúde humana em meios midiáticos, jornais avulsos e televisivos. Tal incitativa deve permitir maiores esclarecimentos sobre o problema e ajuda os pais a protegerem seus filhos e amigos. Contudo, é por intermédio dessas resoluções pelas quais o cidadão consiga equilíbrio e vivência mais democrática.']",200,120,120,200,160,800
50,Desvalorização da ciência no Brasil,"['A ciência é de extrema importância na preservação da vida em todo o mundo. A varíola, por exemplo, foi responsável por epidemias mortíferas ao longo da história e, somente em 1798 o médico britânico Edward Jenner doi capaz de desenvolver uma vacina para essa doença. E graças a ciência em 1980 a varíola foi finalmente declarada erradicada pela OMS (Organização Mundial da Saúde) . Embora a ciência tenha se mostrado eficaz ao longo dos anos, assim como no combate à epidemias como a varíola, na contemporaneidade a comunidade científica enfrenta diversos problemas. No Brasil as circunstâncias não são diferentes, já que a ciência nacional precisa lidar com a falta de recursos e o corte no investimento público.', 'Primeiramente, é imperioso destacar a falta de recursos como um dos principais problemas que atravancam o desenvolvimento científico no Brasil . Essa carência, de acordo com o G1, tem resultado na paralisação de laboratórios nacionais, prejudicando a formação de novos pesquisadores , além de comprometer projetos já aprovados .', 'Em segundo lugar, o corte no investimento público agrava ainda mais a situação dos cientistas no país . Em 2019 o governo anunciou o congelamento de 42% das despesas de investimento do Ministério da Ciência, Tecnologia, Inovações e Comunicações . Tal medida reflete a desvalorização que a ciência enfrenta no Brasil, assim como a falta de reconhecimento por parte da população .', 'Entende-se, portanto,  a obrigação do governo federal em reconhecer o valor que a comunidade científica tem para o país e para cada indivíduo. Desse modo, cabe ao governo federal promover um aumento nas verbas destinadas ao Ministério da Ciência para o desenvolvimento de pesquisas e novos projetos científicos . Além disso, a comunidade deve atuar em conjunto para combater a desvalorização da ciência no Brasil, por meio de protestos, virtuais e em praças públicas, para que o governo, então pressionado pela população, priporcione a ciência seu devido reconhecimento . Apenas assim a comunidade científica pode prosperar no Brasile lutar pela prevenção da vida humana, como em epidemias e outras doenças que diariamente matam seres humanos.']",160,160,160,160,160,800
57,Democratização do acesso ao cinema,"['O “Cine Sesi”, evento criado pelo grupo SESI, tem como objetivo primordial levar a arte do cinema às ruas, buscando possibilitar que as pessoas mais desfavorecidas socialmente tenham conhecimento do tipo de cultura. Nesse sentido, vale ressaltar que a intenção da organização é democratizar o acesso ao cinema, contudo, encontra-se impossibilitada, dado que não recebe contribuições diretas do Estado para maiores progressos. Assim sendo, essa realidade desgastante se faz real devido à negligência estatal,  em não colaborar com o divertimento da população, bem como em detrimento do ideal enraizado na sociedade de que o cinema é uma cultura elitista.', 'Em primeira ordem, de acordo com a Constituição Federal de 1988, o lazer é um direito do cidadão. Todavia, a prática deturpa a teoria, uma vez que o Poder Público não direciona verbas significativas para consolidar o imperativo constitucional . Então, no que tange à democratização do acesso ao cinema no corpo social, essa falha monstruosa de falta de investimento governamental se torna um empecilho, pois com essa inoperância não existem maneiras de possibilitar a inclusão dessa cultura no cotidiano dos tupiniquins.', 'Somado a isso, na Grécia Antiga, o cinema — que na época, pela inexistência de muitos adereços tecnológicos, era teatral — era visto como um tipo de arte da elite grega. De maneira análoga, hodiernamente, o ideal criado no passado cresce de maneira exponencial na sociedade, já que a presença das classes médias e altas nas salas de cinema é gritante, além dos valores do ingressos serem altíssimos. No entanto, o projeto do grupo SESI serve para quebrar esse estereótipo e para propor às comunidades carentes o discernimento e a experiência destes no ambiente das telas.', 'Diante desses impasses, urge que o Ministério da Educação e da Cultura inclua no planejamento das escolas públicas —as quais possuem maior parte do público carente — passeios culturais, como idas ao cinema, além de custear a ida dos alunos por meio de um maior percentual de investimento — o qual será possibilitado por uma mudança na Lei de Diretrizes Orçamentárias—, com o fito de exercer a ordem constitucional de direito ao lazer na comunidade, além de democratizar o acesso ao cinema. Por outro lado, cabe ainda ao Ministério contribuir com projetos sociais de cinema nas ruas, para propor um maior avanço no processo inclusivo.']",120,160,80,120,80,560
85,,"['Há muitos anos, percebe-se claramente que o sistema democrático brasileiro é indireto e representativo. Desde 1988, quando foi promulgada a Constituição Federal, apenas quatro leis do código nacional vieram de projetos de iniciativa popular, ou seja, é indubitável que a soberania dos cidadãos é fraca, como também a participação popular.', 'Um exemplo que retrata o fracasso de projetos de leis com iniciativa popular, está na obra “Capitães da Areia” de Jorge Amado, na qual Pedro Bala, o líder que representa o grupo dos meninos ladrões e abandonados, ordena as regras, enquanto a maioria dos outros integrantes da equipe, quando às vezes faz algum projeto de normas, não élevada em consideração pelo chefe. Isso em geral, demonstra uma democracia representativa, no qual não há participação direta de todos.', 'A punição de um menor de idade da mesma forma que um adulto é uma proposta que poderia ser criada e debatida como lei de iniciativa popular para o Congresso Nacional. Usando-se como exemplo uma criança de 13 anos que tem a capacidade de roubar, assassinar e sequestrar seres humanos, também tem o merecimento de pagar pelo que fez da mesma forma que um adulto. É inadmissível privilegiar e proteger o adolescente sempre com a mesma desculpa de maturidade mental, pois se esse jovem sabe praticar uma atrocidade, deve conhecer as consequências disso, portanto precisa ser julgado e cumprir pena sem favorecimentos.', 'Além disso, não há dúvidas que a população do país será muito superior em fatores como seriedade, respeito, hábitos e modos por conta de uma possível aplicação dessa lei. A sociedade também ficará mais igualitária, justa e menos criminosa, já que todos serão julgados da mesma maneira e o jovem terá receio de praticar crimes.', 'Sendo assim, a possível iniciativa popular de tornar realidade o projeto de lei “A punição do menor de idade criminoso”, pode ajudar a acabar com essas travas que bloqueiam a real prática da soberania popular, e fazer com que a sociedade brasileira tenha um nível de rigorosidade bem maior. Com a implantação dessa norma, todas as pessoas que cometerem atrocidades, independente da idade, serão punidas da mesma forma, exceto em casos de acidente e ocasiões na qual o ser humano praticante do malefício, possui algum tipo de deficiência física ou mental.']",160,120,160,160,120,720
94,Exclusão social dos autistas,"['O filme norte-americano ""Temple Grandin"" aborda a vida de Temple Grandin, uma jovem que tem Transtorno do Espectro Autista (TEA) e que precisa lidar, diariamente, com o preconceito social e com a falta de inclusão escolar. Fora da ficção, muitos indivíduos que possuem distúrbio neurológico dessa ordem também enfrentam obstáculos que impedem a sua inserção social. Nessa temática, a mentalidade retrógrada da população, motivada pelo preconceito, e a falta de preparação pedagógica são os principais desafios para a inclusão de indivíduos como Temple Grandin e muitos outros.', 'Inicialmente, é importante citar a obra ""Estigma"", do filósofo Erving Goffman, na qual ele afirma que os indivíduos tendem a se distanciar e a evitar, ao máximo, o contato com pessoas que são diferentes do que é denominado ""normal"". Esse pensamento desenvolvido por Goffman explica o preconceito destinado às pessoas autistas, por exemplo. Isso porque a maioria das pessoas se mostra impaciente e desconfortável com a presença desses indivíduos, haja vista que eles têm pouca interação social, geralmente uma das principais características de quem possui TEA.', 'Ademais, a falta de preparação pedagógica intensifica, ainda mais, a exclusão do grupo de pessoas autistas. A esse respeito, pode-se mencionar a Política Nacional de Proteção dos Direitos das Pessoas com TEA, instituído em 2012 pela lei 12764, que garante acesso à educação com adaptações cabíveis que contemplem suas necessidades. Ocorre que essa política é negligenciada, uma vez que o atual sistema educacional brasileiro é despreparado, já que possui uma educação ""plural"", ou seja, que atende apenas os indivíduos que não possuem nenhum distúrbio mental, impossibilitando, assim, que alunos que tenham algum tipo de atraso no desenvolvimento da aprendizagem, a exemplo de grande parte dos autistas, consigam aprender os conteúdos propostos. É fulcral, desse modo, que os professores sejam mais preparados para que possam atender as necessidades de pessoas com dificuldades  semelhantes s de Grandin, por exemplo.', 'Portanto, é essencial que o Ministério da Educação, por meio da mídia- em especial os meios de comunicação, a exemplo do rádio e da televisão, dado que têm maior abrangência social-, elabore campanhas informativas acerca do Transtorno do Espectro Autista. Isso será feito com o objetivo de desconstruir a mentalidade preconceituosa e ultrapassada da sociedade brasileira. Além disso, o mesmo agente deve investir na preparação dos professores para que eles consigam desenvolver técnicas de ensino de acordo com a necessidade de cada aluno, atendendo, assim, ao que é proposto na lei 12764.']",160,160,80,200,120,720
71,Suicídio entre os jovens,"['A configuração moderna de sociedade nos trouxe  os mais diversos benefícios. Entretanto, evidente são os diversos malefícios que, hoje, contribuem para taxas de infelicidade e suicídio alarmantes . Esse fator, assim como suas causas, apresenta-se como temas que, na lógica de dependência da sociedade em criticar suas tradições, de Jugen Habermas, devem ser discutidos.', 'Primeiramente, altos índices de suicídio estão intimamente ligados à pressão e ao estresse, constantes problemas contemporâneos. Um exemplo disso são países como a Coreia do Sul e Japão, que, devido à competitividade e expectativas colocadas em estudantes e jovens, possuem as maiores incidências do mundo. Nessa vertente, é imprescindível ver essa problemática com olhos críticos para efetivamente vence-la.', 'Além disso, o estigma associado à procura por ajuda profissional psiquiátrica é um obstáculo para tratamento de depressão e ansiedade. Esse efeito é especialmente danoso para estudantes,  devido à quantidade de pressão familiar/social, somado ao fato do cérebro humano estar em desenvolvimento até os 25 anos, que nos torna ainda mais sujeitos à essa pressão. Com isso, percebe-se que esses desafios, legado da organização social moderna, não recebe devida atenção, dificultando o dialogo critico necessário, como prescrito por Habermas , para reduzir os impactos e sofrimento causado por esse mal.', 'Sendo assim, dado a seriedade do assunto, bem como o envolvimento social, que, essencialmente agrava o problema na atual conjuntura, faz-se imperativo que atitudes sejam tomadas. É dever do governo, em seu papel de gestor dos interesses públicos, trazer a devida atenção para doenças mentais. Pode-se atingir esse objetivo por meio de campanhas publicitária, entrevistas e palestras com psiquiatras, principalmente em ambientes universitários, a fim de atingir a maior quantidade de jovens possível, e, nesse processo, reduzir o estigma atribuído ao tema. Espera-se assim, por meio do dialogo crítico, seguir a ideia de Habermas, e propriamente avançar a sociedade.', 'nota: deu 28 linhas escrito em papel.']",120,160,120,160,120,680
126,Todos devem ter o mesmo direito,"['A alguns anos atrás          , após muito tempo de          luta          os estudantes finalmente conquistaram o direito a meia-entrada em shows, cinemas, atividades          cultural          e em passagem de ônibus. Foi considerada uma enorme vitória e a maior parte da população apoiou a causa.', 'Após esta nova lei estabelecida         foi necessário fazer                 uma série de mudanças para que as empresas e os clientes continuassem no lucro referente aos preços pagos nas entradas dos eventos. Porém isso não reflete na situação atual, uma vez que o valor do ingresso precisa ser muito além do normal para que a direção dos eventos possa arcar com todos os gastos.                Os responsáveis         de         pagar pela quantia que os beneficiários não desembolsam são os pagantes das entradas inteiras, os quais não         tem         nenhuma vantagem em relação a essa nova lei.', 'Essas questões precisam ser revistas, para que todos os cidadãos possam usufruir de um bom evento a um preço acessível. O que precisa ser feito é estabelecer um equilíbrio no valor dos ingressos, muitas vezes uma pessoa não é estudante, mas também não possui condições para pagar pelo valor integral da entrada. Em relação a meia-passagem quem deve ter o direito são as pessoas que necessitam utilizar o transporte público todos os dias e não recebem nenhuma ajuda do empregador ou possui trabalho autônomo.']",120,120,80,120,80,520
43,A cultura do cancelamento nas Redes Sociais,"['Com o constante avanço das redes sociais e com as críticas advindas delas, a cultura do cancelamento, ou seja, ignorar um indivíduo nas redes sociais por ter feito algo julgado como ruim pelos usuários, faz com que a pessoa que foi cancelada perca parcerias e trabalhos. Esse fato tornou-se algo comum nos meios de comunicação hodiernos. Desse modo, a cultura do cancelamento pode acontecer por diversos motivos e provocar diversas negatividades para quem sofrer com essa situação.', 'Dessa maneira, por comportamentos ou atitudes que não condizem com o que é correto, as pessoas correm o risco de serem canceladas nas redes sociais, como Twitter e Instagram. exemplo disso, cabe citar o que aconteceu com o jovem influencer Pedro Avelar, que foi cancelado por postar  há dois anos, comentários racistas em uma rede social.', 'Nesse sentido, traumas psicológicos farão parte da vida desses indivíduos, visto que de acordo com o psicanalista Sigmund Freud, tudo que acontece durante a infância ou adolescência de uma pessoa irá interferir em toda a sua vida. Assim, situações de cancelamento na internet, que provocam consequências ruins, como baixa autoestima, falta de oportunidades, entre outras, traz prejuízos para o resto da vida.', 'Portanto, cabe ao Ministério da Mulher, da Família e dos Direitos Humanos mostrar para a população as consequências negativas de cancelar uma pessoa nas redes sociais, por meio de campanhas publicitárias, com o intuito de menos pessoas serem cancela, e, assim, menos indivíduos sofreriam com os malefícios de ser cancelado.']",160,160,120,160,160,760
51,A educação no Brasil,"[""Tudo é na base do automático, quando escrevemos  uma mensagem por exemplo no celular ou até mesmo pelo computador, o corretor logo indica que a palavra está incorreta, e em seguida corrigindo-a. Estamos acostumados a copiar e colar textos, a compartilhar mensagens, videos e áudios sem ao menos checar a veracidade das informações que lhe foi passado. Hoje, muitos dos que usam a internet ou a mídia social, têm analfabetismo funcional, onde só se sabem o básico como, ler e escrever e identificar números e rebeber trocos por exemplo e em outros casos não sabem escrever o próprio nome; Contudo, fica cada vez mais difícil ter um bom aprendizado e interpretação de textos e informações. Por isso o grande público alvo das ''fake news'' são os que não têm uma boa educação necessária para checar a fonte da informação se é verdadeira ou falsa."", ""Alguns anos atrás, com a popularização das mídias sociais como : o whatsApp, facebook e o instagran, praticamente não se usam mais o serviço de sms da operadora e muitos dos que não sabem ler e escrever optam em mandar áudio pelo aplicativo porque para eles é muito mais prático e eficiente . E nas redes sociais, compartilham ''gifs, videos memes'' porque acham legais e engraçados."", 'Engana-se que pensa que as pessoas de ensino superior não estão sujeitas a desenvolver o analfabetismo funcional, é claro que é uma porcentagem muito pequena, mas inclui-las também, pois de acordo com algumas pesquisas que já foram realizadas no Braisil, estamos sujeitas ao vício da conversa informal , principalmente quando convivemos com pessoas que não são alfabetizadas ou que tem algum tipo de gerundismo; as vezes a convivência frequente com essas pessoas pode nos tornar prisioneiro do nosso próprio vocabulário. Por isso é essencial a leitura e a escrita frequente, as duas devem sempre andar juntas pois a prática acaba levando a perfeição, não adianta ser ótima na leitura, e não dominar na escrita.', 'É lamentável saber que alguns dos espaços públicos como as bibliotecas e museus  por exemplo, já não são mais frequentadas como antigamente, com a praticidade de hoje em dia muitos optam por ler livros on-line e usar as ferramentas do Google para pesquisar trabalhos ou algo do seu interesse ;  Não se tm mais o trabalho de ir atras da informação, ficando  horas e horas grifando  no livro as partes de mais importância e passando para o papel, agora é questão de um simples click e em segundos a informação estará diante dos seus olhos. Porém é imprescindível checar a fonte da informação, antes de sair compartilhando notícias falsas, ou em algo que você acredita que seja verdadeiro . Infelizmente a educação no País ainda é muito pobre, e está bem longe de ser um dos melhores em educação.']",120,80,80,80,0,360
62,O discurso de ódio nas redes socias.,"['O mundo virtual tornou-se umas das ferramentas mais eficazes e abrangentes da qual se tem conhecimento.', 'Além de aproximar as mais longas distâncias,houve também a possibilidade de acesso as mais diversas informações em um exíguo espaço de tempo,consequentemente houve a disseminação de conteúdos incongruentes, formulados com o intuito de ferir a integridade alheia.', 'Sites, paginas nas redes socias e ate pperfils que propagam idias antiquadas de que toda e qualquer forma de diferença é repugnante,dando origem as mais diversas formas de agressões tanto psicológicas quanto físicas.', 'Portanto cabe as autoridades competentes, punir os responsáveis pela disseminação destes dicursos ofensivos publicados nas midias sociais,além de promover palestras e projetos que englobem a sociedade como um todo,visando advertir a população das consequências que as manifestações de ódio podem ocasionar dentro do contexto comunitário.']",120,80,80,80,120,480
11,A ação antrópica e suas consequências,"['Há, na pré-história, pinturas rupestres que registram os primórdios dos seres humanos em contato com animais selvagens. O tempo passou e a humanidade dominou o meio natural. Com isso, modificou paisagem e transformou, de modo expressivo, a vida de muitos seres vivos. Assim, devido a diversas ações humanas, animais de vida selvagem tem têm sido forçados a ultrapassar suas barreiras naturais e adentrar em território dominado pelo homem. Nesse sentido, existe a extrema necessidade de buscar maneiras e soluções para tal cenário.', 'Num primeiro momento, o ser humano, reconhecendo seu potencial para manipular o meio em que vive, torna-se o único animal capaz de raciocinar e fazer uso da razão. Assim, durante muito tempo, tem vivido para satisfazer somente as suas necessidades e vontades, ignorando a existência de outros animais. Na atualidade, contaminar, desmatar e poluir são algumas das ações antrópicas que tem têm afetado o meio ambiente, fazendo com que recursos naturais se esgotem e causem total desequilíbrio ecológico. Por consequência, animais são obrigados a buscar outro meio para sobreviver, adentrando, em certos casos, em espaços urbanizados.', 'Somando-se a isso Além disso, pode-se dizer que que, após as Revoluções Industriais, o modo de produção a produção se intensificou e gerou mudanças radicais em vários aspectos. Em primeiro lugar, tem-se a massiva urbanização, fazendo as cidades se expandirem e ultrapassarem limites ambientais, resultando em desmatamento. Em seguida, verifica-se a poluição tomando espaço, gerando, como em um efeito dominó, mais problemas, por exemplo, o aquecimento global que tem como consequência o derretimento das calotas polares, afetando os seres vivos que vivem naquele lugar. Além disso, deve-se por pôr em evidência o alto risco de extinção de animais que são essenciais para o ecossistema, causando podendo causar desequilíbrio nas cadeias alimentares. O que afeta diretamente o próprio ser humano que, em casos como na o da Rússia, termina por ser uma presa fácil para ursos polares que estão invadindo o arquipélago de Nova Zembla.', 'Mediante os fatos expostos, a humanidade deve estar ciente que o excesso de exploração do meio natural tem causado sérios problemas e que sua resolução é de muita complexidade. Dessa forma, como uma primeira medida, pode-se criar barreiras físicas em locais com maiores riscos de invasão de animais selvagens, buscando preservar as vidas humanas. Em segundo lugar, mas não menos importante, deve-se intensificar as campanhas em prol do meio ambiente que possa ambiente, que possam resultar em ações que diminuem diminuam a sua degradação. Para que que, dessa maneira, possamos diminuir os conflitos e os danos entre homem e a natureza.']",120,120,80,120,120,560
52,Gravidez precoce,"['No filme ""Juno"", a personagem Juno é uma adolescente que engravida de seu melhor amigo e decide dar seu bebê para adoção por não ter condições psicológicas para ter uma criança.  Fora da ficção, muitos adolescentes no Brasil acabam sendo pais antes de concluírem o ensino médio, o que ocorre devido a falta de conscientização e da ausência de diálogo entre pais e filhos.', 'Pesquisas feitas pelo ministério da saúde revelam que cerca de 56 adolescentes a cada grupo de mil adquirem uma gravidez precoce, muitos diretamente ligados falta de informação referente  importância do uso de preservativos . Muitas escolas brasileiras não possuem nenhum programa relacionado à educação sexual, situação consequente da negligência governamental, o que tornam os casos de gravidez e DSTs ainda mais frequêntes.', 'Faz-se mister ainda, salientar a carência da educação por parte dos pais , que é indispensável na formação de jovens concientes, como impulsionador do problema . De acordo com o filósofo Paulo Freire, ""se a educação sozinha não transforma a sociedade, sem ela tampouco a sociedade muda"", informação desconsiderada quando muitos pais optam por deixar de lado diálogos referentes a sexo a fim de evitar relações na adolescência, não percebendo o efeito contrário a tempo de evitar uma gravidez precoce.', 'Infere-se, portanto, que ainda há barreiras serem quebradas para que o problema seja resolvido. Diante dos fatos, é necessário que o ministério da saúde, atrelado ao MEC , promova, por meio de verbas governamentais, aulas semanais nas instituições de ensino público do país destinadas à educação sexual, além de fornecer acompanhamento psicológico aos jovens que passam pela gravidez na adolescência para que,  casos como o de Juno sejam cada vez menos frequentes no país.']",120,160,120,120,120,640
49,Quem  e o erro meio digital,"['Canal digital que a maior influência é Youtube, Facebook enstagram , esse canal asatem pessoas mas famosos tem maior influência com sociedade grande indústria usa pessoas meio digital para divulgar seu produto.', 'Em primeiro vale destacar também que com Polamento também influencia as sociedades a de um vez Jesus Cristo (filho de Deus )me diz com quem você andar que dico que tu és, ou de outra gesto me diz quem de influência que direis como e seu padrão social', 'Ademais vale ressaltar grande imprensa de influência Youtube Facebook e enstagram outro tem todos dados pessoais assim ele tem comprole de persuadir sociedade de um escolher do produto que verdade não escolhas nenhum.', 'Verefeica-Se então a necessidade de ampliar papel do governo e escolas governo tem que cria uma projeto ou palestra para divulgar mas informações para sociedade saber grande imprensa fazer com seu dados e escola tem que desenvolve aluno mas crítica para assim saber verdadeira mundo digital']",80,80,80,80,80,400
53,sociedade e imprensa,"['Os veiculos de comunicação fazem parte do cotidiano dos brasileiros, no qual, são essenciais para conduzir informação de qualidade, além disso, transmitir os fatos importantes que acontecem no país. m 1939, no governo de getúlio vargas, foi criado o dip (departamento de imprensa e propaganda), no qual, foi responsável por veicular as principais noticias e aproximar o governo do povo. porém, serviu como meio de influncia politica, a fim de conquistar mais simpatizantes na ditadura varguista. atualmente, com a democracia, é perceptível a liberdade em vários meios de comunicação em trazer a informação real e desfazer bolhas ideológicas, no qual a sociedade está inserida.', 'Em primeira instância, vale ressaltar, a importancia dos meios de comunicação na sociedade em combater as fakes news (noticias falsas), onde vem ganhando destaque, principalmente nas redes sociais, onde há o maior número de mensagens compartilhadas, a fim de conseguir chegar a mais cidadãos. segundo dados do laboratório de cibersegurança da empresa psafe, cerca de 4,4 milhões de casos de notícias falsas sendo compartilhadas, nas eleições de 2018 . notório que, esssas mensagens são difundidas por questões ideolgicas, ou por situações sociais, onde envolvem problemas de saúde pública. imprensa é de extrema importancia para desmentir essas informações errôneas.', 'Ademais, convém lembrar que, todos os meios tm o direito da liberdade de expressão garantido na constituição, no qual, presente no artigo 5, onde nenhuma lei possa contér a liberdade jornalística em nenhum veiculo de comunicação social, assim libertando de uma censura. são importantes para mover a população ao senso crítico, tomando por si, suas impressões e sua posição ideologica.', 'Contúdo, os meios de comunicação são essenciais para transmitir uma noticia excepcional a todos, para garantir esse direito e combater as noticias falsas, é nescessário que, o ministério da ciencia ,tecnologia, inovações e comunicações (MCTIC), juntamente com os principais meios de comunicação brasileiro, criar ações em fóruns, instituições sociais e propagandas televisivas, sobre os maleficios das noticias falsas, a fim de proteger e garantir o bem estar social.']",120,120,80,120,40,480
63,Negligência em Brumadinho,"['A tragédia em Brumadinho trouxe impactos ambientais e sociais irreparáveis para a região. Além disso, nos fez lembrar de outra tragédia que ocorreu a cerca de três anos na mesma região - a de Mariana.', 'A tragédia de Brumadinho pode ter causado danos ambientais e sociais maiores do que os de Mariana, embora sua extensão em quilômetros tenha sido menor. Diversas espécies de mamíferos, aves e peixes, muitos que estavam em extinção , morreram. Além disso, centenas de pessoas morreram e muitas outras perderam suas casas.', 'Nos últimos 20 anos, a cada 2 anos, houve um rompimento de uma barragem em Minas Gerais sem que ninguém ficasse sabendo . As barragens não são seguras, porque investir em segurança custa caro e as mineradoras não querem pagar o preço. Para elas sai mais barato recorrer na justiça, caso haja o rompimento de alguma barragem, do que investir em segurança, pois, no fim, elas sabem que vão acabar saindo impunes mesmo.', 'Para que mais barragens não continuem se rompendo e causando estragos como vem ocorrendo, as empresas responsáveis pelo rompimento dessas barragens devem ser punidas por seus atos, seja com multas, indenizações ou mesmo com prisões. Apesar disso não reparar os danos causados, mas servirá de exemplo para que as mineradoras procure tomar medidas mais seguras para impedir que mais barragens se rompam e causem mais danos ambientas e às vidas das pessoas.']",120,120,120,120,120,600
82,"Automedicação,quando a solução pode ser um problema","['A automedicação é algo que deve ser discutido,pois sua praticidade faz com que nos tornemos adeptos deste  hábito na solução de problemas com a saúde que acreditamos que possamos resolver,porém não devemos nos deixar levar por esse conceito de alívio imediato,pois podemos estar mascarando algo muito grave ou até mesmo dando início a problemas,como vícios,intoxicações e tratamento para problemas errados ', 'A sensação de alívio imediato gerada por medicamentos é incrível    o que faz com que acreditemos que podemos aliviar as dores e mal-estar por nós mesmos,porém   medicamentos são drogas lícitas que podemos ter no nosso cotidiano,mas devemos tomar cuidado para não nos tornarmos dependentes delas,até porque nosso organismo pode acabar se adaptando  a elas e exigir aumento de dosagem,pois o alívio imediato pode começar a demorar um pouco mais de tempo para acontecer,e o contínuo uso e aumento de dosagens podem gerar consequências muito maiores e   algumas vezes    irreversíveis.', 'A automedicação pode ser um problema não apenas pelo vício que pode ser acarretado por esse método prático   porém perigoso,diversas outras coisas podem ocorrer    uma delas é a intoxicação,  segundo pesquisas    medicamentos são a principal causa de intoxicações no Brasil   ficando a frente de produtos de limpeza,agrotóxicos e alimentos estragados,ou seja,às vezes   tentando aliviar um problema   estamos dando início a outro e intoxicações   dependendo da gravidade   podem levar a óbito.', 'Outro ponto que não podemos deixar de levar em consideração é o fato de que nem tudo que parece realmente é,  um bom exemplo é a dengue,ela apresenta sintomas muito parecidos com os da gripe,mas os medicamentos são contra-indicados,porém   se formos adeptos da automedicação para obtermos alívio instantâneo    podemos estar contribuindo para o agravamento de um problema,sendo este  um bom exemplo já que este ano os problemas causados pelo Aedes aegypti foram bem discutidos.', 'Portanto,a automedicação deve ser algo tratado com muito cuidado,não que tenhamos que correr para um hospital mais próximo sempre que tivermos uma simples dor de cabeça,mas devemos ir ao médico às vezes só para uma melhor indicação do que é mais benéfico para o nosso bem estar  e até mesmo para não desenvolvermos problemas maiores que poderiam ser evitados se não nos rendessemos  tão facilmente a praticidade,porque temos que ter sempre em mente que   com saúde   não se brinca.']",120,120,120,120,120,600
62,,"['A criação da internet, na quarta revolução industrial foi vista como um marco de progresso na história, no olhar de muitos o mundo ta em constate evolução. Entretanto, as pessoas utilizam ela de forma erronea, ou seja, ao invés de manuseá-la como instrumento de pesquisas, comunicação, acabam fazendo dela um verdadeiro campo de batalha. Disseminando o ódio  como também atacando as pessoas, demonstrando assim que o físico Albert Eisten,  não estava errado quando nos  mostra que “Tornou-se aterradoramente claro que a nossa tecnologia ultrapassou a nossa Humanidade"".', 'Nas eleições presidenciais do Brasíl, no ano de 2018, foi comum ver pessoas com ideologias distintas,  tratando uma as outras como verdadeiros inimigos, não apenas utilizando palavras de baixo calão para comunicar-se com o outro, mas também fazendo jogos psicológicos que deixam as pessoas ofendidas. Mostrando assim, como a tecnologia, quando empregada por pessoas que não contém respeito com os demais, acaba tornando-se uma grande adversária da população.', 'Sem contar ainda , a maneira que através de perfis fakes ou até mesmo originais, pratica-se os mais diversos tipos de preconceitos, mostrando como sentem-se superiores aos demais. Acreditando que sua cultura, costumes e tradições sejam melhores que a dos outros. Esquecendo, que apesar de vivenciar um mundo que segundo Bauman ,  está cada vez mais líquido, onde pessoas, relacionamentos e raízes são deixadas de lado o tempo todo. As palavras, são guardadas e acabam deixando pessoas depressivas bem como destinadas à cometer o suicídio.', 'Sendo assim, uma vez que acredita-se que a educação é primordial para transformação do ser humano como do mundo  pode-se através dela formar pessoas que saibam respeitar umas as outras e que aprendam a fazer do meio de comunicação o seu aliado. A mídia com auxílio do governo devem conscientizar a população através de propagandas direcionadas ao uso correto da internet e do bem estar social.']",120,160,120,120,120,640
83,A sensação de Vencer,"['As Olimpíadas e Parolimpíadas são as melhores formas de mostrar ao mundo o bem que o esporte faz, pois é o evento esportivo mais importante do mundo, e nessa época o evento se torna destaque  , fazendo com que todos possam conhecer um pouco de cada modalidade esportiva.', 'Com a modernidade e a pressa pela estabilidade financeira, a população vem deixando a atividade física de lado, dando mais importância a rotina do trabalho. Essa pressa pelo sucesso faz com que muitas  pessoas se tornem ansiosas, focando somente em trabalho, e dessa forma ficam sem tempo, alimentando-se mal, dormindo mal, sem nenhum escape, como por exemplo a atividade física. Essa rotina acaba causando danos às pessoas, pois muitos ficam estressados , e esse mal acarreta em uma série de danos ao nosso organismo como um todo.', 'Com as Olimpíadas, várias modalidades esportivas são apresentadas e demonstradas ao público, o que pode despertar o interesse pelo esporte, ver o atleta em ação nos desperta uma emoção muito grande, principalmente quando há vitória, pois faz com que o outro sinta a mesma vibração, que é possível vencer obstáculos e que a gratificação em conseguir realizar uma atividade física ou vencer um jogo é muito grande.']",160,80,120,160,200,720
46,Privatização do Saneamento Básico,"['Água não potável, esgoto céu aberto, proliferação de doenças . Essas realidades parecem distante mas para parte da população brasileira é somente uma situação cotidiana. Atualmente  no Brasil, a maior parte da população é atendida pela iniciativa pública, cerca de metade da população não tem acesso a rede de esgoto, e 16% dessa população não possui a acesso água tratada. Esses deveriam ser recursos básicos fornecidos e assegurados pelo governo, mas que infelizmente parte da polução não é contemplata.', 'Países como Chile, Alemanha que já possui praticamente toda rede de saneamento básico pela iniciativa privada, e certa de 90% da população tem acesso ao tratamento de esgoto e água. Com a privatização do saneamento básico no Brasil, surgem muitas dúvidas, com a implantação inicial alega-se que os preços ficaram mais baixos pela concorrência com a iniciativa pública. Porém ao analisar de uma forma mais ampla e a longo prazo, investidores realmente irão querer invertir em regiões periféricas, onde os lucros e o retorno financeiro não serão como de uma metropóle.', 'Para que a população seja contemplada e que todos os acordos sejam cumpridos, uma vez que a rede pública não consegue atingir boa parte da população, com a inserção da iniciativa privada deve se assegurar de que as taxas não aumentarão de forma absurda, assim toda a população poderá manter a rede de tratamento. Também precisa se estabecer metas para o atingimento das cidades onde atualmente não há o tratamento de esgoto para que com a privatização toda população seja resguardada, e que os valores dessas regiões sejam proporcionais a renda da população para que consigam custiar o saneamento. Sendo assim a toda a população terá acesso a rede de saneamento básico , evitando assim problemas de saúde, atraindo invertidores pela qualidade das cidades e gerando uma qualidade de vida muito melhor para muitos brasileiros.']",160,160,120,120,120,680
47,"Educação, um direito de todos!","['De acordo com o rt.6º da Constituição Federal Brasileira de 1988, a educação é dever do estado e direito da população. No entanto, com o surgimento da pandemia do novo coronavírus (Covid-19), as aulas presenciais foram suspensas. Dessa forma, a modalidade a distância é implementada para assegurar no que diz respeito ao artigo 6º dos direitos sociais. Contudo, surge o desafio das desigualdades sociais onde muitos jovens não têm sequer acesso à internet; bem como ambientes desfavoráveis para o estudo.', '""Se a educação sozinha não pode transformar a sociedade, tampouco sem ela a sociedade muda."" A declaração do filósofo e escritor brasileiro Paulo Freire, nos permite refletir sobre como é importante o acesso à educação como principal meio de mudança. Infelizmente segundo dados do Instituto Brasileiro de Geografia e Estatística (IBGE), o Brasil é um dos países mais desiguais do mundo, onde a renda dos mais pobres caiu mais de 3% e dos mais ricos aumentou mais de 8% em 2018.', 'Além do problema de mal distribuição de renda, o que impossibilita a disponibilidade de internet e até mesmo aos equipamentos necessários para o seu uso como o celular ou computador, muitas vezes os alunos não têm um ambiente confortável e silencioso para realizarem suas atividades. Tristemente essa é a realidade de muitos jovens que não podem sair de casa devido ao atual cenário de isolamento social.', 'Portanto, para que os ideais da educação citado anteriormente por Freire não sejam apenas teoria, mas base para os dias de hoje, se faz necessário que Família e Estado trabalhem juntos. Com o apoio das famílias, os estudantes devem montar horários certos de estudo e evitar supostos desconfortos como excesso de barulho. Assim como os Governantes devem proporcionar mais qualidade de ensino por meio de priorização de verbas em regiões mais carentes com o intuito de amenizar os efeitos das desigualdades. A longo prazo, mais qualificação, e consequentemente melhores salários!']",160,160,160,160,120,760
59,Fome,"['A fome assola mais de cinco milhões de pessoas por todo o Brasil, ainda um número assustadoramente grande, entretanto é quatro vezes menor que valor das pesquisas dos anos 2000, quando havia cerca de 22 milhões de brasileiros vivendo na penúria, sem ter condições básicas de sobrevivência. Esse decaimento no número se deve a programas de auxílio financeiro e alimentício aos indivíduos de baixa ou nenhuma renda.', 'A baixa renda é um dos motivos pelos quais muitos ainda passam fome, além da falta de oferta de emprego, superfaturamento dos produtos alimentícios e má distribuição destes. Muitos brasileiros não têm condições financeiras para comprar o essencial e básico da alimentação,  devido baixa remuneração e desvalorização de muitos empregos. A má distribuição salarial, provinda da falta de reconhecimento de algumas profissões e super reconhecimento de outras  causa a desigualdade social e diminui a qualidade de vida de indivíduos que passam horas em um trabalho para ter condições mínimas de sobrevivência.', 'Além da baixa renda, o superfaturamento dos produtos agrícolas e a má distribuição pelas regiões brasileiras fazem com que muitos destes alimentos estraguem por não haver quem compre ou por falta de renda dos consumidores e não cheguem até as famílias mais necessitados. O Brasil possui grande extensão territorial, terras muito férteis e uma boa localização geográfica, portanto percebe-se que não há, em muitos casos, falta de alimento, mas má distribuição destes e de renda entre os brasileiros, além da falta de oportunidade de plantar em terras que estão sem uso próximas às casas da população.', 'Para sanar os problemas de alimentação no Brasil e no mundo, criou-se a Organização das Nações Unidas para Alimentação e Agricultura (FAO), a qual tem como objetivo combater a fome e a pobreza e tem como proposta desenvolver a agricultura de forma sustentável para alcançar este objetivo e preservar os recursos naturais.', 'Para que a proposta seja executada, no Brasil, é necessário que haja também união entre o Ministério da Agriculta e do Meio Ambiente, a FAO e apoio governamental, visando utilizar formas mais baratas para o cultivo de alimento, como utilização de água da chuva estocada, húmus orgânico, produzidos com resíduos de legumes, verduras, frutas e vegetais, adubo orgânico com resíduos fecais bovinos, melhor distribuição dos produtos. Estas ações tornariam os produtos mais acessíveis à população brasileira e alcançarias mais pessoas. Diminuindo ainda mais a pobreza e a fome no país.']",120,160,120,160,120,680
45,Abuso de autoridade no Brasil,"['A palavra democracia significa poder na mão do povo. Entretanto, indivíduos utilizam-se de cargos importantes para abusar do poder à qual o povo lhes atribuiu. Isso, infelizmente, ocorre devido a falta de conhecimento da polulação sobre seus direitos e a passividade do Poder Judiciário.', 'Em Cidades de Papel, obra do jornalista Gilberto Dimeinstein, o autor expressa a importância de se conhecer os direitos do cidadão. isso, a fim de que casos como em que o policial Paulo Servato foi filmado pisando no pescoço de uma senhora de 51 anos sejam evitados. logo, enquanto patentes forem, às vezes, sinônimo de poder abusivo, o conhecimento será o sinônimo de defesa absoluta.', 'Neste viés, é valido salientar a passividade do Poder Judiciário no que se refere à penalidade de indivíduos que utilizam cargos púbicos para se beneficiar. Ratificando-se isso, o desenbargador Eduardo Almeida se recusou a pagar uma multa e chama o guarda de analfabeto . Ele foi afastado do cargo, mas continuou recebendo um salario à cima de 35 mil reais. Casos como esse indica que o coronelismo tomou outra forma e precisa ser combatido.', 'Diante do exposto, o Governo, por meio do Ministério da Educação, deve criar cursos que ensine aos cidades os direitos e deveres da Contituição do Brasil. Isso, através da tv aberta e plataformas como Youtuber e Facebook, a fim de que o abuso de autoridade seja contido. Logo, poder-se-ia esperar uma mudança e a democracia estaria sendo ratificada.']",120,160,160,200,160,800
47,Educação à distância no Brasil e seus desafios,"['Desde a Revolução Industrial, com o avanço da tecnologia, as relações humanas mudaram - inclusive a forma de obter educação. Nesse contexto, a educação à distância é a realidade atual no Brasil, porém, infelizmente é um processo nocivo, uma vez que exclui parte da população. Sendo assim, a falta de recursos para usufruir desse método e as precárias condições econômicas são desafios que impedem a educação à distância.', 'Em primeiro plano, vale ressaltar a Constituição Federal, que no artigo 205 garante a educação para todos . Entretanto, esse direito é violado à medida que há a falta de recursos, sejam eles cursos ou aulas digitais, falha do Ministério da Educação por não disponibilizar. Dessa forma, é difícil haver rendimento no ensino distância, justo porque os métodos são falhos e não atingem o alcance necessário.', 'Em segundo plano, é possível observar que condições econômicas interferem no aprendizado. Como visto em um estudo realizado pelo Banco Interamericano de Desenvolvimento, o qual afirma que alunos com melhor infraestrutura apresentam um desempenho superior. Nesse sentido, tendo em vista a realidade precária individual, é erro do Governo Federal não contribuir com recursos que diminuam a desigualdade no quesito de estudo. Essa prática é inadmissível e precisa ser combatida a fim de reduzir os desafios.', 'Por fim, é responsabilidade do Ministério da Educação , através de platafomas online, disponibilizar materiais de estudo visando facilitar esse ensino para melhorar a aprendizagem. Paralelo a isso, cabe ao Governo Federal, por meio de programas de cadastro, oferecer recursos para diminuir a desigualdade entre os estudantes, objetivando o aprendizado para todos. Só assim será possível reduzir os desafios da educação a distância no Brasil e democratizá-la.']",160,160,160,160,160,800
71,,"['O suicídio de jovens no Brasil tem apresentado um aumento significativo na última década. De acordo com o Mapa da Violência de 2014, o número de mortes por essa causa aumentou em 15,3% no período de 2002 a 2012. Neste contexto, é necessário analisar os fatores que contribuem para o aumento dessa problemática.', 'Em primeira análise, o suicídio considerado problema de saúde continua sendo um tabu na sociedade . Cabe pontuar que essa repreensão não é algo recente: quando a obra de Goethe, Os sofrimentos do jovem Werther, no século XVIII, causou uma onda suicídios na Alemanha, a então reação da sociedade foi proibir a discussão sobre o tema, por acreditar que seria algo que incitasse a prática. Atualmente, com o aumento de suicídio na juventude, percebe-se que o silêncio em torno do assunto não evitou essas mortes.', 'Além disso, 90% dos casos poderiam ser prevenidos se houvesse oferta de ajuda, como mostrou o dado da Organização Mundial da Saúde (OMS), porém na maioria das ocorrências em que os jovens demonstram um quadro suicida ou algum tipo de sinal que iram cometer o ato, muita vezes são ignorados por familiares que interpretam como ""frescura"" . Ademais.  sem um apoio da família, eles acabam esbarrando na glamorizaão da mídia, como exemplificação: a série americana Os Treze Porquês, pode ser um gatinho para quem já passa por uma situação delicada, pois mostra a protagonista recorrendo ao suicídio como solução para seus problemas. Logo, essa negligência familiar é um fator preocupante, já que acaba impulsionando outros fatores.', 'Portanto, se faz necessário medidas para que tais fatores não contribuam com o aumento do suicídio. Por isso, o Ministério da Saúde em parceria com o da Educação  promovam  treinamentos de profissionais da educação, cursos e palestras em escolas para haver um amplo debate e desmitificação do assunto em sala de aula e informar os responsáveis, através de cartilhas educativas,sobre fatores de riscos e sinais de alerta que não podem ser negligenciados;a mídia deve divulga campanhas de valorização à vida e o incentivo procura de auxílio, não só para os jovens, mas para a sociedade toda .Feito isso, as taxas de suicídio amenizar e logo não será mais um problema alarmante.']",120,160,120,120,120,640
134,Paraíso tropical,"['""O gigante acordou"".                 A frase que impulsionou as manifestações                e foi tema de diversos cartazes nos faz pensar: será que o Brasil realmente despertou?', 'Embora os protestos desses últimos dias obtiveram uma          ascensão midiática         impressionante, sabemos que isso não será o suficiente para alcançarmos o êxito em relação         as         pautas. É necessário, além da exposição de nossa insatisfação, darmos um prazo para que o governo                 regularize sua situação                e cumpra o que foi reivindicado.', 'Desse modo, se as devidas providências não forem tomadas, devemos voltar                 ""às ruas"".                Democracia é isso: a constante fiscalização daqueles que nos representam         dentro do         contexto político nacional.', 'Existe ainda uma questão sobre o que, de fato, mudará no país após esse movimento. Isso         porque, toda         revolta possui um objetivo. Será que o Congresso aprovará                 os pedidos                ? Uma coisa é certa, já demos o passo de partida para a alteração do cenário.                 Através dos ocorridos                , já conquistamos, por exemplo, em São Paulo e no Rio de Janeiro, a redução das tarifas dos transportes públicos; em âmbito nacional, a PEC 37, que limitaria o poder investigativo do Ministério Público, foi rejeitada.', 'Entretanto, não foram solucionados todos os requisitos. Há ainda         muito o que         fazer. Melhorias na educação e na saúde                 são também bastante exigidas                , uma vez que é lamentável que um país com                 economia crescente                como o Brasil, ocupe o penúltimo lugar no ranking mundial da educação e o 72º no de saúde.', 'Fundamentado no que foi exposto, é possível aferir que estamos         em progresso         . Porém, o trajeto será longo e árduo. Precisamos romper com alguns paradigmas e esquecer o famoso ""jeitinho brasileiro"", pois só assim                 estaremos inseridos no verdadeiro paraíso tropical                : uma nação isenta de corrupção e agindo em benefício de todos.']",120,200,160,160,160,800
42,Responsáveis pelo próprio sucesso,"['Atualmente, é visível a decadência da educação brasileira. A baixa qualidade do ensino no país é evidenciada dia após dia com índices preocupante tornando a realidade brasileira uma situação preocupante. Será possível o aluno correr atrás do seu próprio sucesso sem depender da educação oferecida pela escola?No Enem em 2014 8,5% dos alunos tiraram nota zero em redação e apenas 0,004% tiraram a nota máxima, isso evidencia claramente a baixa qualidade no ensino do país já que um em cada cinco alunos do 3º ano do ensino fundamental não possui os mínimos requisitos de alfabetização e leitura. O primeiro detento a ter nível superior do Estado de São Paulo já se destaca. O diploma foi obtido através de uma parceria com uma universidade que oferece a modalidade de ensino á distância, sendo o detento um exemplo de superação e esforço próprio em busca da educação. É necessário que o aluno tenha a capacidade de perceber que a educação também depende dele, para que possa ir atrás de uma qualidade de educação sem depender do que é oferecido pela escola.']",120,120,80,0,80,400
90,Rafaela Freitas Caires,"['Os transgêneros enfrentam diversos obstáculos para se inserirem na sociedade brasileira, visto que, conforme dados da Associação Nacional de Travestis e Transexuais(ANTRA), cerca de 90% das travestis e transexuais usam a prostituição como fonte de renda. Nesse contexto, a falta de acolhimento da família e o preconceito nas instituições de ensino dificultam a ascensão dessa população e a sua representatividade nos diferentes espaços e, por conseguinte, acarretam a permanência da transfobia e da marginalização desses indivíduos. Logo, medidas devem ser tomadas, a fim de combater esse preconceito e facilitar a inclusão dessa comunidade.', 'Nesse âmbito, diversas vezes, a discriminação começa a aparecer no ambiente familiar que deveria ser um espaço de acolhimento. Como resultado, várias pessoas que possuem uma identidade de gênero diferente do sexo atribuído são expulsas de casa e encaram bastantes desafios para a sua sobrevivência. Prova disso é a ovem Patrícia Borges que foi banida da residência da sua família aos 13 anos, em razão de ser trans. Nesse sentido, é necessário desenvolver uma maior tolerância dentro desse meio.', 'Além disso, em virtude do enorme preconceito nas escolas, inúmeros transgêneros abandonam os estudos e, por consequência, encaram várias barreiras para ingressarem no mercado de trabalho e acabam na prostituição, tendo sua imagem marginalizada. Segundo dados da Rede Nacional de Pessoas Trans do Brasil(RedeTrans) 82% das mulheres transexuais e travestis abandonam o ensino médio, devido à discriminação. Nesse contexto, deve-se criar condições para a permanência desses cidadãos no meio acadêmico.', 'Portanto, embora não haja soluções imediatas para esse problema, torna-se indubitável que a transfobia precisa ser combatida. Nesse sentido, cabe ao governo, em parceira com o Ministério da Educação, diminuir esse impasse. Para isso, esses agentes devem contratar psicólogos para fornecer palestras sobre esse tema e oferecer auxílio aos transgêneros, com o intuito de diminuir o preconceito na família e nas instituições de ensino e amparar as vítimas, além de ofertar bolsas para esses indivíduos, com o intuito de diminuir a evasão escolar. Assim, a transfobia será um mal cada vez menor na sociedade.']",160,200,160,200,160,880
119,A beleza vale tudo isso?,"['Hoje em dia a busca pelo padrão de beleza perfeito vem levando muitos homens e mulheres para as mesas cirúrgicas ou até mesmo         injetando e passando substancias         químicas no corpo.', 'A ditadura da ""beleza perfeita""         esta dentro da         sociedade         a         muitos         anos, e         vem se consolidando         ate hoje, essa         ditadura atinge principalmente as pessoas que acreditam que para serem aceitas na sociedade e serem felizes         tem         que estar dentro dos padrões. A mídia é a principal fonte         que se         propaga essa ditadura, pois         a mesma criar a ilusão alienadora         que só homens e mulheres de corpos esculturais, cabelos lisos ou ondulados e de pele perfeita se enquadram no que chamamos de beleza.', 'Essa busca         inassinalável faz com ser o ser humano seja         capaz de passar por cima da sua saúde, só para ter o ""corpo perfeito"". Os procedimentos cirúrgicos         como: lipoaspiração,         próteses de silicones; a injeção de         substancias         químicas no músculo como o hidrogel;         substancias química         para alisar os cabelos como o formol         vem         sendo         banalizado         cada dia que         passa, as         pessoas         vem esquecem o risco         que estão pondo sua saúde, pois a vontade de serem aceitas fala mais alto,         mas as vez         acabam pagando um preço muito         alto; pois em muitos casos         as pessoas que         faziam         uso desses procedimentos adquiriram alguma doença, complicações e outras foram a óbito.', 'Portanto, visando o bem estar da         sociedade          a mídia deveria quebrar esses padrão, colocando modelos com beleza diferentes da atuais para fazer as          propaganda          e o          governa e população          dar atenção          os          protesto contra o padrão atual, pois eles mostram a verdadeira realidade.']",120,120,160,160,80,640
17,O país desmemoriado,"['Não é a primeira vez que o nosso país sofre uma perda cultural e científica, o incêndio que atingiu o Museu Nacional, fez com que grande parte da população brasileira refletisse sobre isso, gerando distintas opiniões, desdê aqueles que apontam culpados àqueles que comemoram tamanho desastre.', 'Infelizmente, é com frequência que a nossa história é desvalorizada e esquecida, a maioria das pessoas só dão a devida atenção a ela, quando a mesma é destruída. Por isso mesmo, não se pode apenas acusar a um governo que não investe o suficiente na nossa biografia, mas também a todos nós, a população, que espera fatalidades acontecerem para enxerga-la .', 'Danos irreparáveis são consequência da perda do nosso patrimônio, pessoas que desconhecem a real história cultural do próprio país estão sujeitas a ignorância e isso, em grande escala, traz o risco de cometermos os mesmos erros que deveriam servir de aprendizado para nunca acontecerem novamente.', 'Nos dias de hoje, vemos que uma grande parte da população já desconhece os fatos de sua nação, um dos exemplos disso, são aqueles que admiram a ditadura militar e a querem de volta. A história dos negros no nosso país também é algo tratado com descaso, boa parte do nosso passado parece estar sendo omitido de nós mesmos, um povo que é ensinado a ser cego diante dos acontecimentos.', 'O maior desastre, em relação ao nosso legado histórico e cultural, é a falta de informação, se desenvolvêssemos projetos, campanhas e movimentos em prol da nossa valorização como país já seria de grande ajuda, a sociedade brasileira, em sua maioria, desconhece a importância de seu patrimônio , das nossas raízes e de todas as pessoas que deixaram um marco, seja ele bom ou ruim, afinal, até as coisas desagradáveis servem como aprendizado. A responsabilidade não é só da população, devemos exigir de qualquer governo, que no mínimo, disponibilize verbas .']",160,160,120,120,160,720
79,Recuperação carcerária,"['Atualmente, prender bandidos não está resolvendo no Brasil. Além da superlotação dos presídios, a falta de uma gestão mais efetiva só tem agravado a situação. A transferência de presos para outros presídios tem sido uma de muitas ações ineficazes. Mas será possível chegar em  uma solução eficaz?', 'Um dos acontecimentos recentes mais absurdos que mostrou  a ineficiência administrativa e a falta de comunicação dentre  os órgãos competentes da segurança brasileira foi a notificação da fuga de um presidiário que sempre esteve em sua cela.', 'Pesquisas recentes concluíram que mais da metade nos presos são reincidentes, e destes reincidentes, grande parte são jovens entre dezoito e vinte e cinco anos.', 'A criação de medidas socioeducativas junto com  incentivos à qualificação e empregabilidade dos ex-detentos seriam um grande passo para diminuir o número de reincidentes, além de auxiliar na reestruturação da economia brasileira, ou seja, é uma das melhores opções para se começar a restabelecer o sistema carcerário brasileiro.']",120,80,80,120,80,480
43,P,"['A cultura do cancelamento das redes sociais é uma problemática que precisa ser repensada, pois ao cancelar uma postagem o indivíduo que a fez pode destruir a reputação de uma empresa. Desse jeito, essa cultura traz vários problemas como o desemprego de terceiros e a falta de liberdade de expressão.', 'Em primazia, esse cancelamento pode lavar tanto influenciadores quanto empresas a falência. Assim, como disse o ativista estadunidense Martin Luther King: ""a injustiça num lugar qualquer ameaça a justiça em todo lugar fechar "".Sob tal ótica, a exclusão de uma conta na internet não adverte apenas a quem fez a mal conduta  mas também,  inocentes que estavam trabalhando para aquela empresa ou influenciador. Logo,esse ato acaba deixando-os desempregados.', 'Ademais, o bloqueamento de postagem afeta a liberdade de expressão das pessoas, que ficam com medo de publicar algo e serem censuradas. Dessa forma, segundo o filósofo alemão Arthur Schopenhauer:"" todo homem toma os limites de seu próprio campo de visão com os limites do mundo"". Nessa perspectiva, entende-se que algumas pessoas tomam o seu próprio julgamento para determinar se a publicação é prejudicial ou não para a sociedade. Dessa forma, é evidente que essa ação deve ser repesada.', 'Portanto, para que essa cultura se torne eficiente, é preciso que os donos de empresas como Facebook e Twitter faça a contratação de funcionários capacitados, para verificar se o pedido de cancelamento foi pertinente e apenas em casos graves deletar aquela mensagem. Desse modo, se elas não forem tão agressivas, esses funcionários pediriam para que o publicante se desculpar publicamente. Só assim, essas pessoas teriam que se responsabilizar pela sua conduta sem prejudicar mas ninguém como a frase de Luther King.']",160,160,120,200,160,800
126,Dualidade Cultural,"['O objetivo das meias-entradas é o de levar acesso à cultura aos estudantes, que possuem renda significativamente baixa, e aos idosos, que estão aposentados, mas não necessariamente possuem baixa renda.                O Congresso Nacional lançou uma proposta de lei que limita a venda dessa modalidade de ingressos a 40%         para os         beneficiados, fruto da         briga feita pelos empresários que dizem ter que         aumentar o valor dos ingressos         para que, dessa forma, consigam suprir         as perdas com as meias-entradas.                 Assim, a parcela da população considerada adulta tem que pagar pelos estudantes e idosos. Logo, estes são os mais prejudicados por essa prática dos empresários.', 'Os empresários visam o lucro de suas empresas, por isso é normal que eles cobrem ingressos significativamente caros para suprirem as perdas com as meias-entradas. Em locais como cinemas, teatros e eventos esportivos,         os valores praticados é extremamente alto         para os padrões da sociedade brasileira.                 Dependendo da atividade cultural, o valor de um ingresso inteiro pode custar até 100 e a meia-entrada 50 reais, assim, nota-se que há uma contradição, pois o salário mínimo hoje está em torno de 650 reais, e mais da metade da população vive com esse valor. Logo, grande parte do povo não tem acesso à cultura.', 'Já a população em idade adulta, trabalhadores, que não         tem         direito a meia-entrada, são os que mais sofrem com os aumentos dos ingressos, gerando                 uma dualidade                , pois, nem sempre são os que possuem a maior renda para poderem pagar o que os empresários cobram. São muitos os exemplos de beneficiados que não necessariamente necessitam                 destes                . Adolescentes, estudantes,         em que seus         pais possuem renda significativamente         elevada         e idosos aposentados com mais de         5         salários mínimos são exemplos         de pessoas que possuem e usufruem do direito à meia-entrada, mas que não necessitam', 'Por conseguinte                , a prática da meia-entrada induz os beneficiados a frequentarem os mais diversos locais de entretenimento e lazer. Em contrapartida, o que deve ser repensado pelas autoridades         são quem deveriam         ser os beneficiados, pois nem sempre os que usufruem de tal modalidade são os que realmente necessitam. Assim, um pai de família carente também conseguiria ter acesso a eventos culturais junto de toda sua família, o que raramente acontece hoje no Brasil, pois na maioria das famílias falta verba para o lazer, por isso         da         importância de se repensar nos beneficiados pela meia-entrada.']",120,120,120,200,120,680
55,Desrespeito aos direitos indígenas,"['No capítulo intitulado Eva Tupinambá, o historiador Ronald Raminelli, que integra o conjunto de autores do livro “História das Mulheres no Brasil”, apresenta ao leitor relatos de viajantes europeus, revelando a perspectiva dos mesmos diante da cultura indígena do Brasil colonial: um estranhamento que se apoiava na tradição cristã como parâmetro de julgamento, não levando em consideração as particularidades dos habitantes do Novo Mundo. Nesse sentido, o viajante europeu entendia os costumes dos nativos como representações do mal e logo se julgava eleito por Deus na missão de exterminar o mal e disseminar o bem, ou seja, disseminar sua própria cultura em detrimento da cultura indígena, considerada maligna. Atualmente, em pleno século XXI, embora supostamente resguardados pela Constituição Federal, os povos indígenas enfrentam os mais diversos atentados contra seus direitos. A expropriação de terras indígenas em prol de ocupações rurais e urbanas, por exemplo, não é surpresa em um país em que o histórico de preconceito e perseguição em relação aos povos indígenas somou-se à valorização do lucro em detrimento dos direitos humanos e do meio ambiente.', 'Diante de tal realidade, mostra-se importante destacar a facilidade com que estatísticas são levantadas e leis são escritas, o que parece resultar em progresso na teoria, embora na prática o que se vê são valores equivocados que mobilizam emoções, implicando em injustiças sociais. Portanto, não é possível propor valorização da cultura indígena sem tocar em um ponto nefrálgico: o medo da alteridade e os reais valores que prosperam em nossa cultura. De acordo com o professor do departamento de psicologia social e do trabalho da USP, Alessandro Oliveira dos Santos, o etnocentrismo é a representação do medo da alteridade no nível político, e de nada adianta a integração da diferença em termos de discurso e teoria quando politicamente os indivíduos não são considerados iguais no direito de falar, propor regras para a convivência e serem ouvidos e respeitados em suas necessidades e diferenças. Aliás, esbarra-se em outra constatação mais ampla que, apesar de óbvia, é motivo de desdém: os direitos humanos devem ser prioridade. Não há outra forma de lidar com os problemas que assolam o país sem que esse valor seja o alicerce da perspectiva do povo brasileiro.', 'Infelizmente, o cenário político atual promete uma realidade cada vez mais hostil para a população indígena. Com a tarefa de demarcação de terras indígenas retirada da FUNAI, Fundação Nacional do Índio, e destinada ao Ministério da Agricultura, a população indígena está mais vulnerável do que nunca: seus direitos básicos estão nas mãos daqueles que visam à expropriação de terras indígenas em nome do agronegócio. Como afirma Sidney Possuelo, ex presidente da FUNAI, tal decisão governamental colocou em risco a integridade física dos índios, propiciando ataques reais às frentes de proteção etnoambiental. Portanto, urge que, em primeiro lugar, o governo repense a forma como está lidando com a política indigenista, reconsiderando imediatamente a entrega da autoridade sobre as terras nas mãos do Ministério da Agricultura e, em contrapartida, tome a iniciativa de promover, por meio de verbas governamentais, campanhas publicitárias nos principais meios de comunicação que instiguem a empatia, o respeito e a admiração por culturas diferentes que compõem o Brasil, sobretudo aquelas que são alvo constante de preconceito. Somente com iniciativas na contramão das que foram tomadas até agora, será possível transcender a perspectiva do viajante europeu que demonizava o diferente e, ademais, promover de fato um país tão rico de humanidade quanto é de fauna e flora.']",160,160,120,120,120,680
76,O Legado da Desigualdade de Gênero,"['A desigualdade de gênero no Brasil é uma herança histórica. Durante anos, por lei, os homens eram provedores e gestores dos bens familiares, enquanto as mulheres eram mantidas por esses recursos e responsáveis pelo zelo de tais. Vê-se então o desafio da equidade de gênero, pois, os costumes mencionados anteriormente estão enraizados na sociedade brasileira.', 'No decorrer dos anos, com influência de alguns fatores como a greve das costureiras e as guerras , as mulheres foram inseridas em mais atividades do espaço público, porém, com uma remuneração inferior. Ainda em um passado recente, empresas justificam este fator devido ao prejuízo causado por uma eventual gravidez, já que teriam o custo de dois funcionários com a mão de obra de apenas um.', 'Através de movimentos, greves e protestos, as mulheres alcançaram grandes conquistas, o direito ao voto e a candidatura obtidos durante o governo de Getúlio Vargas é uma das mais populares. Entretanto, há problemas persistentes que vão além dos assuntos relacionados à política e a remuneração, questões como a violência doméstica, a cultura do estupro e o machismo, que ferem a saúde e a moral da mulher.', 'As medidas para a resolução do impasse é que os movimentos feministas e os demais grupos que lutam por causas públicas promovam palestras e debates sobre o assunto, sejam em escolas, nas mídias sociais ou na televisão, para que a população, principalmente os jovens, conscientize-se sobre a importância da equidade de gênero, e que com o passar das gerações os maus costumes sejam atenuados.']",120,120,120,120,120,600
10,O estudo é a base para melhorar de vida,"['Com os avanços que a sociedade deu em tecnologia, nas últimas décadas, o estudo se tornou indispensável para quem deseja progredir na vida. Apesar disso, recente pesquisa realizada pela Datafolha demonstra que o brasileiro considera ele o considera em segundo plano em comparação com a fé religiosa.', 'A rede mundial de computadores, desde sua criação nos anos 89 e 90, trouxe consigo muitas tecnologias e avanços em muitas áreas como na Medicina medicina, na indústria e no serviço público. Nos hospitais e Laboratórios laboratórios, os equipamentos modernos, como os de ressonância magnética, auxiliam muito no tratamento e prevenção da Saúde saúde. Na indústria automobilística, os robôs assumem os postos de trabalhadores os postos, que, outrora, eram de pessoas. Já no serviço público, os processos, do poder judiciário, por exemplo, são, em sua maioria, totalmente eletrônicos.', 'Pelo exposto, os profissionais que desejam atuar nessas e em diversas outras áreas necessitam de qualificação adequada, ou seja, estudo. Ademais, não basta tê-lo de forma superficial, é necessário o maior número de conhecimento possível na área em que se deseja atuar.', 'Nesse contexto, e, pensando num futuro ainda mais avançado com tecnologias em todos os setores da economia, fica evidente que o estudo é pilar fundamental para quem queira melhorar de vida.', 'Por fim, apesar dos de os brasileiros serem religiosos, em sua maioria, e de terem fé em Deus, não se pode esperar que a religião, através dessa fé, possa substituir a busca individual da qualificação, do conhecimento e da Inteligência inteligência, que levará o indivíduo a alcançar os sonhos e planos traçados para a vida.']",160,200,200,160,160,880
37,Chega de fiu-fiu,"['A cultura do estupro é o termo que justifica a violência contra mulher, culpando-a pelo modo de vestir ou pela sua conduta moral e não culpando o verdadeiro agente causador: o homem. Essa cultura começa com a aceitação do pensamento machista de que, por exemplo, é errado a mulher beijar vários homens ou ficar bêbada em um bar. Mas, é certo o homem ser pegador e assoviar enquanto uma mulher passa na rua.', 'Essa expressão nos últimos dias foi muito dita , por causa do estupro coletivo que aconteceu no Rio de Janeiro em uma menina de 16 anos . Após o vídeo do estupro viralizar na internet vários comentários machistas sem saber a real situação aconteceu, julgando-a que se ela estivesse cuidando da casa ou se ela não estivesse com roupa curta tal ato não aconteceria. Outro vídeo foi encontrado da vítima falando a seguinte palavra: não. Ela não queria. Mesmo assim, muitos acham que a culpa ainda é da vítima.', 'Segundo a legislação, relação sexual sem consentimento com menores de 18 anos é considerada estupro e a pena é de 8 a 12 anos de reclusão. Ou seja, independente do comportamento da mulher, da sua roupa e do seu modo de ser, se ela disser não, é não.', 'O correto é erradicar o problema desde criança, ensinando-lhes que a mulher pode agir como bem entender e que nada será motivo para serem violentadas. Ensinando que é errado a cada 11 minutos acontecer um estupro. Ou seja, a solução é romper essa cultura de estupro, demonstrando que o certo é o homem respeitar e não a mulher a ter medo.']",80,120,80,80,80,440
43,Cancelamento por redes sociais,"['Durante a Idade Média, na Europa, a Igreja controlava o pensamento social, inibindo qualquer pensamento contrário ao dela, e punindo severamente quem a contrariasse. Hodiernamente, observa-se uma ação semelhante na cultura do cancelamento nas redes sociais, na qual gera graves problemas, como o impedimento de expressão e livre arbítrio, além dos prejuízos a vida pessoal de quem é cancelado. Desse modo, se torna necessário uma mudança.', 'Em primeira análise, percebe-se o impedimento da exposições de ideias e pensamentos. Pessoas que se auto intitulam como ""juízes"", julgam e analisam pensamentos alheios, além de considera-los errôneos apenas por não compactuar com o que acredita ser justo, acabando com um princípio básico, o direito  livre expressão. Contrariando o pensamento do filósofo francês, Voltaire, defensor do livre arbítrio e autor da frase ""posso não concordar com nenhuma de suas palavras, mas defenderei o direito de dize-las"". Entretanto, poucos acabam seguindo essa filosofia iluminista, alguns até concordam com o pensamento, mas acabam julgando também, apenas para não ficar de fora da maioria e ser cancelado. Assim, torna-se imprescindível uma ação.', 'Além disso, depreende-se diversas peras na vida de quem é cancelado. Quando um celebridade famosa é cancelada, a pessoa por trás do papel que ela transmite a seus fãs, sofrem diversas consequências, desde problemas emocionais, à problemas financeiros. Em 2018, durante a Copa do Mundo, o youtuber Julio Cocielo foi cancelado após fazer um comentário sobre o jogador francês Mbappé, no comentário ""esse Mbappé faria vários arrastões na praia"", no qual o famoso fazia referência, de forma figurada, a velocidade do jogador . Diversos comentários de cancelamento foram direcionados ao brasileiro, que por falta de interpretação, julgavam o mesmo de racismo, atribuindo a frase, à cor de ele do Mbappé. Como consequência, o youtuber perdeu milhares de fã, além de patrocínios.', 'Diante dos fatos supracitados, torna-se fundamental uma mudança. Afim de mitigar os problemas que fomentam os cancelamentos digitais, cabe ao Ministério da Educação e Cultura (MEC), criar campanhas através de redes sociais , como facebook, instagram e principalmente twitter, com o propósito de conscientizar as pessoas sobre a existência de opiniões diferentes, e em casos de crimes cibernéticos, deixar para juízes julgar a punição. Ademais, é fundamental que as próprias pessoas leiam e interprete da melhor maneira as publicações, e incentivem a fazerem igual. Somente assim, a cultura do cancelamento digital deixará de ser um problema, e alcançarão a liberdade de expressão defendida por Voltaire.']",160,160,160,200,200,880
90,,"['Na serie ""Olhos que condenam"" é retratado a historia de preconceito que Marie Wise sofria dentro e fora de casa por ser uma mulher trans. Marie é expulsa de casa por sua mãe, e acaba sendo assassinada na rua por conta de sua identidade de gênero. Nesse sentido tal promissa se faz presente no contexto brasileiro vigente, uma vez que a transfobia é uma questão recorrente. Logo faz-se necessário medidas  a fim de amenizar esse impasse, que dentre as principais causas estão a insuficiência legislativa somado falha governamental em intensificar projetos de socialização.', 'Sob essa perspectiva, convém enfatizar que a ausência de leis está entre as principais causas da transfobia. Nessa óptica, de acordo com o levantamento feito pelo o Grupo Gay da Bahia em 2014, a cada 27 horas um brasileiro é morto por ser LGBT (lésbicas, gays, bissexuais e transgêneros).Sob esse viés, o transexual e o travesti está exposto não só á falta de segurança que, de fato, assola o Brasil, mas também correr risco de ser agredido ou morto por apenas existir. Dessa forma é inaceitável que esse tipo de crime seje tolerado.', 'Ademais, a falta de projetos de socialização é mais um dor fatores que agravam o impasse. Nesse contexto, apesar da constituição federal estabelecer o direito de todos á isonomia social, não há requisitos que obrigam empresas, por exemplo a contratação de transgeneros. Essa conjuntura, segundo o filósofo contratualista John Locke, configura-se como uma violação do ""contrato social"", já que o Estado não cumpre sua função de garantir que os cidadãos desfrutem de direitos indispensáveis, como o trabalho. Sendo assim, com a dificuldade de conseguir um emprego, acabam escolhendo a prostituição, sendo uma das poucas formas de se sustentarem.', 'Fica evidente que a insuficiência legislativa e a falta de projetos de socialização são prejudiciais ao combate a transfobia e que, por tanto é necessário mudanças. Para tanto, o governo deve  investir na implementação de delegacias especializadas nessa forma de agressão. Ademais, o Ministério do Trabalho deve facilitar o acesso dos trangeneros nas empresas, por meio de um projeto de lei a ser entregue á Câmara dos Deputados. Nele deve conter que as empresas privadas aceitam a contratação de transexuais e travesti, afim de tornar possível o acesso ao trabalho e diminuir o número de prostituição de pessoas trans. Assim, se consolidará uma sociedade menos transfobica, na qual o Estado desempenha corretamente seu ""contrato social"" tal como afirma John Locke.']",160,200,160,200,160,880
105,(Sem título 046),"['Nos últimos meses, a discussão a respeito da publicação de biografias não autorizadas ganhou destaque e esteve, inclusive, em avaliação no Supremo Tribunal Federal. Artistas reclamam seu direito à intimidade e demandam a publicação somente de biografias autorizadas.', 'Autores desse gênero de livro costumam buscar por [buscar] informações pessoais curiosas ou inéditas das celebridades sobre as quais escrevem para atrair leitores. Essas informações são íntimas e, muitas vezes, cautelosamente resguardadas pelos biografados, que têm claros [bons] motivos para se sentirem invadidos e até agredidos. Sem falar nas situações em que, além do artista, são expostos indivíduos comuns que, por terem se relacionado de alguma forma com ele, aparecem na história. Familiares, por exemplo.', 'Há outro aspecto que merece atenção: sendo o biografado fator atrativo [elemento de atração] de leitores (sem os quais não há lucro), não seria ele merecedor de parte desses lucros? Além de ter sua vida revirada e seus “podres” revelados, o artista tem que aceitar o fato de que alguém está ganhando em cima disso, e não é ele. Algo deve mudar.', 'Indivíduos favoráveis à publicação de biografias não autorizadas recorrem ao argumento do direito à informação. De fato, é pertinente biografar (mesmo sem autorização) figuras públicas cujas ações sejam de interesse e importância social, ou seja, pessoas cujas atitudes se reflitam diretamente na sociedade prejudicando-a ou beneficiando-a. Tomem-se como exemplo políticos, que podem ser biografados com objetivo de se revelarem escândalos sobre os quais o público deve tomar conhecimento. Esse fim justifica os meios e trata-se de um caso bem particular.', 'Conclui-se, finalmente, que (com ressalva para os casos de real necessidade) a publicação de biografias não autorizadas é injustificável. O direito público à informação termina quando o direito do indivíduo à privacidade começa.']",200,200,200,200,120,920
77,Preconceito troque por Respeito,"['A homofobia é a repulsa ou aversão aos homossexuais. O preconceito em muitas sociedades impede que gays possam exercer livremente a sua cidadania ou viver em segurança. Alvo de discriminação, são constantemente ameaçados com insultos ou agressões físicas que muitas vezes levam à morte.', 'O pior acontece quando o preconceito se torna uma política de Estado. Em pleno século XXI, a prática homossexual é considerada crime em mais de 70 países. Em oito deles, a punição para quem se relaciona com alguém do mesmo sexo é a morte: Mauritânia, Nigéria, Sudão, Lêmen, Arábia Saudita, Irã, Iraque, Paquistão e Afeganistão. Qual crime comente um cidadão gay nesses países para pagar com a vida? Nascer.', 'No Brasil, o casamento gay foi reconhecido pelo Supremo Tribunal Federal (STF) em maio de 2011. Com isso, as pessoas do mesmo sexo podem desfrutar dos mesmos direitos e garantias que eram exclusivos dos casais heterossexuais, como a comunhão de bens, pensões e aposentadorias e a possibilidade de compartilhar uma adoção. E mesmo assim é o país que mais mata gay no mundo. É preciso que a sociedade brasileira se mobilize em pro desta causa.', 'Por falta de valorização profissional, muitos homossexuais acabam caindo na prostituição. É preciso uma politica de cotas de empregos nas empresas publicas e privadas, para que assim aqueles que não têm muita instrução, possam ganhar seu pão com dignidade. O governo deve fazer uma lei mais severa para punir o agressor preconceituoso e assim instaurar o respeito. E o debate é fundamental para que se possa compreender e ser compreendido. Todo o mundo é composto de mudanças, tomando sempre novos caminhos. O principio que tem norteado a vida continua o mesmo. O respeito.']",120,120,120,120,120,600
143,A violência dos trotes,"['O trote nas         Universidades, serve         como uma forma de integração entre calouros e veteranos, em que os novatos deveriam ser recebidos de forma a se familiarizar com o ambiente em que         passará por         um certo período da vida.                 Sendo assim, esses trotes deveriam acontecer de tal forma que          escolhesse          os calouros, mas em muitos casos é o que não acaba acontecendo.', 'Em muitas          Universidades          no Brasil, foram registrados casos em que calouros sofreram violência e humilhação praticadas por          veteranos que de uma certa forma          cometem          excesso de abusos          simplesmente por sentir prazer em fazer          isso, e por saberem          que não          iria          ser devidamente          punido          ou por não dar em nada, chegando          em          um ponto em que                  deixa de ser brincadeira e passa a ser uma forma de tortura, que acaba violando os direitos humanos.', 'Quando a situação se torna abusiva, pode         gerar traumas ou até mesmo mortes. Muitas                 vítimas          reprimidas  , não informa         autoridades para punir os criminosos. Algumas         Universidades         do Estado de São         Paulo, tem         investido nos canais de         denuncia         e da advertência oral, escrita ou suspensão por injúria ou agressão física. Mas essas medidas         pode         não ser o suficiente para resolver o problema.', 'É importante que os         casamento          de abuso          seja          responsabilidade civil, penal e administrativa                , pois não         deixa         de ser crime         e         se ficar apenas na responsabilidade da         Universidade         , os problemas não         iram         diminuir expressivamente.']",80,120,80,80,80,440
94,The good doctor(não é título),"['A série "" bom doutor"" mostra a rotina de um jovem médico autista, durante os episódios é possível perceber o preconceito e o desmerecimento da sua capacidade por parte dos colegas de trabalho e pacientes, mesmo sendo brilhante ele sempre é pressionado a provar que é capaz. Fora das tela isso infelizmente acontece, no Brasil muitas pessoas com autismo tem que lidar com o preconceito, falta de estrutura e desrespeito à sua condição. sendo o direito de igualdade garantido por lei a todos, esse se torna um problema que deve ser discutido e solucionado com a colaboração de todos.', 'Um dos problemas começa logo na educação, sendo um transtorno que afeta a interação social, comunicação e comportamento do indivíduo é necessário profissionais habilitados para o oferecimento de uma educação especial que seja focada nesses alunos e alcance um resultado de qualidade, mas mesmo o Brasil possuindo mais de um milhão de alunos nesse segmento segundo o Inep , a matrículas dos mesmos em classes comuns tem aumentado, demostrando um despreparo do setor público.', 'Outros problemas são a exclusão e a falta de informações, segundo o site globo, uma pesquisa realizada nos Estados Unidos, demostrou que mais de 80% dos autista estavam fora do mercado de trabalho. Como no Brasil só em 2019 foi sancionada a lei que inclua dados sobre os autistas no censo de 2020 ainda não há dados sobre esse publico, o que dificulta saber a proporção do problema, aumenta mais a exclusão social e favorece a veiculação de informações falsas para a população em geral.', 'Portanto se faz necessária medidas para sanar o problema, ministério da educação e da economia devem juntos criar um projeto de lei no qual sejam incluída nas escolas profissionais capacitados para lidar com esses alunos, sejam feitas cartilhas com informações e dados sobre o assunto e distribuídas população e as impressas devem ser incentivadas por meio da diminuição dos impostos a colocarem no seu quadro de funcionários pessoas autista respeitando suas limitações, tendo por finalidade uma verdadeira inclusão com o auxílio de todos.']",120,120,120,160,120,640
44,P,"['longo da história a mulher foi vista como ser sensível, irracional e incapaz de conquistar a sua independência. Porém, elas provaram que são sim capazes de se sustentar e fazer parte do que quiserem. Nessa perspectiva, muitas mulheres participam do atletismo, mas de modo seletivo, competindo apenas com aquelas que tem a mesma capacidade física . Desse modo, as que não se enquadram nesse padrão são muitas vezes impedidas de competir e acabam sendo injustiçadas por esse preconceito.', 'Primeiramente, os padrãos sempre estiveram presente nas competições, principalmente para selecionar só aqueles que mais se enquadraram neles. Tal contexto, se compara com a frase do grande filósofo alemão Arthur Schopenhauer "" Todo o homem toma os limites de seu próprio campo de visão como os limites do mundo"". Assim, muitos coordenadores das olimpíadas acabam tomando os limites das competidoras com menor capacidade física como as ademais que são mais fortes por possuírem naturalmente maior níveis de testosterona. Desse maneira, se medidas não forem tomadas essas mulheres não seram capazes de romper com esse padrão.', 'Ademais, a injustiça e o preconceito que essas mulheres sofrem para provarem que são realmente mulheres acabam deixando muitos indignados . Sob tal ótica, como dizia o filósofo Friedrich Nieztische ""a desigualdade dos direitos é a primeira condição para que haja direto"". Nesse sentido, essa desigualdade provocou no Brasil o movimento chamado Let het run - deixe ela correr - para permite a parcipação delas nessas olimpíadas. Sendo assim, esse movimento deve persistir até ser permitido que essas mulheres entram nessa competição.', 'Portanto, para que essas atletas possam participar dessa competição, é preciso que os coordenadores das olimpíadas selecionem aquelas com os hormônios mais alto de modo que elas poderão competir entre s - para que nenhuma competidora esteja em desvantagem- e por fim da um do mesmo troféu que as outras competidoras galharam só assim elas poderão competir sem maiores problemas. Caso contrário, as competições continuaram tomando seus limites como disse Arthur Schopenhauer.']",160,160,160,200,160,840
58,,"['A Floresta Amazônica, uma das maiores riquezas do povo brasileiro, mas ainda vista e utilizada como um mero instrumento de lucro para a classe agropecuarista . Mesmo que a maior parte da população adquira consciência sobre a importância da Amazônia, tanto como patrimônio histórico e cultural, quanto para realização de pesquisas que beneficiarão a humanidade, basta um “pequeno” grupo de fazendeiros para acabar com tudo.', 'Segundo dados do G1, o fogo “é parte de uma estratégia de limpeza do solo desmatado, para ocupação de terras pertencentes à união”, reforçando assim quem são os verdadeiros culpados pelo problema: os fazendeiros, e indiretamente, o Estado, que não toma as medidas necessárias de prevenção e remediação.', 'Assim, cabe ao Governo Federal a destinação de mais recursos à instituições como o IBAMA (Instituto Brasileiro do Meio Ambiente) e Ipam (Instituto de pesquisa ambiental da Amazônia), viabilizando a utilização de mais equipamentos (como Drones por exemplo) e pessoal , consequentemente dando maior agilidade ao processo de identificar queimadas e as tentativas de ocupação do território. Deve o Ministério Público Federal também, realizar investigações e prender os responsáveis – os que tirariam lucro daquele ato ilegal, não apenas os que estão literalmente no campo – , respaldando assim as atitudes de fiscalização e dando credibilidade e suporte à luta contra o desmatamento.']",120,120,80,120,80,520
46,JXP-A anti-democratização de um sistema de saúde precário,"['“Equidade” é tratamento igual aos iguais e desigual aos desiguais. Nesse sentido, percebe-se que o conceito aborda a questão da privatização do saneamento básico, tendo em vista que é necessário a análise dos critérios de justiça e uniformidade para intermediá-lo de maneira eficaz, pois, a utopia que a sociedade quer, não está formada conveniente a dois pontos: a desproporção de um sistema de saúde nacional, com o intuito de arrecadar dinheiro em troca dos ofícios e serviços precários que não cumprem atos e fiscalizações que deveriam ser feitas.', 'Em primeira visão, a principal ideia da política hodierna é aumentar seu capital, em concordância com pensamento do filósofo Nicolau Maquiavel, o qual afirma que, deve-se crescer o poder do governo, ainda que derrame sangue. Assim, revela o problema da anti-democratização da saúde pública, onde as autoridades concentram o seu foco em áreas mais urbanizadas (sul e sudeste), onde o patrimônio investido rende mais, e esquece do resto território brasileiro, desta maneira, ocorre acontecimentos sub-humanos em relação ao cuidado pessoal nessas regiões, como o acesso um saneamento básico precário, ou até mesmo,  inexistente.', 'Ademais, a pouca admissão de profissionais nos pontos em que o tratamento de esgoto, limpeza da água e retirada do lixo são baixas, faz crescer os casos de escassa higienização, o que aumenta o índice da problemática. Segundo dados do Instituto Brasileiro de Geografia e Estatística (IBGE), 34,7% dos municípios brasileiros ainda registram doenças relacionadas à deficiência de um saneamento básico, e mostra que, a falta de especialistas no combate as epidemias é outro fator para o aumento da desigualdade em questões básicas de saúde.', 'Diante do exposto, é necessário a reprovação aos imbróglios referenciados. Em função disso, o Ministério da Saúde deve promover a democratização do saneamento básico, por meio de campanhas que combatem situações de precária saúde. Isso será feito, por exemplo, pela conscientização da população, explicando como evitar cenas de higiene anti-humanas. Essa medida tem a finalidade de instruir os cidadãos para que não sofram as consequências da desigualdade do saneamento básico. Posto as medidas em prática, o Brasil terá um futuro mais saudável, junto com projetos de intervenções na companhia de mais benefícios.']",160,160,160,200,160,840
115,De adaptações a clássicos,"['Simplificar a linguagem dos clássicos é uma solução para mudar o cenário atual no que diz respeito         a         leitura.                 Em geral                , a população brasileira não tem interesse pela leitura e isso pode ser corroborado por pesquisas que demonstram que o brasileiro lê em média 4 livros por ano.         Geralmente         ao se deparar com textos de difícil compreensão, como as obras de Machado de Assis, os leitores optam por realizar outras atividades.', 'Adaptações dos textos clássicos, como os do escritor supracitado, com uma linguagem mais acessível, poderiam despertar o desejo         em         conhecer mais da literatura brasileira. No entanto, essas adaptações não podem descaracterizar as obras         a que se referem         , muito menos ferir o estilo de escrita do         autor permitindo         que, aos poucos, o leitor se acostume com tais características.', 'Em conclusão, percebe-se a importância         do uso das         adaptações de clássicos         literários, como         ferramenta para incentivar a leitura. É importante salientar que o leitor deve ser instigado a ler outras obras, inclusive as de         complexa compreensão         .         Desta         forma, adquirirá para si o hábito da leitura e se tornará um cidadão mais crítico e informado.']",200,120,120,160,120,720
75,,"['Uma vez que o livre porte de armas significa o aumento do número desses artefatos na sociedade, não faz nenhum sentido falar em progresso, haja vista que esse último tem a ver com um estado de paz social, o que é difícil numa sociedade em que grande parte dos cidadãos têm o direito de andar armado com um objeto mortal. Logo, o livre porte de arma de fogo é uma medida que o Brasil deve prescindir.', 'Num país que, em apenas um ano - 2016 -, contou com mais de 60 mil mortes por causas violentas, as quais a maior parte foi provocada por armas de fogo, é conspicuamente insensato não concordar que, com a extensão do direito ao porte de arma, o número de mortes violentas no país seria muito maior. Basta ver o caso dos EUA, onde a população sem antecentes criminais tem livre acesso ao porte de arma, e onde, infelizmente, quase todos os meses, um atirador mata dezenas de pessoas.', 'Vale lembrar ainda que, no Brasil, desde a implementação do Estatuto do Desarmamento, em 2005, o número de vidas salvas graças a essa Lei foi de 160 mil. Isso evidencia que a redução do número de armas de fogo é um meio mais efetivo de alcançar a paz e, assim, o progresso social. De fato, não se apaga um incêndio jogando gasolina nas chamas.', 'Portanto, cabe à sociedade civil o papel de buscar a paz social, promovendo caminhadas, bem como pessoas do mesmo bairro devem se juntar e fundar organizações comunitárias em que se trate questões sobre segurança e criminalidade; nas escolas, palestras devem ser feitas, tratando da extensão da violência, ao mesmo tempo em que a educação formal deve ser enfatizada como meio efetivo para alcançar o bem-estar social. Dessa forma, o país progredirá sem recorrer às armas.']",160,160,120,120,120,680
63,O ônus da soberba,"['“Quando a última árvore for cortada, o último rio secar e o último peixe for pescado, o homem perceberá que dinheiro não se come”. A frase, atribuída ao Greenpeace, ressalta a importância que devemos ter com o planeta em que vivemos. Apesar disso, grandes corporações vêm alterando tanto a sociedade quanto a natureza. Impactos ambientais foram e vêm sendo gerados frequentemente como resultado de uma busca insaciável do homem por poder e riqueza, mas que atrai apenas dor e perda.', 'Em um período de quatro anos, presenciamos dois desastres  monumentais no Brasil que acarretaram a comoção do povo frente aos danos irreversíveis causados ao meio ambiente, às mortes e a destruição de incontáveis lares. Até hoje a impunidade se mantém, e os verdadeiros responsáveis por este crime ambiental permanecem livres.', 'Nosso  país conta com a presença de grandes empresas multinacionais que constantemente agridem o ecossistema em que se localizam e mesmo assim saem impunes ao cometerem tais barbáries. Em notícias recentes, foi descoberto que houve negligência, bem como falsificação de documentos ambientais e processos de corrupção envolvendo as empresas e os locais aonde os desastres aconteceram.', 'Direta ou indiretamente, estas empresas matam, escravizam, discriminam, violam direitos civis, dentre outros crimes reconhecidos internacionalmente. E suas punições estão aquém de seus delitos, porém é um desafio, tanto na esfera nacional quanto internacional, o de punir estas empresas, já que muitas correm à margem das leis.', 'Entende-se, diante do exposto, a real necessidade de ações governamentais que garantam que a lei puna todos os tipos de crime ambiental. O Ibama, aliado ao Ministério do Meio Ambiente deve multar, além de fiscalizar rigorosamente os locais de risco, enquanto a população tem como papel denuncia quaisquer atividades suspeitas realizadas pelas empresas. Cabe à sociedade, em parceria com o Governo, reduzir o impacto sobre o ambiente causado pelo homem.']",120,160,120,160,160,720
59,Fome nas famílias brasileiras,"['A escritora alemã Herta Müller diz que não há palavras adequadas para o sofrimento causado pela fome. Em pleno século XXI, o Brasil sendo um país nomeado por suas grandes exportações é um dos quais possui um índice de de fome e miséria altíssimos. A falta de alimentos na mesa de diversas famílias é um problema que tem assolado os brasileiros.', 'Não descarta-se as melhorias que foram feitas nos últimos anos, o Jornal Folha de São Paulo em uma reportagem publicada em julho deste ano mostra que o índice de desnutridos caiu de 4,6% no período de 2004-2006 para menos de 2,5% entre 2016 e 2018. Porém o sistema público tem sido falho quando se trata de disponibilizar as verbas destinadas a população. A desigualdade é gritante, enquanto uns tem até mais do que precisam, outros não tem acesso nem mesmo ao básico.', 'Com a fome diária em certas regiões, o índice de IDH acaba decaindo, crianças e idosos morrem por causa da falta de nutrientes necessários no corpo. No caso das crianças não conseguem nem mesmo ir à escola, pois há também a falta da merenda . O grande mal é que o país tem produzido muito, mas nestes locais onde há uma necessidade extrema de alimento, as famílias não conseguem adquirir principalmente pela falta de dinheiro.', 'Conclui-se que é necessário a criação de novos meios para erradicar a fome no Brasil. A criação de mais projetos sociais, criação de novas leis para que a distribuição dos alimentos seja fiscalizada e chegue as casas das famílias brasileiras. Cabe também aos Estados retomarem as atividades de restaurantes populares, que eram oferecidos nas campanhas de Fome Zero, para assim conseguir levar alimentação ao maior número de pessoas possíveis.']",120,160,120,160,120,680
59,,"['O Brasil, segundo dados do FMI (Fundo Monetário Internacional), tem a segunda melhor economia do continente americano, tendo a agricultura uma de suas principais bases. O país tem recursos suficientes para alimentar todos os brasileiros, porém, devido a má distribuição de renda e leis de tributação que desfavorecem os mais pobres, a fome ainda é uma realidade.', 'Segundo o psicólogo norte-americano Abraham Maslow, as demandas fisiológicas em um ser humano são as mais básicas, compreendendo a base de sua “pirâmide de necessidades”. Apesar de uma boa situação econômica e abundância de recursos e terras cultiváveis no país, muitos brasileiros não conseguem suprir estas necessidades básicas devido a fome. Estima-se, segundo a FAO ( Organização das Nações Unidas para Alimentação e Agricultura) que existe 5,2 milhões de famintos no Brasil.', 'Concomitante a isso, segundo dados do Governo Federal, a maior parte da tributação do país é arrecadada através do imposto indireto, isto é, do preço total dos produtos no mercado. Ao comprar alimentos, tanto o cidadão rico quanto o pobre pagam uma parte em impostos, mas o pobre é mais prejudicado, pois essa taxa acaba sendo uma porcentagem maior do seu salário. Isso agrava os problemas da desigualdade social, que tem a fome como sua maior mazela.', 'Há comida o suficiente no país, porém a má distribuição e alta taxa de impostos indiretos contribui para que a fome persista. Diante disso, uma ação eficiente seria o governo legislativo propor leis para que se aumente a arrecadação de impostos diretos e diminuísse a dos indiretos, para que a compra de alimentos seja facilitada. Além disso, os veículos midiáticos poderiam estimular a população a votar em políticos com propostas que atenuariam essa situação, como aumento dos empregos e políticas públicas (como bolsa família, por exemplo). Isso ajudaria a erradicar este problema que infelizmente ainda fere a dignidade de milhões de brasileiros.']",120,120,120,120,120,600
43,A cultura do cancelamento,"['A cultura do cancelamento é um fenômeno onde as pessoas retiram o apoio já seja, moral, financeiro, digital e social a uma pessoa em uma certa posição de influência ou fama devido a atitudes questionáveis. É uma espécie de recusa coletiva que protesta no contrário de um indivíduo (geralmente uma celebridade) em redes sociais que compartilhou uma opinião discutível ou polêmica, ou que no passado fez um ato ou declaração que é socialmente reprovável ou potencialmente criminoso, é ""cancelado"". Eles são excluídos e afastados por seu círculo social, seguidores e apoiadores, onde em casos de celebridades, sua base de fãs pode diminuir de modo considerável, o que prejudica na carreira e reputação do indivíduo cancelado, em alguns casos, pode ultrapassar as redes sociais e afetar na vida pessoal deste e ter implicações reais, como a perda de emprego, de oportunidades ou até o desenvolvimento de problemas psicoemocionais.', 'É um tema polêmico, dado que abre passo ao debate sobre assuntos relevantes no âmbito real e digital, como assédio, racismo, homofobia, etc. e reúne distintas opiniões e pontos vista em um amplio mundo virtual . O cancelamento ocorre em redes sociais, quando um usuário acusa outro, em tom condenatório por um ato que pode ser considerado socialmente errado; a acusação, geralmente, exasperada, se espalha pela rede, impulsionada por curtidas e comentários sufocando o cancelado, sem que a pessoa sob ataque tenha o espaço para se defender, crescer e melhorar amplamente. É inadmissível, desumanizante e pouco realista esperar um padrão de perfeição moral sem erros por parte de um indivíduo ou celebridade. Cancelar e deixar pública e permanentemente marcada a uma pessoa que cometeu um erro corrigível por ignorância ou desinformação da mesma forma que uma pessoa que cometeu um crime é uma consequência desmedida em relação a outros casos mais graves.', 'O cancelamento é uma ferramenta capaz de forçar ações por parte de figuras públicas, amplificar a voz por causas de justiça social de grupos oprimidos e brindar liberdade de expressão, que é um direito fundamental de qualquer cidadão, sem embargo, ao exercer aquele direito implica responsabilidades especiais e limitações quando essa liberdade entra em conflito com outros direitos e liberdades, uma ferramenta com uma significativa capacidade de difundir amplamente nos meios de comunicação, deveria ser utilizada em casos que onde seja realmente justificável e de maneira responsável, mais especificamente em crimines violentos em relação a uma vítima. Também, cabe ressaltar,  que cancelar não deveria ser sinônimo de acossar, ser abusivo ou fazer “Bullying”, existe uma significativa diferença entre criticar e conscientizar a atacar pessoalmente, burlar-se de situações abusivas, do aspecto físico, ou inclusive ameaçar de violência ou de morte, esses são extremos aos quais não se deveria chegar, dado que é possível formar argumentos sólidos contra um discurso de ódio, desinformação ou ignorância, conscientizar acerca dos atos e promover um âmbito de debate saudável, sem a necessidade de insultar ou agredir.', 'Infere-se,  que é importante responsabilizar as pessoas de suas ações, só que as consequências tendem a ser injustas e excessivas em alguns casos que não merecem essa condena ou se torna um ataque revestido em ofensas. Portanto, é preciso que a sociedade associada às mídias sociais, implementem novos padrões mediante  os quais realizar, a nível individual, um anlise, crítica ou conscientização adequada para forçar ações públicas necessárias a cada caso e brindar ao indivíduo a possibilidade de progresso intelectual e evolução pessoal por erros corrigíveis cometidos no passado, através de espaços sociais que influenciem o debate favorável, conscientização e possa prover a informação sobre o tema e os diversos casos para os usuários, com o objetivo de promover um âmbito de disputa saudável e controlar que as consequências das ações não sejam desmedidas e possam ser redimidas.']",160,160,120,120,160,720
43,O cancelamento da liberdade de expressão.,"['A internet no século XXI está cada vez mais presente na sociedade mundial pelos seus avanços nas pesquisas científicas, no entretenimento e nas redes sociais. Todavia, um movimento idealista perigoso surgiu com o advento das mídias, conhecido como “A cultura do cancelamento”. Atualmente, esse movimento se faz presente constantemente nas mídias sociais, gerando diversos óbices na liberdade pessoal e na Constituição ederal, além de originar uma ditadura ideológica das classes militantes.', 'A cultura do cancelamento é o julgamento das atitudes e ideais de alguma pessoa famosa, onde a mesma publica uma foto, uma frase ou um arquivo que resulta em uma polêmica virtual, muitas vezes desencadeando discussões políticas e sociais de longo alcance. O grupo que compõe essa cultura,  possui como objetivo principal inflamar o indivíduo contrário, por meio de ofensas ideológicas, raciais, culturais ou até mesmo religiosas. Desta forma, o grupo fere a Constituição ederal, já que o artigo Art. 5º assume que a lei punirá toda discriminação atentatória dos direitos e liberdades fundamentais, o que é feito pelo grupo como forma de justiça, sendo na verdade, um crime cibernético.', 'Voltaire em suas obras afirmou que “quando não há entre os homens, liberdade de pensamento, não há liberdade”. O pensamento do filósofo que viveu cerca de 300 anos atrás vem de encontro com a linhagem do cancelamento virtual moderno. Torna-se perceptível de que o “tribunal” que comanda essa linhagem de pensamento,  não permite qualquer direito de liberdade de expressão e de respostas aos ataques, dado que a partir do cancelamento, o indivíduo cumpre um cárcere online e consequentemente deixa de ser acreditado pelos apoiadores e pelos leitores. Além disso, os famosos não são tratados da mesma forma. Existe a expressão virtual “passar pano”, a qual os grupos que normalmente atacam, se omitem diante os fatos, comprovando que o movimento não oferece justiça.', 'Diante dos fatos citados, comprova-se que a cultura do cancelamento é duvidosa e muitas vezes criminosa. Logo, medidas severas devem ser tomadas. Os donos das maiores redes sociais , como o Twitter, Facebook e Instagram, devem criar leis internas proibindo a prática desses comentários ofensivos nas redes, por meio de robôs virtuais que acompanham postagens com caracteres ofensivos e denunciam instantaneamente. A partir da denúncia, profissionais especializados julgarão se foi um discurso de ódio. Ao ser comprovado, a conta automaticamente é deletada e o dono processado. Cancelando aquele que iria cancelar. Somente assim, o óbice será resolvido.']",160,200,160,160,160,840
83,Atividade física e social,"['A prática esportiva é importante tanto por estética quanto por saúde, pois pode, além de combater problemas como obesidade, ajudar socialmente e ser estimulada de diversos modos.', 'O esporte é supervalorizado em nosso país, em especial o futebol. Isso é muito importante em áreas periféricas, já que tira crianças das ruas, onde podem estar à mercê do perigo das drogas e da criminalidade, e traz para o campo dos esportes. Prova disso é Rafaela Silva, que, morando na favela, decidiu ingressar no esporte e hoje é a mais nova medalhista de ouro de judô nas Olimpíadas do Rio. E muitos outros esportistas como Neymar, que morava na periferia, também entrou em campo e pôde ajudar a família, além de abrir um instituto esportivo para outras crianças carentes, o Instituto Neymar Júnior. Com isso, o esporte nos ensina que é possível realizar nossos sonhos e os de outras pessoas.', 'Mas a atividade física nem sempre precisa ser a nível profissional, como citado anteriormente. Ela também pode ser pela saúde e longevidade do corpo. Existem diversos aplicativos de exercícios físicos disponíveis para smartphones que disciplinam o praticante, como tempo de exercícios, de caminhada ou de corrida. É interessante citar um aplicativo recente chamado Pomona GO, um jogo n o qual consiste em capturar criaturas virtuais e, para isso, o jogador precisa andar pela cidade e caçar. O jogo estimula crianças e adolescentes à caminhada ou a andar de bicicleta. Isso faz com que eles fiquem determinados e competitivos, o que é exatamente o que os esportes nos mostram, que o importante não é só ganhar ou perder, mas também competir. Essa competitividade é importante socialmente para os jovens em provas ou entrevistas de empregos , por exemplo.', 'Portanto, a prática de exercícios é necessária não apenas para o nosso corpo, mas também para nossa sociedade. Ela nos mostra como pode ser importante socialmente e fisicamente. Ela pode ser estimulada tanto pela televisão com os Jogos Olímpicos, como por aplicativos. Além, é claro, da educação física nas escolas, que também é essencial.']",160,200,160,160,200,880
83,"Boa performance, com respeito às regras","['Os Jogos Olímpicos de 2016 tiveram início no mês de agosto na cidade do Rio de Janeiro, no Brasil, e tornou-se um dos maiores assuntos nas mídias e redes sociais do país. Por consequência, passou-se a conhecer mais da vida dos atletas, os problemas e escândalos das competições esportivas.', 'Muitos dos atletas olímpicos tiveram suas vidas e caráter transformados devido as oportunidades que a prática esportiva oferece. Este fato é mais nítido em países subdesenvolvidos, em que jovens de baixa renda tornam-se ídolos do esporte e influenciam os outros a serem esportistas. Mesmo que estes não se tornem famosos, vão ser beneficiados mental e fisicamente.', 'Entretanto, a competitividade exagerada no esporte gera a trapaça, que mesmo com tanta segurança para evitá-la, continua acontecendo. Como pôde ser visto na delegação russa, que teve um terço de seus atletas excluídos dos Jogos Olímpicos 2016, após a descoberta de um grande esquema de uso de doping. Por isso, a Rússia, que tinha ótimos resultados, perdeu a credibilidade e também algumas medalhas.', 'Portanto, mesmo com a corrupção nas competições, o esporte é uma ótima ferramenta para melhoria de vida. Logo, é necessário que desde cedo os atletas aprendam o valor da ética, possam olhar para os maus exemplos e ver que não compensa o “jogo sujo”. Que nas aulas de educação física e treinos eles sejam levados a melhorar sua performance, mas sem desrespeitar as regras. Pois como disse Immanuel Kant “o ser humano é aquilo que a educação faz dele”.']",160,200,160,200,200,920
68,Valorizando o patrimônio da forma que este merece,"['Há pouco tempo ocorreu um incêndio no Museu Nacional, fazendo com que quase todo o material histórico fosse perdido.', 'Neste contexto entra a questão ""Por que valorizar o patrimônio histórico?"". É por meio dele que as gerações atuais e futuras entendem um pouco do passado, compreendendo melhor o futuro.', 'Porém o governo brasileiro têm deixado a desejar no quesito manutenção e divulgação dos seus patrimônios, pois encontra-se muitos museus fechados por falta de verba, e muitos dos museus presentes no Brasil são desconhecidos pela população.', 'A valorização desses patrimônios  não se faz apenas na criação de museus ou monumentos, e sim na forma com que este patrimônio é exposto a sociedade.  Poucos são os que podem visitar um museu no Brasil, e essa falta de participação acarreta na ausência de conhecimento histórico do próprio país. Esta ausência não se dá apenas a falta de condição da população de ir a um museu ou exposição, mas a falta de verba do governo para manter estes patrimônios.', 'A valorização total dos patrimônios seria feita no momento em que o governo se importasse mais com a cultura, e então reabrisse os museus fechados e incluísse toda a população, desde os mais ricos até os mais pobres, divulgando os dias de visitação, o endereço e deixando os ingressos mais acessíveis aos mais desfavorecidos.', 'Assim, o conhecimento histórico da população aumentaria e o patrimônio histórico seria valorizado da forma que merece.']",120,120,120,120,120,600
15,A obesidade humana,"['A obesidade humana é um problema que vem se agravando, a cada dia, e poucas medidas são tomadas pela nossa sociedade, que seja realmente eficiente para a solução desse caso alarmante.', 'Ninguém consegue viver sem comer, isso é óbvio. No entanto a comida pode se tornar um inimigo mortal do ser humano. Quase 40%, por cento, da população mundial adulta e 20%, por cento, das crianças e adolescentes, entre 5 e 18 anos, já sofrem de sobrepeso e obesidade sendo a segunda causa de morte no mundo, devido a série de riscos que acarreta a saúde.', 'Em virtude dos fatos mencionados, para combater o sobrepeso e a obesidade da população , são necessárias várias medidas de conscientização da população, dos governantes e setores industriais ao consumo saudável dos alimentos a esse ""novo ciclo"" da vida moderna.']",120,120,120,120,120,600
70,,"['Atualmente no Brasil ocorrem diversos casos de doenças sexualmente transmissíveis entre o público jovem, muitas vezes por falta de orientação vindo dos familiares, algumas vezes por acharem cedo demais entrar nesse tipo de assunto e outras por se sentirem constrangidos em dialogar com seus filhos.', 'Hoje existe um programa governamental onde disponibilizam em postos de saúde preservativos gratuitos e de fácil acesso, ainda sim muitos jovens se recusam em proteger-se muitas vezes por não ter informações sobre os riscos que estão expostos.', 'O governo  junto às escolas e unidades de saúde deveria promover palestras incentivando o uso de camisinha e os danos que podem ser causados pela ausência do uso de preservativos em suas respectivas relações sexuais.', 'Com o incentivo e auxílio do governo  juntamente a sociedade  esse aumento de DSTs entre os jovens pode ser controlado, não adianta disponibilizar preservativos e não incentivar o uso dos mesmos nem muitos menos tapar os olhos perante essa situação tão intrínseca em na população brasileira .']",120,120,120,120,120,600
70,Como combater o aumento das DST entre os jovens brasileiros?,"['É evidente o quanto as DST são muito mais comuns entre os jovens, é um dos maiores perigo dessa fase da vida, é um problema muitas vezes causado pela própria mentalidade de adolescente, que pode por em risco todo o resto de sua vida.', 'Doenças como AIDS, gonorréia e síflis são transmitidas durante o ato sexual sem o uso de preservativo, as chances de se obter essas doenças aumentam ainda mais quando o indivíduo detém relações com várias pessoas em um curto período de tempo. Na juventude, muitas vezes falta maturidade e conscientização, pois os tratamentos, consultas e prevenções estão a disponibilidade todos, através do Serviço Único de Saúde , que oferece, por exemplo, preservativos de forma gratuita, basta que os jovens tomem ciência disso, pois é normal nessa fase querer aproveitar os prazeres máximos e acabar se expondo a riscos.', 'Enfim, é essencial que os jovens brasileiros tomem responsabilidade pelos seus atos e não ajam de forma compulsiva quando iniciam sua vida sexual, cabe ao ministério da saúde oferecer uma educação sexual por meio de colégios e mídias sociais, instruindo a importância do uso de preservativos e apresentando dados sobre as diversas doenças, garantindo um ganho de maturidade nos jovens para com o futuro de sua vida sexual.']",120,120,80,120,120,560
83,O que podemos aprender com a prática esportiva?,"['O período Neolítico foi marcado por grandes transformações. O homem, a partir deste momento, passou a se enxergar como um ser social, portanto, passou a viver em grupo. Uma das principais características do período foi o desenvolvimento da agricultura, que trouxe para o homem uma comodidade, pois a partir disso passou a morar próximo a rios, plantar alimentos e não depender totalmente da caça para sobreviver. Uma das maiores consequências do desenvolvimento humano no período neolítico foi o chamado sedentarismo. Atualmente, o sedentarismo é considerado a doença do século.', 'Inúmeras são as consequências do sedentarismo, por isso, cada vez mais adultos e crianças são incentivados a praticarem atividades esportivas. Um dos maiores incentivos que o Brasil ofereceu a população foi sediar os Jogos Olímpicos, pois mostram uma variedade de esportes disponíveis para àqueles que querem iniciar uma prática esportiva. Além de mostrar que o esporte não se trata apenas de uma competição, pois também existe superação de limites, desafios, lágrimas e vitórias.', 'O esporte, durante a infância, por exemplo, ajuda a moldar o caráter do indivíduo. Além do desenvolvimento físico e motor, age também no desenvolvimento social, pois a criança, desde cedo, compreende a importância do trabalho em equipe, regras, condições e, principalmente, aprende a lidar com frustrações. Existe uma geração que não consegue lidar com derrotas, talvez se o esporte tivesse presente na vida dessas pessoas, elas saberiam lidar melhor com as mais diversas situações.', 'Fica evidente a importância da atividade esportiva. O governo brasileiro deve continuar incentivando a população com campanhas televisivas, eventos, construções de espaços onde esportes possam ser praticados gratuitamente e com segurança. Os pais também têm um papel importante, devem, cada vez mais, incentivar os filhos a praticarem esportes e, principalmente, mostrar que o esporte vai muito além de uma competição. Aos poucos a população vai abandonando o sedentarismo e compreendendo que o esporte é libertador.']",120,160,200,200,200,880
95,,"['A promulgação da Constituição federal de 05 de Outubro de 1988  foi uma grande vitória da sociedade civil, sendo reconhecida como constituição cidadã, mas deixou pontos vagos do povo indigena. O que precisa pra ser reconhecido como índio? Como ganhar erra do Estado?', 'Para ser considerado cidadão brasileiro basicamente basta nascer em território brasileiro e o índio? Precisa de forma mais elaborada como: auto-declaração, consciência e reconhecimento do grupo a que pertence como índigena tendo a Funai como instituição protetora.', 'O grupo indgena pode requisitar a Funai um território, farão todo esforço possível para encaminhamento de criação de uma nova erra índigena. Há uma proposta sensata no Congresso Nacional de ""Marco Temporal das erras Índigenas"" que é o ponto exato que pode ser reconhecido o território índigena essa estratégia evita que um dia a tribo ou a que vier sugir por exemplo, resolva pedir a praia de Copacabana porque lá foram enterrados seus ancestrais.', 'Devido ao tipo de reconhecimento do indgena como autodeclaração a proteção da Funai e visando o interesse da Constituição federal a melhor alternativa é o marco temporal com isso evitando a implosão das garantias constitucionais.']",80,80,80,120,0,360
124,"Lixo, reciclar poque  não reutilizar?","['O aumento do consumo         mundial, gera         uma grande quantidade de lixo urbano, isso porque cada vez mais as coisas estão se tornando descartáveis. Um dos maiores exemplos é o descarte de aparelhos         eletrônicos,  pelo          alto preço do conserto                , as pessoas preferem comprar um novo,                 pela maior praticidade                . Isso não ocorre apenas com esse tipo de produto, roupas, calçados, também são exemplos.', 'Um dos desafios que cidadãos e governantes tentam resolver é o local onde esse lixo é depositado. Segundo dados da Abrelpe, um a cada quatro sacos de lixo vai para um local         improprio         ,                 sendo resultado muito negativo, o que gera grandes problemas ambientais e sociais.                  A contaminação do solo, do ar pelo mau cheiro, a desvalorização dos terrenos que cercam o local onde o lixo é jogado inadequadamente, além de ser um atrativo para diversos insetos, pondo em risco a saúde da população no local.', 'Soluções como a criação de mais aterros sanitários e a extinção dos chamados ""lixões"",         depositados         irregulares de lixo, coleta seletiva, campanha de reciclagem, são atitudes cabíveis ao governo, porém a população é a que possui o maior papel para a solução desse problema.', 'O cidadão deve se conscientizar do seu papel na reciclagem, separando o lixo, não jogando na rua, pois é uma das causas de entupimento de bueiros, consumir menos, reaproveitar e reutilizar quando possível, são pequenas práticas para cada um, mas é uma grande atitude para um todo.']",80,120,120,80,120,520
46,Desvantagens da privatização do saneamento básico no Brasil,"['Com a revolução taylorista no final século XIX, a venda de empresas estatais para as privadas trouxe uma nova alternativa para áreas em desenvolvimento competirem na economia global. Desde então, no Brasil, diversas infraestruturas da sociedade passaram pelo processo de concessão. Hoje, do mesmo modo, o saneamento básico tem sido alvo dessa política entre os empresários e o Estado. Todavia, apesar de ser um modelo adotado historicamente no país, ele põe em risco não só a autonomia nacional, como a democratização de acesso à água potável e tratamento de esgoto . Mediante a isso, cabe analisar suas desvantagens ao território brasileiro, considerando a atuação do corpo cívico quanto a coibir que a privatização do saneamento básico chegue a vigor.', 'A priori, pode-se afirmar que a desigualdade social tende a ser mais acentuada com a legislação de tal serviço. Inicialmente porque as empresas do setor almejam exclusivamente a obtenção de lucro. Com isso as regiões menos atrativas, como a periferia, deixam de ser atendidas, o que dificulta ainda mais a democratização do acesso às medidas sanitárias. De maneira análoga, no filme fictício ‘’Mad Max’’, a água potável da cidade era controlada pela elite e utilizada em demasia por ela em comparação com os pobres. Esse contexto revela que a responsabilidade sobre a distribuição de saneamento no comando de iniciativas privadas favorece aqueles de maior prestígio social. Por fim, é preciso se levar em conta a tendência segregacionista que a privatização promove nas produções sociais as quais atua.', ""Outrossim, a concessão do fornecimento de água e coleta de esgotos ameaça a soberania nacional. Essa circunstância se dá, na medida em que, com a compra da empresa estatal, a atuação dos representantes políticos nela é limitada. Pois, como maiores acionistas, a tomada de decisões dos empresários prevalece acima da autoridade do Estado . Em paralelo, o regime expansionista ‘'Rota da Seda’’ da China tem realizado obras gigantescas em países de terceiro mundo em troca de acordos comerciais com eles. Essa relação financeira, entretanto, restringe o poder de escolha desses locais, referente decidir os melhores importadores para seus negócios. Logo, com a nova venda, o papel do Estado fica suscetível depender das empresas privadas."", 'Em suma, o saneamento básico vem sendo tramitado como próximo setor a ser privatizado no Brasil. Para mudar esse panorama, os sindicatos brasileiros devem produzir juntamente a petição oficial ‘’Água: Poder da Gente’’ para os seus cidadãos. Esse abaixo-assinado, em defesa do saneamento estatal, estará em aberto na internet. Apoiado pelas redes televisionárias, a peça publicitária conscientizará as pessoas a participar. Além do mais, o intuito é que o documento seja entregue ao Governo Federal. Feito isso, seguindo a premissa que ‘’a vontade geral deve emanar de todos para ser aplicada a todos’’, conforme afirma o filósofo Rousseau, a sanção será revogada e, assim, a autonomia nacional será mantida.']",160,200,160,200,160,880
84,Armamento civil problema ou solução?*,"['Diante do cenário atual de insegurança da população brasileira, está em discurção no Congresso um projeto de lei que tenta tornar o acesso a armas de fogo mais acessível a populaçao civil, porém os números de mortes alarmantes com armas de fogo parecem insuficientes para se pensar em tamanho projeto.', 'Na década passada houve a criação do Estatudo do Desarmanto e a campanha que recolheu milhares de armas da sociedade civil, porém o número que armas que entram no país clandestinamente e vão parar nas mãos erradas vem crescendo nos últimos anos. O aumento da violência e a falta de segurança faz com que uma parcela da população civil queira andar armado ou ter uma arma em casa. Isso é reflexo do aumento da criminalidade nas grandes cidades e até mesmo nas pequenas cidades.', 'A ideia do armamento tem fundamento desde que apesar da facilidade em poder poder possuir porte de armas, a pessoa possua condições para possuir a mesma  como tendo treinamento por exemplo. Mas o aumento do número de armas em circulaçao não irá diminuir o número de criminalidade, irá aumentar o numero de mortes como casos banais, acidentes dentro de casa etc.', 'Criminalidade se combate com educação, melhoria das condições sociais da população, maior eficiência nas fiscalizações das fronteiras, aumento da guarda civil.']",120,160,120,160,200,760
20,As oportunidades,"['O Brasil e um pais bom de si viver, porem tem suas desvantagens em alguns aspectos, por isso ocorrer ocorre que cada vez mais os jovens estão orbitando por sair do brasil por falta de oportunidades.', 'Os jovens de hoje buscam oportunidades para ter um futuro, e o brasil esta meio difícil para pessoas com pouca condição financeira, sem nenhuma experiência e vão em busca de conquista seu futuro de forma honesta, e por falta de oportunidades na educação, moradia falta de emprego buscam fora ter um futuro promissor.', 'Cada dia mais o índice de criminalidade do brasil aumenta e isso tem tudo haver com a relação de pessoas carentes, que por falta de oportunidades buscam meios errados, ter alguma coisa na vida, o Brasil esta escasso de muitas coisas políticos, corruptos, que por falta de honestidade leva o pais a falência e isso influência faz com que cada dia mais as pessoas não só os jovens a procura por coisas melhores, e buscam isso em outro pais .', 'Para que os jovens fiquem em seu pais de origem o governo deveria, ter criar mais oportunidades nas seguintes áreas da educação, emprego, saúde e fazer com que os jovem tenha interesse pelo seu pais , e incentivar os jovens com programas que possam ter oportunidades e consiga um futuro.']",80,80,80,80,80,400
82,Automedicação seria um bem necessário?,"['A conquista do bem estar  da saúde física e mental estar  ligada à existência de medidas preventivas e ao combate aos sintomas estranhos presentes no corpo humano. No entanto, esse último procedimento, como solução final de uma doença, tem aumentado, em lugar de diminuição, uma prática comum da sociedade moderna: a da automedicação.', 'A doença em suas variadas formas é considerada como sendo o oposto à saúde: é aquilo que causa uma alteração ou uma desarmonização no sujeito, seja a nível molecular, corporal, mental, emocional ou espiritual, Essa  desarmonia   carregada de dores, infecções, mal estar , entre outras centenas de sintomas mais,   têm tirado a saúde e paz de uma sociedade , que  cada dia mais vive buscando maneiras de prolongar seus dias de vida, em decorrência de uma velhice com boas condições de saúde.', 'Essa seria a ordem natural das coisas, mas diferentemente desse anseio popular, a realidade da saúde do povo brasileiro, em face ás  doenças atuais, vem contrariando essa lógica,  quando ao primeiro sinal de dor  ou infecção    primeira coisa a se fazer é correr direto para a farmácia em busca de algo que os alivie.   Alimentando assim o mercado farmacêutico cada vez mais reabastecido em que vê nesses pacientes enfermos a oportunidade de faturaram  com vendas de medicamentos por muitas vezes sem uma prescrição médica ou indicação profissional.', 'Tal comportamento é algo a ser evitado, pois tende a comprometer o combate real das enfermidades, por exemplo, um uso desorientado de antibiótico segundo a patologia, responsável pelo estudo das alterações estruturais, bioquímicas e funcionais nas células,   pode trazer um problema maior. É que as bactérias, quando não tratadas com rigor, se tornam resistentes a antibióticos, contribuindo para que as infecções se tornem cada vez mais difíceis de serem tratadas. Por outro lado   é preciso considerar que  uma simples dor de cabeça, nem sempre haverá necessidade de um consulta médica, sendo assim   a utilização de analgésicos de forma moderada não representa um remediável mal.', 'Fica evidente que a saúde, como bem precioso para o alcance da longevidade, é um alvo a ser conquistado e vivenciado da melhor forma possível e só conseguiremos isso se mudarmos os nossos comportamentos. Não no sentido de auto nos medicarmos , mas de uma conscientização popular capaz de desenvolver hábitos saudáveis como forma de prevenção das doenças. O governo, por sua vez, deveria através  da Anvisa aumentar a política de fiscalização do comercio farmacêutico   punindo-o  pelas vendas de medicamentos que uma vez prescrito venham ser vendidos livremente. Agindo dessa  forma    a automedicação sofrerá uma redução considerada e os nossos anos de vida receberam   aumentos.']",120,160,160,120,160,720
52,Hormônios Precoces,"['Em um mundo onde as coisas estão ficando cada vez mais rápidas, mais precoces, onde tudo tem que ser “realizado para ontem”, os adolescentes acabam precipitando também as coisas e com seus hormônios sendo estimulados por comidas gordurosas, como salgadinhos ou até mesmo hormônios que são colocados em animais para que se possa ser feita a venda de sua carne mais rapidamente.', 'O ato sexual é uma coisa normal na vida do ser humano, mas tudo tem que ser bem precavido . A gravidez na adolescência está cada vez mais constante, o índice no Brasil chega a ser de 68 bebês nascidos de a cada mil mães de 15 a 19 anos, e a média mundial é de 46 nascimentos a cada mil.', 'Uma das matérias escolares ensina que deve-se prevenir de doenças sexuais, mas acabam não explicando sobre a gravidez na adolescência pois seria algo “supostamente” imposto no uso de preservativos, já que se protege da doença também diminuiria a chance de gravidez.', 'Contudo por causa dos hormônios elevados por “N” motivos, o adolescente acaba ignorando o uso desse meio de proteção, ocasionando assim um aumento em dois parâmetros de pesquisa: o de doenças sexuais e no de gravidez precoce']",120,80,40,120,0,360
58,Proteção da Amazônia,"['A Floresta Amazônica é a maior área verde com cobertura original no Brasil. É rica em biodiversidade e coopera no desenvolvimento econômico do país. Entretanto, apesar das riquezas biológica, natural e cultural, ela vem sofrendo rigorosamente com o desmatamento e queimadas.', 'Primeiramente, importante analisar a degradação da floresta amazônica, muitos seres vivos principalmente os animais estão sofrendo com essa desgraça . Por exemplo: o Instituto Brasileiro do Meio Ambiente (IBAMA), estudos revelão que aproximadamente mil espécie pode ser extinta da floresta por causa do desmatamento. Por isso, para evitar que isso ocorra temos que preservar a floresta amazônica.', 'Além disso, é fundamental considerar relevância da floresta para o povo indígena De acordo com a Fundação Nacional do Índio (FUNAI) a Amazônia serve de lar para 80 tribos, e todas elas vivem de recursos naturais que nossa  floresta dar, como caça, pesca e frutos. Com esse desmatamento e queimadas eles ficarão sem as principais fontes de substâncias.', 'Portanto, a preservação da floresta crucial para garantir a perpetuação das espécies e para assegurar a vivência do povo indígena. Contudo, para que isso aconteça, é fundamental que o Ministério do Meio Ambiente atue para reprimir o bioma . Isso pode ser feito por meio de patrulhamento junto com a força aérea para detectar esses responsáveis e puni-los pela degradação da floresta será contida. Portanto, tais medidas seriam eficiente para combater o desmatamento e queimadas na Amazônia.']",120,120,120,120,120,600
27,Sabedoria para argumentar,"['Brasileiros são muitas vez um povo que gosta de uma discussão. Seja nas redes sócias ou num barzinho, também na maioria das vezes em casa mesmo. Ocorre que essa discussões não tem fundamento pois os argumentos são baseados em uma ideologia fragmentada. Quando ocorre atos de desentendimentos a opinião do outro pode ser vista como uma ameaça e devido a isto ocorre brigas sem nexo.', 'A maioria não sabe lidar com opiniões diferentes e já partem para agressão física. Muitas vezes os fatos são baseados em caráter religioso ou político. A crença de ter uma argumentação melhor dá a entender que esse tipo de indivíduo e um ser preferível no padrão social.', 'A lógica argumentativa e de que o conhecimento é algo a ser praticado e transmitido de forma simples e racional Não e necessidade de refutar fatos para apresentar uma apresentação plausível. E possível que o debate seja uma forma de respeitar a opinião do próximo através de controle emocional para aprender com o que este de para oferecer. Assim e necessário mais leitura e interpretação dos fatos para chegar em uma conclusão de tolerância e ética.']",80,80,0,80,0,240
52,Perdendo a vida desde cedo,"['Declarado pela Organização das Nações Unidas (ONU) em 1948 a Declaração Universal dos Direitos Humanos, todo o indivíduo tem direito à saúde e educação. Porém a gravidez precoce mostra que parcela da sociedade não desfruta desses direitos.', 'A educação pode ser considerado um dos pilares na formação do ser humano , é normal acreditar que todos usufruem desse direito, mas é claramente contrastante com o reflexo de gravidez na adolescência. Segundo a OMS  um em cada cinco bebês nascem de uma mãe de 10 a 19 anos, isso é prejudicial a criança e aos país. Algo que ubsiste como herança social na Índia.', 'Há de se ressaltar que no século XIII a. C. (Vírgula) na Roma Antiga, isso era incentivado através de casamento permitido a partir dos 14 anos para homens   e 12 para mulheres, podendo ser prometido ao cônjuge aos 7 anos de idade. O principal objetivo era criar filhos legítimos para herdar propriedades.', 'Medidas cabíveis são necessárias para conter tal problema, um dos principais métodos seria nas escolas com o reforço na educação de práticas sexuais usando materiais específicos para a área, com finalidade de aumentar o uso de métodos contraceptivos. Dessa forma, espera-se a diminuição da taxa de natalidade na adolescência.']",120,80,80,80,80,440
82,O melhor custo-benefício,"['Imagine a seguinte cena: uma idosa, que há muito sofre com dores pelo corpo, árdua e dolorosamente se dirige à caixinha de remédios e ingere uma cavalar dose do seu tradicional fármaco na tentativa de banir sua dor. A dose é tão elevada que incorre em drásticos problemas para o organismo da vítima. O que parece ser algo pouco provável de se acontecer tem uma frequência elevada em nosso país. Em dias atuais, a realidade demonstra que pela falta de informação pública e até por conta de comodismo pela facilidade de se tomar as pílulas na caixa de remédios, o indivíduo gera uma autodependência por compostos da indústria farmacêutica, ou seja, algo difícil de se engolir com toda a medicina alternativa que se expande no século presente.', 'Para comprovar que o brasileiro está cada vez mais “escravo” de suas necessidades químicas, basta recorrer à análise de alguns dados clínicos e numéricos. Segundo a Agência Nacional de Vigilância Sanitária (Anvisa), os maiores responsáveis por intoxicação são analgésicos, antitérmicos e antiinflamatórios . Outro dado alarmante: o Instituto de Ciência, Tecnologia e Qualidade (ICTQ) expôs que   a cada 100 brasileiros, cerca de 76 admitem que realizam a automedicação e, como fator ainda mais prejudicial, 32% destes afirmaram tomar mais de uma pílula a fim de potencializar o efeito do remédio, basicamente, a sociedade se encaminha para uma overdose de problemas.', 'Na expectativa de se combater a automedicação e evitar problemas de saúde futuros, a necessidade de adotar uma medida é urgente. Para tanto, uma parceria entre o Ministério da Saúde e as redes sociais seria bem vista e vinda .  A função do Ministério seria a formulação de cartilhas sobre o perigo de se tomar remédios sem a prescrição médica, além de instruções (abrangendo a medicina alternativa) que ensinam métodos e preparos de receitas com compostos naturais que têm benefício sobre determinado mal-estar. Como a campanha será via internet (nas redes sociais), o custo será mínimo e a conscientização será máxima.', 'Partindo dessa tática, uma grande parcela das filas que ocupam o Sistema Único de Saúde (SUS) seria dispensada   já que é grande o número de pessoas vítimas de intoxicação. Dessa forma, contribuiremos para uma reeducação da sociedade brasileira e excluiremos desta o ideário de que apenas o puramente químico pode ajudar, contribuindo para que o brasileiro use de meios menos agressivos e mais baratos para a cura de seus males, tecnicamente, uma  ótimo custo-benefício.']",160,200,200,200,200,960
60,Reforma da Previdência,"['No Brasil, atualmente, pode-se elucidar tanto aspectos positivos quanto negativos a respeito de uma Reforma da Previdência. Se por um lado é inconcussa a veemente necessidade de equilibrar-se as contas públicas do país, por outro, deve-se levar em consideração os efeitos e impactos sociais que a reforma trará.', 'Segundo dados oficiais do governo, em 2018, os gastos públicos relacionados a saúde estavam na casa dos R$100 Bilhões, enquanto os dispêndios jungidos a previdência ultrapassaram o patamar dos R$700 Bilhões. Mudanças e reformas na legislação previdenciária vigente se fazem necessárias, dado o caráter deficitário do atual sistema previdenciário que representa um rombo nas contas públicas.', 'Não obstante, alterações no sistema previdenciário que têm como objetivo a diminuição de gastos são dotadas de um ônus de caráter social. O acesso a determinados benefícios se torna mais difícil, de forma que as classes sociais que dispõem de menos recursos financeiros são mais vulneráveis, isto é, são impactadas mais significativamente.', 'Nesse sentido, convém lembrar que o atual sistema previdenciário brasileiro é dotado de um caráter social; corresponde a um programa de seguridade social . Para o professor, historiador e jornalista Marco Antonio Villa, a reforma da previdência faz-se urgente e promissora por seus aspectos econômicos, desde que o novo modelo previdenciário não aja em detrimento das camadas mais pobres da população.', 'É preciso, portanto, de uma reforma da revidência que satisfaça as necessidades econômicas do Brasil e que não seja austera com a população mais pobre. Assim, cabe a sociedade, mídia e instituições brasileiras fiscalizem o processo de aprovação de uma reforma revidenciária, de maneira a exercerem pressão sobre o governo e garantirem que a revidência mantenha sua função social eficiente e eficaz.']",120,160,120,160,120,680
52,O choro que não tem informação,"['A música ""pele na pele"", do Grupo Nosso Sentimento relata informações que fomenta mais ainda a sexualidade. No entanto a gravidez na adolêcencia vem acontecendo muito no Brasil tornando-se uma problemática familiar e do governo. Desse modo, os jovens tem que buscar melhor as informações porque elas existem, esse assunto sexo tem que ser mais dialogado entre pais e filhos.', 'Em primeiro lugar, o ECA ( Estatudo da criança e adolescente ) precisa trabalhar melhor essa didatica tanto no ambiente escolar como junto com a família do menino e menina, nesse sentido dados coletados pela OMS (organização Mundial da Saúde ) mostra que 68,4 bebês nascidos de mães adolecentes a cada mil garotas de 15 a 19 anos. Essa situação pode ser ainda pior devido o livre acesso as redes socias e com a falta de acompanhamento do pai e da mãe por apenas ter vergonha de tratar sobre o assunto sexualidade em casa sendo os mesmo responsaveis pela falta de informação correta para seus filhos.', 'Em segundo lugar, o poder público atua com diversos grupos de intervenção para evitar a grávides,  com palestras, divulgações nas princiais midias socias . Contudo, essas informações não são levada aos adolescentes e se ao público adulto, nessa tematica , o governo precisa se organiza e focar em criar situações de divugações bem mais especificas tanto para menina como o menino, em muitos casos as jovens tem que criar o bebê sozinha sem apresença do pai e acaba tornando os avôs os responsáveis pela criação.', 'Infere-se,portanto, que medidas governamentais precisam lidar melhor com a linguagem do jovem, para que o assunto sexo seja melhor explicado para evitar a grávidez indesejada . Em paralelo , os adolecentes tem que conversa sobre o tema na juventude e mostra as maneiras de evitar essa realidade tão prematura em suas vidas.']",80,80,40,120,80,400
2,Opinião Leiga,"['Olhando para o passado vemos que em Atenas, na Grécia Antiga, berço da democracia uma vez por ano era feita uma reunião, em praça, na qual decidiam qual político estava sendo mais destrutivo para a Cidade-Estado esse Estado. Este era exilado. Voltando ao presente, notamos que grande parte da população, caso pudessem, fariam pudesse, faria de modo semelhante com os ministros do Supremo Tribunal Federal. Mal visto Federal, mal-visto pela grande maioria do povo.', 'Primeiramente, é importante destacar que a imagem criada para o STF se dá pelo entendimento popular popular, que é formado em sua maioria em por conjecturas leigas. Uma pesquisa do Datafolha mostrou que cerca de 39% da população julga julgam ruim a atuação do órgão, apenas 19% afirmou afirmaram que era boa ou excelente. Assim, tal fato confirma que a maior parte das pessoas não entendem entende como funciona o apoderar Público. Isso se deve, sobretudo, a uma à má educação que é ofertada, no ofertada no Brasil, principalmente, em escolas públicas, a respeito do funcionamento político da nação.', 'Concomitantemente, como dito por Pitágoras Pitágoras, devemos educar as crianças para que não nos preocupamos preocupemos com os adultos. Ademais, é possível ver que as organizações devem atender a critério da sociedade com como um todo, já mais, jamais acatando interesses de pequenos grupos ou pessoas e isso desagrada a alguns. De tal modo, juntando o desagrado de tantos que não têm suas intenções pessoais atendidas pelos parlamentares, resulta nos números já apresentados.', 'Com base nos dados já apresentados, observamos que a opinião pública a respeito do Supremo Tribunal Federal é extremamente ruim, fato que se deve a à falta de conhecimento dos indivíduos acerca de assuntos políticos. Logo, para amenizar essa situação situação, urge que o Ministério da Cidadania em parceria com o INEP(Instituto Nacional de Estudos e Pesquisas Educacionais Anísio Teixeira) inclua o funcionamento dos órgãos e instituições públicas nos assuntos abordados nas questões do Enem(Exame Nacional do Ensino Médio), fazendo com que um grande número de jovens venham a entendimento do venha entender o assunto. Dessa forma, levando conhecimento aos jovens jovens, não será preciso nos preocupar com os adultos.']",120,80,80,80,80,440
126,Meia-entrada,"['A lei         de         meia-entrada foi criada com a função de         acessibilizar         atividades culturais como espetáculos teatrais, por exemplo, para estudantes, menores de 21 anos e idosos, já que, supostamente,                 essa classe                não tem uma renda muito alta. Apesar de ser um ótimo incentivo, precisa-se avaliar até que ponto a lei é realmente funcional.', 'Pagar         meia entrada         tornou-se comum entre os         brasileiros, a         população sofre de um ""vício"" do ingresso barato. Com isso, nem todos que usufruem do benefício da meia-entrada têm real necessidade                . Há os que se encaixam nos requisitos da lei (estudantes/menores de 21 anos/idosos), mas não possuem uma renda tão baixa a ponto de não poderem pagar o valor inteiro do ingresso; e         tem         os que não se encaixam nos critérios da lei e ainda assim dão um jeito de pagar meia-entrada pelo costume de pagar barato.', 'Jovens e idosos se beneficiam pagando         meia entrada         , contudo não         tem         quem arque com os custos deste benefício. A lei         implica em         subsídios aplicados sobre o valor do ingresso inteiro para suprir os que são         vendido         pela metade do preço. Mas quem paga esse custo se numa plateia todos forem         pagante         de meia-entrada?', 'Um ator de teatro, por exemplo, tem como pagamento de seu serviço o valor arrecadado na bilheteria. Se um dia todos da plateia forem jovens e         idoso         o ator só receberá metade de seu pagamento. Olhando por esse         lado         a lei não parece ser tão benéfica como a maioria da população acredita ser (de acordo com pesquisas do IBGE, mais de 90% dos brasileiros apoiam a lei de meia-entrada).', 'Dado isso, conclui-se que é necessária a conscientização do Governo e também da população. A população precisa agir com mais honestidade e cidadania sobre essa e qualquer outro tipo de lei; o Governo precisa rever a lei da meia-entrada,                 um acordo entre artistas, produtores culturais e empresas ligadas ao ramo cultural,                onde o Governos repassasse a outra metade do valor do ingresso, seria uma solução onde todos saem ganhando, inclusive os que realmente precisam de apoio e incentivo para ter acesso à cultura.']",120,160,160,200,200,840
34,Mimados no passado e infelizes no futuro,"['Em qualquer lugar é possível encontrar pessoas que fazem parte da turma do “eu me acho”. Não raro, elas fazem parte da nossa família e do nosso cotidiano. Basta um olhar minucioso para conseguir identificar algum indivíduo que faça parte desse grupo. Eles se reúnem em lugares comuns como praças e parques, e só dão atenção a si mesmo – algo que eu jamais faria. Se consideram autossuficientes, e por esse motivo criam o chamado isolamento social.', 'Isso acontece por diversos motivos, os principais são: riqueza (se consideram superior por possuírem bens aquisitivos ), tratamento especial exagerado por parte da família (faz com que o indivíduo pense que deve ser tratado da mesma forma em qualquer lugar), e até por serem considerados pessoas de boa aparência física (com isso o ego delas faz com que se sintam ainda mais especiais). Ao analisar essas características fica claro que não me encaixo nesses padrões.', 'O resultado disso aparece nitidamente na fase adulta. Quando precisam se distanciar da família, conseguir um emprego e serem responsáveis por si mesmo . Como esse grupo foi “amaciado” a vida toda, terão dificuldades de aceitar críticas, precisarão de muito tempo para se adaptar na sociedade, vão vai se frustrar com o mundo por isso, e poderão até desenvolver uma depressão por conta de tantos problemas e por seu psicológico não estar preparado pra esse tipo de resposta do mundo.', 'Portando , é evidente pra mim que não faço parte desse grupo, pois acredito que não faz sentido se isolar das pessoas que eles consideram “diferentes”, porque é com os “diferentes” que conseguimos aprender coisas novas, aprimorar nossos conhecimentos e, assim, nos tornar pessoas melhores']",160,160,120,120,120,680
75,Vida sim armas não,"['Os Estados Unidos hoje chora seus mortos, por causa da liberdade as armas. Lá qualquer um pode comprar armas, sem restrições nem controle. E cada um por qualquer motivo torto pode causar uma tragédia anunciada. Passeatas, debates, e pressão do povo americano não são o bastante para sensibilizar o congresso e mudar a lei.', 'O Brasil não precisa que as armas sejam de livre comercio,  é um país muito violento, não pode dar certo . Quem teve essa infeliz ideia? Não é possível que os parlamentares brasileiros não vejam que se nos EUA, que é um país rico e civilizado, com uma policia preparada e atuante, se lá não existe favelas nem guetos, nem subúrbios violentos, e mesmo assim eles não conseguem impedir as mortes de inocentes, imaginem aqui, onde tudo no mundo é motivo de morte.', 'É muita responsabilidade muito grande, para não ser tão levada a sério uma questão dese porte. Vai ser à volta ao faroeste, á pensou no duelo das torcidas rivais armadas com armas de fogo? Eles agridem seus adversários com pau, pedra e tudo o que acham no caminho, imagine com uma arma de fogo e farta munição. Será uma carnificina por semana.', 'Quando o dialogo, a educação, o respeito e o amor não resolvem mais nada, tem algo muito errado no mundo . E não são as armas que vão resolver. A bancada da ala, como é popularmente conhecida, não está pensando no povo e sim no dinheiro. Talvez a bancada da bala também queira investir em cemitérios, funerárias e floriculturas em todo o país . O governo não deve aceitar esse retrocesso. Esse assunto deve ser morto e sepultado para o bem de todos. As armas não trazem segurança nem paz, só mortes e guerras. Pelo bem da vida armas não.']",120,80,80,80,80,440
94,Os desafios que os autistas passam na sociedade.,"['70 milhões de pessoas tem autismo no mundo e 2 milhões estão no Brasil. Percebe-se que se não são poucos e com isso acaba tendo um desafio de inclusão dentro da sociedade, e também acaba tendo inexperiência que acabam resultando na exclusão social vivenciados por esses indivíduos, que muitas vezes são ofendidos com as palavras ""anormais"" ou ""mentalmente atrasadas"".', 'A sociedade vê o autista como alguém de intelecto inferior, e por conta disso o exclui socialmente. No entanto, esse pensamento prova-se equivocado, uma vez que, na maioria dos casos, a maior dificuldade do autista concentra-se apenas na comunicação. Na série americana ""The Good Doctor"" é possível ver a ocorrência dessa discriminação, pois conta a história de um médico autista que busca provar que é tão intelectualmente capaz quanto os médicos considerados ""normais"". Ao longo da trama, ele prova-se mais capacitado do que todos os médicos que o subjugaram, apesar de sua comunicação debilitada.', 'Outro fator existente apresenta-se no fato de a população não saber lidar com quem sofre essa síndrome, om isso as pessoas acabam agindo com ignorância pois, não tem conhecimento. Isso fica evidente, como por exemplo nas escolas que não abordam o tema autismo com as crianças, que acabam evitando os colegas com essa síndrome por falta de instrução logo, acabam não sabendo como agir.', 'Diante do exposto, fica evidente que medidas precisam ser tomadas para resolver a problemática supracitada. É essencial que o Ministério da Educação faça palestras e discussões sobre o autismo nas escolas e faculdades, a fim de informar mais a população sobre o assunto, causando o aumento da inclusão social.']",160,160,120,160,80,680
47,Desafios para a educação a distância no Brasil,"['De acordo com a primeira lei de Newton, a qual afirma que um corpo tende a permanecer em movimento até que uma força suficiente atue sobre ele, fazendo-o mudar de percurso, é perceptível que os desafios para a educação a distância persistem há algum tempo na sociedade brasileira. De maneira análoga à lei da inércia, em vez de funcionar como a força capaz de mudar o curso desse problema, fatores de ordem educacional, bem como a iniciativa governamental, contribuem para o caótico cenário atual.', 'Primeiramente, é importante pontuar que a negligência com a educação digital é um dos principais impasses enfrentados, visto que as escolas não têm cumprido efetivamente o seu papel de promover aos alunos a construção de um conhecimento eficiente sobre como interagir de modo eficiente no ambiente virtual . Essa falta de capacitação prática dos alunos torna a oferta dessa modalidade de ensino um desafio ainda maior, uma vez que influencia diretamente nos resultados de aprendizagem dos estudantes. Conforme Kant, o homem é tudo aquilo que a educação faz dele . Depreende-se, portanto, a importância dessa na formação de valores educacionais ausentes nesses indivíduos.', 'Sob outro ângulo, cabe ainda avaliar a iniciativa governamental como um dos complicadores do problema. Segundo Rousseau, na obra “Contrato Social”, compete ao Estado viabilizar ações que garantam o bem-estar coletivo. Entretanto, nota-se que, no Brasil, falta de investimentos públicos voltados para o desenvolvimento da educação à distância rompe com as defesas do filósofo iluminista, já que, conforme a Constituição Federal de 1988, os cidadãos têm direito educação de forma igualitária. Dessa forma, é inaceitável que, em pleno século XXI, os cidadãos não tenham acesso igualitário a uma educação de qualidade - uma vez que grande parte da população não tem acesso aos recursos necessários para participar desse modelo de ensino - violando o que é exigido constitucionalmente.', 'É imprescindível, portanto, ação coletiva para mudar o percurso dos desafios para a educação a distância no Brasil. Segundo Paulo Freire, a educação transforma as pessoas e essas transformam o mundo. Logo, o MEC - como administrador da educação - deve, por meio da aplicação de verbas, expandir programas de educação digital em todas as escolas para instruir os alunos sobre como interagir de modo eficiente no ambiente virtual, promovendo-lhes a construção de um conhecimento eficiente sobre o assunto. Por conseguinte,o Governo deve atuar, através de investimentos direcionados para o desenvolvimento desse modelo de ensino, para disponibilizar, de maneira universal e democrática, o acesso à educação para os cidadãos, assegurando os direitos constitucionais e o bemestar social. Só assim, a educação e o Governo, agindo como a força descrita por Newton, serão capazes de mudar o curso dessa problemática - da persistência para a extinção.']",160,160,120,200,160,800
93,,"['Em meados de 2000,alguns movimentos contrários à hospitalização do parto começaram a crescer no Brasil,questionando nossas altas taxas de cesárias e excessivas intervenções nos partos. No entanto,mesmo com o reconhecimento e relevância dada, a problemática persiste pela falta de respeito e apoio às decisões maternas e percebe-se a falta de políticas públicas que favoreçam a autonomia da mulher e a promoção de métodos evasivos.', 'Sob esta ótica,a mentalidade social também deve ser questionada por sua restrição ,pois mesmo com os avanços medicinais,antigos métodos ainda são consideráveis,por isso o respeito é essencial-mas não ocorre na prática. Conforme a teoria de John Locke da ""tabula rasa"",o ser humano é como uma tela branca preenchida por experiências e vivências,assim,a população brasileira-em especial os médicos-deveriam tomar consciência do que ocorre no cenário da falta de humanização nos partos e utilizar disto como uma maneira de ampliar a mentalidade em um âmbito social e geral.', 'Consoante a isso,o Brasil realiza quase quatro vezes mais cesárias do que os 15% permitidos pela OMS , e além disso, faltam casas de parto normal no Sistema Único de Saúde. Isto reflete da ineficácia do Poder Público em garantir ações harmônicas na sociedade,pois gera falta de autonomia materna e apoio,além da desconsideração de métodos tradicionais,o que pode ser visto como falta de respeito e gerar estresses aos envolvidos no parto.', 'Perfaz-se que o Brasil ainda carece muito de humanização relacionada aos partos e algo deve ser feito para reverter tal problema. Primeiramente,cabe ao Ministério de Saúde através do SUS aumentar o número de casas de partos normais em prol do respeito e da liberdade feminina pela escolha de métodos. Fora isso,cabe ao governo promover a conscientização geral da população(principalmente em hospitais) sobre a importância do respeito e pregando a importância de uma mente aberta,lutando assim, por um país humanizado e com direitos garantidos.']",160,160,120,160,120,720
19,Os Titãs são um grupo musical,"['Os Titãs, é um grupo músical, cujo qual , em trechos de sua canção ""Que país é esse?"", evidência o atual cenário brasileiro, haja vita que, há ""sujeiras por todo lado, niguém respeita a constituição , mas todos acreditam no futuro da nação"". Tais sujeiras pode ser comparadas com os problemas que as redes sociais passam para os leitores , através das fake news (falsas notícias), ligada fortemente as manifestações políticas, visto que ninguém respeita a constituição .', 'Contudo, o filósofo Fuller afirma em uma de suas sitações, que a humanidade usa toda tecnologia certa por meio das razoes erradas, percebesse que tal afirmação encontra-se acertada, mediante as falsas notícias vinculadas a política e tais mentiras encontradas na internet.', 'Todavia, vale resaltar que, há vários sites de pesquisas e que cabe ao interessado pela reportagem procurar saber mais sobre o assunto.', 'indubtavelmente , as manipulações politicas usando as redes sociais devem acabar, por meio de mais fiscalizações nesses sites.']",120,120,80,80,80,480
95,Índios,"['""Quem dera, ao menos uma vez, que os índios não fossem atacados por serem inocentes."". Essa letra da banda Legião Urbana trata, de forma acrônica, a questão do marco temporal na demarcação de terras indígenas, uma vez que, os direitos à moradia e à manifestação cultural destes povos são negligenciados e o problema é persistente. Desse modo, é imperiosa a análise dos fatores que consolidam este quadro, com foco no estigma temporal e na lógica capitalista.', 'Em princípio, cabe analisar as consequências da colonização sofridas pelos indígenas. Durante o processo de ocupação portuguesa sobre o território recém-descoberto, os povos autóctones ali viventes foram perdendo, cada vez mais, seu espaço de vivência, tal fato traz como consequência a desapropriação de suas terras atualmente dificultando assim, a sua manifestação cultural e suas práticas de subsistência. Logo, é necessário amenizar estes impactos da colonização.', 'Ademais, a priorização dos interesses financeiros é um entrave no que tange à problemática. Para Bauman, os valores da sociedade estão sendo invertidos pela lógica de mercado. Tal constatação é nítida no debate sobre o marco temporal, já que,  proprietários rurais se apropriam de terras indígenas a fim de maximizar seus lucros. Assim, inverter a lógica e colocar os valores humanos em primeiro lugar é urgente.', 'Depreende-se, portanto, a necessidade de intervir sobre o imbróglio. Para isso, cabe ao poder público, por meio das verbas da União, a criação de programas sociais que possuam como público alvo os nativos brasileiros  com o objetivo de minimizar os impactos da colonização portuguesa. Paralelamente, é necessário a criação de leis mais eficientes que impeçam a apropriação de terras indígenas por fazendeiros. Dessa forma, os índios terão seus direitos universalizados.']",160,200,120,200,160,840
75,Porte de armas no Brasil,"['O porte de armas é um documento que autoriza o cidadão a portar uma arma de fogo consigo. No Brasil para adquirir tal autorização é preciso dirigir-se a uma unidade da Policia Federal e atender a uma série de requerimentos burocráticos. Entretanto, um debate contemporâneo questiona o livre porte de armas em solo brasileiro seria este um avanço? Os dados dizem por si, a resposta é claramente negativa.', 'É indubitável dizer que aqueles que apoiam o porte de armas, utilizam como argumento a autodefesa e aumento da própria segurança. Porém, tal tese entra em confronto com um dado que indica,  no Brasil de 25% a 80% das mortes são causadas por motiveis fúteis como, brigas domésticas, brigas no trânsito, discussões entre pessoas alcoolizadas, entre outras situações. Sendo assim, como afirmar que o porte de armas estaria favorecendo a segurança e não o aumento da violência?', 'Segundo a OMS (Organização Mundial da Saúde), o Brasil tem a nona maior taxa de homicídios, e está no ranking de países mais violentos do mundo. Vale ressaltar que um fator empírico para estes dados é o narcotráfico, traficantes adquirem armas através do contrabando e do mercado negro, travando com policia um combate assíduo. A violência se propaga com velocidade, causando nos cidadãos o sentimento de insegurança e terror.', 'Embora tais fatores nos faça acreditar que o porte de armas auxiliaria na proteção individual, torna-se necessário evidenciar que o papel do policial é proteger o cidadão e a sociedade. Inegavelmente a policia vive uma deficiência no controle de portes de armas e em questões gerais, como o combate ao trafico e violência. Sendo assim, cabe ao governo garantir a segurança da população e uma efetiva atuação de nossos guardas. A educação segundo Émile Durkheim assegura aos indivíduos uma visão menos egoísta, portanto está é a grande munição. Ademais algumas questões devem ser consideradas, como a discriminação de drogas, que certamente enfraqueceria o narcotráfico. A luta pela segurança é primordial, contudo para a garantia da mesma, os males precisam ser difundidos e combatidos de maneira coerente.']",120,160,120,160,160,720
93,Humanity,"['Em 1867 Samuel Kristeller, ginecologista alemão, descreveu para todos uma técnica arriscada que consiste na aplicação de pressão na parte superior do útero, ""facilitando"" assim o nascimento do bebê, recebendo o nome de Manobra de Kristeller, não só ela como também a cesariana são metodologias que possuem certo risco, por isso a gestante deveria escolher a melhor maneira de parir seu filho, pois ao serem submetidas a situações estressantes, que as deixem ansiosas ou até mesmo traumatizadas, há grandes chances de tais desenvolverem depressão pós-parto, sem contar os perigos aos quais seus filhos são expostos.', 'A priori, convém analisarmos que 55% dos partos realizados no Brasil são cesarianas, um procedimento completamente invasivo que pode prejudicar a humanização de um dos momentos mais importantes para uma mãe, além disso tal método expõe a criança a inúmeras bactérias, aumentando assim a probabilidade de infecções. Os principais estudos sobre o tipo de parto observaram que a cesariana aumenta o risco de asma e de alergias em cerca de 30%, segundo Nigel Field, pesquisador da University College de Londres.', 'Ademais, uma análise realizada pela pesquisadora Mariza Theme, da Escola Nacional de Saúde Pública Sergio Arouca, aponta que em cada quatro mulheres, pelo menos uma apresenta sintomas de depressão no período de 6 a 18 meses após o nascimento do bebê, representando cerca de 25% das mães no país. No Brasil a maioria das genitoras são pobres e não têm condições para tratar essa doença, isso escancara, ainda mais, a precariedade do sistema de saúde brasileiro.', 'Portanto, é notória a escassez de recursos e apoio para as gestantes, ssim sendo o Ministério da Saúde deveria instruir os médicos a atender a vontade das grávidas , viabilizando o melhor jeito para que tenham seus filhos com segurança e tranquilidade, sendo amparadas por uma equipe de qualidade; outrossim um programa de humanização do parto poderia ser lançado juntamente com a criação de mais maternidades especializadas.']",160,120,120,160,120,680
48,A relevância do SUS para a sociedade,"['Em 1988, por meio da promulgação da Constituição da República Federativo do Brasil, foi implantado no Brasil o Sistema Único de Saúde a fim de disponibilizar um sistema de saúde totalmente acessível para todas as classes sociais, principalmente a classe baixa, sendo 100% gratuito e eficaz.', 'A priori deve-se destacar a imensa importância do SUS na sociedade brasileira, ele é capaz de fazer um atendimento simples mas também de realizar atendimentos complexos com efetividade para todos . Ao longo dos anos o Sistema Único de Saúde vem promovendo campanhas de vacinação e oferece remédios gratuitamente para todos. Ele é importante e o responsável pelo bem-estar do grupo social que não possui condições de ter um convênio em hospitais particulares. Porém, enfrentam problemas e dificuldades.', 'Em segundo plano, o SUS apresenta dificuldade em sua gestão do sistema, considerado como desorganizado . E também pela falta de recursos, aparelhos e infraestrutura. Atualmente surgiu um novo problema: Corona Vírus. O que resultou altíssimo número de pacientes, e os exemplos citados acima se mostram mais atona . O Sistema Único de Saúde é desvalorizado, e consequentemente não tem progresso. De acordo com o dramaturgo e jornalista irlandês, George Bernard Shaw "" O progresso é impossível sem mudança (...)"" .', 'Em suma, verifica-se que o SUS precisa de mais recursos e valorização. Cabe ao Governo conceder mais recurso e infraestrutura, a fim de que este Sistema de Saúde consiga cumprir o seu papel na sociedade brasileira: salvar vidas.']",160,120,120,160,160,720
126,Uma democracia desonesta,"['A meia-entrada é um direito de estudantes, jovens de baixa renda, deficientes físicos ou mentais e         idosos         que assegura o benefício de pagar 50% do ingresso de eventos culturais ou esportivos. Porém, essa proposta não está correta. A meia-entrada acaba somente transferindo renda de um grupo social para outro, além de ser mais uma tentativa do governo de manter sob controle um segmento da população que procura mudanças, mas não exatamente essas.', 'Embora a meia-entrada seja uma proposta                 relativamente ótima                , é preciso analisar a                 renda                usada para isso. São privilégios e benefícios cedidos a camadas mais pobres da população, sem perceber realmente quais os custos que o restante da sociedade terá de arcar. Nesse caso, não há igualdade para todos e não está sendo avaliado o                 impacto social e econômico que esse projeto irá causar.                  Além disso, o governo está tentando mais uma vez compensar o que não foi feito anteriormente. A sua baixa capacidade de administrar o país com políticas eficientes faz com que sejam aceitas propostas como essas          que          na verdade, são ?esmolas? dadas ao povo, causando uma boa impressão de que tudo é de graça, quando na verdade há uma concentração de renda e não a distribuição desta.', 'Logo, pode-se perceber que a meia-entrada não é uma política transparente, embora tenha seus diversos benefícios.                 É fundamental que haja honestidade e igualdade nas propostas governamentais para que elas funcionem corretamente,          contabilizando          os verdadeiros gastos necessários, sem          omitir          o que realmente acontece ao se distribuir tantas vantagens                .']",160,120,120,120,120,640
56,A utopia não é impossível,"['Crimes dos mais diferentes tipos sempre assolaram à  população humana. Em maior ou menor grau más condutas precisam ser remediadas de forma a colocar o sujeito infrator a pagar de alguma forma pelo o que foi feito de maneira a haver também a sua conscientização de erro para que não ocorra repetição posterior . A mais comum forma de punição é a dita prisão celular (em celas), nela ocorre privação de liberdade, sendo o tempo estipulado pelo Poder Judiciário. Sua utilização não acompanhada do número de vagas disponíveis com a demanda gera problemáticas que envolve vários pontos.', 'Quando se pensa em prisão humanizada logo se imagina pela maioria da população que o preso não cumprirá como se deve a sua sentença . Em sua teoria do Super Homem, Nietzsche fala da importância de se libertar das amarras e padrões fixados; plicado a essa visão, deve-se repensar conceitos como superlotações, má-higiene, rebeliões, inviabilização dos direitos humanos, sendo tudo isso fatos de ocorrência presente no sistema carcerário do rasil e que precisa ser revistos e reparados para garantir o principal objetivo da prisão de um infrator: a sua reeducação.', 'Noruega é um país exemplo em como se administra seu sistema carcerário, lá a reabilitação ocorre devido a suas práticas bem orientadas e bem planejadas . É importante que se tenha no Brasil atitudes semelhantes porém adaptadas a nossas  entranhas, para então conseguir tal exito, começando por mudanças na agilidade de processos de presos temporários, na efetivação de direitos básicos humanos, em uma qualificação profissional almejando reinserção social,além de uma consciência de direitos e deveres de um cidadão.', 'Desta maneira, fica evidente que crimes devem ser tratados com punição para manter a sociedade em ordem. Porém, sua punição deve ser vista fora de padrões que consideram presos apenas meras estatísticas. Dessa perspectiva, bons exemplos devem ser levados em conta, Noruega conseguiu com boas medidas alcançar o que seria utópico para muitos']",120,120,120,120,80,560
50,A Importância da Ciência  em Meio a pandemia do Coronavírus,"['O atual vírus que expandiu o Brasil está sendo o assunto auge no momento. O coronavírus é o causador da Covid-19, e por ser uma doença nova os cientistas ainda não desenvolveram meios para combate-la.', 'É correto afirmar que o coronavírus é o ápice global no momento, trata-se de um vírus letal que se originou em Wuhan cidade localizada na China, e vem abrangendo todo o mundo . É um assunto de extrema delicadeza que amedronta a população pelo fato da rápida proliferação nos países e também as inúmeras ocorrência de mortes em diversos lugares do planeta . Com esse grave problema a ciência uma é grande aliada em meio a essa pandemia  tendo uma de grande importância, pois é a partir de estudos científicos que desenvolve métodos eficazes, como vacinas e medicações no qual ajuda a amenizar o índice de doenças na população.', 'De acordo com as informações anteriores  a pandemia que hoje predomina o mundo é de auto grau de gravidade. Para melhor controle da situação abordada, devem decorrer aos órgãos governamentais para que tomem medidas urgentes, aprimorando  a saúde nos hospitais públicos, e disponibilizando equipamentos hospitalares para facilitar o atendimento de infectados, ampliar a gama de médicos especializados para suprir as necessidades cotidianas e  também é essencial investir mais na ciência para garantir a cura da sociedade . Com isso ajudaria nosso  país expandir socialmente, e juntos combater esse novo vírus.']",160,160,120,160,80,680
87,A sociedade pedófila e a sexualização precoce,"['Cada vez mais cedo as crianças estão sendo expostas à internet. Muitas figuras públicas têm como marca o próprio corpo, a maioria das vezes de forma sexualizada, o que pode acabar se tornando um problema quando o público inclui crianças e até adolescentes.', 'Desde pequenas as crianças, principalmente as meninas, são ensinadas a se comportar de um certo modo, não usar roupas muito curtas ou decotes muito grandes. É compreensível que famílias ensinem isso com medo de situações que podem ocorrer fora de casa. Mas s vezes elas são ensinadas isso para se proteger dentro da própria casa , pois todos os seus atos podem ser sexualizados por membros da própria família. E aí está o problema: a preocupação é realmente com as crianças ou com a sociedade pedófila?', 'Entretanto existe o outro lado da moeda. Na internet as pessoas lucram com a sexualização do próprio corpo e uma criança, ao ser exposta, talvez imite . A partir desse momento a infância é encurtada e essa criança acaba passando por um desenvolvimento precoce. As ações se tornam mais adultas e as roupas também passam por uma mudança, e a sociedade, muitas vezes, se aproveita da inocência.', 'Portanto o problema não está no desenvolvimento da sexualidade e sim no seu acontecimento precoce, influenciado por fatores externos, e no estigma que existe sobre esse assunto. É necessário que as famílias conversem para evitar problemas futuros no crescimento da criança (que vai muito além do físico). É importante também que crianças tenham limites quanto ao uso de redes sociais e internet em geral, que são impostos pela família levando em conta a idade e sempre pensando primeiro na segurança, mas sem acabar com a liberdade e lazer.']",160,120,120,160,160,720
62,O discurso de ódio nas redes sociais,"['Em todo o mundo a pluralização da informação por meio da internet atrai milhares de pessoas às redes sociais. Através de uma tela de celular, muitas sentem-se seguras para exporem as mais remotas ideias, inclusive para dar voz aos mais odiosos pensamentos, muitas vezes gratuitamente. Esse discurso antipático  que fere a estima de alguém, não pode ser tolerado e deve ser parado.', 'As mídias sociais possibilitam que a expressão de ideias alcance um maior número de pessoas. Infelizmente, nem todos acabam utilizando a ferramenta para o bem e reagem com ódio ao diferente, seja com comentários difamatórios ou publicações que expressam desgosto sobre grupos, opiniões, estilos e culturas diferentes. Segundo o relatório realizado pelo projeto ""Comunica que muda"", foram identificados 393.284 menções sobre temas sensíveis como racismo no Facebook, Twitter e Instagram, sendo que 84% expunham abordagens preconceituosas ou de discriminação. Esse tipo de crítica acaba muitas vezes repercutindo mais que o normal, já que os ""feedbaks"" são rápidos e aumentam o alcance  e trazem apoiadores ou contrários que respondem no mesmo tom.', 'Consequentemente, o uso dessas mídias se relaciona com o aumento de transtornos como depressão, ansiedade e FOMO, como mostra estudo de 2017 da Royal Society for Public Health. Entre os jovens de 12 a 25 anos os casos de depressão saltaram 40% nos últimos 5 anos, conforme a revista Veja, podendo ser relacionado com a ascensão da tecnologia. Ainda podemos  associar a expansão do ódio a casos de violência, principalmente em escolas, onde jovens optam por cessar os casos originados nestes veículos com socos e chutes, aumentando ainda mais o problema.', 'Portando, o discurso de ódio nas redes sociais precisa ser estancado para que não mais interfira de forma negativa na vida das pessoas, principalmente na dos jovens. Sites destas mídias sociais precisam educar seus usuários antes e durante o uso com campanhas e punições em casos mais extremos. Pais e a comunidade escolar precisam  também, estar atentos e orientar estes jovens para que aproveitem da melhor forma possível o recurso que lhes é disponibilizado, aumentando os sentimentos de tolerância e empatia.']",120,160,120,120,120,640
62,Umberto Eco tinha razão,"['Ao discursar na aceitação do título de Doutor Honoris Causa em Comunicação e Cultura na Universidade de Turim, em 2015, o escritor Umberto Eco (1932-2016) disse o seguinte: “As mídias sociais deram o direito à fala a legiões de imbecis”. A afirmação de Eco nunca esteve tão atual.', 'As redes sociais nos últimos quatro anos estão sendo usadas para a amplificação de discursos racistas, misóginos, xenófobos e de intolerância religiosa. Amparados pelo discurso de “liberdade de expressão” e legitimados por centenas de milhares de “likes” e milhões de compartilhamentos, os imbecis  sentem-se legitimados para propagar ódio, rancor e fustração', 'O ódio nas redes sociais está naturalizado e é, inclusive, utilizado como plataforma política. Atualmente, o presidente do Brasil alimenta o ódio, o preconceito e a discriminação via rede social para governar o país e manter controle sobre seu eleitorado. Nos EUA, o mesmo fenômeno: Donald Trump usa o Twitter para promover seu machismo e principalmente sua xenofobia para manter seu eleitorado.', 'Apesar da quantidade de conteúdo de ódio circulando nas redes ser crescente, há cada vez menos pessoas dispostas a denunciar. Hoje é curtido, compartilhado e viralizado. Pessoas que antes se indignavam com conteúdos que pregam o racismo, hoje ajudam a disseminá-lo a partir da interação nas redes sociais. Algumas até fazem isso sem entendimento das consequências. Outro fator relevante a ser mencionado é o anonimato. Um número absurdo de perfis falsos e de bots (diminutivo da palavra ""robot”, softwares que simulam ações humanas) trabalham pela disseminação de discursos de ódio, replicando as postagens e, dessa forma, ampliando seu alcance e garantindo o já mencionado anonimato.', 'Se as mídias sociais deram voz aos imbecis , pouco importa. Afinal, pode-se combater o problema, pois, cabe,  às corporativas responsáveis pelas redes sociais elaborar mecanismos para monitorar as postagens irregulares e retirá-las de circulação. Ademais, o Ministério da Justiça poderia  criar delegacias e centros de investigação especializados em crimes virtuais, a fim de minimizar as ocorrências e evitar a impunidade. Por fim, é importante promover campanhas socioeducativas na TV e principalmente na internet, com o intuito de alertar a população quanto à reprodução de imagens e textos associados ao discurso de ódio e, com isso, reduzir a sua disseminação.']",120,160,120,120,120,640
89,A relevância do distanciamento social frente ao combate ao Coronavírus.,"['Desde o Iluminismo, entende-se que uma sociedade só progride quando um se mobiliza pelo problema do outro. Entretanto, quando se observa a suspensão do isolamento social para todos os indivíduos, no Brasil, hodiernamente, verifica-se que esse ideal iluminista é constatado na teoria e não desejavelmente na prática, e a problemática persiste intrinsecamente ligada à realidade do país seja pela necessidade do cidadão em garantir sua renda econômica para poder viver, seja pela ignorância por parte do corpo social quanto ao número de casos e de mortes confirmadas pelo coronavírus. Nesse sentido, convém analisarmos as principais consequências de tal postura negligente para a sociedade.', 'É indubitável que a questão constitucional e sua prática estejam entre as causas. Segundo o filósofo grego Aristóteles, a política deve ser utilizada de modo que, por meio de justiça, o equilíbrio seja alcançado na sociedade. De maneira análoga, é possível perceber que, no Brasil, a necessidade do cidadão romper com o isolamento social para garantir o seu sustento em meio a uma pandemia rompe com essa harmonia, haja vista que se o individuo põe a própria vida em risco ao abrir seu pequeno comércio para conseguir subsistir em meio crise econômica, essa ação é a consequência da falha estadual em ceder pessoa, recursos para que consiga manter-se segura em isolamento social e ainda sim possa viver, sem danos expressivos em sua renda.', 'Outrossim, destaca-se a ignorância por parte do corpo social quanto ao número de casos e seu aumento ininterrupto dia após dia como impulsionador do problema De acordo com Durkheim, o fato social é uma maneira coletiva de agir e pensar dotada de exterioridade, generalidade e coercitividade. Seguindo essa linha de pensamento, a influência de pessoas que possuem certa importância dentro da mídia social ao banalizar e minimizar a relevância do isolamento social induz cada vez mais pessoas a ignorarem a dimensão do problema e irem às ruas.', 'É evidente, portanto, que há entraves para a solidificação de políticas que visem a construção de um mundo melhor. Como dito pelo pedagogo Paulo Freire, a educação transforma pessoas e essas mudam o mundo. Logo, o Ministério da Saúde deve instituir, através de veículos midiáticos, palestras ministradas por profissionais de saúde, que discutam o combate ruptura do isolamento social feita por muitos brasileiros, afim de que o tecido social se desprenda de certos tabus, para que não viva a realidade das sombras, assim como na Alegoria da Caverna de Platão.']",160,200,160,200,160,880
122,Intolerância e suas transgressões,"['Intolerância religiosa é toda forma de agressão, sendo ela física, verbal ou até mesmo reclusão de um indivíduo por sua crença. Ato transgressor         que infelizmente         é comum nos depararmos,                 sobretudo                no Brasil que,                 apesar de ser um país laico, possui uma variedade de religiões.', 'Em contrapartida         as         demais crenças,         existe         duas que geralmente são alvos constantes de repúdio, atos         descriminatórios         e violentos, sendo elas as religiões         Afrodescendentes         .', 'Um dos casos mais recentes que         reforça essa problemática social         foi a garota de 11 anos, apedrejada após sair de um evento religioso, no Rio de Janeiro, por dois homens. Ambos portavam uma         bíblia         nas mãos. A agressão teria ocorrido pelo simples motivo                 da mesma                pertencer ao         candomblé         .', 'Todavia, assim como ela, há outras pessoas obrigadas a omitir suas crenças por medo de perseguições e represálias         que         com o passar do         tempo mostra-se cada vez maior e mais explícita         .', 'Faz-se         necessário         a criação de projetos, campanhas e debates em instituições públicas e privadas, como escolas, universidades, empresas e outros, acerca dessas atitudes         repugnantes. Visando         a conscientização         coletiva afim         de mostrar que o respeito mútuo deve abranger até mesmo a própria religião.']",120,80,80,80,120,480
46,Universalização do sanemanto básico (bdsm),"['De acordo com o levantamento feito pelo Sistema Nacional de Informações sobre Saneamento (SNIS), 17% da população brasileira não tem acesso à água tratada e apenas 46% dos esgotos são manejados e tratados corretamente. Privatizar, ou seja, vender uma empresa pública para a iniciativa privada, principalmente no ramo do saneamento básico, é uma medida necessária para viabilizar contas públicas e melhorar a questão de saúde da população.', 'Deve-se pontuar, de início, que em 2019, com autoria do Senador Tasso Jereissati, foi apresentado um projeto de lei que altera o marco regulatório de saneamento, colocando empresas privadas para concorrer com órgãos públicos na licitações da área. Tal mudança acarretará na atração de investimentos para o setor, universalização do serviço, valorização ambiental para a economia turística, entre outros.', 'Vale ressaltar, também, que de acordo com a Organização Mundial da Saúde (OMS), diversas doenças são proliferadas em decorrência da falta deste serviço . Com a privatização do setor, os investimentos da iniciativa privada garantiriam que praticamente 100% da população tenha acesso à água potável e tratamento de esgoto. Tal medida garante que o governo deixe de gastar milhões com internações por diarreia, segunda maior causa de mortes em crianças abaixo de cincos anos de idade, segundo a Unicef .', 'Em virtude dos fatos mencionados, é extrema a necessidade da privatização do saneamento básico, dado os expostos de que haveria melhora em contas públicas e na saúde da população. Esse resultado só se dá como concluído com a presença do Estado brasileiro em privatizar o serviço, tendo como exemplo o Chile, em que o serviço cobre mais de 90% da população. Só assim esse direito, presente na constituição, se forma  eficiente.']",160,160,160,200,120,800
113,Ganhar para perder,"['Sob o prisma em que vivemos hoje                , nota-se grande melhoria nos conceitos de liberdade aos jovens,         mas  que  ,         ao mesmo tempo, presenciam-se indícios de regressão quando o assunto é ética. A liberdade,         éticamente         falando, deveria ser exercida respeitando os limites do ser humano sobre o que é certo e o que é errado, como na situação do consumo de álcool moderado, em que o indivíduo satisfaz sua vontade de beber e não perde sua liberdade por não ter exagerado na dose, encontrando-se         à         base da liberdade e do princípio ético; mas, na prática, essa relação muitas vezes não é vista. Antigamente, só se podia ter relações sexuais após o         casamento,         hoje, com maior esclarecimento da sociedade, considerando a escolha de vivência entre o casal, se querem ou         não casar-se         , transar sem firmar uma legitimidade não rege discórdia de modo geral. Contudo, em oposição, repercute recentemente a ""venda da         virginidade""         ou seja, a banalização do tão-pessoal         a troco         de dinheiro,         a modo peculiar.          A liberdade do primeiro ato sexual junto ao desrespeito ético-social.', 'Reality-shows sempre foram         ênfase em         audiência por atenderem ao gosto de maior parte do público, que é jovem, por meio de belos rostos e corpos invejáveis, pessoas de personalidade forte e espírito competitivo, dispostas a realizar qualquer tipo de coisa a troco de dinheiro, utilizando predominantemente o verbo ""polemizar"". Mesmo com o tarjamento de algumas imagens e que cubram certos termos vulgares, as atitudes vistas nesses programas aparecem de forma explícita àqueles que         os assistem         , que por sua vez influenciam em sua conduta, e isso não se dá simplesmente pelo perfil influenciável da maior parte desse público, mas pelo fato de                 a mídia ser um veículo                altamente contagioso, que atinge seu alvo desde propagandas de produtos a programas voltados a uma audiência específica, com conhecimento sobre aquele que         assiste         . Essa influência é tão grande, que a         virginidade         vendida foi repercutida como sendo análoga a um reality-show, já que é possível estabelecer uma relação entre sexo e reality shows. Nessa ""novidade"", a moça então vende seu corpo para sua primeira vez         ""ao ar""         ou seja, no interior de um avião, para que não haja comprometimento com a legislação dos países. O compromisso é ajustado com um estranho, a quem não conhece sequer fisicamente, que a ?ganha? pelo alto valor que ultrapassa um milhão, mas para tirar-lhe o mais importante e pessoal, que é sua         virginidade          digna.', 'Desejar valores materiais é normal e intrínseco         de         qualquer um, mas de nada vale essa obtenção pela troca de um bem maior, que é a dignidade própria e mesmo familiar. No âmbito legislativo,                 não deve haver apoio da lei sobre essa impunidade revestida de negociação.                Se há duas coisas que devem         andam         sempre juntas, essas são a liberdade e a ética.']",160,120,160,120,120,680
71,Adolescente logado jovem frágil,"['Durante séculos a morte tem sido considerada um método eficaz de punição para assassinos, corruptos e estupradores entre outros. Outrossim em períodos remotos  a morte autoinfligida foi considerada crime e traição contra Deus, mesmo com todo o aparato da ciência o aumento de suicídio tem assustado, ainda porque a maioria é jovem. Mas o que há de tão grave para um jovem cometer suicídio?', 'Visto que a adolescência é uma fase importante para a interação com a sociedade, mas eles estão freneticamente envolvidos em jogos e mídias sociais quando deveriam estar interagindo com a família, preferem ouvir suas músicas favoritas, jogos ou acompanhando as vidas utópicas de famosos;  formando assim uma personalidade instável e vulnerável a realidade . Desse modo quando atingem a idade mais independente, em momentos que se sentem confrontados não possuem autocontrole para suportar ou ainda forças para tomar atitude. Contudo, quando o problema começa em casa a vulnerabilidade é ainda maior e por maior que seja sua aflição e a desesperança seja letal, é mais fácil silenciar e negar.', 'Portanto há necessidade de maior participação dos pais na formação dos jovens, ainda enquanto adolescente, desvinculá-los das mídias sociais e influenciá-los a ler livros, praticar esportes, de forma que os membros da família estejam comprometidos uns com os outros; e também um processo de iniciativa do governo de cadastramento de pessoas com distúrbios psicológico e emocionais com acompanhamento periódicos preventivo para pacientes com tendencia a depressão.']",120,120,120,120,120,600
91,Efeitos do negacionismo científico na sociedade,"['O filósofo grego Aristóteles cunhou que apenas o conhecimento pode nos levar a obtenção da plenitude da essência humana. Nesse viés, analisa-se que a negação de estudos científicos por parte de algumas pessoas vai contra essa prerrogativa. Sendo assim, é necessário analisar os efeitos que essa problemática pode causar na sociedade brasileira, como a propagação de notícias falsas e, consequentemente, a desinformação que isso pode gerar na população.', 'Em primeira análise, é preciso destacar a disseminação de mentiras contra estudos comprovados cientificamente. Em janeiro de 2021, durante a pandemia da covid-19, vários movimentos antivacina espalharam notícias falsas de que a vacina contra o coronavírus era perigosa e podia matar as pessoas. Nesse contexto, esses movimentos ficaram populares através do temor que foi colocado na população em tomar essa nova vacina. Esse é um exemplo de como a propagação de notícias falsas contribuem para o negacionismo científico, visto que não era necessário ter preocupação pois todas as vacinas que circulam no Brasil recebem a aprovação da Agência Nacional de Vigilância Sanitária (ANVISA) através de diversos procedimentos para demonstrar a sua eficácia. Sendo assim, essas notícias sem base alguma podem desvalorizar os estudos de cientistas e contribuir para a não confiança da população na ciência.', 'Ademais, essas notícias falsas acabam gerando desinformação na sociedade. Em 1937, Getúlio Vargas botou em prática o Plano Cohen, que consistia em anunciar para população brasileira a existência de uma ameaça comunista querendo tomar o poder. Porém, esse plano não passou de uma invenção de Vargas com o objetivo de concentrar o poder político em suas mãos. Esse ocorrido gerou na população uma falta de informação, em que várias pessoas passaram a defender Getúlio e disseminar ódio contra comunistas. Isso mostra como a falta de conhecimento por consequência da disseminação de notícias falsas pode afetar o julgamento da opinião pública. Dessa forma, o negacionismo científico não só gera mentiras, assim como pode influenciar outras pessoas a seguirem ou aceitarem essa inverdade.', 'Portanto, é necessário que medidas sejam tomadas a fim de diminuir os efeitos do negacionismo científico na sociedade brasileira. Sendo assim, o governo federal, na figura do Ministério da Ciência, Tecnologia e Inovações, deve desenvolver uma plataforma que armazene as mais diversas comprovações científicas e disponibilizá-la para a sociedade acessar sempre que quiser confirmar quando uma notícia é verdadeira ou falsa. Isso pode ser feito através de desenvolvedores de softwares e programadores que irão montar esse sistema e permitir que apenas cientistas competentes e encarregados de verificar as informações postem os artigos científicos e notícias sobre os avanços da ciência. Dessa forma, através da disseminação de conhecimento, poderemos alcançar a plenitude da essência humana, como dissertou Aristóteles.']",160,200,160,200,160,880
73,O Brasil é negro,"['Tantos se passaram e a discriminação racial ainda está presente em diversas partes do mundo. No Brasil, país com a maior população negra fora do continente africano, o preconceito e a falta de oportunidades evidenciam o pouco espaço que o negro ocupa nos setores das grandes profissões da sociedade.', 'Segundo a Pesquisa Nacional por Amostra de Domicílios (Pnad), realizada em 2014 pelo IBGE, 53% dos brasileiros se declararam como negros e pardos, um aumento de 5 pontos porcentuais em relação à mesma pesquisa realizada há dez anos.', 'Vários aspectos revelam a desigualdade existente entre os negros com relação às pessoas brancas, sejam eles econômicos ou sociais. Seus salários são mais baixos, a precariedade das condições de vida, as oportunidades de emprego são mais baixas, entre outros.', 'Dado o exposto, conclui-se que as instituições de ensino superior incluam em seus vestibulares a inclusão social através de cotas , assim o estudante negro terá outra possibilidade além do Enem e provas de instituições públicas. O governo deve elaborar projetos junto ao Ministério da educação e da cultura para realizar debates no combate ao preconceito nas salas de aula e também promover eventos sociais em que tenha como foco a cultura negra e a questão do racismo por meio de exposições, danças e teatro aberto ao público e gratuitos.', 'O Brasil precisa da educação,para que através dela se formem melhores cidadãos para um futuro onde o fenótipo de uma pessoa não seja motivo de discriminação. Como disse Nelson Mandela: ´´ A educação é a arma mais poderosa que você pode usar para mudar o mundo´´.']",120,80,80,120,120,520
44,Sociedade machista,"['Nascemos em uma sociedade machista e patriarcal, onde a mulher é dada como inferior e julgada pela sociedade diariamente e por dentre esses motivos ela tenta se esforçar para mostrar o quão ""mulher"" ela é.', 'Mulheres são criticadas por não fazerem os deveres de casa, mas sabe-se que não é obrigatório, como vemos na constituição todos temos direitos iguais, então temos deveres iguais. O corpo é algo físico que não influência no que a pessoa deve fazer.', 'Muitas mulheres deixam de fazer o que gostam, para não serem julgadas, porque muitos serviços e até mesmo o lazer é ""dividido"". Se alguém vê alguma mulher em um barzinho, é julgada e mal falada, mas quando é um homem, é normal,', 'Deve-se quebrar essa ideologia imposta, todos devem aceitar que somos todos iguais, pessoas devem se conscientizar que ninguém precisa mostrar nada para ninguém se a pessoa se sente bem com ela mesma, não interfira.']",160,80,80,80,0,400
54,,"['A vacinação é um método importante e eficaz de prevenção contra doenças. Entretanto a sociedade contemporânea brasileira,  demonstra uma despreocupação em se prevenir, já que nos últimos anos os índices de vacinação vem caindo, situação ocorrida pela ineficácia do governo ,porém vale ressaltar que a sua falta pode ocasionar em uma vulnerabilidade a doenças e gerar epidemias que chegam até mesmo em níveis internacionais.', 'A problemática de vacinação no Brasil, ocorre desde o século passado, pois a uma ruptura clara de comunicação entre o Estado com a população, iniciada em 1904 quando o médico Oswaldo Cruz, propiciou uma campanha de vacinação obrigatória  sociedade da época, porém não apresentou nenhuma fonte de informação sobre os benefícios da vacina , obtendo como resultado um movimento social contra a campanha, denominado revolta da vacina,onde os integrantes denegriram patrimônios públicos para mostrar o seu descontentamento com a medida abordada pelo governo .Na atualidade a comunicação é ineficaz também, pois as campanhas de vacinação não possuem um amplo espaço nas mídias sociais , que por sua vez, é onde encontrasse a atenção constante da população brasileira,gerando a desmotivação em buscar sobre o assunto.', 'Torna-se inevitável a preocupação com a problemática abordada, pois devido a globalização eminente, o deslocamento de pessoas nunca foi tão facilitado. Entretanto entrelaçado a este fenômeno surge a decorrente preocupação, em uma epidemia se espalhar rapidamente, pois mesmo que a ANVISA (Agência Nacional de Vigilância Sanitária) tenha permissão por lei a barrar passageiros com doenças infectocontagiosas, como nenhum meio de transporte pede laudos médicos recentes, apenas a carteira de vacinação, muitas vezes o passageiro pode ser apenas um portador do gene da doença, e quando o mesmo chegar ao seu destino ocasionará a propagação do vírus, como ocorrido nos países da América Latina no ano de 2018 onde ocorreu a propagação da infestação da dengue, epidemia que precisou da ajuda das forças armadas brasileiras nas ruas para combater os focos da doenças.', 'Devido aos aspectos abordados torna-se evidente a intervenção do Estado em conjunto com os Ministérios da Saúde e da Educação. para que a importância da vacinação seja relembrada a população,onde o Estado cria um aplicativo que avisa quando houver campanha de vacinação nos municípios. Ademais o Ministério da Saúde cria páginas em redes sociais para alcançar e se comunicar com os cidadãos, enquanto o Ministério da Edução ofertará palestra em escolas de níveis fundamentais e médios, pois como o filsofo norte americano Ralph Emerson afirmou a maior riqueza é a saúde .']",120,120,80,120,40,480
87,Hipersexsualizacao Infantil,"['A atriz americana de 37 anos , Natalie Portman , contou em entrevista revista ""People"", que começou a sua sua carreira aos 13 anos , na mesma época passou a ter um tratamento diferenciado pelos homens após sua representação no filme : "" O Profissional"", passando a receber cartas de fãs tendo fantasias sexuais com ela. No entanto, situações de erotismo infantil não se limitam ao mundo cinematográfico , mas também nas letras das músicas , novelas, desenhos animados , brinquedos , dentre outros, haja vista que há uma grande persuasão da publicidade através das mídias , como também desde cedo s crianças são e influenciadas e ambientalizadas pelas atitudes dos pais . Neste sentido, compreende-se que há uma omissão advinda da família e do Estado quanto aos cuidados e proteção a estas que precisam ser contornados , portanto,para a preservação da vivência infantil.', 'Em primeiro lugar , é importante salientar que a hipersexsualizacao infantil está ligada a propaganda publicitária . Isso , porque , aproveitam-se da inocência e falta de discernimento da criança para promover atração de produtos e o consumismo. Partindo desse pressuposto, identifica-se o exemplo da revista americana Vogue , que publicou, no ano de 2011 , uma menina , com vestes , maquiagem e poses sensuais. Na época , o fato,  foi duramente criticadas pela sociedade americana, mas no Brasil é preocupante , uma vez que pode está sendo culturalmente aceito.', 'Ademais, algumas famílias tem influenciado negativamente quanto  erotização infantil , uma vez que ,  tem -se estimulado aos filhos a terem comportamentos que são próprios para adultos. Sob esse vieis, destaca-se como análise , a cantora MC Melody, a qual quando tinha onze anos foi fortemente influenciada pelo pai , MC Belinho, sendo que este postava nada redes sociais fotos da filha com trajes e poses impróprios para menores.', 'Desta forma , cabe ao Ministério da Mulher, da família e dos direitos humanos primar pelo direito inviolável da criança , que é a sua infância, por meio da conscientização da população , através de campanhas expostas nas principais mídias sociais .Assim sendo , evitarse-a possíveis abusos ao simples direito de ser criança .']",160,160,120,200,160,800
63,O retrocesso e a ambição do ser humano no meio ambiente,"['Grandes corporações ocasionaram inúmeros impactos ambientais  como desenvolvimento mercadológico e crescimento empresarial, trabalhando com variantes para em algum momento sair do oligopólio e encontrar o monopólio desejado.', 'Impactos ambientais atualmente não são barreiras para corporações de grande porte apenas objetivando lucratividade . Em contrarresposta desmatam floresta,poluem rios e ocorrem rompimento de barreiras causando um caos imenso no planeta, não surtindo efeitos demasiados apenas para o planeta mas também para o ser humano devido a imprudência de outros seres humanos, rios são contaminados como aconteceu com o porto de SUAPE com objetivo de crescimento empresarial tornou as praias do grande recife proliferada de tubarões devido ao despejo de material contaminado no mar os tubarões necessitaram para avançar para próximo da praia.', 'O caso citado acima comparado a casos de grande taxa de mortalidade tornasse quase irrelevante, rompimento de barragem ocorridos geram transtorno de imensa escala como pausa no desenvolvimento loca, transtornos industriais, psicológicos e físicos para as pessoas, em alguns casos fatais com mais de duzentos mortos e vários feridos, lama e dejetos transitaram até chegar a segunda maior bacia hidrográfica do Brasil, bacia de são francisco, o que esperamos que vá acontecer com essa bacia contaminada?', 'Deveras o homem corporativo tem muita culpa pelos ocorridos, necessita-se de mais avaliações rotineiras  e principalmente de conscientização de quem trabalha na área e sempre destacar em meios de comunicações que extração e poluição ambiental de grande escala não desenvolve,retrocede..']",120,120,120,120,80,560
48,O SUS é importante,"['A Constituição Cidadã em 1988 selou o processo de redemocratização do Brasil e definiu as bases do comprometimento do Estado com o direito social. De tal forma que o Sistema Único de Saúde (SUS) foi criado como serviço público de acesso universal e atenção integral. Em seus mais de 30 anos existem importantes conquistas atestadas pela amplitude da atenção primária até a rede nacional de transplante de órgãos, e também sérios problemas, pela precarização do financiamento e a burocracia que têm causado a fragilização do SUS . E diante da pandemia do covid-19 é urgente a dinamização das ações de gestão do serviço para atender e proteger a população.', 'E são as Unidades Básicas de Saúde (UBS), as equipes de assistência social e agentes comunitários,  que obtêm informações para o mapeamento da doença, e que também têm a experiência para implementação de ações de prevenção e cuidado. Como atestam os feitos das campanhas de vacinação que já eliminaram o sarampo no Brasil, o acompanhamento e cuidado às pessoas com Aids, dentre outras ações como o combate à dengue . E pelo potencial do SUS a covid-19 será vencida se houver investimento em contratação e em insumos, o que não vem acontecendo nos últimos anos, haja vista o sucateamento do serviço. E para além do nível comunitário é imprescindível a articulação eficiente da União no cenário internacional com o intuito de garantir insumos para o fortalecimento da pesquisa nacional.', 'Portanto, devido à importância do SUS para a saúde pública no Brasil o desafio lançado pelo contexto da pandemia aos governos federal, estadual e municipal é o de aprimorar a atenção primária, a fim de que vencendo a crise atual possa restar de legado UBS equipadas e eficientes para o futuro. Por meio de aumento no financiamento e realização de contratações para o fortalecimento humano das equipes. Quanto a construção de saída da pandemia há de se articular a diplomacia e ministério da saúde aos órgãos internacionais de pesquisa , segundo o princípio de prevenção do SUS, pois possibilitará à ciência brasileira chances de produção da vacina.']",160,160,120,160,120,720
82,Melhor do que reprimir é ensinar,"['A prática da automedicação, embora muito comum, pode acarretar sérios problemas à saúde  sendo comumente criticada por especialistas. Porém   seria necessário o cidadão ir à  um hospital cada vez que apresentasse uma dor de cabeça? A automedicação deveria realmente ser tão reprimida?', 'A justificativa dos especialistas é válida, a prática de se automedicar na maioria dos casos é feita por pessoas que não possuem o mínimo conhecimento na área da saúde, portanto  poderiam, em sua ignorância, causar sérios danos à sua saúde, ou até mesmo a morte. Outro costume alarmante é a automedicação para sanar sintomas e não a doença em si, o que pode acabar mascarando o verdadeiro problema.', 'Apesar das críticas serem justificáveis  a automedicação não traz apenas malefícios,  para as doenças comuns do cotidiano  é prático que o indivíduo se medique conforme já está habituado, afinal  seria inviável para o sistema de saúde a sua procura cada vez que uma pessoa fosse acometida por uma doença trivial.', 'Portanto  uma melhor forma de lidar com o problema seria uma conscientização da população, explicar porque  a automedicação é uma prática perigosa, esclarecendo os seus riscos e deixando para o cidadão decidir se, em sua situação, ele deveria procurar um especialista,  ou se seria um problema mais leviano, que não necessitaria de uma ajuda profissional, assumindo a responsabilidade por sua decisão.']",160,160,160,160,120,760
69,O uso de agrotóxicos no Brasil,"['O modelo de agricultura voltado para a exportação fez do Brasil o país que mais consome agrotóxico no mundo, 20? de toda a produção mundial é usada aqui .', 'O uso indiscriminado desses produtos é altamente prejudicial ao ser humano, e principalmente ao nosso meio ambiente. É importante ressaltar que os agrotóxicos como tudo na vida tem seus dois lados, o bom e o ruim assim dizendo, que por um lado ajuda no cultivo de frutas, verduras, entre outros alimentos, por outro traz diversos problemas  para nosso  meio.', 'Os produtores que trabalham diretamente com esses produtos podem vir a desenvolver doenças , os consumidores consequentemente também, a mortandade da fauna e da flora é outra consequência do uso exacerbado dos agrotóxicos. Embora o uso dos mesmos seja amparado por lei, à intensidade com a qual estão sendo aplicados não está de acordo.', 'Portanto seria importante que os órgãos responsáveis como a ANVISA tornasse maior a fiscalização dos alimentos, o Ministério da agricultura que poderia aumentar a fiscalização das propriedades agrícolas, oferecendo também capacitações e treinamentos para os agricultores, onde estariam mais informados sobre a execução dos produtos. Importante também a ação do Ministério da saúde procurar informar os consumidores sobre os riscos do consumo de alimentos contaminados com agrotóxicos, ou até mesmo ensiná-los a como higienizar esses alimentos  assim reduzindo a taxa de contaminação dos mesmos.']",120,120,120,120,120,600
95,Debate sobre o marco temporal,"['\'\'No meio do caminho tinha uma pedra, tinha uma pedra no meio do caminho"". Esse trecho de Carlos Drummond de Andrade exemplifica bem o marco temporal aqui no Brasil, visto que é mesmo uma pedra para a sociedade indígena. Estão tentando tirar as terras dos índios, onde ali estão situadas suas famílias, moradias e também onde nessas terras os índios exploram seus recursos naturais e desenvolvem suas culturas.', 'Em primeiro plano, o marco temporal é uma ação no Supremo Tribunal Federal ( STF ) onde defendem os direitos indígenas . Isso já existe desde do dia 05 de outubro 1988 que entrou em vigor a Constituição brasileira que reivindicam as terras indígenas. Além disso, os índios precisam dessas terras para ter onde plantar seus alimentos para poderem sobreviver, porque sem essas terras eles não vão ter como desenvolver suas culturas.', 'Do mesmo modo, a Funai ( Fundação Nacional do Índio ) inicia um processo de identificação do território indígena que com isso será, aprovada uma criação da nova terra indígena no Brasil . Os índios defendem que têm direito \'\' originário à terra "" por estarem aqui antes da criação do estado brasileiro, com isso os povos indígenas terão que lutar por suas terras e pela sua cultura.', 'Portanto, medidas são necessárias para resolver o impasse. O ministério justiça devem tomar providências para acabar de vez com essa situação que está causando um grande transtorno na sociedade indígena. Só assim, os índios teram paz e suas terras por direito.']",120,120,120,160,80,600
90,Transfobia,"['Hodiernamente o Brasil é o país que mais mata pessoas transgênero em relação ao mundo todo, conjuntura que é bastante preocupante. Segundo o filósofo Voltáire: ""Preconceito é opinião sem conhecimento"", ou seja, as pessoas julgam sem ao menos entender o lado da pessoa oprimida.', 'O preconceito ás  pessoas trans é algo levado de geração, no qual,  essa discriminação disfarça-se muitas vezes como uma ""piada"" entre família. Sobretudo todo esse preconceito enraizado, está presente historicamente no nosso passado, como por exemplo na época Nazista, em que o ditador praticava muitos abusos, dentre eles a tortura contra várias pessoas, incluindo pessoas pertencentes à comunidade LGBT . Ademais, essas pessoas sofrem até os dias atuais, são vitimas do desemprego, pois há poucas oportunidades para eles, além disso, são constantemente ""obrigados"" a escutarem ofensas e piadas ao seu respeito, e como se não bastasse, muitas vezes chegam a resultar em violência.', 'A princípio ações como esta podem ser amenizadas, entretanto falta mais respeito e empatia por parte da sociedade como um todo . Há muita falta de aceitação por parte da família e das pessoas ao redor, por conta que a maioria dos seres-humanos estão cada vez mais querendo impor um padrão nas pessoas.', 'Em suma, para a resolução desse problema, há de ter uma grande colaboração do governo federal, que por meio de leis pudessem garantir mais direitos e também a segurança dessa minoria, a fim de eles se sentirem mais acolhidos socialmente e menos inseguros, evitar que fiquem com o receio de a qualquer momento ser violentado, por conta de sua identidade de gênero.']",160,120,120,160,120,680
74,Combate á violência contra a mulher,"['O tema feminicdio no nosso pas vêm crescendo rapidamente, e a decorrência de mulheres que são violentadas e estrupadas tem um alto índice de discriminação ao sexo feminino , ainda vale ressaltar que vai se tornando um problema global.', 'O número de mortes pela a violência doméstica é um dos que mais acontece, ou seja, pelo o próprio parceiro e até mesmo os familiares, aonde dados indicam que cerca de 100 mil mulheres são mortas, e esses assassinatos estão ficando mais comuns e fora do sério.', 'As mais afetadas são as mulheres negras, pelo o fato de serem bastante discriminadas devido a sua cor de pele, é onde entra o racismo que de uma tal forma acaba afetando o lado físico e mental, que não deixa de ser um tipo de violência, além do mais, acabam deixando marcas que demoram a serem  esquecidas, principalmente se for em caso de estrupo, o ato mais comentado em meio ao feminicídio, que deve ser trabalhado com o máximo de de rigidez e cautela para tentar diminuir os números de violência e morte.', 'Portanto  violência causadas devido ao homicídio feminino , vai continuar aumentando se não fizermos nada, e a Lei Maria da Penha é o caminho mais apto para a proteção dessas mulheres, e casos como esses devem ser denunciados sem pera de tempo e a mídia trabalhar com propagando em relação ao feminicídio divulgando o quanto é importante lutar pelos seus direitos, arrumando uma estratégia que possa acabar com essa violência.']",120,80,80,80,80,440
87,Novos tempos,"['A cultura da erotização infantil vem de muito tempo. É natural do ser humano desenvolver esse desejo, já para os pequenos é um tempo de descorberta . Vale lembrar que para cada fase  uma nova descoberta. A televisão e a internet são pilares importantes para informações, sendo usada para o bem, tem um valor muito grande.', 'Vemos séries, filmes, e novelas que normalizam muito esse ato, por estarmos em novo tempos. Mas, é essencial que tenhamos cautela em falar sobre esse assunto, já que o mesmo espanta muita gente.']",200,80,40,40,0,360
95,1 - Marco Temporal,"['Em 22 de abril de 1500, os portugueses chegaram ao território que anos depois se denominaria Brasil. A partir dessa chegada, tiveram contato com povos nativos, com os quais mantiveram uma relação conflituosa, que resultou no desaparecimento de etnias e na expulsão de indígenas de suas terras. Contudo, a Constituição federal, promulgada em 1988, instituiu o direito dos indígenas sobre seus territórios, mas é importante destacar que essa conquista está sendo ameaçada pela possiblidade do Supremo Tribunal Federal, em 2021, aprovar um marco temporal para demarcação de terras indígenas, o qual é injustificável e evidentemente prejudicial a todo corpo social, devido ao seu caráter anticonstitucional e ao perigo que representa para a preservação da biodiversidade brasileira.', 'Primeiramente, o fato da Constituição federal instituir, em seu artigo 231, o direito dos povos indígenas sobre suas terras, não fazendo menção a nenhuma data, comprova a ilegalidade de qualquer tentativa de se atribuir um marco temporal que restrinja a demarcação de terras indígenas. Assim, a tentativa do Supremo Tribunal Federal determinar que apenas os indígenas que habitam um determinado local desde 1988 possam ter a posse dessas terras legalizada evidencia uma manipulação arbitrária da Carta Magna brasileira.', 'Por outro lado, as áreas de domínio indígena constituem blocos em que a exploração dos recursos naturais é significantemente controlada, já que, apesar da invasão por garimpeiros, por exemplo, mantém-se distantes de atividades ligadas ao agronegócio, cujos resultados representam a devastação do meio ambiente. Essa relevância ecológica das terras indígenas foi demonstrada em um estudo divulgado pelo Instituto de Pesquisa Ambiental da Amazônia, no qual foi exposto que, entre os anos 2000 e 2014, a perda florestal em terras indígenas foi menor que 2%, o que não aconteceria se essas áreas não fossem demarcadas, pois, nessa condição, seriam facilmente exploradas em setores como a pecuária.', 'Em suma, constitui-se insustentável qualquer barreira relacionada demarcação de terras indígenas. Visto isso, é dever do Supremo Tribunal Federal, instância máxima do Poder Judiciário, negar a criação do marco temporal das terras indígenas, por meio de uma votação embasada na Constituição federal e com total ciência dos impactos que essa medida pode causar em relação a preservação ambiental, a fim de que os indígenas não tenham o direito às suas terras violado, e a grande diversidade biológica brasileira se mantenha amparada . Feito isso, as etnias indígenas deixarão de se preocupar com impedimentos para o pleno usufruto das terras que lhes foram destituídas com a chegada dos portugueses ao território tupiniquim.']",160,200,160,200,200,920
47,Educação na Pandemia (Bdsm),"['Mediante ao tal acontecimento da pandemia do novo coronavírus (Sars-CoV-2), as aulas em todo o território federal precis ser suspensa. Visando a diminuição no atraso do calendário escolar, foi-se instalado o EaD (Ensino à Distância). Porém, diante de tamanha desigualdade no país, esse método vem se mostrando ineficaz, seja pela incapacidade dos docentes e/ou acesso limitado à internet pelos estudantes . Logo, muitos desafios são encontrados no caminho da educação a distância no Brasil.', 'Pegos de surpresa pela pandemia , a maior parte dos docentes em todo o Brasil são incapacitados de desenvolver, com mesmo resultado e maestria, as atividades escolares . De acordo com a pesquisa realizada pelo Instituto Península, estima-se que 83% dos professores não estão preparados para ensinar online. E isso resulta em uma queda na qualidade do ensino brasileiro, já que os professores são obrigados a se desdobrarem e a se reinventarem para uma boa aprendizagem dos alunos, fato que pouco ocorre.', 'Vale ressaltar, também, que o acesso limitado e pouco abrangente da internet aos estudantes vem sendo uma problemática pertinente, já que aproximadamente 30% dos lares brasileiros não possuem o acesso amplo à internet . E esse número persiste ainda mais em alunos de escola pública, acentuando a desigualdade do ensino público comparado ao ensino privado . Logo, há um maior aproveitando de alunos de classe alta, o que irá gerar em uma maior diferença ao ingressar o ensino superior.', 'Dado o exposto dos desafios da educação a distância no Brasil, seja pela incapacidade docente ou acesso limitado à internet, é necessário uma interferência do Ministério da Educação (MEC) quanto a capacitação dos professores brasileiros ao ensino online, visando uma melhor qualidade do ensino brasileiro e a garantia do acesso à internet ao estudantes, em especial aos de baixa renda, garantindo educação à todos.']",160,160,160,160,160,800
66,Luta contra a manipulação,"['É notório que a internet é peça fundamental para o acesso de conteúdos como vídeos, mensagem, pesquisas, entre outros. Além disso, ela consegue, por meio de algarismos e códigos, filtrar e transmitir ao usuário sugestões personalizadas de informações e páginas de sites. Entretanto, essa autonomia da internet com o uso dos dados pode trazer uma certa manipulação de conteúdo e uma falsa impressão de escolha.', 'Convém ressaltar que a internet é um dos meios usados para a divulgação de marcas e produtos pelas empresas e, para conseguir uma maximização de desempenho, é usado o banco de dados dos usuários para divulgar o produto de acordo com as suas preferências. Essa atitude proporciona ao indivíduo uma falsa ideia de escolha  visto que ele está sendo induzido pela rede. Um exemplo disso são os anúncios localizados nos sites que são personalizados a partir de pesquisas anteriores.', 'Analogamente, dados do IBGE  mostram que mais de 80% dos jovens usam a internet para diversas finalidades como o envio de mensagem, recebimento de correio eletrônico e receber ligações de alguém . Além disso, a internet é usada como formadora de opinião e de gosto visto que pessoas com consensos divergentes expõem seus pensamentos na rede, influenciando a vida do jovem. Dessa maneira, dos propostos à certa pessoa podem manipulá-la devido a falta de controle de informações. Pode-se tomar como exemplo a opinião distorcida que consumismo é algo bom.', 'Assim sendo, a internet é uma benéfica peça de pesquisa e de propagação de conteúdo. Contudo, pode-se tornar influenciadora de opinião e de manipulação do comportamento do usuário. Com o objetivo de tornar a internet mais segura para todos é necessário o uso consciente dessa ferramenta como também se vê necessário uma preocupação dos pais com o conteúdo oferecido ao seu filho . Deve-se ressaltar, através de palestras em escolas  a necessidade do uso consciente e formas de prevenção contra a manipulação na rede. E é imprenscíndivel haver uma maior transparência dos sites e aplicativos com o uso dos dados do usuário. Dessa maneira será possível combater a manipulação a internet.']",160,160,120,160,120,720
86,Sociedade do espetáculo,"['No episódio intitulado “Nosedive"", da série “Black Mirror”, é mostrada uma sociedade fictícia, na qual os indivíduos vivem de aparências nas redes sociais e, por isso, ficam alienados tentando performar uma realidade perfeita para o público -os outros usuários. No contexto atual brasileiro, a situação é semelhante da ficção, uma vez que os indivíduos buscam mostrar, de forma ilusória, uma realidade utópica e, assim, desenvolvem transtornos mentais. Nesse sentido, o uso excessivo das redes sociais e a busca pela perfeição podem afetar a saúde mental dos usuários.', 'Em primeira instância, o doutor David Greenfield, fundador do Centro de Tecnologia e Internet, diz que quando um indivíduo realiza uma ação prazerosa – como checar “Instagram”, por exemplo- o cérebro deste produz dopamina em maior quantidade, o que causa um desequilíbrio, uma vez que ele sentirá prazer apenas enquanto estiver realizando esse mesmo ato. Nesse viés, os efeitos provocados pela utilização de ferramentas como o “Facebook” e “Instagram” são semelhantes aos das drogas, uma vez que ambos causam forte dependência a quem os usa e representa um grave problema para a saúde mental desses indivíduos, já que eles ficam propensos a desenvolver transtornos como ansiedade.', 'Adicionalmente, a busca pela perfeição mostrada nas redes sociais é um dos agravantes para o problema. A esse respeito, Guy Debord- expoente filósofo francês- desenvolveu a teoria da Sociedade do espetáculo, segundo a qual as pessoas buscam performar uma realidade inalcançável ao público. Nessa perspectiva, a teoria de Debord se aplica à realidade atual, especificamente, no mundo digital – nas redes sociais-, já que os usuários postam em seus perfis imagens de uma vida perfeita, o que causa depressão e ansiedade, pois as pessoas irão buscar uma perfeição inalcançável. Além disso, tal situação pode ser comparada ao caso de uma das personagens do episódio “Nosedive"", que faz postagens apenas das coisas  boas que acontecem em sua vida, deixando a imagem de que a vida dela é sem defeitos. Assim, enquanto a cultura da perfeição for a regra, a saúde mental será a excessão.', 'Dessa forma, para a resolução do problema é necessário que sejam tomadas medidas informativas. Nesse sentido, o Estado, por meio de parcerias público-privadas,  deve realizar políticas públicas que visem informar a sociedade acerca dos prejuízos que o uso inadvertido das redes sociais podem provocar à saúde mental dos utilizadores de redes sociais, a ação teria como objetivo adverter a população a cerca dos prejuízos causados pela utilização execessivo de ferramentas como o “Facebook” e “Instagram”.']",160,200,160,200,160,880
54,Revolta contra os antivacinas,"['Brasil. País vasto mas que conseguiu o feito de ser um exemplo internacional de modelo de vacinação pública. Devido a sua inquestionável importância desde a Revolta da Vacina sua integridade nunca teve grandes levantes sobre seu uso. Porém, hodiernamente, o chamado movimento antivacina tem se mostrado presente, difundindo falsos princípios que acabam por criar uma cobertura vacinal reduzida.', 'Resultado de um avanço a criação de vacinas contribui significamente para a qualidade de vida fazendo com que exista uma queda abrupta no numero de casos (Vírgula) bem como em suas complicações que poderiam levar até mesmo a morte. O instrumento mencionado trata-se de um antígeno atenuado ou inativo que não causa a doença mas que estimula o sistema imunológico para uma resposta rápida e precisa num segundo contato. Com pesquisas e testes sua eficacia é posta em analise para que quando usada em pessoas cumpra o seu proposito, tudo muito criterioso obedecendo especificações da Agencia de Vigilância Sanitária (Anvisa). Sabe-se que por mais esforço dos órgãos competentes dificilmente a cobertura de vacinação chega a 100% ???????seja por pessoas imunocomprometidas ou alérgenas, porém, quanto maior for o contingente vacinado ??????? maior é a proteção ???????inclusive aos não vacinados.', ""O Programa Nacional de Imunizações (PNI) tem a função de gerenciamento de imunizações no Brasil, seu trabalho dentre outros é combater aquilo que segundo a Organização Mundial de Saúde (OMS) é considerado uma das dez ameaças a saúde global: resistência à vacinação . Disse Aristóteles ''O ser humano é naturalmente um ser social e politico''  e justamente por ser social deve pensar no outro, saindo da esfera singular e adentrando na plural e também na de saúde pálica pois uma pessoa não vacinada influncia em toda a cadeia de imunizações. Repensar conceitos e não se fixar a falsas noticias, procurando embasamento concretos leva a um melhor discernimento de quão importante é essa invenção para todos. Ao governo federal, estados e município cabe a função do incentivo por meio dos veículos de comunicação, orientação no pre-natal ou mesmo usando táticas como a matricula em escolas mediante apresentação do cartão de vacina devidamente preenchido."", 'Dado o exposto, a vacina é o melhor meio preventivo por diminuir casos de doenças e de seus agravantes ??????? por isso seu uso é de suma importância. Grupos antivacinas precisam receber instruções embasadas para assim se verem utilizadores de uma das melhores invenções da humanidade. Ao governo cabe por meio de ações estimular a vacinação, abrangendo os postos, esclarecendo dúvidas ??????? criando então uma revolta, a revolta aos antivacinas, efetivada pelo comum.']",120,120,80,120,80,520
76,Uma luta interminável,"['Ser mulher desde sempre foi um desafio perante o mundo. Permeadas de desrespeitos e preconceitos, elas tiveram que se moldar ao que sociedade julgava ser coerente para as mesmas. É fato que com o passar dos anos, diversas reivindicações a esse respeito aconteceram e algumas vitórias foram conquistadas, como por exemplo, a instituição do voto feminino por, o até então presidente, Getúlio Vargas, no ano de 1932. Infelizmente, porém, apesar das diversas mudanças ocorridas no mundo, em pleno século XXI, o Brasil ainda é um país majoritariamente machista, Faz-se necessário, portanto, que medidas sejam tomadas, visando erradicar esse problema.', 'No mundo capitalista em que vivemos, a tendência é que as grandes corporações procurem os mais fortes e aptos para o emprego, visando um maior lucro. Devido a isso, a população feminina, estigmatizada como fraca e incapaz, não consegue seu merecido lugar no mercado de trabalho com a mesma facilidade que possui o sexo oposto. Além disso, quando o cargo é conquistado, elas, muitas vezes, acabam recebendo salários menores do que deveriam, apenas pelo seu gênero. Essas ações demonstram a tamanha diferenciação entre os gêneros e nos revelam a seriedade do problema.', 'Fora isso, é importante citar, as mais variadas situações nas quais a população feminina sente-se coagida e invadida pela parte masculina da sociedade. Podemos citar como exemplo,  o abuso sexual, muito mais recorrente com as mulheres e muitas vezes  ainda, sendo tido como falta de cuidado e culpa da vítima. Ademais, existem também, os diversos estigmas sociais, como o fato de algumas pessoas ainda acreditarem que elas devem limpar a casa e cuidar dos seus filhos, não servindo para nenhum outro tipo de atividade. Esses atos têm consequências profundas na vida dos que sofrem e devem ser mudados.', 'Com todos esses problemas, começaram a ganhar força movimentos feministas, apoiadas inclusive por alguns homens, diversas são as reivindicações, mas a principal delas é respeito. Espalhados por tudo mundo, apresentam-se na forma de passeatas e protestos, demonstrando uma melhoria da população se comparada com a forma de pensar antiga . Infelizmente, ainda não são suficientes para mudar o pensamento geral, mas já são um bom começo.', 'Diante do exposto, é de extrema importância que a mudança se inicie pela base, com as escolas constantemente transmitindo aos alunos a igualdade de gêneros e a importância da mulher no mundo. Além disso, os cidadãos precisam promover mais passeatas transmitidas à população através das redes sociais, visando ter um alcance mais amplo. Com essas mudanças, o respeito para com elas vai aumentar e conseguirão se igualar aos homens na sociedade e ter um emprego de qualidade.']",120,160,120,160,120,680
88,...,"['O machismo é um impasse social que concerne não só as mulheres em seus cotidianos, em ramos profissionais, religiosos e de entretenimento, mas também abrange os homens no que se refere aos estigmas. Haja vista, a visão opressora que esse empecilho social apresenta em relação às doenças mentais de que esses são distúrbios dispensáveis, sendo assim, banalizados o que provoca , consequentemente, malefícios para mulheres e homens. Nessa perspectiva, é necessário mencionar a ausência de informação e a cultura de banalização de transtornos psicológicos como causadoras dessa problemática.', 'Em primeiro lugar, faz-se fundamental citar a deficiência de conhecimento como impulsionadora do conflito em questão. Destarte, as informações limitadas do corpo social brasileiro associadas aos transtornos mentais acabam por, propulsionar o preconceito que existe atribuído a eles. Diante disso, ao dispor do mínimo conhecimento sobre essas doenças, o sujeito tende a julgar aquele que contém a enfermidade, por justamente essa, não apresentar incapacidade visível e, portanto, alimenta esse estigma. Nesse sentido, essa situação é capaz de prejudicar o doente que passar por julgamentos pois o enfermo sente-se sem apoio emocional, ocorrência favorável a sua doença. Dessa maneira, esse fato diverge do pensamento do filósofo John Locke, que visa a necessidade da reflexão sobre as experiências que o ser humano obtém ao longo da vida para desenvolver o conhecimento. Sendo assim, a sociedade brasileira reproduz a intolerância à doença mental sem ao menos cogitar sobre tais transtornos psicológicos.', 'Além disso, é preciso salientar que as doenças da mente são desconsideradas em analogia àquelas físicas. Sob esse viés, os distúrbios mentais são desprezados e possuem pouca atenção por parte da sociedade. À vista disso, essa banalização é retratada pela escassa investigação profissional e também pelo número crescente de suicídios no Brasil. Dessa forma, a cultura de desdenhar esses problemas de saúde provém de um contexto histórico, pois somente no século XXI que a população iniciou o investimento nesse âmbito psicológico . Isto decorreu por existir esse estigma, o que ocasionou sua conservação por muitas gerações.', 'Tendo isso em vista, é dever do Ministério da Saúde  realizar consultas psiquiátricas com a comunidade, por meio do Sistema Único de Saúde e necessita priorizar aqueles que dispõem do diagnóstico da enfermidade. Essa ação tem a finalidade de tornar essa área da saúde menos estigmatizada, ao demonstrar que todos carecem de cuidados com a saúde mental. Logo, a cultura de banalizar e estigmatizar serão apenas lembranças da história brasileira.']",160,160,160,200,160,840
95,O marco temporal no Brasil,"['O termo maro temporal surgiu com uma decisão do STF com o ministro Ayres Brito, sobre a demarcação da erra indígena Raposa Serra do Sol em Roraima . Essas terras indígenas eram reivindicadas por produtores de arroz e pelos índios que ocupavam o lugar.', 'Na Constituição do Brasil, no art.23,diz respeito s terras indígenas, seus direitos, tradições ,costumes, e em lugar nenhum se fala sobre data de promulgação . O marco temporal se inicia-se em 5 de outubro de 1998, dia que foi promulgada a constituição.', 'Para os indígenas que dependem da erra para sobreviver esse marco temporal será injusto  pois está favorecendo o produtor rural que não está nem um pouco preocupado com a preservação ambiental. Segundo a antropóloga Luíza Molina, diz que o marco temporal reduz o acesso do direito originário da terra por parte dos povos indígenas.', 'O maro temporal surgiu para ajudar os povos indígenas naquela ocasião  mas infelizmente ele está sendo usado para que os índios percam os seus direitos. Cabe aos ministros do STF aprovarem leis que dêem legitimidade aos povos indígenas.']",120,120,120,120,80,560
62,A Felicidade se constrói,"['No Brasil, tudo começou em 2013, até aqui, as redes sociais eram usadas com harmonia e muita alegrias . Os brasileiros estavam em festa com essa fantástica e revolucionaria ferramenta de comunicação e aprendizagem. Era novas descobertas de pessoas maravilhosas a cada dia. Cada usuário compartilhando a mensagem mais bonita, de amor, bondade, caridade, compaixão e alegria. Até que veio a politica e tudo desmoronou. Dilma Rousseff era a presidente do país. O que ela, o seu partido o PT e o Lula,  (o ex presidente) sofreram de ataques de ódio, ecoará na eternidade para sempre. Foi uma coisa horrível, triste e inacreditável de se ver. E as autoridades competentes não fizeram nada. Tudo o que essas pessoas aguentaram de discursos odientos e repugnantes, merecem o troféu da resistência.', 'Desarmonizaram o âmago da nação. Tudo era motivo de brigas, discórdias, ofensas e estupidez desnecessárias . Quem deveria dar o exemplo, os políticos, jornalistas, humoristas, religiosos, etc. Eram os primeiros a propagar os mais inflamáveis discursos tóxicos que só envenenavam a população. E não se chegava a luz alguma, só escuridão. Foram momentos de trevas profundas. Não houve providência hábil no momento, ninguém foi punido e o ódio só crescia em proporção gigantesca. Assim também cresceu todo o derivado do ódio, e enveredou para todos os setores da sociedade. E hoje tudo é motivo para a insensatez online, ninguém respeita mais ninguém, viver hoje neste país se torna insuportável virtualmente ou realmente.', 'O exemplo não é só uma maneira de ensinar, é a única correta. O que essas autoridades podem cobrar dos loucos que criaram?  É a lei do faça o que mando, mas não faça o que faço? É complicado resolver essa situação com falta de exemplo. Liberdade de expressão não é passaporte para o desrespeito. O respeito deve ser o dever da expressão. Agora o STF,  ( Superior Tribunal Federal), colhe a amarga colheita da negligência. Talvez se ele tivesse agido em 2013 quando tudo começou que era o seu dever agir como suprema corte da justiça, guardiã das leis e da Constituição, esse cas. Nunca teria nascido, ou já estaria morto e descansava em paz. Mas foram muitos erros coletivos e ninguém para assumir a culpa. A solução é simples, mas complicado é ser simples.', 'Portanto, ninguém poderá mudar o que passou, mas juntos todos poderão reconstruir tudo o que se perdeu. O novo presidente do Brasil deve dar o exemplo,  de tolerância, liderança e principalmente de respeito às diferenças. O presidente do STF deve junto com o congresso nacional encontrar um mecanismo para coibir e punir quem cometer crime de ódio nas redes sócias e na vida real também. Campanhas publicitrias sobre tolerância e respeito em todas as mídias. Escolas e sociedade unidas com palestras semanais sobre o assunto fará florescer cidadãos mais conscientes de seus direitos e dever. Que todos os mais preciosos valores humanos neste país faça morada.']",120,120,80,120,80,520
50,Covid-19,"['Com esse vírus que surgiu na China, na cidade de Wuhan no final de dezembro de 2019, o novo Coronavírus também conhecido como covid-19 acabou se tornando uma doença que chocou o mundo , com pouco tempo do seu surgimento ela se tornol uma pandemia, sendo comparada com outros coronavírus ela é menos agressiva e com menor taxa de mortalidade em comparação a Sars e Mers que são doenças que causam síndromes respiratórias agudas mais seu contagio supera as duas. Por entanto esse foi uns dos principais motivos para se tornar uma pandemia, sendo assim muitos governantes tomaram medidas extremas como o isolamento social, mais muitas pessoas se perguntam como isso ir ajudar.', 'É simples o isolamento social ajuda de muitas formas , como evitar o contatos com contaminados, evitar a proliferação desse vírus, assim como não possui uma vacina pra esse vírus , fica difícil para os hospitais contem a alta demanda de contaminados, sendo assim os governos de muitos países estão criando hospitais de campanha de suprir a demanda e dar tempo para os cientistas criarem uma vacina. Claro que o isolamento social tem seus contras como podem fazer um país acabar entrando numa crise financeira, mas isso não chega aos pés dos prós, claro que o isolamento social não seja a unica forma de prevenção como também manter a higiene em dia, lavar as mãos com frequência, ao tossir cobrir com o braço.', 'Cientistas pedem que a população obedeça as regras do isolamento por causa que nem todos os pacientes vão apresentar sintomas. Hoje em dia mais de 1 milhões de pessoas já foram contaminadas no mundo, mais de 100 mil mortes, atualmente existe no mundo pelo menos 4 vacinas contra o covid-19 segundo a ONU  em faze de teste pelo mundo e estão previsto pra chegar ao mercado no final desse ano']",120,120,80,80,40,440
20,O país do futuro,"['No Brasil, o número de cidadãos que querem migrar para outros países tem crescido drasticamente.', 'Atualmente, o território brasileiro vem enfrentando uma crise desde séculos passados, como a queima do café em 1931 e a queda do PIB (produto interno bruto). Tais fatores, formalizaram a encomia do Brasil se estagnar durante anos. A problemática é que com a queda do capital, o desemprego cresceu, pois, os governos reduziram o número de servidores contratados.', 'Todavia, pesquisas realizadas pelo IBGE mostram que um quinto dos jovens brasileiros não estudam e não trabalham. O problema vem sendo que os jovens do Brasil não querem arrumar um emprego. Entretanto, para a preparação, formação e educação de um cidadão, a vida exigirá investimentos seguido por anos.', 'Como já dizia a música do famoso cantor Renato Russo: “O Brasil é um país do futuro”. Um país que vem acomodando grande parte de seu povo pela falta de investimentos na infraestrutura e deficiências na educação. Em destarte, vista tal situação, a maioria dos cidadãos hesitam por mais uma espera de décadas de conversão e optam assim por deixarem seu país de origem.', 'Portanto, medidas precisam ser tomadas para resolver o impasse. Novas leis deveriam ser aplicadas pelo Ministério Do Trabalho, possibilitando vagas de emprego para jovens ainda inexperientes. Assim dando novas oportunidades. Por ora, o MEC realizaria nas escolas públicas a verificação do ensino aplicado nos jovens acompanhando o desenvolvimento dos envolvidos. Em suma, a formação do jovem de hoje é a construção de uma sociedade de amanhã.']",0,0,0,0,0,0
45,Não ao autoritarismo,"['Platão, filósofo da Antiguidade Grega afirmou: “Onde houver justiça, aí está a felicidade”. No entanto, aquilo que o pensador pregava não é cumprido na contemporaneidade, uma vez que o abuso de autoridade no Brasil é um entrave para o bem comum. Sendo assim, a inoperância governamental e a insuficiência legislativa configuram-se como as causas latentes da questão, à medida que implica em uma resolução efetiva no país.', 'Primeiramente, é válido ressaltar que a passividade do Governo acarreta a persistência da problemática nacional. De acordo com uma notícia de maio de 2020, a má conduta de um militar que pisou no pescoço de uma senhora negra enquanto fazia uma abordagem ganhou repercussão nas mídias , porém ele somente foi afastado de seu cargo. Nesse sentido, é fato a tamanha ineficiência estatal, já que deveria coibir a prática do uso em excesso de poder dos agentes públicos. Desse modo, uma urgente mudança faz-se importante.', 'Ademais, é relevante salientar que a ausente legislação, não oferecendo uma justa punição  contribui na perpetuação do quadro negativo atual. Segundo o pensador iluminista, John Locke: “As leis foram feitas para os homens e não para as leis”. Nesse contexto, evidentemente, a falta de atuação legislativa prejudica a segurança dos cidadãos que se tornam vítimas dos abusadores de poderio, que permanecem impunes. Enfim, a elaboração de uma solução é cabível no Brasil.', 'Portanto, uma intervenção faz-se necessária para mitigar o problema. Dessa forma, urge ao Poder Executivo , juntamente ao Poder Legislativo  criar e executar uma lei direcionada aos servidores do Estado. Por meio do Conselho Nacional de Justiça, proibindo o pagamento de salários aos infratores da lei, como policiais, desembargadores, magistrados e outros, a fim de priorizar a segurança dos brasileiros e de extinguir o abuso de autoridade, bem como concretizar o ideal platônico no território nacional democrático.']",160,160,160,200,160,840
61,,"['Depressão, sofrimento, solidão, arrependimento, são temas interligados e presentes em muitos policiais, principalmente quando se está envolvido em grandes operações . No Brasil, as polícias não possuem estrutura e preparo para enfrentarem grandes perigos, com isso se sentem despreparados e acuados diante de uma operação policial.', 'Em diversas regiões, não encontramos estrutura suficiente, por exemplo, para um policial enfrentar um confronto de rua. Muitas vezes, são agredidos pelos marginais de forma a serem atingidos não só fisicamente, mas também moralmente, prejudicando principalmente a sua forma de pensar e agir, se tornando pessoas agressivas e violentas. Quando param para pensar no que fizeram se sentem arrependidos, por exemplo, por ter matado uma criança inocente ou agredido uma pessoa sem pensar, no “momento da fúria”.', 'Diante dessa situação, se sentem deprimidos e imaginam que a vida não tem mais sentido, por não ter conseguido cumprir uma operação ou até mesmo ter matado ou maltratado um inocente. Retirando assim a sua própria vida.', 'Mas o que podemos fazer para resolver essa situação? A corrupção no Brasil só aumenta , o dinheiro que era para melhorar a estrutura das polícias no Brasil está sendo desviado para benefício próprio. Mas, esse dinheiro deveria ser usado na melhoria e aperfeiçoamento de equipamentos de segurança, cursos e treinamentos especializados, avaliações com psicólogos. Com isso nossos policias iriam se tornar cada vez mais preparados para enfrentar diversas situações, ocorrendo assim menos casos de suicídio e depressão entre os policiais.']",120,40,40,120,40,360
14,Imigração ou problematização,"['É notório que, a imigração tem sido um grande obstáculo para os governos nos últimos tempos, e de hoje que existe migração entre países, mas atualmente com grandes crises, a imigração vem tomando grandes proporções que se tornam impossível suportar. O Brasil por exemplo, carrega uma crise financeira e, com um número enorme de desempregados.', 'Em tempos remotos, a imigração era vista como um futuro próspero forasteiros que traziam novas experiências, oportunidade e grandes descobertas e novos empregos, como os alemães, que trouxeram a cultura de fabricar vinhos de altíssima qualidade, em tempos atuais, temos os americanos, trazendo tecnologias para à plantação de soja. A imigração era vista como uma oportunidade de crescimento, assim como acontece no estado da Bahia por exemplo, mais precisamente em Luís Eduardo Magalhães, cidade pequena, mas que tem crescida e evoluída rapidamente através da plantação de soja, isso graças aos investimentos dos imigrantes, contudo a cidade vem crescendo a renda per capita, assim melhorando a qualidade de vida daqueles que ali reside , consequentemente povoados e regiões.', 'Hoje a situação é bem diferente, pois a imigração e vista como uma ameaça para o povo, já que o país passa por uma recessão gravíssima, o índice de desemprego é alarmante, há sérios problemas vários setores, tais como a saúde e outros. O governa tem tentado ajudar, fazendo pactos imigratórios, recebendo várias pessoas do país vizinho, como a Venezuela, refugiando e dando emprego a eles, mas existe uma grande preocupação, pois o Brasil já se encontra em uma situação alarmante, precisando é de ajuda, como ajudar os países vizinhos. O Brasil possui atualmente cerca de 450 mil desempregados, dessa forma, ao invés de ajudar o país vizinho, vai ser o inverso, vai é atrapalhar tanto eles como sua própria nação.', 'Sendo assim, nota-se que o ideal seria arrumar a pátria, ou seja, levando ao pé da letra a constituição , com saúde, educação, saneamento básico, moradia para todos, depois fornecer ajuda aos países vizinhos, pois se não há expectativa de vida, não tem como oferecer algo ao próximo.']",40,80,120,160,120,520
70,Informar é preciso,"['No Brasil, o aumento de jovens infectados por doenças causadas durante o ato sexual é crescente e motivado por fatores sócio-econômicos. A AIDS é a doença que mais afeta jovens e quando entra no corpo torna se fatal podendo levar a morte do jovem em pouco tempo, por isso é necessário oferecer condições dignas para o jovem proteger seu corpo e sua vida das DSTs .', 'A falta de informação constitui um fator que estimula o aumento de doenças sexualmente transmissíveis entre jovens. A informação é o primeiro passo para conscientizar o ser humano sobre a necessidade de se prevenir contra doenças transmitidas através das relações sexuais, entretanto, as condições de pobreza na qual o jovem viver e a falta de acesso  escola limita o acesso a informação,assim o jovem  por ignorância  tende a ter uma vida sexual sem proteção e regras correndo o risco de pegar AIDS ou sífilis pelo ato sexual desprotegido ou com vários parceiros.', 'Além disso, a desvalorização do sistema público de saúde se reflete na incapacidade para combater o problema. Isso pode ser observado na falta de recursos nos hospitais para desenvolver palestras abordando o assunto como forma de despertar o interesse do jovem pelo grave problema mostrando a necessidade de usar camisinha no ato sexual para não desenvolver doenças sexuais preservando assim, sua saúde física.', 'Por tudo isso , ações são necessárias para prevenir as doenças causadas pelo ato sexual, por isso o estado deve investir recursos em hospitais públicos para que os profissionais de saúde possam elaborar campanhas e palestras visando informar, conscientizar e estimular jovens a se prevenir nas relações sexuais, o poder público deve também melhorar a educação no pais e favorecer a inserção dos jovens escola, pois o conhecimento provem da escola e é a melhor formar de se prevenir contra qualquer doença.']",120,120,120,120,120,600
88,SAÚDE MENTAL,"['Em um mundo tão globalizado e avançado tecnico e cientificamente, é algo extremamente vergonhosos o fato de que muitas informações essenciais ao bem-estar geral não sejam propagadas devidamente a toda população. A questão dos problemas mentais, por exemplo, algo muito recorrente do meio da sociedade contemporânea, ainda é algo excessivamente estigmatizado.', 'Segundo a OMS (Organização Mundial da Saúde), 322 milhões de pessoas no mundo sofrem com a depressão, sendo essa considerada a doença mais incapacitante do planeta. A falta de informação e conhecimento sobre o assunto leva os indivíduos portadores da doença a se afundarem cada vez mais em sua própria condição, e alimenta o preconceito nas mentes dos ignorantes á situação.', 'As mídias sociais possuem um grande peso em relação á saúde mental. A busca irracional e exagerada pela vida perfeita e inalcançável, vista nos perfis sociais alheios, produz um efeito contínuo de autodepreciação, causando ansiedade e baixa auto estima nos indivíduos,', 'Analisados os fatos mencionados, é visto que medidas visando o bemestar da saúde mental do população devem ser tomadas pela tríade Estado, escola e mídia. O Estado se responsabilizaria por oferecer profissionais da saúde mental em postos de saúde e hospitais, A escola, como instituição educacional desenvolveria palestras com psicólogos e psiquiatras a cerca de problemas mentais. E por final, a mídia, com seu grande poder informacional, daria um maior holofote no que tange ao conhecimento sobre a saúde mental.']",160,160,120,160,160,760
41,Disciplina para vida toda,"['""O Brasil é um país do futuro"", já dizia Renato Russo em suas belas canções . Para que haja uma ordem no progresso da nação, é necessário ter muita disciplina, que em contra partida denotará o interesse na educação do país e com rigidez, esforço e paciência, isso espelhará em um futuro promissor para a educação brasileira. O ensino militar, por exemplo, mostra que a junção desses elementos (citado no primeira paragrafo ) resulta nas boas notas em avaliações externas que são submetidos. Dedicação e foco são necessário para formar críticos, que por sua vez, tende a contribuir no aperfeiçoamento dessa metodologia de ensino do país. Não é para tanto que a demanda da procura para ingressar no ITA é uma das mais cotadas hoje no Brasil, isso só deixa mais claro o quão bom e a forma de ensino nessa instituição, que forma profissionais de alta qualidade, tal qual uma nação em desenvolvimento necessita na atual contemporaneidade .Por tanto , em feito aplausivo, seria a ampliação desses colégios militares feito pelo governo, a acessibilidade à essas escolas trará uma nova visão para o jovem que sonha. Essa autoridade no ensino mudará a forma de pensar, agir, senso crítico . A presença da disciplina militar em regiões com baixo rendimento em avaliações externas, deve ser prioritária e urgente. Para termos ordem e progresso, é necessário uma boa base educacional para os jovens, que são o futuro do país.']",80,120,80,80,80,440
82,Automedicação,"['Cuidar da saúde é uma atividade constante, principalmente quando essa  se encontra ameaçada por uma doença, a qual deve ser tratada o quanto antes for descoberta    visando a  melhora do quadro e seu não agravamento. Embora o ideal seja procurar um profissional da área dq  saúde, muitas vezes tais casos podem ser resolvidos com a automedicação sem necessariamente ser algo ruim.', 'Apesar de a automedicação ser vista como uma prática imprudente, na maioria dos casos, ela resolve o problema das pessoas sem que precisem procurar um médico. Ao longo do ano é comum que as pessoas tenham certas doenças, como resfriados, dores de cabeça, pequenas inflamações, que, por experiência e autoconhecimento, é sabido que serão sanadas em poucos dias. Excetuando-se casos alérgicos, os remédios comercializados livremente são bastante seguros para o uso comum, auxiliando a aliviar os sintomas enquanto o corpo se cura. Sendo assim, a automedicação evita o transtorno de ir a um consultório, além de contribuir para que o sistema de saúde possa se ocupar com casos mais graves.', 'Por outro lado, caso a melhora nao  aconteça, é fundamental a intervenção de um profissional para correto diagnóstico e tratamento. “Ao persistirem os sintomas    o médico deverá ser consultado”, famosa frase ouvido  ao final das propagandas de medicamentos é simples, porém muito precisa para com o cuidado com a saúde. Essa ação é importante pois  negligenciar qualquer doença ou tentar se medicar com drogas específicas pode ser perigoso. No caso dos antibióticos, por exemplo, seu uso errôneo aumenta as chances de uma bactéria se fortalecer e ser fatal. E uma doença não tratada também pode se agravar em um quadro irreversível.', 'A automedicação é uma prática comum e tem seu papel positivo para a população e no sistema de saúde. Contudo, é importante que as pessoas procurem se consultar sempre que seu quadro persistir ou for diferente do habitual para o correto tratamento. Além disso, é necessário que o controle sobre medicamentos específicos continue sendo rigorosamente feito pela ANVISA a fim de só ter acesso aqueles que possuem receita médica para tratamento de doença. “A diferença entre o remédio e o veneno está na dose”, da mesma forma é a automedicação, que se praticada com responsabilidade será somente o remédio.']",160,160,160,160,200,840
56,A humanização dos detentos numa perspectiva de reciprocidade criminal,"['Na obra cinematográfica “Gamer”, o protagonista é um detento que é obrigado a participar de jogos de morte em busca da liberdade, nesse mundo de ficção os presos são usados para o entretenimento da população. Com isso, é possível associar tal obra de cunho ficcional com a realidade, em que, muitas vezes, as pessoas desejam visualizar o sofrimento desse grupo de indivíduos. Dessa forma, o maior empecilho, para um desenvolvimento mais humano dos encarcerados e da mudança da visão carcerária, é a mentalidade de grande parte da sociedade.', 'Em primeiro lugar, nota-se que a noção deturpada de justiça é basicamente na lei de talião “Olho por olho, dente por dente”. Esse ideal é bastante aceito pela população, uma vez que compartilham a ideia de que os detentos devem sofrer por seus crimes ao invés de serem reeducados. A esse respeito, a primeira Lei da Dinâmica, formulada pelo físico Isaac Newton, trata do aspecto da inércia e que caso não exista uma força que atue sobre um objeto, ele tende a permanecer em movimento. Por conseguinte, para buscar fragilizar ou até mesmo romper esse estado de fluxo citado, é preciso combater a ideologia de reciprocidade criminal presente na mente de um grande número de pessoas.', 'De outra parte, é necessário apontar que os presos, apesar de terem infringido a lei para estarem em estado de cárcere, são como todo o resto da população e que por isso merecem um desenvolvimento mais humano. Princípio semelhante se observa na ideologia de Martin Luther King, em que uma das coisas mais importantes da não violência é buscar transformar o indivíduo. Essa relação mencionada, de procurar mudar o indivíduo, demonstra o lado da evolução da consciência das pessoas, buscar atos violentos só tendem a gerar outros, constituindo, assim, um ciclo sem fim de violência.', 'Portanto, o Ministério da Educação, órgão regulador da sociedade, deve em parceria com a mídia, grande propagadora de informação e principal veículo formador de opinião, abordar a questão da justiça e do desenvolvimento humano dos detentos, com o propósito de combater o ideal da lei de talião e favorecer uma evolução da mentalidade da população. Essa ação pode ser realizada por meio de cartilhas, comerciais, anúncios entre outras estratégias que tragam em sua programação propagandas referentes ao assunto e busquem revelar os danos que essa ideologia de reciprocidade criminal ocasiona na sociedade. Assim, poder-se-á atenuar o cenário da atual situação carcerária do Brasil e evitar que o filme “Gamer” deixe de ser ficção e se torne realidade.']",160,160,120,160,120,720
79,Degradação por trás das grades,"['O cenário falido do sistema carcerário do Brasil não é exclusivo deste milênio. No século XX, mais precisamente durante a década de 1990, muitas das unidades prisionais brasileiras apresentavam problemas, como, por exemplo, superlotação e degradação estrutural. Tal situação culminou no episódio mais trágico do sistema prisional do país: o massacre do Carandiru, quando presos iniciaram uma rebelião naquela unidade. Atualmente, o problema penal persiste e tende a aumentar vertiginosamente. Superlotação, agentes mal treinados e instalações precárias tornam o modelo prisional tupiniquim um dos piores do mundo. Com isso, surge a questão: quais os caminhos para melhorar o sistema carcerário brasileiro?', 'De acordo com dados do Conselho Nacional de Justiça, o Brasil possui déficit  de 250 mil vagas em presídios, gerando a situação de superlotação e de quebra do estado  de direito. A ausência de vagas traz consigo a depredação das unidades e a falta de higiene necessária para condições de bem estar  . Além disso, penas severas para crimes brandos aumenta  a densidade demográfica de detentos, fazendo dos presídios o habitat ideal para recrutamento de novos integrantes do crime organizado e da violência.', 'Como se não bastasse, a falta de treinamento dos agentes penitenciários provoca, em boa parte dos casos, abusos de poder sobre a vida do encarcerado. Sofrer humilhações e espancamentos faz parte da vida do detento.', 'Fica clara, portanto, a necessidade de buscar caminhos que melhorem essa realidade. O Poder Judiciário deve proporcionar a maior coerência possível em seus julgamentos, fazendo, assim, uma melhor distribuição de presos de acordo com o nível do crime cometido. Segundo o filósofo grego Epicteto, só a educação liberta. Com base nisso, o Governo Federal, por sua vez, deve investir em sociólogos,  para que estes reforcem o treinamento dos agentes prisionais, fundamentando, assim, uma base sólida de ética e cidadania no exercício da profissão. Reparos nas unidades devem ser feitos anualmente, evitando proliferação de pragas e doenças. Com tais medidas, o sistema prisional do Brasil poderá ser mais eficaz e menos degradante.']",160,160,160,160,160,800
78,Laranja mecânica e a reforma brasileira,"['No romance ""Laranja mecânica"" de Anthony Burgess, o protagonista da trama - Alex - é submetido a um processo de ""reeducação"" social de forma massiva, despótica e desprovida de um real ensino. Tal conjuntura, embora fictícia, também pode ser notada no atual modelo de ensino médio no Brasil . Desse modo, a proposta de mudanças nas diretrizes desse nível escolar é salutar e necessária.', 'A reforma do ensino médio no Brasil é positiva, pois proporcioná aos jovens vantagens como a escolha de sua trajetória de formação, maior compatibilidade com os assuntos estudados e qualificação profissional. A atual grade curricular brasileira mostra-se defasada e gera um ""confronto"" de gerações: encontram-se nas salas de aulas professores do século XX ensinando conteúdos fomentados no século XIX e alunos do século XXI tentando assimilá-los de forma improdutiva . Tal contraste é um dos fatores que levam mais de 1 milhão de jovens de 17 anos não terminarem o 3° ano do ensino médio .', 'Convém lembrar, ainda, que a mudança no nível médio oferecerá uma inserção social mais acentuada aos mais pobres. Com a formação técnica o estudante poderá ser inserido no mercado de trabalho e mudar sua situação social, além de contribuir financeiramente para o seu país. Soma-se  a tais vantagens o poder de decisão do estudante em escolher sua trajetória acadêmica, focando nos assuntos que lhe são mais convenientes. Todavia, ainda é necessário um tempo de adaptação das escolas a essas mudanças, uma vez que isso demandará altos custos.', 'Cabe ao terceiro setor - composto por associações que buscam se organizar para conseguir melhorias na sociedade - informar e mobilizar, por meio de mais palestras e grupos de discussão, as famílias de todo o Brasil sobre a importância da reforma do ensino médio. Por fim, o Governo Federal deve solidificar os investimentos na educação técnica e expandir o número de instituição federais que, de certa forma, já vivenciam parte dessa mudança.']",120,120,120,120,120,600
50,Coronavírus,"['No ano de 2009 houve a pandemia do H1N1, também chamado de Gripe Suína, que provocou 18 mil mortes no mundo todo, atingindo pessoas de todas as faixas etárias e em ótimas condições de saúde. Porém, com a criação de vacinas e medicamentos, esse quadro minimizou-se, sendo um grande avanço contra o H1N1. Em paralelo à situação atual, com a pandemia de coronavírus, a ciência continua desenvolvendo  uma importante função no combate à doenças, com estudos e pesquisas, mostrando a extrema importância desse setor na sociedade e como investimentos e recursos ajudam na luta contra pandemias .', 'Em meio à pandemia de COVID-19, os pesquisadores em universidades denotam um papel relevante, como por exemplo os do Instituto Lutz da Universidade de São Paulo  em parceria com a Universidade de Oxford, que sequenciaram o genoma do vírus em 48 horas, trazendo mais informações a respeito da doença e mostrando como educação e ciência estão atrelados na elaboração e a apresentação de dados científicos.', 'A ciência está diretamente ligada ao desenvolvimento de uma nação, pois quanto maior o número de pesquisas e estudos , mais há produção de conhecimento , o que favorece todos os setores da sociedade, visto que o saber ocasiona em mais educação, e logo, mais condições para o desenvolvimento de fármacos, o que gera mais qualidade de vida para a população.', 'Na pandemia de H1N1, as vacinas e medicamentos foram pertinentes contra a doença, assim como são agora. Portanto, o Governo Federal deve trabalhar para que haja a desburocratização mais rápida na liberação e testes desses remédios, com a implantação de medidas emergenciais . Ademais, deve também fazer investimentos nas áreas de pesquisa científica, com mais recursos e equipamentos que facilitarão os estudos. E, por fim, deve oferecer bolsas de iniciação científica, para que a ciência possa continuar progredindo com novos talentos.']",160,160,120,160,160,760
90,12080,"['A emissora Globo  em sua telenovela “A força do querer”  relatou a história do “Ivan”, um menino transgênero e toda sua trajetória de reconhecimento tanto físico e mental até as conturbadas situações do processo familiar e social. Essa representatividade é essencial, quando no Brasil essas comunidades passam por um genocídio, expondo determinado questionamento: quais motivos levam a carnavalização dessas minorias, ou seja, a sua ridicularizarão e humilhação?', 'Tal estereotipo é alvo de conflitos e empecilhos principalmente sobre a sua reintegração na sociedade nos aspectos como uma educação de qualidade, e consequentemente a entrada em universidades, seguinte do alcanço de vagas no mercado de trabalho, no qual pelo preconceito já são de porcentagens inacessíveis, situação que possibilita a integração dessa comunidade na prostituição . Ao exposto, negar que a violência pela identidade desses indivíduos não existe é desumano, principalmente na América Latina  continente com 78% dos homicídios relatados somado ao baixo índice de desenvolvimento humano no país.', 'Partindo desse pressuposto, a realidade atual é fruto do estigma da conturbada colonização em conjunto com a falta de política educacional ao tema abordado, a presença de negligência na justiça e a ausência de representatividade no poder, por exemplo, um membro transexual poderia  na equipe governamental partilhar o mesmo sofrimento dessa parte da população, buscando enxergar e intervir nos problemas cotidianos sofridos. Já o desleixo com as leis e a suas aplicações é a demonstração para os grupos que cometem esses crimes de ódio sobre a desatenção em sua impunidade perante aos seus atos.', 'Diante do exposto, a serventia das punições a LGBTfobia cabe ao poder judiciário e executivo brasileiro , por meio da contratação e decreto vigoroso sobre os funcionários especialistas na área de direitos humanos, no qual devem fiscalizar e buscar compreensão das ocorrências da região local diretamente, com a finalidade de atender e assumir devidas providências aos crimes. Segundamente, a associação novamente da comunidade pelo governo no Ministério da mulher, da família e dos direitos humanos é de extrema importância a respeito da visibilidade e cumprimento dos direitos aos transexuais.']",160,120,160,160,160,760
63,Minimizando os danos ambientais,"['O recente desastre ocorrido em Brumadinho nos  permite perceber que grandes corporações como a VALE , assim como o governo brasileiro, não têm dentro de suas prioridades o cuidado e o respeito pelo meio ambiente. Nesse sentido, convêm analisar as principais causas, consequências e possíveis soluções para minimizar os impactos ambientais resultantes da ação dessas grandes empresas.', 'Inicialmente, podemos  destacar a ausência de fiscalização como um dos principais motivadores para o descuido das empresas quanto ao trato com o meio ambiente; uma vez que as próprias corporações muitas vezes são responsáveis por fiscalizar se estão cumprindo com as legislações vigentes no país . De acordo com o portal de notícias G1 o modelo de autofiscalização ocorre em outros países, porém ele é supervisionado por órgãos de fiscalização do governo, o que o torna eficiente. É, portanto, inaceitável que, o Brasil sendo um dos países com maior diversidade ambiental do planeta, o Governo não dê suporte para que seus órgãos de proteção ambiental supervisionem empresas que exerçam atividades cujas ações possam ser nocivas à fauna e a flora, de forma mais incisiva.', 'Além disso, a falta de leis mais severas e punitivas representa um fator letal para a biodiversidade brasileira. Mesmo depois do desastre de Mariana, ocorrido em 2015, onde pesquisas apontaram que a restauração da área é impossível e a biodiversidade local foi perdida de maneira irreversível; o governo vetou projetos de leis mais duras e também o aumento do teto das multas por descumprimento de leis. Assim, faz-se nociva a percepção de que para o Governo Federal é mais importante o lucro obtido com as grandes companhias, do que o cuidado e o respeito com a diversidade biológica do país.', 'Dessa forma, os crescentes impactos causados a natureza comprovam a urgência de medidas de recuperação de áreas atingidas, além da adoção de projetos de preservação da fauna e flora e da adoção de leis ambientais mais duras. No caso de impactos ambientais causados por corporações como a VALE e a Samarco empresas de mineração responsáveis pelos desastres de Brumadinho e Mariana, podemos  citar como providencias cabíveis a serem tomadas pelo Estado e pelo IBAMA para a recuperação da biodiversidade dessas regiões, o estancamento dos rejeitos, a estabilização do material das áreas atingidas e a restauração pluvial. Espera-se com isso que sejam minimizados os danos causados à natureza pela ação das grandes corporações.']",120,160,120,160,160,720
76,,"[""O livro ''Admirável Mundo Novo'', do escritor Aldous Huxley, revela uma sociedade utópica em que todos são tratados iguais perante a lei, ou seja, os homens e as mulheres possuem equidade nessa sociedade. É inegável que na sociedade pós-moderna a equidade tratada na obra de Huxley não existe, já que mesmo tendo os mesmo cargos em uma empresa, homens recebem um maior salário que as mulheres, necessitando de medidas para que a igualdade, seja ela profissional, psicológica ou social, deixe de ser um desafio e passe a ser uma característica da sociedade moderna."", ""Em primeiro lugar, é necessário ressaltar que os países com melhores índices de desenvolvimento humano, como Holanda, Finlândia e Islândia, a equidade entre gêneros é um característica dessas nações. No ''Manifesto Antropofágico'', do escritor Oswald de Andrade, tem como característica pegar o que é vantajoso da cultura estrangeira e adaptar a nacional, isto é, quando relacionado a igualdade de gêneros, traria benefícios para o Brasil, já que nenhum cidadão teria barreiras que impediria o crescimento psicológico e social, como ocorre atualmente com as mulheres no mercado de trabalho."", ""Consequentemente, os movimentos feministas no Brasil, à exemplo o ''Marcha das Vadias'', explicitam mulheres que buscam equidade social perante o uso das vestimentas, pois na sociedade pós-moderna as mulheres são julgadas pelas vestimentas, traços e julgamentos que persistem no mercado de trabalho, fazendo com que o salário seja menor. É notório que a continua luta por uma maior representatividade política seja uma solução para resolver o problema da equidade no Brasil, visto que as mulheres eleitas poderiam criar leis que fiscalizassem se determinadas empresas cumprem a igualdade de todos perante a lei, isto é, a equidade de gênero no trabalho."", 'Torna-se evidente, portanto, que medidas do tanto do Governo, quando dos indivíduos , devem ser estipuladas para se conviver em uma sociedade harmônica. Para isso, o Governo, por meio da Câmara dos Deputados, têm o débito de aumentar o numero de mulheres nos partidos para cinquenta por cento, tendo as leis como meio para atingir esse feito. Além disso, cabe ao indivíduo, como ser social e comunicativo, o dever de fiscalizar se existe discrepância salarial nas empresas e, caso ocorra, fazer a devida denúncia ao Ministério Público do Brasil. Só assim, a sociedade utópica criada por Huxley deixará de ser uma ficção e passará a ser o termo que designaria o Brasil contemporâneo.']",160,200,200,160,160,880
89,Unidos pelo mesmo interesse.,"['Lojas de roupa fechadas e mercados abertos, voos cancelados e sistema delivery funcionando, hows cancelados e garis nas ruas. A desigualdade social nunca esteve tão perceptível como agora, o que poderia ser a oportunidade de nos unirmos lutando por um bem maior, nos separou, prejudicamos um ao outro e sem perceber, prejudicamos a nós mesmo.', 'Decorrente da pandemia do vírus C-19, a quarentena começou, lojas fecharam, escolas passaram para o sistema EAD , trabalhadores ficaram sem empregos, crianças ficaram confusas, jovens entraram em depressão, o mundo entrou em caos!', 'Contudo, de nada adianta lojas de roupa fecharem, voos e shows serem cancelados, se no mercado que se faz compras quase semanalmente não há distribuição de álcool em gel 70%, se, somente nos mercados maiores há pessoas na entrada conferindo a temperatura de quem entra, de nada adianta se o motoboy e os trabalhadores do Correio estiverem desprotegidos e sem recursos básicos para a não disseminação do vírus, de nada adianta se os naris não estiverem protegidos com máscaras, luvas e o distanciamento social, de nada adianta se somente a pequena porcentagem mais favorecida do Brasil e do mundo estiver cumprindo o isolamento social e outras normas para evitar a contaminação se a grande maioria está desprotegida e nas ruas trabalhando.', 'De fato, não são todos os trabalhadores que tem a opção de ficar em isolamento social, como por exemplo, os profissionais da saúde, o sistema de delivery que evita com que haja grande aglomeração de pessoas em mercados e lojas, garis nas ruas que deixam nossa cidade limpa e recolhem nosso lixo e muitos outros que facilitam a não aglomeração.', 'Todavia, as mesmas devem estar recebendo gratuitamente recursos que evitam de serem contaminados e de espalharem o vírus C-19, sem desconto nos seus salários, e serem reconhecidas pela população, enquanto as funções que podem ficar em casa, se isole e se cuide, sem fazer tamanha injustiça com estes outros trabalhadores saindo para festas e viagens sem fins profissionais, causando e intensificando a desigualdade social.', 'Deve haver uma união de interesses, sabendo que todos querem a mesma coisa, que a pandemia acabe e que tudo volte a ser como antigamente, mas para isso acontecer, deve também haver uma união de deveres, quem pode, fique em casa se cuidando, quem não tem essa opção, que se cuide da mesma maneira e que o governo disponibilize para estes recursos que possibilitem a não disseminação do vírus C-19.']",120,120,120,160,120,640
81,O respeito às diferenças e à diversidade,"['A religião é uma das formas de cultura mais antigas da história da humanidade. Inicialmente criadas como forma de tentar explicar o mundo ao redor, as religiões foram se modificando e se diversificando ao longo do tempo. Hoje, a variedade continua, porém ainda persiste uma intolerância e não respeito a essas diferenças. O questionamento quanto a dogmas religiosos foi sempre comum desde o surgimento da filosofia. No entanto, quando o posicionamento parte para discriminação e agressão verbal ou física, já trata-se  de intolerância religiosa.', 'Um exemplo claro disso são as capas das publicações de uma revista francesa, Charlie Hebdo, que expõe  desenhos obscenos e desrespeitosos contra a religião Islâmica. No Brasil, umas das principais religiões que sofrem discriminação são as afro-brasileiras. Surgidas na época da escravidão, até hoje os seus participantes sofrem frequentemente preconceito. Alguns dos motivos que causam esta  aversão é a ignorância quanto ao que realmente pregam e o preconceito racial, por consistirem em sua maioria de pessoas negras.', 'Os casos de intolerância religiosa não se limitam a  agressão verbal, mas também física, causando até mesmo mortes. As vítimas dessa violência, principalmente quando esta é verbal, em grande parte não denunciam à Justiça,  por não conhecerem muito bem os seus direitos e as punições aos agressores. Pode-se afirmar, portanto, antes de tudo, que deve-se  respeitar a liberdade de crença de cada indivíduo.', 'Para que essa ideia se fixe na sociedade brasileira, é necessário haver uma divulgação maior sobre o tema pela mídia, mostrando os casos de violência física e verbal,   e informando sobre as leis e os direitos relacionados. Estas  informações também devem ser passadas nas escolas, junto com uma abordagem cultural sobre as religiões para que as crianças e os jovens as conheçam e, em um futuro próximo, o nosso país seja constituído de uma sociedade com mais respeito às diferenças.']",120,160,160,160,160,760
127,"Escola, um mundo de aprendizado.","['A escola é a instituição fundamental na educação de uma criança.                Ela deve deixar bem claro ao aluno que a forma mais adequada de se comunicar é através da norma culta, já que                 vão                utilizá-la a vida inteira. É claro que                 podem                usar outras variantes linguísticas, contudo                 devem                saber com quem estão se comunicando e o nível da conversa.', 'Nunca usar uma linguagem informal em uma entrevista de emprego é absurdamente inadequado.                Não podemos usar, por exemplo, gírias o tempo todo, existem momentos informais para utilizá-las. A linguagem culta                 foi criada justamente por ser a mais importante e a mais civilizada.                É a variante linguística mais importante que precisamos saber,                 é cheia de conhecimentos e formalidades                .', 'Utilizar outras variantes seria estar colaborando para um ensino errôneo da Língua Portuguesa e, assim, desrespeitando o fato de que deve haver uma         língua-padrão         a ser seguida. Não que seja proibido falar ou escrever errado, mas é proibido querer fazer desse errado um certo, um mal exemplo. Devemos refletir também que a linguagem é um meio de                 comunicação mundial e não de si mesmo                ,         portando         a escola tem                 o objetivo de alertar ao aluno, o mundo em que ele vive e as descobertas que vai encontrar por toda sua vida.']",120,80,80,80,80,440
83,Com esporte garantindo o equilíbrio da vida,"['É fato que, desde os primórdios da sociedade, até mesmo enquanto éramos simples caçadores e coletores, depois pequenas tribos de agricultores e cuidadores de animais, depois grandes sociedades mercantilistas, até hoje, no mundo globalizado, enfrentamos um problema bastante significativo, (:) nós mesmos. Em um planeta com inúmeras culturas diferentes, é provável que aconteçam batalhas, físicas ou não, entre os povos do globo. E foi pensando nisso que o renomado pedagogo Pierre de Coubertin, sustentando-se nos jogos olímpicos da Grécia antiga, idealizou as olimpíadas, com o intuito de, por meio do esporte, provocar a paz entre os povos.', 'Deveras, o esporte em geral é um grande mecanismo precursor, não só da harmonia em si, como também da liberdade, da inclusão, da justiça, e do amor ao próximo, dentre outros. Um grande exemplo é a situação dos atletas paraolímpicos, e de todas as pessoas que possuem qualquer tipo de deficiência física. Nestes casos, o esporte permite com que todas essas pessoas possam realizar seus sonhos e combater suas dificuldades, dando esperança e combatendo o preconceito em torno desse grupo de pessoas. Um grande caso é o do campeão paraolímpico de canoagem, que após um desastroso acidente de carro, perdeu o movimento das pernas, mas viu no esporte um caminho para a superação de suas dificuldades.', 'Outra realização do incentivo e da prática de esportes são os benefícios à saúde que os mesmos nos proporcionam. Perante o ilustre médico Turíbio Leite Barros Neto, pesquisador, escritor e entusiasta do assunto, “a falta da atividade física faz com que o coração regrida funcionalmente e a condição respiratória fique comprometida”, e esta citação apresenta apenas um ponto sobre a importância da prática esportiva para os seres humanos. Também de acordo com esse especialista, por causa da falta de tempo, da alimentação ruim e da agitação da maioria da população brasileira, especialmente nos grandes centros, pelo menos 70% da mesma é considerada sedentária. Assim, aumenta-se o risco de doenças como hipertensão, diabetes e a temida obesidade, doenças facilmente combatidas pela atividade física.', 'Portanto, segundo Fernando Fernandes*, o esporte nos dá a sensação de prazer, de igualdade; é democrático, rico misturado com pobre, branco com negro, nos dá o poder de superar nossos limites. Assim, buscando um maior incentivo à essa prática, é de suma importância que todas as instituições da sociedade se unam, garantindo esse direito a todos os brasileiros. Para isso, é fundamental a ajuda da família e das escolas, com a tarefa de incentivarem o esporte, sem preconceito, a todos os jovens, por meio da instituição de ações como campeonatos em que o mais importante não é vencer, mas participar. Outra ação indispensável é a criação de novas leis pelo poder legislativo, assegurando segurança, inclusão e acesso a todas as pessoas a essa prática que dá à sociedade o movimento que Albert Einstein consagrou, como o agente do equilíbrio da vida.']",160,160,160,200,200,880
50,Coronavírus no Brasil,"['O que antes era nacional, agora virou preocupação no cenário mundial. O novo coronavírus, conhecido como covid-19, de certa maneira, virou o assunto mais comentado no nosso território nacional e mundial. Semelhante a algum tipo de gripe, por conter sintomas semelhantes como coriza, espirro, falta de ar ou tosse. O Ministério da Saúde vem orientando os brasileiros a se prevenirem com atos de : usar máscara, lavar as mãos frequentemente ou passar álcool em gel e evitar lugares de aglomerações.', 'Entretanto, os números de pessoas contaminadas pelo vírus, se agrava em 24 horas, ou seja, em um dia até mil pessoas podem ter sido afetado. Os centros de saúde vem trabalhando cada dia trabalhando a cada dia tentando encontrar uma vacina para a doença, mas como se trata de um vírus RNA e não DNA  o processo de desenvolvimento e o prazo, viram questões mais delicadas de se resolver, pois é certo de que não é fácil produzir.', 'Como a pandemia afetou a população inteira, as pessoas tem têm  ficado em casa para evitar a propagação do vírus, pois é uma das situações mais eficazes para combatê-la, porém o isolamento social foi a medida mais benéfica para todos.  Em Minas Gerais,  foram atualizados 1.139 casos da doença, sendo muitos na região do Vale do Jequitinhonha, para essa região urge-se de equipamentos e de recursos, pois são lugares não muito precavidos.', 'Para resolver esse problema, é preciso todos os brasileiros  combaterem esse enorme problema, seguindo todas as orientações médicas e necessárias, pois quanto mais aumentar, mais irá demorar acabar e as punições irão aumentar ainda mais . Portanto as ordens são claras, objetivas e necessárias, não irá somente beneficiar os brasileiros, mas também o lugar onde vivem. Com isso a normalidade voltará sendo mais breve.']",160,120,120,120,120,640
43,Gamer Over!,"['No livro “ 1984”, de George Crowell, a sociedade da época é retratada submetida a um forte poder político, no qual espionam todos e os forçam a acreditarem em suas doutrinas, pois, caso contrário, quem não se submeter era “ vaporizado”, apagado da existência. Análogo à realidade, na sociedade atual a cultura do cancelamento vem refletindo muito esse contexto de banir as pessoas, só que porém das redes sociais, com base em algum comentário ou atitude considerada errada. Com base nisso, é válido analisar os efeitos dessa ação virtual, os quais privam a liberdade de expressão das pessoa, além de provocar-lhe a exclusão virtual e social.', 'Em primazia, a privatização da liberdade de expressão se mostra um grande causador do problema em relação à cultura do cancelamento. Sendo assim, faz-se necessário analisar a frase do livro “ 1984”, a qual diz: “ Liberdade é escravidão”. De acordo com a frase, analisa-se que a partir do momento que retira-se o direito de um cidadão de se expressar ele fica aprisionado na coletividade, sem assim, poder usufruir de seus devidos direitos constituídos nos Direitos Humanos . Ademais, a rede social é um ambiente livre e de fácil acesso no qual qualquer indivíduo pode compartilhar de seus momentos e de suas opiniões, sendo um campo onde a diversidade se mostra constantemente presente, assim, necessário a atuação dessa autonomia de pensamento. Com isso, a cultura da suspensão fere esse princípio atingindo qualquer um e comprometendo sua imagem social. Portanto, entende-se o quanto esse feito infere nos princípios humanos.', 'Em continuidade, o cancelamento virtual pode levar à exclusão social e virtual de um utilizador. De acordo com a parábola do filósofo Nietzsche, em que um cordeiro diz a outros  “essas aves de rapina são más; e quem for o menos possível ave de rapina, ou antes, o seu oposto, cordeiro – este não deveria ser bom?”. Com base nisso, a lógica do autor é justamente apontar que os cordeiros para se mostrarem bons e corretos devem analisar os erros dos outros e condenar. Logo, refletindo isso com a questão da anulação virtual, entende-se que o que motiva a maioria dos usuários é a condenação e o apontamento dos erros e furos na rede, principalmente de artistas e celebridades. Como consequência, esse ato gera tanto a retirada virtual do navegante, visto que esse tem que apagar seus perfis e se afastar do mundo cibernético,quanto como o afastamento social, em razão da má fama que lhe é acometido na sociedade. A partir disso, entende-se o quanto esse costume interfere nas relações sociais e digitais dos sujeitos.', 'Assim, faz-se necessário uma solução para o problema vigente.Em suma, cabe o Ministério das Comunicações promover uma campanha, por meio das mídias sociais e digitais, sobre as consequências negativas da cultura do cancelamento no âmbito tecnológico, com palestras, cursos, e com a presença de convidados e célebres vítimas dessa ação social, nas quais contem suas histórias e seus pontos de vista sobre o assunto, com a finalidade de conscientizar a população em razão do referido. Por meio disso, se concretizará um mundo mais consciente e humanizado, diferentemente do mundo controlador e condenatório do livro “1984”.']",160,200,160,200,200,920
6,Problemas ambientais críticos,"['Muito se tem discutido e comentado sobre os problemas críticos que a Amazônia está sofrendo ultimamente. Queimadas, devastação, riscos devastação e riscos ambientais é o que está agravando cada vez mais a preservação da floresta amazônica. Este acontecimento não impressionou somente os brasileiros, mas também outros países do mundo.', 'Convém lembrar de que que a Amazônia é algo grandioso para o nosso Brasil, porém deve ser protegida por todos, em função da importância para o equilíbrio ecológico do planeta. Em relação a esses fatos mencionados, a Amazônia deve ganhar status internacional, pois é de extrema necessidade para todas as pessoas.', 'Em uma segunda análise, observa-se que muitos seres humanos não contribuem para o meio ambiente, ou seja, não dão importância para ocorridos questionáveis como esse. Podemos destacar essa notícia em jornais, programas de televisão e redes sociais.', 'Faz-se necessário que providências sejam tomadas para que essas complicações sejam suspensas. Governos, população e demais autoridades precisam agir e solucionar esse problema. Se isso não for resolvido, também estaremos comprometendo nossa vida e possíveis problemas de saúde virão. É fundamental que as escolas ensinam ensinem os alunos, através de palestras para que ficam fiquem conscientes e preservam preservem nosso planeta.']",120,80,80,80,80,440
83,O exercício do esporte possibilitará a paz,"['Na Pré-história, os seres humanos eram nômades, mas com a descoberta e a dominação da agricultura, eles se tronaram sedentários, algo que está presente na sociedade contemporânea. Esses, mesmo sem saber o que era uma atividade esportiva, exerceram uma, pois quando eles eram nômades, ou seja, não tinham lugar fixo, realizavam a caminhada, porque se deslocavam de um lugar ao outro.  No entanto, a raça humana evoluiu, pois no século VIII a.c, na Grécia, desenvolveram os jogos olímpicos,o qual passou por algumas alterações no século XIX, e está presente atualmente, com o acréscimo de várias modalidades esportivas. Segundo Pierre Frédy, “o exercício do esporte possibilitava a paz entre as pessoas, principalmente entre as crianças e os jovens”.', 'Diante disso, muitas olimpíadas foram realizadas em diversos países, o que possibilitou aos indivíduos de forma explícita ou implícita a aprender a amar, conviver, dialogar e respeitar as diferentes etnias mundiais, porque a olimpíada é realizada no período de quatro em quatro anos em diferentes nações. Além disso, quando iniciamos a execução de um esporte coletivo, exemplos: o futebol, o voleibol, o handebol, etc. Aprendemos o significado de equipe e a cooperar com o próximo. Porém, quando uma criança que pratica alguns desses jogos é influenciada e estimulada pelos pais a competir, ou quando eles cobram muito dela, caso o seu time perca, certamente ela ficará triste, depressiva e poderá se tornar um adulto frustrado. A educação dos pais é essencial, eles devem ensinar a criança a participar e não competir, pois ela irá conhecer outras pessoas de diferente cor, religião e classe social, ela criará vínculo de amizade com elas, como também, se ela foi tímida deixará a timidez para interagir como os jogadores.', 'Ainda mais, em Israel os atletas podem faltar aula com o consentimento dos pais, caso temam um jogo importante, entretanto, isso não deveria acontecer, pois a educação deve ser primordial. Ademais, de acordo com pesquisas, muitos atletas são incentivados pelos treinados e pelos pais a dar o máximo de si, mesmo se isso for machucar alguém do time adversário. Por isso, que eles se tronam violentos, agressivos e têm maiores chances de se envolverem em alguma briga. Essa influência daqueles distorce o caráter e a índole deles. Outrossim, vários atletas roubam para beneficiar o seu time em um jogo, com isso, provavelmente eles serão adultos corruptos, se isso continuar acontecendo.', 'Logo, o governo federal, estadual e municipal, juntamente com as instituições privadas, podem criar centros de prática esportiva, visando à inclusão social, e também, organizar campeonatos nas escolas públicas e privadas. Os pais devem criar o hábito de realizar algum esporte com os seus filhos e elaborar campeonatos com outros pais, isso possibilitará a integração e interação das crianças no circo  social. Ademais, a mídia pode exibir campanhas mostrando os benefícios do esporte e os problemas ocasionados à saúde pelo sedentarismo, como também, as histórias de vários cidadãos que venceram as drogas e a criminalidade, quando iniciaram alguma atividade esportiva, porém, o esporte não deve ser mais importante do que a educação, no entanto, esses podem os dois são benéficos e importantes para a sociedade contemporânea.']",120,160,160,120,200,760
74,Sem título,"['Desde o iluminismo, sabe-se que o bem estar social é alcançado quando um se mobiliza com o problema do outro. Quando se trata de feminicídio e violência contra a mulher, no Brasil, hodiernamente, o ideal iluminista não é praticado. Entende-se que a mulher sofre tais violência por causa de problemas governamentais e educacionais na sociedade.', 'A priori, é indubitável que a questão da constituição e a sua aplicação estejam entre as causas do problema . Para o filósofo grego Platão, a política deve ser aplicada de maneira que, através da justiça, seja alcançado o equilíbrio social. Assim sendo, é notório que o governo está sendo falho, haja vista que mulheres são brutalmente violentadas diariamente no país.', 'Outrossim, destaca-se a má educação como impulsionador do problema . Tal fato se reflete em uma sociedade patriarcal e machista. Para o filósofo Kant, o homem é aquilo que a educação faz dele . Diante disso, é perceptível uma falha educacional na sociedade, uma vez que o cenário social demonstra violência hedionda para com as mulheres. Prova disso, é o fato de que entre 1980 e 2013, segundo a Organização Mundial da Saúde, 106.093 pessoas foram mortas por sua condição de ser mulher.', 'Portanto, fica evidente que há necessidade de ações sinérgicas entre o governo e a escola. A princípio, o Ministério da Defesa deve instalar mais delegacias da mulher, essas devem investigar veemente os casos de abuso e punir severamente os criminosos, a fim de que a segurança da mulher melhore. Para o pedagogo Paulo Freire, a educação transforma as pessoas, e essas mudam o mundo. Logo, o Ministério da Educação deve fornecer palestras nas escolas ministradas por profissionais da segurança que discutam o combate ao feminicídio, para que a sociedade se renove e saia da realidade das sombras, assim como na alegoria da caverna de Platão.']",160,120,160,160,160,760
112,Arcar com as consequências é necessário,"['O índice de criminalidade no Brasil é muito alto, devido a vários aspectos econômicos e sociais. A         constituição         brasileira já foi modificada diversas vezes desde a proclamação da         república         , porém                 essa ainda possui falhas que pune inadequadamente                atos de menores infratores, o que, de certa forma, incentiva-os a praticar o crime', 'É perceptível          que o menor de idade não possui amadurecimento suficiente para responder seus atos, mas ele precisa sofrer as consequências cabíveis às suas atitudes criminais para adquirir responsabilidade e cidadania.                Quase todos os dias os jornais mostram crimes bárbaros cometidos por         adolescente         , isso acontece principalmente porque o menor não é punido devidamente, então         ele aproveita-se         da sua idade para roubar e matar. Além disso, existem as chantagens que os maiores impõem ao jovem imaturo, induzindo-o a praticar o crime para continuar fazendo parte um determinado grupo.', 'Analisando o outro lado de toda essa situação, observa-se que         as condições carcerárias do nosso país são precárias,                 uma vez que na maioria das vezes                os delinquentes são tratados de forma muito desumana,                 fato esse que complicaria ainda mais a vida de um menor.', 'Diante disso, para que a maioridade penal seja reduzida de forma eficiente, faz-se necessário que o governo melhore as condições da                 cadeia nacional, direcionando                mais verbas e, principalmente,                 criando um programa para a reeducação do menor infrator, transformando-o em um trabalhador e em um cidadão que honre a sua pátria.']",120,120,80,120,80,520
48,Sus,"['A série ""Sob pressão"" foi exibida pela Rede Globo retratando diversos casos em um hospital público da periferia. Em um dos seus episódios a falta de recursos causado pela corrupção mostra o Doutor Evandro improvisando materiais para fazer procedimento cirúrgico .Fora da ficção,muitas das vezes a realidade é parecida com as imagens mostradas nas telas.', 'Em primeiro lugar é valido ressaltar a importância do SUS para a população brasileira onde  200 milhões de pessoas são beneficiados com remédios,cirurgias e vacinas. Entretanto,os desvios de verbas e a má distribuição torna-se uma problemática para quem depende do SUS (Sistema Único de Saúde) os mais afetados são os hospitais de bairros pobres e periferias causando super-lotação, falta de medicamentos e leitos para a população que mais precisa dos benefícios .De acordo com a constituição Federal de 1988  diz que a saúde é direito de todos e dever do estado. Porém a falta de fiscalização rigoroso contribuem para o efeito negativo nas distribuições de recursos nas unidades de saúde.', 'Portanto,medidas serão necessária para resolver o impasse. Os gastos da saúde não devem ser cortados visto que a população dependem desse sistema .O ministério da saúde deve administrar deforma correta a distribuição de verbas .O ministério da justiça precisa ser mais severo com aqueles que participam de corrupção punindo conforme a lei. A sociedade precisa usar a mídias para fazer denuncias de forma célere para que essa situação não persista. Assim os problemas da série ficaram apenas na ficção.']",160,120,120,160,160,720
133,O bom funcionamento do Estado,"['O Estado foi criado para atender         a necessidade         do cidadão, sendo ele         o provedor dos serviços que presta a sociedade         ; mas na pratica         existe         falhas         como: desviou do         dinheiro público e                falta de mais investimento nos setores que         atende         a população.', 'A existência do Estado foi para criar um papel de bem servir a população em seus anseios, por isso há arrecadação de impostos para          servir de subsídio na          manutenção dos serviços          prestado          pelo governo. A segurança pública por exemplo, tem sido pouca ofertada, diante disso, o crescimento da violência e impunidade tende a aparecer.', 'O governo tem que combater a corrupção e criar         mecanismo         que         assegure         mais investimento nos setores públicos;                 uma alternativa favorável seria capacitar os funcionários públicos em suas atividades, conscientizando estes para a melhoria dos serviços ofertado pelo Estado ao cidadão.', 'É preciso         ter         uma harmonia entre                 governo, investimento e funcionários do Estado                para se ter um bom funcionamento                 em seus serviços                , e somente a ética e a transparência         fará         com que a sociedade seja bem atendida.']",120,120,80,0,80,400
66,O ser humano alienado a internet,"['A respeito do tema ""Manipulação do comportamento do usuário pelo controle de dados na internet"", por base em pesquisas, pode-se enfatizar que há um percentual cada vez mais elevado, deixando explícito quanto ao uso de informações.', 'Assim, também vale ressaltar que ocorre por falta de pesquisa e restrição à quem se dirige.', 'Fomentando a própria internet, é indevido restringir à um público-alvo, quando englobado diversos aspectos, sites, endereços, páginas, além de repetidas pesquisas em locais diferentes com dados exemplificados ou parecidos.', 'Contudo, a situação é especular afim de não alienar-se ou acabar se deixando perder em meio a tantos dados..', 'Logo, é importante visitar diferentes websites, verificar dados e sua estrutura, a grafia, enfim, ler para conhecer. Ainda que não se crie algo à respeito, melhorar o acesso s páginas e aos produtos do próprio computador para não ""aprisionar-se"".']",120,80,80,80,80,440
47,Sou1000Al,"['Desde a popularização da internet, a qual foi inicialmente criada para estrito uso militar, muitos passaram a ter acesso a aquilo que dificilmente se encontrava apenas em livros ou enciclopédias. Hoje, com o avanço tecnológico, se torna possível através da Educação a Distância (EaD) conectar alunos e professores por meio de plataformas de comunicação. Porém, a falta de equipamentos por parte dos alunos e a baixa atuação governamental se tornam desafios para a total abrangência do ensino remoto no Brasil.', 'A priori, muitos alunos carecem de internet ou até mesmo aparelhos eletrônicos que permitam o acesso online, como computadores . Exemplo disso são os alunos residentes em perímetro rural , ou seja, os quais não possuem acesso internet em suas residências. Logo, o ensino remoto se torna algo restrito a quem pode, e não um sistema universal.', 'Ademais, as ações inconsistentes do governo dificultam a universalização da Ead . Ao tomar com exemplo a atual pandemia do coronavírus, o governo lançou o Programa de Estudos Tutorado (PET) com o intuito de suprir a ausência de aulas através de atividades curriculares acessadas online. Apesar de serem avaliadas como carga horária escolar, muitos alunos não tm acesso ao conteúdo, como os que residem na área rural e  portanto, serão reprovados.', 'Destarte, urge que a EaD se torne universal no Brasil. Para isso, o governo federal , juntamente com o municipal, deve criar um programa que não se limitem apenas a internet. Tal programa deve suprir tanto aqueles que por um imprevisto estão longe da escola, como na atual pandemia, quanto os que buscam cursar uma faculdade. Através de veículos de transporte municipais, conteúdos impressos teóricos e práticos fornecidos pela instituição de ensino deverão ser entregues aos alunos que não tm acesso a internet. Tudo isso como forma de suprir a ausência de aulas práticas e não deixar margem quem necessita da EaD.']",160,160,160,200,160,840
55,A IMPORTÂNCIA DE VALORIZAR E GARANTIR OS DIREITOS DOS POVOS INDÍGENAS NO BRASIL,"['A importância de valorizar e garantir os direitos dos povos indígenas no Brasil tem sido um tema ainda mais discutido em nosso  país nos últimos anos, embora tenha origem desde os tempos de colonização, quando os portugueses tomaram suas terras sem quaisquer acordos para permissão, exterminando porte de sua população e altura ao longo do tempo, processo que segue atualmente pela expansão urbana e rural que atendem a soberania dos interesses daqueles chamados civilizados.', 'Assim, podemos  concluir como esta massa indiretamente se impõe ainda contra a voz indígena de forma desconsiderável a seus próprios descendentes, descartando ainda mais a origem do que aprendemos e mantivemos  por meio de seu povo . A desconsideração dum  grupo que contribuiu para o desenvolvimento duma grande população é como rasgar as páginas dum livro didático de história, em que não compreendemos  parte do que somos , sem saber o que éramos.', 'Contudo, há muitos fatores que implicam esta contínua discussão seguir sem ações. É provável que seu preconceito étnico e o crescimento de nosso próprio país são assuntos que colidem entre si, fazendo o levantamento destas questões. Entretanto, não há efeito recobrarmos o Dia do Índio apenas como símbolo, mas valeria levarmos em conta sua preservação atual nos planejamentos dos ministérios do país. Fato que não há ocorrido, acarretando toda ausência de conservação.', 'Portanto, medidas são necessárias para resolver o impasse. O Ministério da Cultura deve constituir leis para a segurança do legado indígena, além de promover a ecologia no Brasil. Sendo contribuintes do florestamento, é de grande importância ao meio ambiente que são não só nossas , mas principalmente suas terras. Sua moradia.  O Ministério da Educação igualmente deve instituir palestras em importantes memorandos brasileiros para tal conscientização. Como já dizia o filósofo Immanuel Kant,  “o ser humano é aquilo que a educação faz dele”. Ótima referência para fazermos desde cedo um Brasil melhor.']",120,120,80,120,120,560
60,A Reforma previdenciária do Brasil,"['È possível afirmar que a reforma previdenciária foi criada com a intenção de melhorar o país no seu desenvolvimento econômico e social, dando direito a todos os brasileiros o direito da aposentadoria previdenciária, mais os militares não foram contemplados com essa reforma.', 'Pode-se perceber que essa reforma vai ajudar a diminuir os gastos das contas públicas e acabar com os rombos de seus cofres, vale também lembrar que essa reforma vai regularizar a economia do país, controlando a entrada e a saída de dinheiro dos cofres públicos, inimizando seus gastos , mas vai continuar com a desigualdade social na qual o Brasil.', 'Além disso, a reforma previdenciária foi uma mudança que atingiu todos os setores, excerto os setores militares,  na qual distancia a igualdade social no país, pois a as contribuições será conforme ao salario ganho  de cada trabalhador , que além de contribuir para o seu aposento , também contribuirá para o aposento dos militares que já é injusto demais .', 'Sendo assim, mesmo que todos os brasileiros sejam beneficiados com a previdência social , o Brasil pode melhorar economicamente mais a desigualdade social vai continuar, bom seria que essa reforma também afetasse os setores militares, pois se todo brasileiro tem um prazo de contribuição e uma idade certa para aposentar, assim deveria ser para os militares, fazendo isso acabaria com a desigualdade social.']",120,120,80,120,80,520
58,A floresta amazônica pede socorro,"['Adotada pela ONU  desde 1948, a Declaração Universal dos Direito Humanos visa a garantir o respeito à dignidade humana. No Brasil, entretanto, muitas vezes, tais garantias, não são verificadas em relação ao desmatamento e queimadas na floresta amazônica, uma realidade que a cada dia assusta os brasileiros. Nesse cenário, convém analisar as principais causas e consequências dessa problemática no país.', 'O desmatamento é uma prática que acontece no Brasil desde o seu ""descobrimento"" pelos portugueses. Esse comportamento iniciou-se com a exploração do pau-brasil, uma planta nativa usada pelos índios para a fabricação de corantes. Hoje, com a falta de fiscalização por parte do Governo Federal, aquelas atrocidades crescem desenfreadas por empresas clandestinas . Além de desmatar, o homem também coloca fogo no bioma mais biodiverso do mundo, levando várias espécies de seres vivos a extinção e a saúde humana em risco.', 'Segundo dados do jornal O Globo, nos últimos dez anos foram descobertos por pesquisadores biólogos vários desmatamentos irregulares e focos de incêndio na floresta para a obtenção de lucro fácil no mercado, onde consequentemente, leva ao aquecimento global desordenado, desequilíbrio da cadeia alimentar e perda da biodiversidade. Desse modo, é inadmissível que em pleno século XXI, o Brasil ainda tenha impactos tão negativos devido ao problema da floresta amazônica.', 'Sendo assim, o desmatamento e as queimadas representam uma ameaça concreta a todos os cidadãos que figuram como vítimas do seu legado. Nesse sentido, o Governo do Estado deve fazer fiscalizações mais rigorosas e punir com longas prisões e multas as empresas que cometem tais ações. Além disso, a sociedade deve ir às ruas em favor da preservação do bioma, pois pressões populares sempre funcionam. Espera-se com isso, que a população viva com mais tranquilidade, dignidade e saúde.']",120,160,80,120,80,560
56,A problemática da população carcerária no brasil e a ordem social,"['A problemática da população carcerária no rasil se dá pela superlotação do sistema carcerário e sobretudo pela falta de presídios, em razão disso,  tem-se as conhecidas rebeliões responsáveis por centenas de mortes dentro do sistema carcerário, criando assim,  uma situação quase que irreversível aos olhos da sociedade e um problema desafiador para o Estado enfrentar.', 'Vale ressaltar antes de tudo, que a população carcerária é formada por indivíduos que infligiram a lei num determinado momento de suas vidas, o que consequentemente os levou a estar aonde estão, isto é, na cadeia. Entretanto, sabe-se que assim como qualquer outro ser humano, a população carcerária é possuinte de direitos fundamentais que não podem ser violados por uma perspectiva ou julgamento moral de seus atos. A falta de atenção devida do Estado para com essa pequena parte da sociedade,  tem sido responsável pelas barbáries que hoje se vê noticiadas nos meios de comunicação.', ""Um sistema carcerário que funciona de forma devida,  contribui para a ordem social e o bem comum, tendo em vista que enquanto esses sujeitos marginalizados são devidamente tratados dentro de um sistema carcerário que funciona de forma eficiente, menos risco de fuga .rebeliões, e até mesmo de coligação com o tráfico e formação de ''tribunais do crime'' dentro das prisões , será representado para o Estado , o que vislumbrado na sociedade atual,  resultaria numa ínfima ou quase inexistente preocupação dos cidadãos de bem em verem, por exemplo, correndo nas ruas um sujeito que outrora preso,  escapou da prisão."", 'Portanto, pode-se concluir  que não é eficaz apenas prender alguém enquanto o sistema carcerário sofre de diversas deficiências internas, o que não significa dizer que não se deve prender, mas sim que se deve rever a funcionalidade do sistema carcerário num país onde uma cela que tem a capacidade de abrigar 20, tem abrigado 40/50, num país onde rebeliões ceifam a vida de centenas de pessoas não somente dentre os detentos, mas de carcereiros e policias que atuam dentro dos presídios. A ordem social está sujeita á violações quando a funcionalidade de um sistema responsável pelo afastamento de marginais da sociedade, está pairando completamente alheio do que deveria ser.']",120,160,120,160,80,640
89,,"['Desde março,  tivemos a catastrófica ascensão do Corona vírus. Tendo seu nascimento em Wuhan, na China, a doença abalou o frágil cenário mundial.  Tendo logo no seu início números assustadores de mortos, equiparo a números de guerra.', 'Após a sua rápida propagação se deu uma busca por uma solução à longo prazo, uma vacina, porém as mesmas necessitavam de tempo até a sua conclusão que trouxesse o mínimo de efeitos colaterais para a população, sabendo disso, logo começou recomendações vinda da Organização Mundial da Saúde (OMS), utilizadas em todas pandemias posteriores e que, se acatadas, nos ajudaria a diminuir a curva de contaminados e mortos. coisas como: utilizar máscaras, lavar as mãos e o isolamento social, tendo assim serviços não essenciais suspensos, contudo, temos o governo federal mais despreparado para o enfrentamento da pandemia, além de já estarmos vindo de um cenário delicado economicamente e tendo um presidente publicamente contra a ciência, não tinha como termos resultados promissores, estávamos fadados ao colapso do sistema de saúde . Mas para evitar um julgamento em corte internacional, foi instituído o auxilio emergencial para os trabalhadores de serviços não essenciais, que são a maioria esmagadora, pudesse permanecer em casa, porém, após poucos meses sendo distribuído tivemos o seu veto, pois houve retorno das atividades, como consequência tivemos uma nova onda de contágio.', 'Agora, já no pico de uma segunda onda, é preciso retrocedermos alguns passos e voltarmos a nos resguardar, assim, para colocarmos todos em casa novamente é fundamental que tenhamos uma pressão maior encima dos contratantes para dispensar os contratados sem os demiti-los, como também um auxilio para aqueles que não podem se manter sozinhos e ainda sim pagar o salário dos que trabalham consigo. É indispensável uma campanha massiva e incisiva a favor do isolamento social e, como em todos os casos, um suporte para aqueles que não podem se manter assim, teríamos que ter, claro, um incentivo a empresas pequenas e nacionais, pois quanto mais o dinheiro girar dentro do país menor o déficit econômico, assim como cobrar um valor maior nos impostos de grandes empresários não levaria o Brasil a uma recessão enorme. É impossível evitar uma crise econômica, todos países passarão por esse período após a pandemia, a diferença será com que rapidez sairão dela e também se terá população o suficiente para essa saída']",160,120,80,120,80,560
76,A mulher e a luta pelos seus direitos,"['Pode-se dizer que no Brasil, ainda encontramos desigualdades entre homens e mulheres com relação ao salário e ao emprego, mesmo possuindo a mesma qualificação. Hoje, com a implantação de novas leis que defendem as mulheres, vemos que elas já conseguiram obter grandes avanços na sociedade e que estão lutando contra o preconceito.', 'Segundo pesquisas do Fórum Econômico Mundial, o Brasil caiu onze posições, ficando em 90º lugar na lista do ranking de igualdade de gênero. Isso significa que nos últimos dez anos, a desigualdade só aumentou e observa-se que as mulheres ainda vêm sofrendo com esse problema. Outro fator que tem sido muito frequente na sociedade brasileira são as taxas de feminicídio, principalmente  mulheres negras que  nos últimos anos, tiveram um aumento de 51%. Além disso, as mulheres buscam ser mais independentes e mostrar que podem adquirir os mesmos direitos que os homens, não sendo vistas como pessoas inferiores', 'Portanto, apesar do preconceito, da violência e da desigualdade presentes no país, ainda é possível encontrar uma esperança de que isso possa mudar um dia. Durante todo o século XX, as mulheres já garantiram muitos direitos como o voto direto, exercer profissões importantes e ser também chefes de família para manter a educação e sustento de seus filhos. Enfim, as mulheres já conseguiram dar muitos passos, mas há muito o que conquistar para conseguir mudar essa forma de pensamento arcaico.']",120,120,120,120,80,560
89,Falta de gentileza gera pobreza,"['A pandemia desencadeou problemas econômicos gravíssimos , tais como, perdas inumeráveis de empregos e e baixo lucro nas vendas. No Brasil, milhares de empresas necessitaram de empréstimos para se manter e segurar funcionários.', 'A falta de empregos gerou estresse, fome, e muitas dívidas. Vendo isso abalar fortemente a população, o governo disponibilizou o auxilio emergencial que visava manter a base financeira das famílias mais abaladas. Muitas pessoas com boas condições financeiras também fizeram questão deste auxilio, dificultando a aprovação de quem realmente necessitava.', 'Foram expostos muitas questões socias durante a pandemia, uma das mais visíveis é o individualismo e o egoísmo, onde as pessoas só pensam nas outras quando são atingidas. preciso que a sociedade tenha mais empatia com o próximo e que se coloque no lugar delas mostrando bondade e não por conveniência.']",160,120,80,120,0,480
10,O mal do século e o combate através da fé,"['De acordo com pesquisas, o Brasil é o país da América do Sul com o maior percentual de doenças psicológicas como a depressão e a ansiedade, presente maioritariamente em adultos e idosos do sexo feminino. Dessa forma, a saúde física e mental é um dos tópicos mais tratados quando é discutido o que um indivíduo necessita para vencer na vida.', 'Não obstante, para obter a saúde - pensando além da biologia do corpo - é necessária uma conexão de sentimentos e forças adquiridas através das relações humanas, como o amor, carinho e compaixão. De acordo com Bauman, a vida tende como um pêndulo: quando temos uma coisa, logo passamos a querer outra, mergulhando em uma modernidade líquida aonde as relações não são bem exploradas, aonde pessoas são descartáveis e levando, então, as às doenças do mal do século como depressão e ansiedade.', 'Em decorrência disso, aumenta o índice número de pessoas que não acham motivos para crescer na vida, tornando-se infelizes, desanimados, dando espaço para esse mal do século, aumenta século. E para combater o impasse, surge a fé: o núcleo da vida humana, o subjetivismo que leva o ser humano a acreditar em algo maior para que se possa fazer o bem, procurando a empatia.', 'De certa maneira, a fé, divergente dos rótulos religiosos, é o que mantém um ser em consciência mútua da realidade, consentindo-a com a irrealidade -presente na metafísica de Aristóteles, na qual o ser procura conhecimento na essência das coisas além da ciência.', 'Portanto, é através da fé que a sociedade encontra o esforço para lutar pelos direitos ao trabalho, a à educação, conquistando outros objetivos superficiais, mas de grande valor social, como explicado pela modernidade líquida de Bauman. Desse jeito, através da conscientização da população a buscar a fé, aderindo compaixão e empatia em suas rotinas, o século XX pode superar os problemas sociais, psicológicos, emocionais e de saúde, conquistando o melhor da vida e vencendo em seus objetivos.']",120,120,120,160,120,640
42,Aluno e escola de mãos dadas,"['O esforço individual pode determinar o sucesso, mas uma escola preparada potencializa as chances. O conjunto dos dois fatores permite o bom desenvolvimento do aluno. E, assim, a trilha de sucesso alcançado pelos estudos será possível. Apesar de haver casos de estudantes que venceram por seus próprios esforços, eles ainda são exceções. Na verdade, exemplos como esses deveriam ser regra, mas nem todos possuem a mesma determinação. Uma escola que desestimula, torna tudo ainda mais difícil. Antes das cotas, por exemplo, dificilmente um aluno de escola pública passava em cursos concorridos, como medicina. Isso não significa que ele não se esforçou, porém as condições de sua escola não permitia superar os concorrentes de escolas privadas mais preparadas .No Brasil, vários jovens precisam viajar horas, não possuem alimentação adequada e falta material didático na escola . Outros fatores como professores insuficientes e desestimulados, infraestrutura precária e má gestão contribuem para o fracasso desses estudantes. Logo, a própria força de vontade, muitas vezes não é suficiente. Portanto, se deve promover uma educação de qualidade aos estudantes. Para isso, são necessárias escolas eficientes, com professores motivados e um bom incentivo ao aluno. E então, juntamente com seus esforços, o estudante terá um futuro brilhante.']",120,200,200,160,80,760
73,Aonde chegamos?,"['Os problemas que são enfrentados por eles hoje em dia são muitos, você pode olhar começando por quem trabalha nos cargos altos.', 'Quantos são negros? Você vai ver que são poucos e além do mais há uma desigualdade de salários entre brancos e negros num mesmo trabalho. E para piorar a vida deles há o preconceito racial, eles são rotulados sem fazer nada, porque um faz acha que todos os outros também fazem. E racismo leva a violência e violência gera violência, logo já se cria praticamente uma guerra entre racistas e negros. Por que fazemos isso? Para qual fim chegarmos? Se ambos os lados acabam perdendo, olhe para o passado já tivemos 2 Guerras Mundiais, já não basta tanto conflito?', 'Olhe para os Estados Unidos a segregação racial que tinha, chegando ao ponto de fazer terrorismo com os negros (Ku Klux Klan), separar sociedades entre brancos e negros:banheiros,ônibus,igrejas entre outros locais. Se já foi confirmado por estudos antropológicos que é apenas uma variação de cor de pele. Nós todos somos seres-humanos. E o que fazer para mudarmos essa realidade na vida deles? O que nós podemos fazer no mínimo e não ter esse preconceito, esse racismo não surge do nada, ele se aprende. Então vamos parar esse ciclo vicioso de preconceito e fazer o dia de amanhã cada vez melhor do que ontem para toda sociedade. Tirando esse racismo da cabeça e tratar todos com igualdade.']",80,40,40,40,0,200
48,Descaso da suade publica,"['A saude publica no Brasil e bastante precaria, os hospitais e postos de sade muitas vezes no conseguem receber grandes numeros de pessoas. Nesse sentido, percebe-se ao  pouco investimento por parte do governo e a falta de profissionais na determinada area de sade.', 'Em primeiro lugar, a pópulaçao de baixa e media renda dispese dos SUS , que  um programa para as pessoas receberem auxlios na sade publica . Contudo, a espera pela liberaço a consultas ou cirurgias e a falta de investimento hospitalar um dos grandes problemas enfrentados pela populaçao brasileira . Sob essa tica, e necessario agilizar o processo de liberaçao do SUS e melhoria nos hospitais publicos.', ""Outrossim, a importancia de profissionais nas reas de atuao imprescndivel. Sengundo, Aristoteles '' a felicidade e a sade so incompatveis om a ociosidade''. Seguindo esse exposto, nota-se a falta de profissionalismo e o descaso sobre a sade publica no Brasil especialmente em regioes pobres do pas. Com isso, a necessidade de profissionais e o aumento de unidades de sade evidente."", 'Em resumo, percebe-se que a importancia da sade publica no Brasil uma questao a ser mais desenvolvida e melhorada. Ademais, e necessario que o Ministerio da Saude  invista e aumentem mais unidades de sade principalmente em lugares precrios. Paralelamente, melhore tambem a condiçao do SUS pois de suma importancia para a populaço']",80,160,80,160,120,600
60,Trajetória até o topo,"['O tema mais comentado dos últimos anos, a Reforma da Previdência entra no ranking de 1° lugar nos temas mais abordados em conversas diárias e jornalísticas. Em diversas opiniões, tem-se os prós e contras. A maior reclamação é a idade para conseguir o benefício.', 'Sabe-se que a grande parte da população que reside no país é considerada idosa. Pessoas com mais de 60 anos sendo que destes, a maioria são dependentes de benefícios previdenciários. Porém ainda há aqueles que conseguem aposentadoria sem ao menos estarem em idade de beneficiário e também aqueles que possuem aposentadoria mas continuam no mercado de trabalho, tendo assim dois meios de renda concedido a apenas uma pessoa. Estes fatores deveriam ser estritamente analisados, há sim aqueles que realmente necessitam de uma aposentaria prematura, como as concedidas por motivos de invalidez, e há também quem necessite trabalhar pelo motivo de instabilidade financeira, como as famílias numerosas dependentes de um único provedor, por exemplo. A análise de cada fato deveria ser minuciosa, se tem conhecimento de inúmeros casos de pessoas que recebem aposentadorias ou pensões de pessoas que já faleceram, burlando leis e contribuindo para a negativa do sistema previdenciário.', 'Além dos fatores já apresentados, se tem o conhecimento que até 2030 a maior parte da população brasileira será idosa, em idades que ultrapassam os 60 anos. Isso significa uma saída maior de dinheiro do que a entrada nas contas públicas. Menos jovens no mercado de trabalho e mais aposentados. Além disso, se aposentados continuarem a participar do mercado de trabalho, interferirá na economia já que novos trabalhadores não poderão ingressar e consequentemente menos dinheiro girará no setor de comércio e serviços.', 'Se não houverem fiscalizações mais rígidas em aposentadorias concedidas indevidamente, poderão ser realizadas inúmeras reformas que, ainda assim, não terá fim os gastos excessivos com beneficiados da previdência. A consciência social também deveria estar em foco, pois a maioria dos “atrasos” e erros cometidos pelos governantes do país é fruto de um pensamento individualista e apático, sendo que a ideia direcionada ao coletivo seria o primeiro passo para o tão aguardado salto.']",120,120,80,120,80,520
52,Um agravante problema emergente,"['No filme ""Simplismente Acontece"", Rosie, uma adolescente de 16 anos, está com seu futuro planejado para fazer sua faculdade em Boston, contudo engravida de seu melhor amigo Alex , e se desestabiliza, ora da ficção é um problema crescente no mundo, onde prejudicam a própria adolescente e seu bebê como também aumentam as desigualdes sociais.', 'Nesse sentido, de acordo com a OMS , a adolescência é um período que vai dos 10 até os 19 anos, sendo assim, onde o corpo está sofrendo diversas mudanças. Dessa forma, ter um filho, poderá acarretar em mau desenvolvimento , problemas de saúde, além de abalar psicologicamente e fisicamente, muitas famílias excluem a adolescente ou mandam abortar.', 'Ademais, segundo a OMG , a cada dia 20 mil jovens dão a luz em paises emergentes, número dez vezes maior do que em nações desenvolvidas, esses dados revelam as preocupantes desigualdades, pois os governos não são capazes de disseminar informações suficientes e quebrar o tabu tanto aos assuntos sexuais. Outrossim, há falta de preservativos as adolescentes em geral.', 'Evidência-se, portanto, uma preocupação maior em paises emergentes. Desse modo, os governos precisam criar campanhas em parceria com a mídia, para que todos saibam o quão perigoso se torna ter um filho na adolescência. Também é preciso distribuir preservativos em postos e hospitais, afim de todos se protegerem, e assim, diminuir as desigualdades para que o caso de Rosie se torne raro.']",120,80,80,80,120,480
47,Os desafios do ensino e da aprendizagem a distância,"['De acordo com o Ministério da Educação, “Educação a distância (EAD) é a modalidade educacional na qual alunos e professores estão separados, física ou temporariamente e, por isso, faz-se necessária a utilização de meios e tecnologias de informação e comunicação”. Assim, dado esse conceito e a situação atual no país, a qual foi preciso adotar o isolamento social devido à pandemia mundial, é fundamental entender os desafios que o Brasil tem acerca do ensino-aprendizagem de forma remota.', 'Nota-se, de início, que o ensino na modalidade a distância escancarou a desigualdade socioeconômica do país. Isso se deve, em grande parte, porque a educação no Brasil já não era garantida de forma igualitária aos estudantes, sobretudo para aqueles mais vulneráveis. Assim, percebe-se que a população que detém o poder aquisitivo mais elevado possui melhores condições de acesso à educação de qualidade e, diante dessa realidade mundial, tende a sofrer menos quanto à adaptação, já que provém de meios tecnológicos: como computador, acesso à internet e lugares “adequados” em suas residências.', 'Ademais, observa-se que o Brasil não estava preparado para adotar o ensino dessa forma. Assim, ao tomar como base a informação do Fundo Monetário Internacional (FMI), a qual o país é a 9ª economia mundial, nota-se a falta de organização por parte do governo em tratar com a situação, visto que estes fenômenos, historicamente, acontecem. Outrossim, percebe-se, mesmo diante da globalização, que professores têm dificuldades em operacionalizar os meios tecnológicos e, muitos desses, não possuem equipamentos necessários para ministrarem as aulas, como também não foram capacitados e nem disponibilizados esses materiais.', 'Portanto, é preciso garantir a todos os estudantes o acesso à educação de forma remota, enquanto perdurar essa situação. Para isso, é imprescindível que os agentes envolvidos, principalmente os professores, sejam capacitados para ministrarem suas aulas com qualidade. Tal ação deve ocorrer por meio dos Ministérios da Educação e Economia , ao disponibilizar cursos, na modalidade EAD, e materiais necessários para os docentes que necessitem. Cabe, ainda, a esses Ministérios, implantarem políticas públicas voltadas para as famílias que não possuem condições mínimas de acesso às aulas, fornecendo materiais, como tablet ou computadores, e internet para esses estudantes.']",160,160,160,200,160,840
57,Acesso,"['A Declaração Universal dos Direitos Humanos-promulgada pelas Nações Unidas em 1948-garante a todo indivíduo o direito à cultura e ao bem-estar. No entanto, os desafios no acesso igualitário da população brasileira ao cinema, seja pela desigualdade de renda, seja pela falta de infraestrutura, vão em oposição a esses direitos. Assim, hão de serem analisados tais fatores.', 'Em primeira análise, cabe pontuar que a desigualdade de renda é um dos principais fatores relacionados a essa problemática. Conforme reportagem divulgada pelo Estadão, jornal brasileiro, a disparidade econômica entre ricos e pobres aumentou 20% entre 2017 e 2018. Nessa lógica, é indubitável, lamentavelmente, o valor desse revés na gênese de tal quadro, visto que muitas famílias brasileiras não possuem recursos financeiros suficientes e, por fim, não podem frequentar esses espaços de lazer.', 'Ademais, cabe ressaltar que a falta de infraestrutura é outro valioso agente causador dessa situação. No livro Utopia, Thomas Morus, escritor renascentista, descreve uma cidade ideal, em que todos os cidadãos tem acesso aos bens culturais e de entretenimento, pois o Estado garante a plena igualdade. Nesse sentido, é inexorável, infelizmente, que a falta de investimentos na infraestrutura, por exemplo, cinemas públicos, rompe com essa máxima e perpetua esse desigualdade.', 'É evidente, portanto, que medidas devem ser realizadas, com o objetivo de pôr em prática os direitos assegurados pelas Nações Unidas. Sendo assim, o Senado, por este ser o principal agente organizador da vida social, deve investir na criação de cinemas públicos, por meio de emendas de lei e de alterações na constituição, com a participação de Deputados e empresas privadas. Espera-se, com isso, a plena democratização do acesso ao cinema na sociedade brasileira.']",160,160,120,160,80,680
148,É preciso prudência!,"['Com os preparativos para os grandes eventos que estão perto de acontecer no Brasil, tornou-se inevitável a discussão sobre segurança no país. Mesmo estando fora da                 faixa de terrorismo                no mundo, o Brasil deve temer uma futura ação terrorista que eventualmente pode acontecer devido ao fato de que o mundo estará com                 todos os holofotes voltados ao Brasil e para esses eventos.', 'Além disso, o Brasil não é considerado um modelo no quesito de segurança, pelo contrário, existe uma grande defasagem nas leis que regem o país, o que dificulta os                 procedimentos a serem tomados                no caso de ataques terroristas.', 'Devido à legislação         regente         , o país possui dificuldades até mesmo de proteger-se de pequenos protestos         ocorridos por protestantes         locais. Com a chegada de visitantes de todos os países, a incapacidade de julgamento e punição que as leis         Brasileiras         apresentam às autoridades         podem         facilitar ataques de terroristas que saibam quão fácil é livrar-se de um julgamento no Brasil.', 'Portanto, não há razões para desespero, mas também não é possível manter absoluta tranquilidade. O Brasil precisa investir intensamente em segurança e em treinamento de policiais. Ainda seria interessante, apenas como prudência, incluir na legislação leis de penalidades para terroristas. Essas seriam maneiras de evitar que o país futuramente entrasse na                 faixa de países                que sofrem com ataques terroristas, e         proporcionaria         maior tranquilidade para visitantes e brasileiros durante os grandes eventos.']",120,120,160,160,160,720
136,Eleger o candidato em branco,"['Quando se fala em         eleções         ,                 o brasileiro                já pensa em um candidato pelo qual tem uma simpatia, pensa na desculpa que irá dar para justificar sua ausência,         a         possibilidade do voto nulo ou         a indaçação de que não deveria ter a obriçação dos votos         .', 'O que os          cidadões         não sabem é que todo o pensamento que vem         nas épocas de eleções         se         vão         com o passar         dele         , mas a sua escolha não. O         brasileiro  ao invés         de                 focar                , estudar o passado de um candidato, prefere votar nulo, devido         à          outros fatos antigos de que políticos que representavam o povo, passaram a ser políticos que roubaram o povo. Se não podemos confiar em quem nos representa, é melhor depositarmos nossa confiança em um simples botão branco                ,         ao invés         de se arrepender de ter escolhido um “defensor popular”, que mais tarde venha nos         decepicionar         , até porque                 nunca candidato algum será o suficiente para nós                .', 'As         eleções         estão chegando e cada um faz a sua escolha, mas                 lembre-se                “cada ação gera um reação”, pode ser ela boa ou         nao         .']",80,80,80,80,0,320
90,,"['A homofobia consiste no ódio e repulsa por homossexuais, atitude esta que deve ser combatida para que possamos formar uma sociedade que esteja baseada na tolerância e respeito ao próximo, independente da sua orientação sexual.', 'Racismo e exclusão social e transfobia são problemas estruturais e mudar esse situação não tão simples devido ideologias antigas . Esses temas tem sido trabalhados em escolas e instituições de ensino para conscientizar que pessoas são pessoas independentes de crenças gênero, costumes, cor, raça etnia etc.', 'A transfobia que passada pela mídia, muitas vezes e do uma parceia do que realmente aconteceu no dia a dia por vezes ela impede pessoas de se relacionar no ambito profissional escolar ou pessoal. Ainda existe um grande preconceito contra os homossexuais na maioria das sociedades que, infelizmente, se reflete em atos desumanos de violência extrema contra esses indivíduos.', 'O assunto cresceu em discussão nos últimos 5 anos  de acordo com Ricardo Sales, CEO da Mais Diversidade - empresa que atua na consultoria, na elaboração, acompanhamento e avaliação de políticas de diversidade no ambiente de trabalho -, mas não chegou para todos da mesma forma, . Ele ressalta que muitos que conseguem empregos têm dificuldade em crescer profissionalmente.']",160,120,80,120,0,480
76,Uma luta e um machismo que já dura décadas,"['Apesar de inúmeros avanços que a mulher tem dado, no decorrer da história, para que tenham o mesmo reconhecimento que os homens, podemos perceber que ainda hoje há um olhar distinto da sociedade perante os dois gêneros.', 'A luta da mulher por um reconhecimento igualitário ao dos homens começa há várias décadas com manifestações sociais para que tal reconhecimento lhes seja dado. O que deixa isso claro são as lutas feministas realizadas no século XX, como a que tornou o dia 08 de março o dia internacional da mulher, onde centenas de operarias morreram carbonizadas em um incêndio numa fábrica, em protesto contra a carga horaria de trabalho atribuída aos homens, que possuía uma considerável diferença em relação a jornada atribuída a elas.', 'A mulher, porém, vem conquistando cada vez mais espaço na sociedade, conseguindo tornar realidade o que antes eram apenas reinvindicações. Graças as suas persistentes lutas, elas conseguiram o direito de votar, de ocupar cargos que antes só eram ocupados por homens e assim conseguir ser mais independentes de seus maridos. No entanto, mesmo com essas conquistas, é possível perceber tratamentos distintos entre os dois sexos , já que é comum vermos telejornais noticiar diariamente casos de agressão domestica e outros tipos de violência. Algo que deixa claro que a mulher, ainda hoje, é tida como “sexo frágil” .', 'Portanto, percebe-se que  apesar de tudo, a mulher aos poucos vem adquirindo direitos e espaço na sociedade. Contudo, ainda há culturas machistas no mudo atual. Cabe ao poder público criar leis ainda mais eficientes para conter o machismo e proteger as mulheres para que elas deixem de ser vítimas de todos os tipos de violência.']",120,120,120,160,120,640
49,Influenciadores digitais,"['Define-se como influenciador digital aquele que consegue influenciar de alguma forma seguidores nos meios digitais, com isso, essas pessoas conquistaram um papel importante na sociedade atual..  Dessa maneira, com a invenção da tecnologia foi possível a profissão de influenciador digital,pórem há exposição da vida privada.', ""A principio, criadores de conteúdo é a mais nova área de trabalho . Atualmente existe vários deles pelas redes sociais, afinal Felipe neto é muito conhecido, mas vale ressaltar que essa possibilidade de trabalho é abrangente, todas as áreas estão relacionadas, de comida a moda. No seriado teen da Disney Channel chamado 'Bia', de junho de 2019 do diretor Jorge Bechara , é visto de como ser influenciador, tal que as personagens ganha dinheiro com essa profissão além de fama. Dessa maneira, ser digital influenciador é outra forma de trabalhar e ganhar dinheiro em uma forma simples"", 'Entretanto, para ter fama e ganhar dinheiro com isso, há a exposição da vida privada e também para familia dessas pessoas. Criar a imagem ""gente como a gente"" para aproximar os seguidores ao influencer há consequência, na internet é repleto de haters – pessoas que só estão na rede para difundir ódio gratuito e isso gera um abalo psicólogico para quem cria os conteúdos, adémais, a familia também sofre com ameaças de morte e isso gera depressões ou abandono das redes sociais. Desse modo, preservar a intimidade é necessário e saudável.', 'De acordo com os fatos mencionados, é visto que os influenciadores digitais são importantes no século xx, pórem há suas consequncias da exposição. Cabe ressaltar que para ter benificos tanto dos influenciadores quanto para o seguidor é preciso ter empatia e saber que são pessoas e todos precisam ser respeitadas. Criadores de conteúdo é algo novo trazido da internet que vai continuar por anos na sociedade.']",160,120,120,160,120,680
20,Luso ou Brasileiro?,"['Com a vinda da família real portuguesa ao Brasil, no século XIX, e junto dela a construção de uma capital que se adequaria a vida de luxos da corte, fortes ondas de imigrações ocorreram no país, não só dos colonizadores mas também de outras diversas etnias. Entretanto, hoje vemos o oposto,  brasileiros que visam deixar o país em busca de um Estado estável, sem violência e com melhores condições de vida.', 'Pesquisas mostram que mais da metade da população de jovens no Brasil deixariam o país se tivessem a oportunidade, esse desejo foi crescendo juntamente com a criança que via em sua volta um país desestruturado, repleto de desigualdade social, roubos e violência. Hoje esse desejo de emigração é alimentado pelo medo de um futuro incerto, no qual a crise econômica e a falta de empregos para a população estão inclusos.', 'Ademais, países como Portugal que precisam de mão de obra e que tem a maior parte da população formada por idosos, estão oferecendo aos brasileiros diversas oportunidades para migrarem e construírem uma nova vida em um país que está no ápice da economia e que é considerado um dos mais seguros do mundo; o resultado disso foi a aceleração dos pedidos de dupla cidadania, com 50 mil concessões desde 2016, só em São Paulo.', 'Em suma, percebe-se uma reviravolta no quadro migratório, antes portugueses fugiam para o Brasil com medo da supremacia de Napoleão Bonaparte e hoje brasileiros fogem para Portugal pelo medo do futuro do país, todavia o fim desses fluxos migratórios devem parar de acontecer em algum momento, e para é necessário uma restruturação política e social no Brasil por meio de uma educação que priorize esses ensinamentos.']",160,160,80,120,80,600
137,"Transgênese, a porta para várias mudanças.","['Com o avanço tecnológico e científico, descobertas que pareciam ser impossíveis em anos passados         vem         fazendo parte da         realidade, quem         em algumas décadas         atrás         acreditaria em seres geneticamente modificados em laboratório, com a função de ajudar os seres vivos? Acredito que pensariam em seres mutantes do         mal, ou         até mesmo de outro planeta.', 'Porém, dia após         dia         os transgênicos         vem         provando ser de grande         ajuda, estão agora         sendo usados para auxiliar na medicina,                agricultura, em                 desenvolvimento de produtos, e em setores que agora sua presença está se tornando de grande importância                . Doenças que antigamente não tinham cura, agora podem ser inibidas graças a eles, plantações que eram devastadas por doenças         agrícolas, ou         não aguentavam constantes mudanças climáticas agora estão se         ""auto protegendo""         pois estão ganhando a resistência natural de                 outros seres                , e também animais que                 eram constantemente atacados por vírus e bactérias estão ganhando a ajuda desse novo recurso.', 'A transgênese sem dúvida foi um grande feito da         biotecnologia, e         ainda será usada para mudar a qualidade de vida de muitas pessoas ao redor da Terra, sendo utilizada para muitas finalidades com um único objetivo: ajudar os seres vivos. A ferramenta         ja         foi achada, agora basta saber usá-la.']",120,80,80,80,120,480
50,Ciência ou Achismo?,"['Como uma maneira de afirmar valores religiosos  ou ideológicos extremistas, evoluiu fortemente o negacionismo científico em um momento de pandemia, trazendo  nitidamente riscos para todos. E acerca disso, a negação de evidências documentais, científicas e consensos históricos são combatidas por puro achismo em que todos deveriam salientar a ciência na luta contra o coronavírus.', 'Nesse prisma, deve-se ressaltar que o retrocesso do negacionismo não se limita exclusivamente ao coronavírus. Como exemplo, na década de 1980, com ausência de recursos medicinais, a Síndrome da Imunodeficiência Adquirida (AIDS), intensificou-se como uma das doenças mais letais. E nesse âmbito, consequentemente  houve uma histeria coletiva devido às notícias falsas que se proliferou no mundo todo, se comparando com a atualidade.', 'Deste modo, já dizia o grande filósofo Sócrates ""a vida sem ciência é uma espécie de morte"", portanto, divergir a ciência é divergir a vida . Nesse nicho, em 1904, a desinformação trouxe à tona a Revolta da Vacina, que por sua vez, era uma disseminação de ódio contra o governo que impôs a vacinação obrigatória, contrariando o que a ciência propunha e parecendo com o que acontece no século XXI.', 'Mediante os fatos elencados, torna-se urgente a execução de medidas atenuantes aos entraves existentes. É de extrema importância que a negligência da ciência seja discutida, e que, conforme assegurado pela Constituição o direito à saúde, as pessoas que vivem à margem da sociedade tenham uma renda básica, e que portanto, tenham acesso à mídia para uma não desinformação.']",160,160,120,160,40,640
44,###,"['Somos todos iguais, em relação a raça, religião e classe social, mas quando se trata de esportes é preciso respeitar a faixa etária e o sexo. Porque o nível de testosterona faz a diferença na musculatura no squeleto e na produção dos glóbulos vermelhos, tornando o indivíduo mais forte.', 'Portanto dentro dessa ótica será que uma atleta com nível de testosterona mais elevado pode disputar com outra mulher? Sabendo que fisiologicamente o organismo desta atleta é muito melhor pois se compara de um competidor do sexo masculino e que ficaria com vantagem sobre outra atleta do mesmo sexo que tem os hormônios adequados.', 'A Federação Internacional do atletismo institui regras para proteger a integridade dos atletas, por isso tenha classificação nas competições para que não haja injustiça mesmo sabendo que os hormônios estão naturalmente presente é notório a diferença não tem como colocar um adolescente de 19 anos para disputar com o senhor de 73 Seria um crime', 'Destarte cabe a Federação do atletismo e os órgãos competentes agir com seriedade e espeito, buscando meios para solucionar as diferenças sem que um atleta se sinta excluído e o outro se sinta prejudicado. Existe medicamento para anomalia o qual pode nivelar a quantidade de hormônio o que não pode é excluir o atleta o esporte precisa de mais incentivo e menos impasses.']",120,160,120,160,160,720
44,Nós por nós.,"['Há séculos, mulheres precisam provar à sociedade que são mulheres. Seja no jeito de agir, na forma de falar, como comportar-se, e até mesmo se nasceu neste gênero. A luta para desconstrução de uma sociedade machista que impõe como uma mulher deve ser está cada vez mais presente, e cada vez mais necessária no nosso dia a dia para podermos ter o livre árbitro de ser quem somos sem a necessidade de provar isso a alguém.', 'Mulheres cisgêneros, e mulheres transgêneros, ainda lutam para poderem viver normalmente, com aceitação a si mesmas, e aguardando respeito alheio.', 'Nenhuma mulher precisa provar que é mulher, cabe aos seres humanos terem mais empatia com o próximo, independente do gênero que nascemos, e como adiante, iremos nos descobrir..  Respeito a cima de tudo. e tolerância.', 'Diversos casos de mulheres sendo expostas a humilhações para provarem que realmente são mulheres, ocorrem diariamente, e muitas vezes ao nosso próprio redor não vemos isso . A sabedoria,  busca pelo conhecimento, e educação devem ser primordiais para termos um futuro evoluído, e próximas gerações,  mais descontruídas e abertas ao ""novo"". Sem preconceitos e com pessoas dispostas a ensinarem que todas somos iguais, independente de cor, raça, ou gênero.']",160,120,80,120,0,480
28,Tantos casos de conhecimento público,"['Com tantos casos vindo a conhecimento público não podemos deixar de reparar no descrédito dos brasileiros na política, sendo um desses a corrupção generalizada nos ramos da politica e economia, desmotivando toda sociedade brasileira.', 'Todavia, observando os fatos que vem ocorrendo nos últimos tempos, é notório o crescimento de escândalos envolvendo deputados, senadores, ministros e presidentes, constando corrupção, lavagem de dinheiro ,caixa dois, onde o número de envolvidos é surpreendente. Assim, como os casos que mais abalaram o Brasil, sendo eles ""Mensalão"", ""impeachment contra dois presidentes, sendo o primeiro Fernando Collor e o segundo contra Dilma Rousseff"", ""as prisões de governantes "", e as acusações contra o atual presidente Michel Temer"".', 'Espavorecidos com tais casos que são relatados diariamente nos meios de comunicação os brasileiros esperam inquietos por algo que aparenta esta distante, a solução. A falta de punição ainda lidera quase tudo sempre. O papel da justiça habita exatamente aí, em acabar com o atual quadro de letargia e fazer cumprir as leis com mais eficiência e igualdade para todas as classes.', 'Contudo, a polícia federal deve continuar agindo da sua maneira, e dessa forma os políticos tendem a ter consciência dos seus atos e antes de pensar em transferir o dinheiro público para a conta pessoal, eles deveriam investir na necessidade de maior eficiência nos recursos disponíveis, priorizando a saúde e a educação.']",0,0,0,0,0,0
90,,"['No contexto atual a transfobia no brasil, vem sendo motivo de diversos debates, pois a discriminação no meio social já está sendo razões de diversos homicídios e abusos psicologicos, entre tudo a homofobia contra o publico LGBT  gera diversos problemas.', 'Nota-se que a discriminação com a diferença do outro vem por falta de informação do que aquilo pode afetar no psicologico do proxímo, falta de responsabilidade emocional e de grande nível, em pleno século XXI a sociedade ainda e homofobica , insistem em julgar ou até mesmo em matar por não entrarem em padrões considerados corretos ou normal.', 'Entretanto apesar do meio social os rejeitarem, por muitas vezes os familiares não apoiam tal sexualidade de seu filho(a), então os mandam embora de casa e sofrem também a tal rejeição social, o nível de homicídios contra os LGBT vem aumentando, presenciamos diversas reportagens com esse tal alto de violência e preconceito.', 'Portanto medidas são necessárias para resolver o impasse. Por meio de concientização nas escolas, ruas , internet,(facebook, instagram, sites famosos, influenciadores) ,devem concientizar a responsabilidade emocional , e devem apresentar os direitos do público LGBT. Os três poderes devem entrar em cena com o poder Judiciário e aplicar uma lei contra tudo que se apresenta ser transfobia. Para que os homícidios acabem,e as discriminações diminuam,precisamos de apresentar as leis j existentes e conscientizar sociedade brasileira. Com o efeito de julgamentos com punição os agressores pensaram duas vezes antes de atuar preconceitos e violência e a concientização para gerações futuras.']",160,120,120,160,120,680
55,Nossos irmãos.,"['Não é de hoje que povos índigenas sofrem total descaso em abrangentes âmbitos. A falta de respeito e atendimento minímo para tais se faz cada vez mais preocupante, visando que se trata tanto de uma conservação histórica, quanto social.', 'A exploração de suas terras continua sendo o maior causador da dimuição das tribos, pois apenas 13% da população brasileira são indígenas, na sua maioria residentes na Amazônia. Invasões em suas propriedades, tristemente, são corriqueiras, ocasionando assim a mudança desses povos para a cidade grande, afim de uma vida mais digna acerca de seus direitos.', 'Outrossim, escolaridade e saúde também são áreas negligenciadas, aonde, muitas vezes, o preconceito ou a falta de infraestrutura para se levar tais atendimentos se faz quase que por completo. Afirmando a falta de consideração com essas pessoas, que, de certa forma, habitam esse solo mais tempo do que os famigerados ""homens brancos"".', 'Com isso, se faz de extrema importância a intervenção da ONU ,  para maiores áreas de preservação desses povos e suas moradias tanto na natureza, como também na civilização. Ajuda governamental se faz útil tanto quanto, promovendo maiores campanhas sobre a interação indígena na sociedade, sobretudo, campanhas em escolas sobre a cultura e respeito necessário com eles . Afinal, Pitágoras uma vez citou  ""educai as crianças para não ter que punir os adultos.""']",120,120,80,120,80,520
87,A cultura da erotização infantil,"['Com os meios de comunicação em alta é notável que a erotização infantil tem crescido. Isso acontece por muitos tipo de acessos. Afinal, quem é o responsável?', 'Com o fácil acesso mídia, seja ela internet, televisão, vídeos, entre outros, muitas crianças passaram a ver e a ouvir cenas obscenas. Assim, despertando curiosidade e desejo de uma sexualidade precoce. Muitos pais tem deixado os filhos vontade na internet, sem nenhum tipo de cuidado, sabendo que eles podem ter qualquer tipo de acesso a mesma. Com a erotização a criança desencadeia desejos de adultos , além de mudar seu psicológico, fazendo com que a criança mude seu jeito de pensar e agir .', 'Para combater a erotização infantil, é necessário que os pais tenham precaução sobre seus filhos, controlando o que eles podem ou não ver. Assim, como a mídia também poderia ser mais rígida nas censuras, seja de vídeos, novelas ou programas. Sendo assim não haveria tantas crianças com a sexualidade precoce.']",160,120,80,120,120,600
89,A CONTENÇÃO DA PANDEMIA E A RECUPERAÇÃO FINANCEIRA - VI,"['No contexto pandêmico atual, que assolou a população mundial, as medidas sanitárias são as mais eficazes contra sua propagação. A lei 13.979, determina no artigo 3, que podem ser decretadas no combate à epidemia medidas como isolamento e quarentena. Hodiernamente, as medidas de distanciamento têm afetado o setor da economia, gerando graves consequências. Assim mostra-se relevante pensar nesta situação econômica que configura as maiores problemáticas desse pernicioso cenário.', 'De início é notório destacar que as condutas sanitárias têm grande importância no enfrentamento à pandemia, devem ser seguidas e respeitadas, prova disso recai nas reduções de taxas de contaminação e o número de falecimentos entre os contaminados. Ademais cabe ressaltar que as normas acabam afetando vários setores da economia, deixando mais evidentes as desigualdades sociais. No Brasil, o desafio vai além de controlar a pandemia, mas também reduzir a crise econômica. Sendo assim torna-se urgente reconhecer a necessidade de refrear ambas as situações, de modo que garanta a recuperação financeira e conter a epidemia.', 'Com o objetivo de minimizar a crise econômica sem afetar a contenção pandêmica, seria necessária a criação de medidas públicas eficazes. Outrossim cabe aos órgãos governamentais e federais, incentivarem o isolamento evidenciando sua importância, como medida significativa da contenção da transmissão. E como ajuda financeira, a criação de auxílios extras, levando em consideração comerciantes com estabelecimentos fechados, trabalhadores que ficaram sem remuneração, desempregados e a população periférica. Somente assim os cidadãos poderiam respeitar o isolamento, sem passar por dificuldades financeiras, ajudando a economia. Para assim garantir a segurança e a saúde de todos.']",160,200,120,160,200,840
103,Uma conquista moderna,"['Analgésicos, antialérgicos e antibióticos estão entre os medicamentos que com a legislação de 1975 se tornaram isentos de prescrição médica. Após          esta          legislação a automedicação se tornou uma prática mundialmente comum. E apesar de ser um grande avanço, o ato desorientado tem desencadeado graves problemas, sobretudo em países subdesenvolvidos.                  Com a crescente demanda social e          econômica          a automedicação é apoiada pela OMS                . Isso porque, segundo a própria                ela é eficiente no tratamento de doenças sem         gravidades         , e já tem gerado resultados positivos em lugares como EUA e Europa. Mas para que         isto          aconteça         estes         locais         tem         desenvolvido         alertas que denotam que estes         resultados só são possíveis                 com a orientação de um médico, ou seja depois de ter informações, como: efeitos colaterais e tempo de uso.', 'Infelizmente em países como o Brasil,         esta          prática                não pode ser caracterizada como eficiente. Pois         neste         , além da falta de investimento e fiscalização pública, há um                 ""comércio medicinal""                altamente perigoso,                 que consiste em propagandas          má          constituídas e de caráter integralmente          consumista  . Que persuadem         todas faixas etárias, principalmente os jovens,         maioria no consumo         de medicamentos,         que com este         alto consumo tem desencadeado problemas como intoxicação e overdose.', 'Neste         contexto, é preciso que haja         do governo uma iniciativa         ,         que junto com a         vigilância sanitária, desenvolva o controle         o         publicidade e         cria         punições a quem tenta         persuadi         pessoas ao autoconsumo de fármacos.                 Para que assim          está          prática já benéfica em países como os EUA, também possa denotar-se como um          auxilio a          saúde pública brasileira.']",80,120,80,80,120,480
87,Pierre Bourdieu redação,"['Barão de Itacaré,um dos criadores do jornalismo alternativo na época da Ditadura no país estava certo ao dizer:""o Brasil é feito por nós, só falta desatar os nós"".Nesse sentido a cultura da erotização infantil se configura como um dos nós a serem desatados no atual cenário mundial. Diante dessa perspectiva cabe avaliar os fatores que favorecem esse quadro,o qual ocorre inegavelmente devido não só pela má influência midiática,mas também pela omissão familiar.', 'Mormente é fulcral pontuar que a cultura da erotização infantil, deriva principalmente da má influência exercida pela mídia, que couve tais recorrências. De acordo com o sociólogo francês Pierre Bourdieu, ferramentas que foram criadas para serem objetos de democracia, não devem ser convertidas em mecanismos de manipulação. Sob esse viés,a mídia promove e permite a divulgação na formação social das crianças. Desse modo, é inaceitável que os meios de comunicação social compactue com tais atos,torna-se necessário desse modo,superar esses paradigmas que afetam esses indivíduos.', 'Ademais, é imperativo ressaltar a importância da família na base educacional de formação das crianças, entretanto,quando esses indivíduos parentais se omitem, dificulta a resolução desse empensilho. Segundo o Estatuto da Criança e do Adolescente (ECA) ,todas as crianças devem gozar de direitos inerentes pessoa humana em evolução,e necessitam de atenção e cuidado extremo dos seu responsáveis. Todavia, é nítido que esse direito não se emprega na realidade atual,já que a imagem de muitas crianças são constantemente adultizadas,e as famílias não cumpre com o seu papel de supervisionar. Tudo isso contribui para a perpetuação desse quadro infesto.', 'Depreende-se, portanto,a necessidade de se combater esse impasse. Distarte, é imprescindível que o Estatuto da Criança e do Adolescente (ECA),por intermédio de palestras ministradas por psicólogos e profissionais capacitados, aborde nas escolas públicas de ensino infantil o problema supracitado. Tais palestras devem contar com os responsáveis famíliar,para que possam saber a melhor maneira de agir diante do quadro,essas palestras também deve ser webconferênciadas em sites da escola e dos demais envolvidos,a fim de atingir um público ainda mais abrangente. com isso espera-se mitigar esse problema,para que assim as criança não continue com seus direitos banalizados.']",160,160,160,200,160,840
127,Correto x Apreçado ,"['Atualmente as pessoas já estão habituadas com o                 linguajar informal ? um          vicio          de linguagem                -, que abrevia as palavras. Isso facilita muito a vida das pessoas.', 'Hoje as coisas estão tão difíceis, corridas, que até a linguagem foi afetada.', 'Por mais que os professores tentem passar a maneira         correta, tanto da fala quanto da escrita,         é muito difícil         praticar e aperfeiçoar         . As conversas através de sites de relacionamentos (MSN, ORKUT,         SALAS DE BATE PAPO         ) contribuem bastante para esse         vicio         , quando conversamos com mais de uma         pessoa         temos que ser         ""raios""         então passamos a atropelar as palavras e escrever         você (VC)         depois passa para (C ),                 é daí já não dá mais.                E cada vez fica mais comum, e todos os dias                 novos atropelos surgem e as pessoas aderem rapidamente.', 'Então é assim, abreviamos tanto as palavras que chegamos ao ponto de transformá-las em uma letra. E até modificar sua         pronuncia,          esta,                por exemplo, passou de VOCÊ para CÊ.', 'Mesmo que se ensine o correto, o dia a dia acaba puxando para o mais fácil e essa luta se torna muito difícil.']",80,80,120,120,0,400
72,,"['Segundo Zigmunt Bauman, sociólogo polonês, a falta de solidez nas relações sociais,políticas e econômicas é característica da modernidade líquida, vivida no século XXI. Analogamente, esta ligada as fake news que vem se tornando uma questão cada vez mais emblemática na sociedade atual. NesseNesse contexto essa problemática é muito maior ao que se imagina, afetando de forma drástica setores políticos e sociais. Nesse viés, são imprescindíveis ações mediáticas para resolução dessa problemática na sociedade.', 'Mormente ao avaliar, o cenário político em que o Brasil se encontra, essa problemática se torna ainda maior, podendo mudar todo um contexto político social em ano de eleição. Um exemplo claro desse acontecimento, foram as eleições que ocorreram nos Estados Unidos no ano de 2016, que ainda repercuti no mundo inteiro. De acordo com o jornal New Work Times, o candidato Donald Trump teria ganhado por interferência de notícias errôneas da concorrente, em várias plataformas de comunicação se espalhando por todos  eleitores, ocorrendo uma manipulação de massa e garantindo a sua vitória.', 'Além disso as notícias falsas são pensadas e estruturadas para atingir alguns objetivos específicos: levar o leitor ao erro, fomentar boatos e deturpar uma informação verdadeira atingindo a honra de alvos públicos. Desse modo ocorre um bombardeio de informações ligada ao principais temas procurados pelo internauta de forma erradicada sendo difícil mensurar o tamanho das consequências . Contudo,  inegável o fato de que essa prática começa a fragilizar muitos valores da nossa sociedade, inclusive chegando ao ponto de colocar o próprio cidadão contra a Constituição Federal e o Estado Democrático.', 'Em síntese emerge a importância de políticas publicas mediáticas, através de oficinas e cursos gratuitos a identificar e filtrar conteúdos falsos na web. Também é viável a criação de plataformas para identificar se as informações são verídicas e se o site é confiável, afim de auxiliar a população a identificar as notícias falsas atentando-os sobre os riscos de compartilhamento de noticias sem saber o fundamento de ta,l para assim, suster o fluxo de notícias falsas na internet, visando o bemestar da sociedade como um todo.']",120,160,120,160,120,680
144,Luta por Igualdade,"['A independência tem sido a maior luta da mulher moderna. Tentamos cada dia mais estabelecer nosso lugar na sociedade e acabar com os preconceitos         destinados a         nós, principalmente no mercado de trabalho. Ainda somos vistas como o sexo frágil, característica que há muito tempo já perdemos, quando passamos a assumir, simultaneamente, a                 “sina”                de ser mãe, dona de casa, esposa e trabalhadora.', 'Muito do crescimento econômico brasileiro deve-se ao fato do ingresso das mulheres no mercado, pois com isso há um aumento de mão-de-obra e, consequentemente, da competitividade e         a         busca por qualificação, fazendo com que o Brasil consiga maior crescimento financeiro e de qualificação profissional. Além disso, a inserção do sexo feminino no mercado faz do Brasil um país cada vez mais igualitário e                 dá espaço a um crescimento social.', 'Hoje as mulheres são maioria na população                o que nos deixa ainda mais incentivadas a essa         luta, temos         que mostrar que não somos mais o sexo         fragil         , e mostramos isso assumindo lugares que são nossos, não por exclusividade, mas por mérito,                 que escritoras de nossa própria história.']",160,160,160,160,160,800
73,Frutos da escravidão,"['O período de escravidão no Brasil foi marcado, principalmente, pela privação dos negros aos que hoje são intitulados direitos sociais (direito à saúde, à educação, etc). Tal privação fomentou a desigualdade racial, que se ramificou em setores da sociedade com eficiência para combate-la, como a educação. Devido a isso, encontra-se hoje na sociedade barreiras que dificultam e, até mesmo, impedem a efetivação da igualdade.', 'No que tange às deficiências na efetivação da igualdade, a desigualdade racial na educação figura como destaque. Em universidades pública e privadas, por exemplo, os negros constituem a minoria entre os docentes e discentes . Tal fato denota que muito em embora a educação seja um direito garantido a todos, não é menos verdade a existência de desproporcionalidade na fruição dele pelos distintos grupos raciais. Mesmo com a disposição de ações afirmativas (políticas de inclusão que, por concessão de privilégios, visam atenuar as diferenças de elenco) a mencionada desigualdade persiste e acentua as diferenças, uma vez que a educação é a maior promotora da mobilidade social , evidenciando a necessidade de que seja instituída uma política de inclusão mais flexível voltada para os negros.', 'Nessa esteira, cabe salientar que a desigualdade social está intrinsecamente relacionada com a desigualdade racial. Embasando-se em uma recente pesquisa, o jorna O Globo publicou uma reportagem na qual era anunciado o atraso em dez anos, no que se refere à qualidade de vida, dos negros em relação aos brancos. Tal realidade corrobora a afinidade existente entre as referidas desigualdades e evidenciam que a superação dos desafios de ordem racial se dará mediante a superação dos desafios de ordem social.', 'Do exposto, infere-se que o contexto histórico brasileiro enraizou as desigualdades social e racial, instaurando desafios aos negros. Portanto, devido ao fato de tais desafios possuírem raízes históricas e desencadearem desigualdades, urge que o Estado, na figura do Poder Legislativo, institua uma nova política de inclusão, por intermédio de uma nova lei, cujas premissas da política e da nova lei, visem flexibilizar e aumentar as ofertas de vagas para negros em universidades públicas e privadas, com o fito de vencer os desafios raciais e conferir à eles condições para vencer os desafios sociais fazendo uso da educação.']",160,120,120,160,120,680
53,A influência dos meios de comunicação na sociedade brasileira,"['Antes mesmo de nos tornarmos adultos,ou adolescentes, já passamos pelas influências dos meios de comunicação em nossas vidas. Na infância; propagandas de jogos, desenhos, lanches, parques, escolas, brinquedos, presentes e mais inúmeras coisas estão a disposição ocular em qualquer lugar: na tv, rádio, jornal, internet,revistas ,nos incentivando em suas demonstrações muitas vezes até fabulosas, aonde ir, onde comprar, onde estudar, o que dar de presente etc. Já na vida adulta temos a disposição o conhecimento universal através dessas redes, muitas vezes nem checamos mais a veracidade, por confiarmos tanto e sermos super influenciados,já que nos traz a praticidade pra vida, nos informa como vai a bolsa de valores, o tempo no Japão, a nova tendência de roupa do verão, os melhores planos de saúde, a pobreza mundial, a politicagem geral, os gastos exorbitantes dos países, as descobertas de vacinas, a via a láctea e muito mais. De uma forma geral, como não seguir ou acompanhar diariamente o que aconteceu hj, ontem ou o que irá supostamente acontecer amanhã? Por conta própria, creio que estaríamos atrasados nas informações,ou retrocedendo ao tempo onde as rolinhas entregavam os recados.', 'Enfim, sempre estaremos sobre a influência dos meios de comunicação, afinal dialogar, conversar e interagir está em nossa formação, e com o auxilio destes meios,  levamos informações do Oiapoque a Chuí .']",120,40,40,40,0,240
47,desafios da educação em meio uma pandemia.,"['Em meio a pandemia do novo corona vírus( covid-19), medidas de segurança foram adotadas para evitar o contágio. Entre essas medidas,  está a recomendação do isolamento social. Dessa forma, todas as escolas e faculdades foram fechadas por tempo indeterminado. Contudo, a educação a distância foi botada  em prática, porém, o percentual de alunos que não estão acompanhando as aulas através da internet só aumenta.', '""nós estamos diante de uma ameaça real de abandono escolar, de total desalento em relação ao processo de ensino-aprendizado. É importante dizer que há um esforço enorme dos professores em garantir o processo de ensino aprendizado, de fazer com que os estudantes se envolvam nas aulas à distância, mas, concretamente, secretarias estaduais e municipais têm errado na questão do projeto pedagógico"" observa Daniel Cara, professor da faculdade de educação USP.', '""Também tem as questões ligadas à situação econômica das famílias: desemprego, queda na renda. Isso cria uma pressão enorme para que o jovem vá trabalhar, vá buscar renda e mais dinheiro para colocar dentro de casa"" explica Priscila Cruz, presidente - executiva de todos pela educação. Além disso, também existe o problema dos alunos que não possui acesso internet e a transmissão pelo canal de TV é ruim.', 'Portanto, medidas são necessárias para resolver o impasse. O governo em parceria com o MEC , devem fazer uma campanha para doar uma antena parabólica para os alunos de família com baixa renda. Dessa forma, resolvendo o problema da transmissão pela TV e dando mais oportunidade para os alunos assistirem as aulas com mais clareza.']",160,120,120,120,80,600
62,"Propaque Amor, não o Ódio!","['Para muitos as redes sociais é uma terra sem leis. Usam e agem da forma que querem tornando-a assim um lugar repleto de discurso de ódio.', 'O fato de todos  terem acesso as redes sociais acaba tornando comum a exposição de ideias e opiniões de todos os modos, sejam elas boas ou ruins. Em contrapartida, a internet está mais propicia a se tornar um campo de discurso de ódio pelo fato dos usuários acharem que, de certa forma, estão em anonimato. Apesar de hoje em dia haver meios de segurança que barra a propagação desses tipos de conteúdo que ofenda raças, etnias, gêneros e nacionalidades, fica fácil para alguns usuários agirem de forma ofensiva e hostil por não serem punidos pelos seus atos.', 'Dessa forma fica claro que na maioria das vezes falta consciência dos usuários e punições mais severas para quem propaga o ódio nas redes sociais. Visar a retirada desses conteúdos sem uma conscientização para quem usa a internet acaba tornando-se um jogo de tapa buracos sem fim.', 'Por tanto, a solução está em criar mecanismos que lute contra o ódio e que faça os usuários perceberem que as redes sociais não é uma terra sem leis criando também formas de punições para quem cometa esse tipo de crime.']",120,120,120,120,80,560
62,Tudo pode mudar,"['No cenário atual brasileiro,  é possível ter a percepção do grande número de manifestações do cada vez mais conhecido discurso de ódio, algo que não deveria existir no século XXI . Porém, é revelado pelas pessoas que o adotam principalmente na internet e nas redes sociais, como por exemplo, Facebook e Twitter. Esse tipo de manifestação é algo que precisa ser combatido com certa urgência, principalmente porque não cabe a ninguém julgar e humilhar um outro indivíduo por quem ele é ou escolheu ser.', 'O ódio surge a partir da intolerância e do preconceito, algo retrógrado que infelizmente algumas pessoas trazem consigo até hoje, mesmo que não percebam. Em todos os casos de discurso de ódio as vítimas são atacadas por pessoas que acreditam-se, de certa forma, superiores e no direito de criticar características físicas e sentimentais de outros indivíduos, como por exemplo, etnia, cor, orientação sexual, religião entre outras coisas. Esse modo tóxico de pensar pode ser transmitido de diversas maneiras. Na internet,  isso inclui vídeos e publicações de pessoas com certa influência nas redes sociais e que, por meio destas, revelam seus pensamentos negativos os quais corrompem e influenciam seus admiradores.', 'Por mais que existam diversas medidas de segurança para evitar que o discurso de ódio se manifeste pelas redes, como por exemplo, a retirada de monetização de determinados canais no YouTube, isso continua a acontecer já que, na realidade, não se pode culpar totalmente a segurança que faz o seu trabalho por trás dos computadores, mas sim os internautas, pois mesmo que existam tantos profissionais na área, eles acabam por não conseguir dar conta da tamanha demanda de casos . Em um comentário feito numa página do Facebook, por exemplo, aquele que o fez pode sofrer com desaforos e respostas preconceituosas. Além da denúncia da vítima, a função da segurança teoricamente seria bloquear esse tipo de resposta e deletar o perfil do agressor da rede, além de alertar as autoridades. Entretanto, não é sempre que isso acontece.', 'Logo, o governo deveria reforçar a vigilância virtual afim de, gradativamente, extinguir o discurso de ódio na internet da sociedade. Além disso, a população deve se conscientizar e mudar a sua maneira de pensar em relação ao que é diferente para cada um, e nesse caso a mídia pode exercer um trabalho importante, já que tem o poder de influenciar as pessoas de forma positiva, abrir mentes e revelar a realidade. Para mudar algo na internet, deve-se mudar primeiro a cabeça de quem está por trás dela.']",120,120,120,120,120,600
55,,"['Antes de 1500, ano da colonização portuguesa na América, os índios já habitavam essas terras e organizavam-se em diferentes etnias. Entretanto, foram submetidos a um processo civilizatório, pois eram considerados como selvagem, com isso a cultura dos nativos aos poucos vem sendo excluída. Dessa forma, evidencia-se a desvalorização cultural, bem como a violação dos direitos indígenas.', 'Convém ressaltar, a princípio, a desvalorização cultural dos nativos por parte da sociedade brasileira. Isso ocorre  porque, desde o período colonial, influenciado não só pelos colonizadores, mas também pelos jesuítas, a cultura indianista molda-se de acordo com do europeu. Segundo o sertanista Orlando Villas Boas, o índio só pode viver dentro de sua cultura, isso mostra que para manter o índio é necessário valorizar sua cultura.', 'Em segundo lugar, vale ressaltar a violação dos direitos garantidos aos índios. O artigo 231, da Carta Magna de 1988, garante a eles terras, além do reconhecimento de suas organizações. No entanto, essa lei é violada pelos grandes proprietários de terras, contribuindo ainda mais para a desvalorização da culta dos nativos, pois a demarcação dos T.I.´s ( Terras Indígenas), é o principal fator para a conservação da cultura indígenas.', 'Em suma, faz-se imprescindível a tomada de medidas atenuantes ao entrave abordado. Posto isso, cabe à FUNAI (Fundação Nacional do Índio) em parcerias com os Ministérios da Educação e Cultura, e também o Ministério da Justiça, esclarecer à população a importância de valorizar a cultura dos nativos, por meio de palestras e aulas de campo em aldeias indígenas, além de fiscalizar o cumprimento das leis indígenas, a fim de manter as etnias dos índios que existem no país. Desse modo, a história dos nativos não será esquecida.']",120,120,80,120,120,560
15,"Obesidade, um problema a ser combatido","['No Brasil, nos últimos anos, podemos abservar um aumento no número de pessoas que sao cosideradas acima do peso e também de obesos. Cabe então aqui discutirmos sobre as causas, consequências e possiveis soluções para o problema.', 'Segundo pesquisa realizada pelo IHME, Instituto de Métrica e Avaliação para a saúde , 30% da população é obesa . As principais causas desse problema é o sedentarismo atrelado a os maus hábitos alimentares. Além dos distúrbios hormonais que também podem causar aumento na massa corporal.', 'Com isso, vem as consequências que são, na maioria das vezes, sociais e de saúde, aonde o indivíduo acometido com a doença sofre tanto com problemas derivados do acúmulo de gordura como o diabetes, artrite e artrose quanto a exclusão social, devido ao não enquadramento nos padrões de beleza virgentes .', 'Com base no apresentado, é necessário, para que esse problema seja resolvido que o ministério da saúde implemente campanhas de conscientização quanto as consequências dos maus hábitos alimentares.']",120,120,120,120,120,600
75,Arma o cidadão,"['O uso de arma de fogo é mostrado em alguns filmes e séries como um meio apropriado e seguro para promover a segurança do indivíduo, pois é retrato como um mecanismo de defesa e que provoca temor, caso alguém queira assaltar ou usar de violência. É apenas ficção e tem o intuito de disseminar um ponto de vista diferente do que acontece na realidade, entretanto. Pois possuir armas em casa não aumenta a segurança, assim como não representa o fim da violência.', 'Antes do estatuto do desarmamento  que entrou em vigor a partir do ano de 2003 no Brasil, após um plebiscito, era possível adquirir porte de arma um cidadão que estivesse com vinte e um anos de idade e seguisse alguns requisitos, como no Art°7..” o requerente comprovar idoneidade, comportamento social produtivo, efetiva necessidade, capacidade técnica e aptidão psicológica para o manuseio de arma de fogo” da lei 9437/97. Mas apesar de exigir tais critérios, aparentava passar certa segurança, o números de mortes no Brasil tendia a aumentar, mostrando que o porte e posse de arma não era um fator preponderante para controlar a violência no país. Assim como, segundo a ONU, o bairro do Jardim Ângela, em São Paulo  em 1996  foi considerado o mais perigoso do mundo, isso em um período que era permitido a compra de arma, logo ter não apresentava garantias de proteção.', 'Do mesmo modo para que diminua as violências que assolam um determinado local é necessário haver investimentos em diversos setores da sociedade, como na educação, política de distribuição de renda, segurança pública e sistema carcerário, por exemplo. Pois, uma vez investindo nesses setores será possível desenvolver políticas preventivas, para que as ações criminosas não ocorram e  com isso, ocorrerá a diminuição da insegurança. Mas é preciso, também, não pensar na arma de fogo como o cerne da solução, já que isto é ignorar os demais aspectos que circundam a violência no Brasil, como má distribuição de renda, educação de baixa qualidade, entre outros. Visto que tais pontos colocam a sociedade em igualdade e evitam que as pessoas busquem situações ilegais para manter a sobrevivência.', 'Logo, é preciso olhar a sociedade de modo mais holístico, pensando que para manter a sociedade segura é preciso investir em todos os setores que propiciem a igualdade social como educação e distribuição de renda. Pois, ir de encontro ao que foi estabelecido no estatuto é ignorar os demais aspectos e colocar nas mãos dos cidadãos, os que podem adquirir uma arma, a responsabilidade pela própria segurança. E ao transferir essa responsabilidade, além de atestar a incompetência do Estado para nos proteger , também deixará de lados pesquisas, como a apresentada Daniel Cerqueira e Danilo Santa Cruz, técnicos do IPEA, que reiteram o crescimento acelerado da posse de armas entre 1983 e 2003, ano da promulgação do Estatuto do Desarmamento e dos homicídios que foi de 8,36% ao ano entre 1980 e 2003.']",160,160,120,160,120,720
57,Filmes para Todos,"['O cinema é um local apropriado para a reprodução de filmes, que podem ser entendidos como imagens em uma sequência específica, associadas ou não a sons, de forma a passar ao espectador uma história, como faz um teatro . Os filmes são um objeto de entretenimento para as populações, além de girarem grandes quantias de capital por todo o mundo; porém, sia expansão aconteceu de forma concentrada e insuficiente, devido a questões socioeconômicas e aos baixos investimentos em infraestrutura realizados para atender às grandes demandas populacionais.', 'Ao se tratar de fatores socioeconômicos, tem-se o fato de a maioria das instituições que reproduzem os filmes buscarem altos lucros em cima de seus produtos. O sociólogo Karl Marx diz que o capitalismo se fundamenta na busca constante pelo lucro, que acaba por deixar a parcela mais necessitada da população excluída de diversas atividades, uma vez que não apresentam condições suficientes para pagar por tais serviços, dessa forma, não geram lucros aos fornecedores. Tais fatores tendem a privilegiar uma parte mais abastada da população, o que torna a indústria cinematográfica elitizada, de forma a excluir a parcela de menor classe social.', 'Outra questão são os baixos investimentos em infraestrutura realizados para atender às grandes demandas populacionais provindas do inchaço urbano . Após a construção de grandes centros urbanos, êxodos rurais tornaram-se cada vez mais frequentes, porém, as cidades não estavam preparadas para receber tantas pessoas, o que fez surgir problemas como subúrbios, precariedade no atendimento de água, esgoto e saneamento básico e, além disso, infraestrutura insuficiente na questão dos cinemas, visto que o Brasil é o sexagésimo país na relação habitantes por sala de cinema no mundo. Essa falta de infraestrutura fez com que apenas centros com mais poder econômico desenvolvessem seus cinemas, de maneira centralizada e elitizada, de forma a contribuir para a exclusão de grupos menos abastados da sociedade na questão cinematográfica.', 'Como visto anteriormente , a constante busca pelo lucro e falta de infraestrutura nos centros populares faz com que o cinema tenda a se tornar elitizado e centralizado, de forma a excluir a parcela mais carente da população dessa forma de lazer. Uma forma de amenizar tal problema seria que os Governos Municipais, através do uso de centros públicos, como anfiteatros, praças e escolas, realizassem periodicamente a reprodução de filmes que já estivessem ""fora de cartaz"", de maneira gratuita, a fim de agregar as classes sociais menos abastadas ao universo cinematográfico, sem causar prejuízos às empresas, uma vez que os filmes não estariam mais em exibição nos cinemas convencionais, de forma a democratizar o acesso ao cinema no Brasil.']",120,120,120,120,80,560
44,Abusos disfarçados de regras,"['Na Grécia Antiga, acreditava-se que as mulheres ficariam masculinizadas com exercícios, além de não terem condições físicas para a prática de esportes. Embora o esporte feminino tenha se popularizado, nota-se, na contemporaneidade, a sua limitação em algumas modalidades, em virtude do discurso machista em que as mulheres são obrigadas a comprovar sua sexualidade no esporte. Essa visão negativa pode e deve ser significativamente minimizada, desde que acompanhada da desconstrução coletiva, junto com o fim das regras vigentes da World Athletics ( Associação Internacional de Federações de Atletismo ).', 'Em primeira análise, é evidente a herança ideológica da pratica de esporte, como algo destinado apenas para homens, o que consolidou na sociedade a ideia de que mulher está destinada apenas para o trabalho domestico e á cuidar dos filhos. Nessa perspectiva, segundo Simone de Beauvoir  filosofa e escritora, o homem é definido como ser humano e a mulher é definida como fêmea. Quando ela comporta-se como um ser humano ela é acusada de imitar o macho. Sob essa ótica, constata-se que o discurso machista e primitivo introduzido, na sociedade, aflige o comportamento do cidadão a acreditar que a mulher não tem capacidade de realizar os mesmos feitos do homem sem abrir mão da sua feminilidade, mesmo na contemporaneidade . Isso enfraquece o princípio de igualdade para ambos os gêneros.', 'Ademais, vale ressaltar que , o uso de medicamentos para a redução de testosterona vai contra a sua forma natural, a sua essência, consolidando a ideia que seu corpo possui deformidades que são considerados ruins, o que a impede de realizar aquilo que ama, oque acaba afetando a autoestima deteriorando a imagem de se próprio . A condição emposta é explicitamente um abuso pois ela teria que abrir mão de sua forma natural para fazer aquilo que ama.', 'Em virtude dos fatos mencionados, conclui- se que ainda há discursos machistas na sociedade que necessita de mudança. Para que isso ocorra, é necessário que a World Athletic ( Associação Internacional de Federações de Atletismo ) , dê fim ao teste que obriga atletas a comprovar a sua sexualidade feminina, junto à difusão da importância da igualdade na vida profissional e cotidiano, nos meios de comunicação, por meio de anúncios, a fim de colaborar com o acesso igualitário. Ademais, a World Athletic ( Associação Internacional de Federações de Atletismo ) deve proporcionar aos indivíduos uma opção de competir com atletas que possui as mesmas disfunções. Assim, haverá um ambiente estável que colabore com a acessibilidade geral em outras modalidades, proporcionando um sistema igualitário para todos os atletas.']",160,160,160,200,200,880
129,Um novo núcleo familiar,"['As visões do meio familiar em relação          a          mudança dos casais homem e mulher para a agregação dos casais homoafetivos é mais aceitável na geração em que vivemos do que antes do seculo          XXI,  entre os jovens         o                 olhar                sobre esse assunto é                 bem          amplo  , já         a maioria das pessoas mais velhas ainda         guardão         a opinião conservadora, por não ter tido contato com esse novo núcleo familiar.', 'Nossos pais e avós, pessoas mais         experientes         viveram em uma época         a onde         o conceito de família era bem diferente do que o de hoje em         dia,          por                  isso não caracterizo como preconceito, mas como conhecimentos e vivências diferentes então, há quem aceite por ter a mente mais aberta e os que preferem a família tradicional, porque esse assunto não era tão debatido no seu tempo não conheceram outras formas de família, claro!          tem          as pessoas          preconceituosas          não as descarto, as que não aceitam e são mais agressivas e fechadas sobre esse          modo familiar          e que          tem          a opinião formada sobre o assunto, mas          ai          é uma questão que abrange todas as idades.', 'Hoje                 essa questão                é exposta não só em debates isolados, mas nas escolas, internet, televisão e etc., e mesmo aqueles que viveram com famílias conservadoras         tem         um olhar diferente sobre essa nova forma         familiar, então         estamos mais inteirados         com         ela e sabemos que se opor a isso só vai gerar mais conflitos e preconceito, pois ninguém         sera         afetado pela união de homossexuais.', 'O pensamento em relação a casais homoafetivos         esta         mudando, a opção sexual não é uma doença a ser         ""curada""         um mau exemplo para o nossos         filhos, ao         contrario é uma escolha que temos que aceitar e         respeitar, afinal é um direito o livre arbítrio o poder de escolha, são         pessoas como todas as         outras         que amam e só querem ser felizes.']",120,120,80,80,120,520
62,A Hostilidade na internet,"['Segundo o educador e filósofo Paulo Freire: ""A violência não é força, mas fraqueza, nem nunca poderá ser criadora de coisa alguma, apenas destruidora.""O discurso de ódio é um cenário comum nas redes sociais atualmente, isso devido a grande desigualdade enfrentada pelo país hoje. As expressões de ódio sobre o racismo e a e as mulheres são os mais ocorridos. Dessa forma, esta fala de fúria não devem acontecer, já basta esses preconceitos ocorridos na realidade, algo tem que ser feito, pois a sua tendência é aumentar cada vez mais.', 'Em primeiro lugar, antes de tudo, é correto afirmar que há a presença expressiva da intolerância racial nas redes sociais. A intolerância racial ainda é persistente em existir nos dias de hoje porque o sentimento da superioridade e o nacionalista deixado pelos portugueses com a escravatura no Brasil colônia, agora eles persistem em ficar encravados na sociedade . A conservação deste pensamento antigo ainda é presente pois se investe pouco na educação, ela é a base construtora do que se conhece hoje, a mesma  é responsável pela formação integral do ser. Quando o investimento é mal aplicado ou nem é aplicado e o ensino se torna péssimo, o rumo é que o racismo apareça em discussões de ódio na internet.', 'Em segundo lugar, é notório que além do preconceito racial,  há a hostilidade contra as mulheres na internet. As mulheres nos últimos anos estão conquistando o seu espaço e os seus direitos cada vez mais na sociedade, por conseguinte, isso desperta um incômodo em alguns homens, fazendo com que eles criem uma fúria em si mesmos . O pensamento primitivo até agora está existente na maioria dos homens, de que existe uma hierarquia do gênero, de que o ser masculino é superior a mulher e a todos. As leis existem, mas quando elas não são colocadas e prática, a direção é que a hostilidade nas redes cresça.', 'Em suma, é de extrema importância combater a ira nas redes sociais com objetividade. Com a liderança do Ministério Público, em grupo com o Ministério dos Direitos Humanos, o da Tecnologia e Inovação e com empresas como o Facebook . Devem dialogar sobre a criação de um projeto com a influência do pensamento de Paulo Freire com o intuito de virar lei, que reavaliaria as diretrizes de proteção atuais na internet. Apresentando novos meios de proteção e denúncias objetivas para as redes sociais e que acelere as denunciais. Isso não será feito radicalmente, mas gradativamente, orientando os usuários das novas normas, dando manuais de instruções de como ambos irão agir. Assim, o meio virtual será mais sociável para se comunicar e se expressar.']",120,160,120,160,120,680
84,Porte de armas e criminalidade no Brasil,"['Porte de armas é um assunto bastante polêmico e há pessoas extremistas em ambos lados, tanto a favor ou contra,  mas sendo um tema que não discutimos profundamente. Alguns países possuem leis que aprovam o porte de armas dos habitantes, como os EUA, mas será que em nosso país, essa decisão diminuiria o nível de criminalidade?', 'Sabemos que mesmo sem  leis, muitas pessoas adquirem armas por contrabando, algumas para autodefesa, mas a maioria com outras intenções. Enquanto marginais estão livremente expostos à armas de fogo e roubando cidadãos de bem, outros se encontram  recuados diante da sociedade amedrontados pela possibilidade de um roubo à qualquer momento.  Em certos países a população reage à assaltos graças ao porte de armas.', 'Pesquisas recentes afirmam que a população brasileira aprova armas para defesa, mas apesar de parecer uma solução, pode não ter os efeitos desejados. O porte sem necessidade de autorização não funcionaria no Brasil, especialmente pela falta de instrução e educação de muitos habitantes. Mesmo com a autorização a fiscalização deve ser rigorosa, acarretando mais preocupação para o Estado.', 'Para um nível satisfatório de queda de criminalidade, só o porte de armas não seria viável para o governo mudar suas leis, pois para os efeitos aparecerem, também seria necessário controlar a desigualdade social, a educação, saúde e moradia. A mudança não é repentina, e ainda há falta muito para que a criminalidade no Brasil seja menor. Não podemos nos acomodas com esta situação, precisamos escolher candidatos eficientes, reivindicar mudanças para os governantes, fazer campanhas, e principalmente, ser cidadãos.']",120,160,120,160,200,760
92,O Preconceito Amarelo,"['Em virtude do cenário atual da pandemia, o racismo contra asiáticos conhecido como o preconceito amarelo, tem se intensificado devido ao fato do surgimento do vírus Covid-19 ser associado aos asiáticos, onde é alegado por muitos que eles ""fabricaram"" e disseminaram o vírus pelo mundo.', 'No entanto, não é de hoje que pessoas asiáticas ou com descendência asiática, sofrem esse tipo de racismo, feito por meio de piadas ligadas traços físicos e estereótipos, logo que esse preconceito é normalizado. Nesse sentido, se faz o questionamento: omo combater o preconceito amarelo?', 'Nessa perspectiva, precisamos ter em mente que o racismo contra esse povo está presente em nossa sociedade desde os primórdios da imigração japonesa, quando estes eram comparados ao elemento químico enxofre pois eram considerados um povo que não se misturava, o que tem como efeito a banalização e normalização desse tipo de racismo na sociedade brasileira, pois como já dito por Albert Einstein ""É mais fácil desintegrar um átomo do que um preconceito"".', 'Em consequência disso, pode-se mencionar, por exemplo o caso da carioca descendente de japoneses, Marie Okabayashi de Castro Lemos, que sofreu esse tipo de preconceito relacionado ao Covid-19 dentro de um metrô e relatou através de um vídeo postado na rede social Twitter.', 'Portanto, de acordo com os fatos apontados acima, se faz necessário por meio do Ministério da Justiça, mais projetos de leis contra esse tipo de preconceito, e através do Ministério da Educação é preciso um programa de conscientização acerca da importância do combate do preconceito amarelo, ara que por fim  seja criada na sociedade uma consciência de respeito a todos.']",160,120,120,120,120,640
20,A canção do sabiá,"['Com apenas 20 anos de idade, o poeta romântico Gonçalves Dias compôs, no século XIX, a “Canção do exílio”, expressão do sentimento nacionalista de retorno à pátria amada. Caso o poeta vivesse no Brasil atual, dificilmente rogaria à Deus para que não morresse antes de voltar aos trópicos. Segundo pesquisa Datafolha, a maioria dos jovens brasileiros – entre 16 a 24 anos – querem deixar o país, abandonar as palmeiras e os sabiás em nome do sucesso que raramente encontram cá, mas é abundante lá. Afinal, o que motiva esses jovens?', 'O Brasil foi construído sob a miscigenação de diferentes povos. Imigrantes portugueses, espanhóis, japoneses, italianos, entre tantas outras culturas vieram em busca da prosperidade que não desfrutavam em seus países. As Grandes Guerras do século passado, a fome e as perseguições políticas forçaram muitas famílias a cruzarem o Atlântico rumo ao recomeço de vida. Sem dúvida, as crises são fatores preponderantes na decisão de abandonar a própria pátria.', 'Dessa forma, a crise brasileira desmotiva sobretudo a juventude. O sistema de ensino público, carente de investimento, não instiga o jovem a produzir e transmitir conhecimentos. Universidades sucateadas, como a UERJ, são reflexos de um Estado omisso e despreocupado em garantir a formação intelectual da população. Ademais, mesmo com um diploma, conseguir o primeiro emprego não é fácil: a especialização exigida afunila, cada vez mais, a competição no mercado de trabalho. Estudar, trabalhar e aposentar: no Brasil, sinônimos de frustrações.', 'Inclusive, no clima de desesperança, nuvens negras do fascismo e da intolerância já são vistas no horizonte. A juventude assiste ao despontar de lideranças autoritárias, cujos discursos já se ouviram na ditatura: “Brasil, ame-o ou deixe-o”. Inevitavelmente, com a democracia ameaçada, a educação abandonada e o emprego que mal paga as contas não bastam estrelas, flores ou amores suficientes para permanecer no Brasil.', 'Assim, torna-se evidente que, sem estímulos, cada vez mais jovens abandonarão a pátria rumo aos países desenvolvidos. Lá, encontrarão boas escolas, universidades e empregos, além de impostos menores (comparados aos brasileiros); enfim, encontrarão oportunidades de ascensão social. Somente quando o Brasil ofertar dignidade para a sua juventude não haverá fuga da nova geração. Caso contrário, quem ouvirá a canção do sabiá?']",200,200,200,200,200,1000
67,Minoria esquecida,"['O descobrimento do Brasil no século XV, e sua posterior colonização pelo homem europeu, acarretaram na escravidão e massacre indígena e de sua cultura, desprezada pelo homem branco . Hoje o indígena é visto como um selvagem imaculado e cria-se reservas para isolá-los do contato metropolitano, mesmo com o fato ignorado de que eles são humanos e de que não precisam continuar a viver em condições precárias, suscetíveis a doenças e aparte da globalização e de seus benefícios.', 'Os indígenas a partir do contato europeu, passaram por significativas mudanças, sua existência foi considerada primitiva, e precisavam ser salvos ao mando do Senhor, na concepção colonizadora . Então, no processo de catequese, é iniciado um programa de assimilação cultural nos moldes do cristianismo europeu, paralelo a extração de recursos naturais para a metrópole lusitana, ao passo que um genocídio se desenvolvia na população indígena. Esse avanço gradual do litoral se expandindo ao interior é guiado pelos bandeirantes, que a procura de riquezas e índios para escravidão, remodelam as fronteiras brasileiras, quebrando o tratado de Tordesilhas com a potência ibérica.', 'Esse rentável comércio por forças de trabalho foi finalizado em 1750, quando a Coroa proíbe seu uso, especialmente pela pressão do clero, em detrimento da mão de obra escrava africana . O índio nos anos posteriores é idealizado pelo movimento literário do romantismo e pelo bom-selvagem de Rousseau, que influencia a perspectiva da sociedade até os dias atuais. Atualmente o índio é visto como um empecilho, ídolo imaculado e primitivo do homem, mas esquece-se que são humanos e que possuem necessidades e ambições, com fraca participação política e assistindo passíveis ao avanço agropecuário e ao desmatamento.', 'Para representar essa população tão intrínseca com a história brasileira, deve-se dar maior participação política e oportunidades de formação acadêmica e tecnológica por meio e um programa governamental em conjunto à instituições educacionais, assim como as de formação superior, sendo elas privadas ou não, associado a assessorias da Fundação Nacional do Índio (FUNAI), para adequar o programa às realidades locais e a diversidade cultural. Um programa regido pelos Estados da União que criaria gerações de índios integrados a política e as informações, acabando com um processo arrastado de segregação social.']",120,120,120,120,120,600
47,Os díspares entre o avanço tecnológico e a desigualdade,"['Com o advento da internet, no final do século XX, as relações sociais à longa distância foram intensificadas, gerando novos meios de comunicação e trocas de conhecimento, como a criação da modalidade de ensino a distância . No entanto, não foi criada nenhuma ferramenta de inclusão dos cidadãos de baixa renda nessa tecnologia revolucionária , fomentando uma barreira entre os que apresentam acesso à internet e os que não a possuem.', 'À princípio, é importante ressaltar que, com a 3ª Revolução Industrial, os investimentos em pesquisas foram intensificados, trazendo avanços tecnológicos à sociedade, como a internet. Em contrapartida, a desigualdade social e a falta de acesso à informação foram aguçadas, uma vez que a parcela da população, que não tem contato com a rede mundial de computadores, foi intensamente prejudicada, já que não teve acesso aos benefícios proporcionados e, consequentemente, caminhou contra o desenvolvimento.', 'Por conseguinte, a implantação de um ensino a distância eficiente, que abranja toda população, tornou-se uma utopia no atual cenário brasileiro, uma vez que, ao analisar as diferenças nos índices de desenvolvimento entre as regiões do país, como a Norte e a Sul, evidencia-se uma dualidade alarmante. Nessa lógica, a introdução de um ensino a distância na região Norte torna-se complexo, se comparado a regiões como Sul e Sudeste, que possuem índices de desenvolvimento maiores e, consequentemente, um maior número de pessoas conectadas à internet.', 'Infere-se, portanto, que é imprescindível a mitigação dos desafios para a geração de um ensino a distância democrático. Nesse sentido, urge que o Superministério do Desenvolvimento Regional , em parceria com o Ministério da Educação, crie políticas de inserção da população de baixa renda, das regiões com os menores índices de desenvolvimento do país, como a Norte e a Nordeste, na rede mundial de computadores, possibilitando sua participação no ensino remoto, por meio de verbas governamentais, a fim de diminuir essa dualidade entre regiões e democratizar o ensino . Desse modo, atenuar-se-ão, a médio e longo prazo, os impactos nocivos da desigualdade social proporcionada pela impossibilidade do acesso à internet e a coletividade aproximaria-se do clímax social.']",160,160,120,200,160,800
94,Desafios para inclusão nas escolas brasileiras,"['Na série americana “The Good Doctor”, Shawn é um jovem doutor, portador do transtorno do espectro do autismo (TEA), o qual se mostra um excelente profissional, mas o personagem acaba enfrentando sérios problemas de socialização e aceitação por parte de seus colegas de trabalho. Diante disso, o enredo americano expõe o notório desafio que as pessoas com autismo enfrentam para alcançar a inclusão nos ambientes da sociedade. É importante destacar que o ambiente escolar é um dos primeiros lugares de interação social do individuo, no entanto o processo inclusivo também se encontra enfraquecido no setor. Nesse sentido o problema se mostra fortificado devido à ineficiência legislativa e fraca presença familiar.', 'Primeiramente, é importante destacar a colaboração da ineficácia de leis para continuidade do impasse. John Locke, filósofo inglês, argumenta que “as leis fizeram-se para os homens e não para as leis”. Todavia o que é observável no cenário brasileiro são regimentos que não instiguem a inclusão de pessoas portadoras do TEA. Há falta de regulamento eficaz que invista na capacitação dos profissionais da educação para recepcionar e lidar da maneira correta com o grupo em questão.', 'Além disso, outra dificuldade é a desvaída presença familiar no ambiente escolar. O Estatuto da Criança e do Adolescente declara que a família tem o dever de assegurar à criança o direito à educação e ao bom convívio comunitário. Pais e responsáveis poderiam contribuir grandemente no detalhamento comportamental da criança ao professor(a), para que este tomasse o melhor caminho para a realização da inclusão . No entanto o que é visto é a falta de contribuição do grupo familiar, o qual acaba a deixar o dever totalmente nas mãos da escola.', 'Portanto, medidas são necessárias para a resolução do problema. Para esse fim é necessário ao poder legislativo investir na área da educação por meio da criação de emendas parlamentares, a fim de que os profissionais da educação possam ter um treinamento adequado para promoção da inclusão de autistas nos estabelecimentos educativos. O investimento pode, ainda, ser direcionado a projetos os quais contam com cursos e palestras de profissionais de conhecimento excepcional no segmento. Desta forma, com pequenos passos, a inclusão ganhará espaço.']",160,160,120,160,120,720
49,A profissão do século XXI,"['As redes sociais ampliaram os mecanismos de comunicação e a forma como os indivíduos se relacionam. Tal cenário rearranjou as possibilidades comerciais, principalmente, por meio dos influenciadores digitais, que exercem forte influência aos usuários dessas redes. Diante disso, o papel dos influenciadores exige atenção em função da qualidade do conteúdo divulgado, e a relação de dependência que provocam nos usuários.', 'Hábitos, costumes, roupas, viagens e eletrônicos têm sua venda ampliada por meio dos influenciadores digitais. Segundo pesquisa realizada pela revista EXAME, 77% dos consumidores consultam as redes sociais antes de efetivarem suas compras . Com isso, é evidente a necessidade de os influenciadores digitais assumirem uma posição ética ao indicar determinados produtos e serviços , zelando pela qualidade e transparência das informações, evitando frustrações e possíveis danos ao consumidor.', 'Ademais, o volume de informação diária superestimulam os usuários, o que pode causar não somente danos financeiros, como também danos psicológicos aos usuários ao gerar uma relação de dependência, ao passo que os influenciadores digitais vendem vidas perfeitas . Desse modo, tal dependência,  provoca o aumento dos quadros de ansiedade , principalmente observado entre crianças e adolescentes. Segundo dados da OMS – Organização Mundial da Saúde -, a ansiedade é considerada a doença do século que afeta milhões de brasileiros, a população mais ansiosa do mundo.', 'O papel dos influenciadores digitais é, portanto, a profissão do século XXI que mais influencia usuários nas redes. Por isso, é notória a necessidade de acelerar o processo de regulamentação da profissão por parte do poder público , de forma a estabelecer normas éticas de atuação profissional . Assim como, cabe aos administradores das plataformas e aos usuários fiscalizarem as publicações publicitárias e filtrarem as informações consumidas.']",160,160,120,160,160,760
92,A raça e a influencia,"['O preconceito é existente em toda a sociedade e é preciso o seu fim. Diversas vezes e por vários meios foi demonstrado a presença do prejulgamento racial pelo mundo todo. Pessoas com grande influencia, até mesmo do meio político, já apresentaram esse discurso de ódio entre as raças em suas redes sociais e em discursos para a rede nacional.', 'Por diversos anos o preconceito racial foi a base da humanidade, com a escravidão e a antipatia do ser humano com o próximo e devido a isso no livro ´´Pálido ponto azul´´ de Carl Sagan, o autor mostra a inutilidade da existencia desse repúdio racial, mostrando o quão pequeno somos de acordo com a vastidão do universo e demonstrando o quão errante o ser é ao ter essa atitude por meios astrológicos.', 'Desde o surgimento do vírus da covid-19 alguns políticos demonstraram um discurso de ódio para com asiáticos dizendo que a culpa da existencia do vírus eram dos mesmos e com isso acabou se espalhando e se tornando o discurso de muitos dos seguidores desses políticos, assim fazendo com que o preconceito com chineses aumentasse pelas palavras usadas por esses influentes.', 'Portando, é notório que é real o preconceito amarelo e que muitas dessas pessoas que cometem esse ato de repúdio racial são influenciadas por quem seguem e escutam.', 'Por isso, é necessário que o governo identifique os políticos e influentes de mídia que praticam essa ato e aplique multas e advertencias e também o investimento na educação para que as pessoas não sejam mais influenciadas por esses comentários.']",160,120,80,160,120,640
145,A herança da Copa no Brasil,"['A Copa         no         Mundo         do         Brasil vem gerando grandes oportunidades aos brasileiros. Devido a grandes investimentos, como estádios e         aeroportos         o número de desempregados vem diminuindo.', 'O Brasil vive o ano         na         Copa, ano de         desenvolvimento o         qual a população brasileira vem trabalhando cada vez mais . Mas a preocupação da sociedade é quanto         a         saúde e         a         educação, devido                 investirem muito em obras e esquecerem das necessidades básicas de cada indivíduo.', 'As condições da saúde e educação estão cada vez mais precárias devido         a         falta de investimento.         No qual esta         virando rotina brasileiros morrerem nos corredores dos hospitais, por não terem recursos suficientes. A educação nem se fala, muitas escolas não         tem         estrutura suficiente para                grande quantidade de alunos,                 os salários          baixo aos          professores levam          a          greve e os alunos ficam prejudicados sem aulas, e acabando se perdendo no caminho das drogas.', 'Portanto, as autoridades deveriam rever seus conceitos e não deixar que a Copa         Do         Mundo no Brasil         revoltem         mais a sociedade devido         as         precariedades e                falta de         recurso         .']",120,120,80,80,120,520
83,O papel do esporte na sociedade,"['Às vésperas das Olimpíadas do Rio, o país enfrenta índices de criminalidade extremamente elevados. A ironia é que, os esportes são justamente uma das maneiras mais eficazes para evitar que os jovens sejam aliciados pelo crime. Nesse sentido, fica claro um dos inúmeros problemas brasileiros, o mau aproveitamento das lições e benefícios que as práticas esportivas podem nos proporcionar.', 'Como nos mostra a biologia, a prática de esportes traz inúmeras vantagens para a saúde, tanto do corpo quanto da mente. Em uma sociedade em que problemas como obesidade, hipertensão e doenças cardíacas são cada vez mais comuns, fica evidente a necessidade de fomentar práticas saudáveis. Sendo os esportes a mais vantajosa delas. Jogos, brincadeiras e competições ensinam de forma natural e prazerosa como levar uma vida ativa e equilibrada.', 'Outrossim, é possível salientar o caráter social das práticas esportivas, o esporte é um excelente caminho para o jovem ocupar a mente e desenvolver o corpo. A criança que pratica esporte aprende a trabalhar em equipe e desenvolve bons hábitos de convívio social. Hábitos que fomentam a inclusão e o trabalho em equipe, que por sua vez têm um papel importante na luta contra a violência e a marginalização. Educadores são categóricos em dizer que os jovens que praticam esportes têm menos chances de abandonar a escola, além de serem menos propensos a se envolverem com drogas e com o crime.', 'Destarte, o papel inclusivo é um dos trunfos a serem aproveitados. E como disse o sociólogo Edgar Morin, é preciso substituir um pensamento que isola e separa por um que distingue e une. Dessa forma, as Paralimpíadas são, sem dúvidas, um dos maiores exemplos de inclusão social voltado a pessoas com deficiência. Os atletas mostram que são capazes de feitos extraordinários e dão exemplo de superação e união, servindo de inspiração para milhares de brasileiros.', 'Dessa forma, fica evidente a necessidade de o Estado investir em projetos e infraestrutura que garantam o acesso dos cidadãos às diversas formas e modalidades esportivas. ONGs e escolas também são fundamentais para universalizar o acesso, principalmente por meio de projetos em bairros de periferia e comunidades carentes. Iniciativas como abrir as escolas aos fins de semana são bons exemplos a serem explorados. Para se construir uma sociedade melhor é preciso trabalhar como um time.']",160,200,200,200,200,960
89,Consciência da população,"['De acordo com a OMS (Organização Mundial da Saúde) as medidas de isolamento social são as mais eficazes para evitar que o coronavírus continue se propagando pelo Brasil, elas  no entanto, não são levadas a sério pelos cidadãos e continuam sendo descumpridas, expondo uma gigantesca calamidade que assola o país atualmente.', 'Primeiramente, é importante ressaltar que o mundo como está hoje, é resultado de 1 ano de imprudência das pessoas e nesse período diversas atitudes foram tomadas para tentar fazer com que esse mal não chegasse a proporção em que está hoje. Inicialmente seriam apenas 15 dias de isolamento, como recomendado pelo ministério da saúde, mas por conta da irresponsabilidade das pessoas descumprindo o distanciamento social, o caos se instalou por completo e o número de casos continuou aumentando progressivamente.', 'Visto que o contágio pela doença se tornou maior, os estados aderiram ao “lockdown” como a melhor alternativa para tentar conter a propagação do vírus. Por consequência, muitos comércios e estabelecimentos fecharam suas portas para atender essa demanda, assim perdendo possivelmente a sua única fonte de renda. Mas, é importante lembrar que ao longo de todo esse ano muitos fecharam as portas definitivamente e se afundaram em dívidas profundas em decorrência disso.', 'Nesse contexto, é notório que se as medidas fossem acatadas desde o início pela população essa grave crise econômica poderia ter sido evitada. Assim, o governo deveria implementar medidas mais rígidas, como exemplo, impedir que veículos de passeio circulem pelas estradas durante os fins de semana, os ônibus comecem a circular pelas cidades com um número reduzido de pessoas, respeitando o distanciamento social e colocar mais policiais vigiando as ruas para evitar a circulação e aglomeração de um grande número de pessoas, além de que os cidadãos comecem a conscientizar os outros sobre a importância de se prevenir do contágio e de proteger seus amigos e familiares, para que o país consiga sair dessa grave crise.']",160,160,120,200,160,800
93,A humanização do parto,"['O artigo 6 da constituição federal brasileira, popularmente conhecido como “artigo social”, é um conjunto de leis que garantem a todo e qualquer brasileiro o acesso à educação, cultura, lazer, saúde e amparo. Por se tratar de um documento que defende os direitos básicos do ser humano, as leis também afirmam proteger a maternidade e a infância, algo que vem sendo colocado em prática com a popularização do conceito de “parto humanizado”, uma discussão relacionada saúde pública e que garante a autonomia e o respeito para com a mãe e o bebê na hora do parto.', 'Em primeira análise, é necessário compreender os motivos pelos quais o parto humanizado vem sendo tão requisitado nas últimas duas décadas. Por se tratar de um processo de extrema importância, complexidade e que pode trazer graves consequências se não realizado de forma eficaz, muitas mulheres acabam desenvolvendo um medo em relação ao momento de chegada do bebê ao mundo. Visando garantir que estas mulheres começassem a se sentir seguras, protegidas, respeitas e relaxadas, o que faria com que o procedimento ocorresse de maneira mais leve e natural, médicos e enfermeiros desenvolveram o “parto humanizado”, onde ambos mãe e filho são colocados em primeiro lugar.', 'Em segunda análise, o fato do corpo feminino ainda ser um grande tabu, principalmente em classes sociais menos valorizadas, acaba criando desconhecimento e fobia relacionados a processos naturais como a gravidez, o que causa insegurança por parte de mulheres grávidas, que ficam com grande receio e dúvida sobre a melhor forma de darem luz aos seus filhos e que não recorrem ao parto humanizado, já que o mesmo aparenta ser muito elitizado, se afastando da realidade de famílias de baixa classe social.', 'Portanto, medidas são necessárias para resolver o impasse. Segundo a teoria filosófica do utilitarismo, devemos gerar o bem para um maior número de pessoas, o que evidencia que o parto humanizado deve sim ser uma questão de saúde pública e acessível a qualquer pessoa. O Ministério da Saúde em conjunto com o SUS (Sistema Unificado de Saúde) devem  promover a opção do parto humanizado como algo seguro e de efeitos positivos, por meio de vídeos, palestras, entrevistas e cartazes, para que mulheres grávidas possam se sentir mais acolhidas e confiantes e a maternidade seja de fato protegida, como afirma o artigo 6.']",160,160,120,200,120,760
58,Quando vai parar?,"['Perda da biodiversidade, empobrecimento do solo, poluição dos rios; Estas são consequências do processo de desmatamento que vem ocorrendo há anos na floresta amazônica.', 'Devido atividade agropecuária na região, são feitas queimadas em áreas de pastagem, para enriquecimento do solo, pobre em nutrientes e eliminação de ervas daninhas, preparando-o para o próximo plantio de pasto, o que causa diversos focos de incêndio..Porém, em Agosto de 2019 a ação do homem excedeu aos anos anteriores, considerando que a seca no mês não foi tão severa quanto os mesmos, ocorrendo um aumento de 60% de focos de calor,segundo o IPAM .', 'A floresta amazônica possui a maior bacia hidrográfica do mundo,contendo 20% da água doce do planeta, bem como sua biodiversidade, que são ameaçados pelas queimadas e constantes desmatamentos,uma vez que afetam o ciclo hídrico do local, trazendo a ameaça de extinção a diversas espécies.', 'O problema pode ser minimizado com constantes fiscalizações, aplicações de multas e penalidades em conjunto ao trabalho preventivo, visando coibir a prática, bem como procedimentar alternativas de fertilização e manutenção do solo, de forma que não haja prejuízo ao bioma.']",120,80,80,120,80,480
143,(Sem título 073),"['Como todo ritual, o trote vem carregado de significados e tradições que estão presentes         desta         formação das primeiras universidades. É         necessário         uma discussão sobre o tema para definir limites, separar tradição e brincadeiras de abusos e atitudes criminosas. Além de identificar e sanar suas causas.', 'Existe uma linha tênue entre brincadeiras saudáveis e abusos         criminosos, quando o assusto         é abordado         logo, surge uma         argumento que muitas vezes parece unânime entre os         universitário         :                 a necessidade de tais trotes mesmo que, muita vezes, torturas evidentes e humilhações, como meio de aproximação entre veteranos e calouros, discordo.          Este          argumento é um meio de uma significação simplória e          infundada  , os         atos de torturas, submissão e humilhações podem, em alguns casos,         serem         equiparados à escravidão                 no aspecto de          superioridade  , e         quando a barreira dos direitos humanos é         rompida         entende-se o momento de parar.', 'Vestibulares, exames, concorrências são palavras conhecidas do mundo          universitários          ,                  e afirmam o ambiente competitivo das instituições superiores de ensino, que          leva          os estudantes, por muita vezes,                  desejarem testes físicos e psicológicos          a se mesmo          e seus          colegas          ensaiando seus próximos anos na instituição e futuramente no mercado de trabalho.                  Como uma significação dos ambientes das universidades promovendo uma comunidade de apoio e ajuda em vezes de competições e rivalidades além de abolir o trote físico, substituindo-o por alternativas mais humanizadas como iniciativas de integração e inserção no mundo universitário.']",80,80,80,0,0,240
68,Valores históricos,"['A valorização de um patrimônio histórico é altamente relevante diante a uma sociedade como um todo que representa seus valores, culturas, conquistas ao longo do tempo para ser prestigiada, pois aproximar esses sentimos através dos componentes da antiguidade, é que haverá possibilidade em pensar ainda mais na progressão do nosso  aís.', 'Sabe-se que desde antigamente,  guardar acontecimentos passados para ser projetados no futuro compreendendo certas circunstâncias e entendimento da evolução, é de natureza humana. A formação da sociedade principalmente na época da revolução francesa, obteve justificativas de litígios causados pelas contradições do governo entendido através dos patrimônios resguardados por cada geração.', 'Com isso, a falta de relevância para com o cuidado histórico está deixada por trás, e acarretará perda da produção científica. Não podemos esquecer que a Constituição Federal alega a competências do Poder Público nesta questão, a partir de seu artigo 24 e incisos seguintes. Entretanto, a ação popular também é válida e muito importante se a parte administrativa for conduzida de má-fé.', 'Fica evidente, portanto, que a valorização do patrimônio histórico é muito importante para usufruto de gerações presentes e futuras. Cabe ao Instituto do Patrimônio Histórico e Artístico Nacional (Iphan) fixada pelo Ministério da Cultura para proteger e atear bens culturais do aís, com melhora na estrutura dos locais, principalmente nos museus. Assim, será oferecido para a sociedade, o trabalho de educação e relevância dos patrimônios.']",160,120,120,120,120,640
54,Melhor prevenir,"['Durante o século xx,  ocorreu a Revolta da Vacina. Foi uma insurreição popular ocorrida no estado do Rio de Janeiro, onde a população era obrigada a se vacinar devido o governo sancionar um ofício. por causa da disseminação de doenças virais que estavam matando pessoas naquela época.', 'A falta de informação era tamanha que muitos chegaram a creditar que a vacinação seria um forma de matar a população carente. Então, após adotar campanhas de conscientização os governantes conseguiram erradicar uma série de patologias, ou seja, a varíola, o sarampo, a rubéola, dentre outras. Entretanto, o movimento antivacina vem influenciando uma parte da população a não se imunizar . De acordo com a Organização Mundial da Saúde (OMS), o movimento é tao perigoso quanto aos vírus que ameaçam a reverter o progresso alcançado no combate de doenças a doenças evitáveis por vacinação.', 'Em primeira analise, cabe destacar que que a vacinação continua sendo a forma mais segura e eficaz de prevenção, principalmente contra doenças infecciosas . Além disso, é a melhor maneira de se proteger de uma variedade de doenças graves e de suas complicações que podem levar a morte.', 'segundo  Organização Mundial da Saúde (OMS), as razões em que as pessoas escolhem a não se imunizar são a falta de confianças e dificuldade no acesso a elas. De acordo com o Programa Nacional de Imunização do Ministério da Saúde (PNI/MS), nos últimos dois anos a meta de ter 95% da população - alvo vacinada não foi alcançada.,  Por consequência, vacinas importantes como a treta viral, que previne o sarampo, caxumba, rubéola e varicela, teve o menor índice de cobertura no país.', 'Portanto, a vacina tem eficácia comprovada e é essencial para blindar o organismo contra doenças que ameaçam a saúde em todas as idades. Contudo, para que a população tenha mais informação sobre a importância de se imunizar o Ministério da Saúde junto com o Ministério da Educação devem criar palestras e campanhas informativas e aumentar o tempo de vacinação no posto de saúde. Além disso, o Governo Federal deve esclarecer e combate e esclarecer por meio de publicidade e mídias o surgimento de notícias falsas sobre a vacina. Dessa madeira, a população se conscientizará sobre a importância de se imunizar.']",120,120,80,120,120,560
90,Garantias contra transfobia,"['No filme de Batman, a cidade de Gotan vive uma elevada criminalidade onde a corrupção atinge todas as pessoas, do mesmo modo no Brasil, o público transexual sofre perseguições, roubos, abusos sexuais, discriminação e mortes. Nessas condições, há necessidade de discorrer sobre soluções para combater a transfobia no Brasil e apresentar suas causas e consequências.', 'Em primeiro lugar no que se refere s causas, é possível elencar entre o alto nível de criminalidade em que os transgêneros ficam assim submissos, devido principalmente s condições de baixa renda em que se encontram. Segundos os dados da delegacia de Polícia Civil as pessoas mais afetadas pela transfobia se encontram em condições financeiras abaixo de pelo menos um salário mínimo  assim elas ficam passíveis de andar desprotegidas nas ruas e pelas madrugadas.', 'Em segundo lugar uma das consequências da discriminação, por escolha pessoal do sexo, é a baixa admissão desse grupo no mercado de trabalho. Além disso, os que assumem algum emprego ficam mercê de maustratos, condições insalubres e pagamentos abaixo do salário mínimo, ainda atrasados, pois geralmente são trabalhos informais. De acordo com a ONU ( Organização das nações Unidas) foi apresentada uma agenda, conhecida como ""17 objetivos"" com 169 metas entre as quais está superar as reais condições, as quais o público travesti está submetido.', 'Portanto para combater a transfobia é necessário medidas comprovadas por pesquisas de grandes centros universitários. omo por exemplo nos Estados Unidos em que os transgêneros tem grande independência, sejam em direções de jornalismo ou seja na moda, através da educação e ciência, desse mesmo modo aqui no Brasil sob o auxílio de protestos e o apoio do congresso com leis que garantam a segurança, o trabalho e a vida assegurados pela constituição.']",160,120,120,200,120,720
89,,"['Diversas medidas foram implantadas no ano de 2020 com o objetivo de evitar a propagação e o avanço do Corona Vírus pelo mundo, tal como o isolamento social. No Brasil, país com alto índice de desemprego e grave crise econômica, entretanto, essas medidas não foram estritamente respeitadas por grande parte da população. Porém, fatores como a saúde coletiva e a divulgação de dados que comprovem a eficácia do isolamento podem ser determinantes para fazer com que a população, mesmo em um cenário de crise do setor financeiro, respeite o isolamento social e as medidas restritivas para conter o avanço do Covid-19.', 'Em primeiro lugar, vale destacar a importância da manutenção da saúde para a manutenção de qualquer outro setor. Essa relação de dependência direta comprova-se principalmente ao ser analisada em um cenário de pandemia, pois é evidente que a contaminação de grande parcela da população pelo novo corona vírus impacta negativamente o setor financeiro do país, uma vez que a grande parcela contaminada não deve exercer atividade remunerada. Dessa forma, mostra-se equivocada a ideia de violar as medidas restritivas impostas para evitar a crise econômica, quando essa violação pode, consequentemente, agravar a crise.', 'Ademais, é grande o número de pessoas que, por não ter conhecimento da eficácia de medidas restritivas como o isolamento social, optam por viola-las. O episódio conhecido como Revolta da Vacina, ocorrido no período oligárquico, em que muitas pessoas foram contra a vacinação para conter a varíola, confirma como a falta de informações necessárias leva a população a estigmatizar e a rejeitar medidas benéficas. Nesse contexto, torna-se evidente a necessidade da divulgação em massa de dados que comprovem a eficiência do isolamento social no combate ao vírus.', 'Diante dessa realidade, medidas que objetivam conscientizar a população a manter o isolamento mesmo em momentos de crise se fazem necessárias. É preciso que o governo federal, em parceria com o Ministério da Saúde, divulgue, através das mídias e veículos de comunicação, dados que comprovem a eficácia de se manter o isolamento social e as demais medidas restritivas. Aliado a isso, é preciso que a população em geral respeite as medidas impostas para conter o avanço do vírus, saindo de casa quando necessário e com o uso de máscara. Dessa forma, garantiremos uma sociedade mais conscientizada e segura do vírus responsável por tantas mortes.']",160,200,160,200,160,880
52,Gravidez na adolescência,"['Um dos maiores tabu, a gravidez na adolescência entrou em cena e passou a ser comentada em diversos estados e regiões brasileiras inclusive no mundo.', 'Muitas meninas entre 15 19 anos começaram a engravidar, comparado com o século passado que nessa faixa etária era considerado norma, porem, antigamente a vida era totalmente diferente, mais complicada, sem muitos recursos, tinha baixa infraestrutura e principalmente o ensino não tinha qualidade.', 'Mas neste século XXI, mais globalizado, cheio de recurso, contendo mais métodos contraceptivos, as meninas assim deveriam se cuidar e prevenir. Pois muita da vezes a gestação não é planejada  com isso, deixa sua vida para dedicar ao filho e acaba deixando a escola de lado e muita das vezes nem volta.', 'Outro problema que acarreta é que cada vez mais as relações não estão sendo realizadas com prevenção podendo transmitir doenças sexuais, que não há cura e gravidez nessa idade trás riscos tanto a mãe quanto ao bebê pois o corpo não esta preparado e formado para uma gestação.', 'Portanto deveriam utilizar os métodos contraceptivos oferecidos e mais palestras feitas nas escolas para a conscientização de todos já no caso de regiões subdesenvolvidas como Norte e Nordeste, deveria ser o foco de melhoria para o Brasil.']",120,80,80,80,40,400
111,Será que uma mudança seria o suficiente?,"['As pessoas tomam bebidas sem parar, não são todas, mas a grande maioria. Tudo bem que elas usam o dinheiro que ganham com o trabalho para comprar, só que o que elas não pensam         que         dirigindo embriagadas                causam acidentes, perdendo sua vida e até de outras pessoas. Por causa disso o governo criou o que chamamos de         lei seca,         onde se o bafômetro marcar 0,6 gramas por litro de sangue ou mais de álcool,                 a pessoa é condenada.                Com isso diminuiu muito         as         pessoas que dirigem sob efeito do álcool, talvez por terem medo, entretanto, o problema não cessou.', 'O governo também criou uma         lei onde         menores de 18 anos não podem comprar bebidas alcoólicas e         nem consumir,         tendo os maiores de idade que mostrar o RG (carteira de         identificação), além dos         estabelecimentos comerciais         não vender         a menores. Só que com certeza ocorre de pessoas com mais de 18 anos comprarem as bebidas e os menores tomarem escondidos, porque se alguém os vir consumindo, bem como o estabelecimento que vendeu, serão autuados,                 mas tecnicamente o local fez sua parte em vender a um maior, então por que ele terá que responder? Não tem um jeito de prevenir isso,          mas          diminuir com as tais leis.', 'Hoje existem propagandas de bebidas que passam a partir das         dez         horas, porém as de cervejas passam a qualquer hora, mostrando pessoas felizes, locais bonitos e mulheres, incentivando o consumo, principalmente         daquelas que têm a cabeça mais fraca.', 'A maioria da população acha que se não beberem não irão se divertir, mas isso é um mito que elas próprias inventaram. Se as tais bebidas não existissem,         acredito que seria         melhor, porque não teriam viciados e pessoas morrendo por causa disso. Porém existem e ninguém pode mudar isso, só que as pessoas poderiam ser mais responsáveis, ou seja, consumir bebidas quando tiverem idade e em pequenas quantidades, não precisando beber até ficarem         bêbadas e terem além de         coma alcoólico         ,         vir a causar sua morte ou de outras pessoas devido a acidentes graves.', 'Deveria existir mais controle, com leis mais rigorosas até mesmo mudando a Constituição, pois hoje existe uma brecha na lei que uma pessoa alcoolizada, se parada numa blitz, tem o direito de não fazer o teste do bafômetro, a fim de não produzir prova a si mesma. Porém, mesmo com leis rigorosas e mudanças na Constituição,                 as pessoas é que deveriam ter mais consciência e responsabilidade                já que poderão ser as mais prejudicadas.']",160,120,120,0,120,520
76,,"['Mulheres e homens coexistem, portanto qualquer tipo de sobreposição entre os gêneros é incoerente. Para aplicar a equidade entre os gêneros se faz necessário ampliar a visão dos problemas,  e entender a construção social dos homens e a sociedade patriarcal.', 'A forma como os homens são criados mudou muito pouco nos últimos 50 anos, segundo a instituição ONU Mulheres .  São educados para não ter nenhum traço e/ou ato feminino , porque isso é tido como ruim e banaliza sua virilidade. A masculinidade tóxica causa reproduções, ecos sociais, ditando regras e cargas sobre os indivíduos, direcionando o seu ser, agir e pensar.', 'A ideia do homem sendo superior a mulher é uma construção enraizada nos anos 4000 a.c (época que o patriarcado começou a se propagar). E ao longo de todo esse período a mulher foi reprimida , tida inferior e submissa. Até mesmo grandes filósofos como Schopenhauer apresentaram os ideais patriarcais: ""A mulher é um ser de cabelos longos e pensamentos curtos"". Essa construção social ainda embutida no subconsciente coletivo, é um claro reprodutor de desigualdades de gênero.', 'Por conseguinte a desafiadora equidade de gênero é algo muito mais vasto e de maior dificuldade que aparenta. A participação escolar é essencial para excitar discussões sobre o tema (para alunos e comunidade). A sua função se baseia em desconstruir e instruir, a nova geração e indivíduos, o ideal de equidade.']",120,200,120,160,120,720
82,Automedicação,"['A automedicação é praticada por uma grande porcentagem dos brasileiros. Em muitos casos  por conselho de família, amigos, vizinhos ou colegas de trabalho,  eles dizem que dar certo  sem saber o que pode causar depois, o objetivo destas  pessoas é fazer com que o sintoma desapareça. Em alguns casos os sintomas desaparecem, mas  em outros casos  diversos problemas aparecem. O melhor e o mais importante é se consultar com o médico, específico na área desejada, para  que indique qual medicamento é necessário.', 'Isso ocorre quando se tem dor de cabeça, diarreia, ou até mesmo quando se quer emagrecer ou engordar, muita pessoa vai  pelo que os outros achar , mas o importante é seguir quem sabe, e quem sabe é o médico. Na maioria das vezes quando se tomar remédio indicado por alguém a dor passar, mas não se sabe o que ele causou dentro de você, e isso só é descoberto depois quando outros sintomas aparecem. O pior é que  mesmo sabendo dos problemas que isso pode causar  muitas pessoas não querem sabe , só querem se sentir aliviadas.', 'Automedicação não é só tomar remédios sem orientação medica mais  também tomar dose duplas e não cumprir o horário do medicamento mesmo que o medicamento tenha sido orientado pelo médico ou farmacêutico, apesar de qualquer pessoa pode  passar mal  o risco é mais  em crianças, idosos e pessoas com doenças crônicas, pois são mais frágeis.', 'Portanto, o uso de medicamentos sem autorização do médico causar  muitos problemas que poderiam ser evitados sem o automedicamento. O importante é se consultar, seguir as orientações do médico, evitando assim danos à saúde  e doenças indesejáveis não vão aparecer  não tem nada melhor do que viver bem tendo uma ótima saúde.']",80,80,80,80,80,400
76,,"['A igualdade de direito e oportunidade de gênero é uma conquista que toda sociedade deve buscar na sua construção como nação. A equidade exemplificada como “tratar desigual os desiguais”, ou seja, é prover maior auxilio para quem mais necessita . Para sanar essa questão, devem-se levar em conta todos os dados, opiniões e politicas públicas viáveis.', 'É nítido pelos dados de institutos econômicos como o IPEA, que as mulheres possuem remuneração inferior ao homem. O papel coadjuvante da mulher em determinadas áreas remonta da formação da sociedade brasileira, como Gilberto Freire aponta em seu livro Casa Grande e Senzala, em que todos os componentes da sociedade sobreviviam ao redor da casa grande, como escravos e trabalhadores que estavam submissos ao poder patriarcal, inclusive as mulheres. A participação feminina no período colonial estava ligada basicamente nos trabalhos domésticos e dos criados da residência, posteriormente no século XX, direitos ao sufrágio universal e participação na politica permitiram maior presença feminina nas grandes decisões do país.', 'Embora seja maioria no ensino superior, as mulheres ocupam pequena parcela em cargos de chefia nas empresas. Diversos fatores são apresentados como motivos para essa desigualdade na sociedade, como a dupla jornada que as mulheres realizam somado aos trabalhos domésticos, à cultura em determinados setores de trabalho em que a presença masculina é dominante como a engenharia civil. Porém, a busca por igualdade avança em alguns pontos, embora ainda pequena, os números do Tribunal Superior Eleitoral apontam que o numero de mulheres em partidos políticos e em cargos do executivo e legislativo aumentou nas últimas décadas. O Ministério do Trabalho aponta que a taxa de mulheres com carteira assinada cresceu progressivamente nos últimos anos.', 'Portanto, a busca pela igualdade de gênero é primordial para o crescimento social brasileiro. Devendo a equidade ser usada para minimizar esse problema . Medidas como incentivo  a participação feminina em áreas que são predominantes masculinas, educação escolar e familiar para a importância dessa ação na sociedade, além de fiscalização de órgãos como o Ministério publico e secretarias do trabalho no tocante a igualdade de oportunidades, ajudaram a conceber uma sociedade mais justa.']",120,160,160,160,120,720
55,Valorizando e cuidando,"['As grandes navegações do século XV trouxeram imensuráveis impactos na América, continente que tinha sido recém-descoberto. Essas mudanças devem-se ao desmatamento e as mortes dos nativos, além da imposição cultural europeia. Além dos índios, a natureza sofreu inúmeras perdas, como as queimadas e o desequilíbrio trófico e ambiental. Não obstante, os direitos indígenas, garantidos na Constituição, e a valorização cultural  são tópicos imprescindíveis na compreensão da história brasileira.', 'A priori, os direitos inalienáveis destinados aos indígenas asseguram território exclusivo para a manutenção dos costumes e da sobrevivência do índio. A Constituição Federal de 1988 garantiu áreas indígenas, como o Parque do Xingu. Além disso, o povo nativo é considerado “guardião” da natureza, devido ao cuidado e respeito com o ecossistema, possibilitando a redução das taxas de desmatamento, que estão diretamente ligadas as regiões destinadas aos aborígenes. Todavia, para o líder do povo Yanomami, Davi Kopenawa, as expansões agrícolas e urbanas estão ameaçando a comunidade indígena como um todo.', 'Deve-se ressaltar,  a valorização cultural contribuiu diretamente na construção de uma identidade nacional . Analogamente, José de Alencar na obra O Guarani, buscou criar uma identidade cultural, valorizando o índio e os seus costumes. A manutenção da cultura indígena está intrinsecamente ligada no cotidiano brasileiro, demonstrando o alto nível de integração e de compartilhamento de conhecimento.', 'Assim sendo, a valorização da cultura indígena é importante na manutenção da identidade cultural, como também os direitos assegurados aos aborígenes garantem a preservação da natureza e dos costumes dos nativos. Entretanto, para a efetivação dos direitos inalienáveis, é necessário que o Ministério Público junto com a Funai  e outras instituições garantam a continuidade das áreas indígenas, por meio de fiscalizações, multas e dados sobre as expansões agrícolas e urbanas, para que haja a concreta continuidade do povo indígena, além de sua cultura e costumes para as próximas gerações.']",160,160,120,160,120,720
118,A Racionalidade Humana em Defesa dos Animais,"['A utilização de animais como         cabaia         para experimentos científicos é muito polêmica. Alguns se mostram a favor, alegando ser essencial para a descoberta da cura de doenças em humanos; outros se mostram contra e alegam maus tratos e sofrimento animal. A recente manifestação para a libertação de cães do Instituto Royal trouxe, mais uma vez, esse assunto à tona.', 'As pesquisas científicas evoluem a cada ano e muitas doenças já foram controladas e curadas graças a essas pesquisas,         onde         muitas utilizaram animais como cobaias. É indiscutível a importância da ciência para a saúde humana, mas até onde vamos para conquistar nosso         bem estar         ? Seria preciso acabar com o         bem estar         do outro (mesmo que esse outro seja um animal) simplesmente para garantir o nosso?', 'Os bichos possuem emoções e sofrem como os seres humanos. Deixar uma animal preso, sendo maltratado, morrendo com o desenvolvimento de doenças ""programadas"" pelos cientistas não é ético.                 Por isso, manifestantes invadiram o instituto Royal no mês de outubro para libertar cachorros da raça Beagle que estavam sendo usados como cobaias.                  Essas manifestações se mostraram violentas e muitos experimentos em finalização foram destruídos pelos ativistas, além de carros de reportagem incendiados.          Esses movimentos          chamam a atenção de muitas pessoas, reunindo não só aqueles que buscam a liberdade do animais, mas também aqueles que procuram a violência e a confusão.', 'A evolução da ciência e da medicina é incontestável.                 Elas deveriam se unir                mais do que nunca, a fim de descobrir um meio de ampliar seus experimentos de maneira ética,         onde         nenhum ser vivo estaria envolvido, ou, na impossibilidade disso,                minimizar o sofrimento do animal seja de que espécie for:                 cachorro, coelho, macacos ou ratos.                A superioridade racional do homem o obrigada         a cuidar e proteger os animais         e não se aproveitar da sua impossibilidade de defesa.']",160,160,160,120,120,720
18,Direitos Humanos é  para todos os humanos?,"['Direitos Humanos (DH) são os direitos básicos de qualquer ser humano como o direito à vida, à dignidade, à liberdade, à saúde, à educação. E há um orgão responsável pela defesa desses direitos a todos. Entretanto fica a seguinte questão: esses direitos, será que é atribuído de maneira igualitária a todos os brasileiros?', 'Cada vez que assistimos um noticiário ou lemos algum jornal fica claro que esses direitos não são atribuídos de maneira igualitária a todos os cidadão mas com uma certa tendência a um grupo de indivíduos que apavora a população de bem.', 'Os fatos mostram: quantas vezes vemos os direitos humanos se manifestando contra a atividade policial em defesa de um marginal em casos que um bandido morre por troca de tiros com a polícia, porém,  ao contrário – casos em que o policial é morto por criminosos - não se manifesta qualquer integrantes dos DH contra o marginal em defesa do policial.', 'Um exemplo muito recente , foi a morte de três militares do Exército Brasileiro no final do mês de agosto na Intevenção Militar . Não houve qualquer ação dos DH em defesa da vida dos militares e contra os marginais. Apenas omissão.', 'Além dos agentes de segurança pública, a população civil de bem também sofre com essa diferença de tratamento. Só lembrarmos do caso “champinha”  - estrupador menos de idade que estrupou em rodízio uma adolescente de 16 anos e depois a degolou. Os Direitos Humanos lutou ferrenhamente no direito de defensa dos marginais, entretanto, não houve qualquer luta do mesmo orgão a favor da vida violada da adolescente contra os marginais.', 'Em vista dos argumentos apresentados fica evidente a discrepancia do tratamento dos DH frequentemente polarizado à parcela criminosa da sociedade. A melhor forma dos Direitos Humanos ser igual para todos é acabar com a inversão de valores e acabar com as ideias equivocadas de que todos os criminosos são apenas vitimas da sociedade. Direitos humanos não devem ser só para marginais, mas, principalmente, para pessoas direitas.']",120,120,120,120,120,600
88,O impacto que a depressão causa na vida das pessoas.,"['Na série 13 Reasons Why a personagem Hannah de uma doença mental extremamente grave, depressão. Sendo assim a série aborda o impacto que a depressão causa na vida das pessoas que convivem com ela. Além de mostrar os 13 motivos pelos quais ela decidiu se suicidar.', 'No entanto, esse não é um caso isolado, a depressão atinge milhões de pessoas no mundo e no Brasil não seria diferente. São mais de 11 milhões de brasileiros que lidam com essa doença e todos os outros males que ela pode ocasionar. Isso sem contar com outros transtornos mentais.', 'Como se não bastasse o fato de conviver com uma doença mental, quem convive com isso ainda tem de lidar com um préjulgamento imposto pela sociedade. O que não deveria acontecer, porque doenças mentais causam dores como todas as outras. Elas deixam feridas que podem ser incuráveis, se não forem tratadas de forma correta.', 'Para tentar evitar um pouco do sofrimento causado pelos transtornos mentais, é de extrema importância,  ter um tratamento adequado e o apoio constante da família. Isso pode evitar que coisas piores aconteçam. Assim como aconteceu à Hannah.']",160,120,120,160,160,720
141,A relação mundial da crise na Zona do Euro,"['A crise que abateu os Estados Unidos da América em 2008                , somada a uma negligência ao controle dos gastos, ou seja, o descontrole que alguns países europeus tiveram em gastar mais do que puderam arrecadar com impostos, levaram os países da Zona do Euro, em 2009, a uma crise econômica preocupante em âmbito regional e também mundial.', 'O euro é uma moeda muito influente no mundo, perdendo apenas para o dólar. A atual crise na         eurozona         tende a aumentar porque com o atual déficit monetário, as importações dos países, principalmente dos mais afetados: PIGS (Portugal, Irlanda, Grécia e Espanha), tende a diminuir de maneira considerável, devido à adoção de pacotes de austeridade         que          alguns países aderiram                . Além disso, os países que comercializam com os afetados pela crise reduziram de forma significativa seu comércio por medo de         um não retono         de capital.', 'Com a         redução da participação desses países na economia mundial         e, pela  redução do valor         do euro, a economia mundial deve alertar-se.                 É possível que essa crise se alastre para as economias mais frágeis, que não é o caso do Brasil, e repercuta de maneira catastrófica pelo fato de que a aliança entre os países da União Europeia facilita a resolução dessa crise, o que não aconteceria em outras economias mais isoladas.                O Brasil está longe de afetar-se de maneira considerável, desde que essa crise não perdure, pois ele se encontra em uma fase economia estável e ascendente.', 'Para auxiliar a resolução dessa crise e evitar que ela se alastre, é preciso que os países ligados economicamente à         zona do euro,         não reduzam seus investimentos e comércio com aquela região, dessa forma evitando que a economia dos debilitados retraia ainda mais e assim eles possam sair da crise com o apoio mundial.']",160,160,160,160,160,800
92,**Como combater o preconceito amarelo*,"['Na Era Vargas, os japoneses e chineses eram representados de maneira estereotipada pelas revistas e charges da época, pois tais indivíduos eram considerados imigrantes indesejáveis. No Brasil atual isso não ocorre mais, porém, ainda é possível observar que o preconceito contra os amarelos continua presente na sociedade . Nesse contexto, percebe-se a configuração de um grave problema em virtude da lenta mudança de mentalidade e do silenciamento.', 'Convém ressaltar, a princípio, que a lenta mudança de mentalidade é um fator determinante para a persistência do impasse. De acordo com Durkheim, o fato social é a maneira coletiva de agir e de pensar. Seguindo essa linha de raciocínio, nota-se que o racismo contra pessoas de origem ou ascendência asiática pode ser encaixado na teoria do sociólogo, uma vez que, se as pessoas crescem inseridas em um contexto social discriminatório, a tendência é adotar esse comportamento também. Assim, o fortalecimento do pensamento preconceituoso, transmitido de geração em geração, resulta numa sociedade cada vez mais xenofóbica em relação aos indivíduos que são amarelos.', 'Além disso, outra dificuldade enfrentada é o silenciamento. Segundo o filósofo Habermas, a linguagem é uma verdadeira forma de ação. Dessa forma, para que um problema como o preconceito contra os amarelos seja resolvido, faz-se necessário debater sobre. Entretanto, percebe-se uma lacuna no que se refere a essa questão, que ainda é muito silenciada. Portanto, trazer à pauta esse tema e debatê-lo amplamente aumentaria a chance de atuação nele.', 'Logo, medidas estratégicas são necessárias para alterar esse cenário. Para que isso ocorra  o Ministério da Educação, juntamente com o Ministério da Mulher, da Família e dos Direitos Humanos, devem desenvolver palestras em escolas por meio de entrevistas com as vítimas do problema, bem como especialistas no assunto. Tais palestras devem ser webconferenciadas e divulgadas nas redes sociais dos ministérios, com o objetivo de alcançar um público maior e trazer mais lucidez sobre o preconceito amarelo. Assim, como propõe Habermas, encontraria-se um meio de solucionar a questão por meio do uso da linguagem.']",160,200,160,200,200,920
63,,"['A Revolução Industrial provocou a ruptura dos mecanismos antigos de produção , elevando consideravelmente a produtividade e o acesso aos bens de produção. Conquanto, os impactos ambientais acarretados por essa atividade ao longo de décadas são enormes. Nessa perspectiva, esses desafios devem ser superados para a constituição de uma sociedade equilibrada em termos econômicos e ambientais.', 'A economia é o motor do desenvolvimento de um país. Hodiernamente, o Brasil ocupa a nona posição no ranking das maiores economias do mundo, com uma matriz de fabricação atuante nos três setores de produção . Independente da área de atuação, seja agricultura, indústria ou serviços, os impactos ambientais provocados afetam o planeta e os seres vivos de diversas formas: soluição dos rios por rejeitos industrias e de mineração, poluição do ar por fuligem industrial, além da posição sonora e visual nos grandes centros urbanos.', 'Outrossim, segundo o Físico Albert Einstein,  “Tornou-se aterradoramente claro que a nossa tecnologia ultrapassou a nossa Humanidade”. Essa frase demonstra o descompasso na relação do ser humano com o meio ambiente. Além disso, a falta de uma legislação ambiental rigorosa e a baixa fiscalização pelos órgãos competentes facilita a atuação das grandes corporações que atuam de forma irregular, principalmente no setor de mineração.', 'É evidente, portanto, que ainda há entraves para garantir o equilíbrio entre o desenvolvimento econômico e ambiental. Destarte, o estado, principalmente o poder legislativo deve atualizar a legislação atual por meio de projeto de lei ou proposta de emenda constitucional, caso seja necessário. Além disso, investir na capacitação dos fiscais responsáveis por setores como indústria e mineração, para que os laudos estejam adequados às normas ambientes. Dessa forma, o respeito ao patrimônio ambiental do país será conquistado, sem que seja deixado de lado o papel da economia para o desenvolvimento da nação.']",160,160,160,120,160,760
91,,"['A revolta da vacina foi uma revolta popular de 1904, ocorrida no Rio de Janeiro, na qual aconteceu o protesto contra a vacinação da varíola. Com base nesse fato histórico, é possível analisar a similaridade com o atual cenário brasileiro, em que a ciência está depreciada, e com isso as mentiras decorrentes da falta de informação afetam a sociedade num todo. Isso posto, é de extrema importância o debate de tal problemática.', 'Primeiramente, o negacionismo científico é nocivo para a população, uma vez que causa a dúvida sobre algo cientificamente já provado, que por consequência, a incerteza das pessoas em acreditar nos cientistas, e infelizmente, essa grave situação é visível nos dias atuais . Pode-se ter como exemplo os grupos anti-vacina e terraplanistas, que cresceram nos últimos anos, mesmo que tudo o que acreditam ser verdade, já tenham sido refutadas cientificamente. Isso vai de oposto o que diz o economista e filósofo Adam mith, em que a ciência é o grande antídoto contra o veneno do entusiasmo e da superstição. Em suma, a descrença com a ciência atualmente é compartilhado por um alto número de pessoas, deixando os cientistas em descrédito no país.', 'Além disso, é possível afirmar a influência das redes sociais para tal problema, em que uma imagem com falsa informação é compartilhada por milhares, espalhando o desconhecimento. No artigo publicado na revista Organicon, por Pollyana Ferrari e Margareth Boarini, é falado do perigo que o negacionismo e a desinformação causam, pois alastram-se indiscriminadamente, gerando confusão à população, reforçando a negação da ciência. Com isso, muitos não procuram a veracidade dessas informações, sem pesquisar a opinião de profissionais da área. Assim sendo, se não houver medidas para reverter esse panorama, materiais falsos atingirão muito mais pessoas.', 'Portanto, o Ministério da Educação com parcerias de escolas, devem usar plataformas digitais e rede televisional, para mostrar vídeos com professores da área, desmentindo informações falsas. Ademais, as redes sociais devem ser mais rígidas em relação ao compartilhamento de informações errôneas, excluindo imagens ou post contendo esse material. Assim, o real conhecimento será cada vez mais consumido pela população, aumentando a valorização da ciência e cientistas no país.']",160,160,160,160,160,800
78,Reforma na educação e suas consequências,"['Sancionada pelo atual presidente, Michel Temer, a medida provisória da reforma do ensino médio - também conhecida como ""MP da Educação"" - tem causado discussões e análises sobre seus benefícios e pontos fracos. A reforma deseja alterar  pontos como: personalização da grade curricular, escolas em tempo integral e contratação de profissionais sem diploma, mas com notório saber na área.', 'É evidente que o ensino médio (e toda a educação brasileira) necessita de uma reforma. Pesquisas do governo afirmam que um milhão de jovens entre 16 e 18 anos estão fora da escola, sendo que 33% desses justificam essa ausência pela falta de interesse nas escolas.  Ou seja, a escola já não atrai mais o aluno e esse, por falta de maturidade, não entende o porquê estudar. Assim, fica mais claro que uma mudança ou reforma será um grande um passo para atrair os estudantes , porém, existem pontos falhos que podem prejudicá-los.', 'Vale salientar que as mudanças da ""MP da Educação"" serão aplicadas apenas nas escolas públicas, enquanto as escolas particulares seguem com grades completas. Observamos, então, um desiquilíbrio no processo de formação, já que as escolas públicas forneceram  uma grade curricular menor. Outro tema muito discutido é que a reforma proporcionará ensino técnico e profissionalizante. Nasce, então, uma indagação: o aluno da rede pública será formado para ingressar no mercado de trabalho técnico enquanto o aluno da rede particular estudará para entrar nas melhores faculdades?', 'Por fim, fica claro que uma reforma no ensino deve acontecer, mas que a atual solução aumentará as desigualdades entre as redes privadas e públicas de ensino. É necessário,primeiramente, transformar a educação básica e, a partir daí, formar jovens maduros e capazes de escolher o que será melhor para cada um, respeitando suas aptidões, vontades e conhecimentos.']",160,160,160,160,160,800
144,Sensato equilíbrio.,"['Dotadas de caráter, extrema dedicação, inteligência e força de vontade. Superando diversos obstáculos e preconceitos impostos pela sociedade tradicionalista. A mulher                hoje ocupa                 locais, lugares e posições                de destaque em vários campos, segmentos e principais cargos de comando em maior parte do mundo.', 'Durante muito tempo discriminadas,         onde         para a maior parte das pessoas o sexo feminino deveria ter seu lugar apenas em frente a tanques e fogões, elas superaram barreiras, qualificaram-se profissionalmente e buscaram no mercado de trabalho lugares que há pouco tempo eram ocupados única e exclusivamente por homens.', 'Vivemos em uma sociedade capitalista, individualista e consumista, que impõe regras, as quais não sendo cumpridas fogem de um padrão aceitável, que uma vez imaginariamente outorgadas assemelham-se a uma ditadura militar.', 'O tempo mostrou a capacidade                . Mesmo sujeitas         as         jornadas duplas de serviço, dentro e fora de casa,                 a sociedade abriu sua mente                . A globalização teve sua contribuição que foi fundamental. A necessidade de crescimento em                 suas                diversas áreas, políticas, sociais e econômicas, propiciaram uma enorme abertura, pois necessitava                de mais pessoas, mais contingente, e é inegável que baseado nas informações dos órgãos de controle estátistico e geográfico de cada Estado, o número de mulheres supera o de homens na maior parte dos países.', 'Definitivamente, graças a uma incansável luta de mães, companheiras, filhas e pessoas eivadas de coragem e determinação, hoje podemos dizer que vivemos, sem sombra de dúvida, bem melhor, em locais que são mais harmônicos e de beleza ímpar, pois nada como lugares justos entre pessoas                 e que simples diferença entre o sexo faziam tão grande importância e extremo mal repugnante para a humanidade.                  Enfim,a capacidade das pessoas deve sempre ser analisada pelo esforço e merecimento intelectual, o caráter seja levado em conta e os caminhos da razão sempre trilhados para que nunca o respeito deixe de prevalecer.']",120,120,80,80,80,480
55,As raízes culturais,"['Sabe-se que em 1500 com a chegada dos portugueses em terras brasileiras,milhões de índios já habitavam o país. Conseguinte dessa vinda  os nativos foram submetidos a novos costumes e doenças que ocasionaram diversas mortes. A falta de conhecimento e até o preconceito social contribuem para quase inexistência da cultura indígena atualmente. partir disso vemos  que transformações precisam ser feitas para preservar a identidade cultural brasileira.', 'Vale ressaltar, a principio a ineficiência no cumprimento de leis que protegem os direitos indígenas. A Funai (Fundação Nacional do Índio) reconhece que 85% das reservas sofrem constantes invasões, logo observa-se a extinção de penalidades por parte do governo e a falta de multas aos responsáveis por apropriação indébita.', 'Ainda convém lembrar, dos costumes e praticas que refletem a extensa diversidade doada pelos índios, tais como atividades de caça e culinária,a influência das línguas indígenas na própria língua portuguesa, o respeito que possuem pela conservação da biodiversidade e uso de plantas para fins medicinais,são algumas das heranças deixadas por eles que sofrem grande desvalorização e esquecimento.', '""O preconceito é opnião sem conhecimento"" a frase do filósofo iluminista Voltaire sem encaixa bem nesse contexto ,pois, a falta de entendimento sobre o assunto leva a ignorância, consequente o preconceito ,portanto é essencial o governo investir em campanhas através da mídia para levar conhecimento a população a respeito da importância da valorização indígena. Fazse necessário também que a Funai ponha  em prática medidas mais rigorosas para aqueles que violam a lei. Assim, o Brasil passará estimar suas raízes culturais.']",120,120,120,120,120,600
146,Tempo ao tempo,"['Segregação racial. Nazismo. Escravidão. Tais vocábulos remetem a fatos históricos         marcados         pelo preconceito e discriminação. A mentalidade ultrapassada e a criação de         esteriótipos         podem ser classificadas como mola         propulssora         para tais ações,         atrelado a         falta de consciência moral que acarreta o racismo.', 'Episódios de desrespeito e hostilidade tornaram-se mais frequentes com jogadores brasileiros que são comparados pejorativamente a ""macacos"", não apenas em âmbito nacional, mas         majoritariamente         no exterior. Os valores de igualdade pregados pelo reverendo ícone         dessa batalha         Martin Luther King, nunca foram tão                 deturpados                .', 'Em função disso,                 gradativamente é          evidenciado          por meio de campanhas publicitárias a notariedade do negro em busca de quebrar rótulos                impostos por uma parcela da população, que persiste em enxergar o negro como inferior.', 'Diante de tal contexto, infere-se que a ética - como fator de harmonia social - deve ser estruturada e desenvolvida desde a base escolar e familiar.                 Sendo assim, fator primordial para um futuro igualitário, parafraseando um dos maiores nomes da literatura mundial, José Saramago: ""Não tenhamos pressa, mas não percamos tempo"".']",120,160,160,120,120,680
62,Mídias sociais e os discursos de ódio,"['A internet revolucionou a comunicação entre as pessoas, tornando-a quase que instantânea, imagens, notícias e dados chegam em poucos segundos a longas distâncias. Mas o que deveria servir para aproximar pessoas, acaba muitas vezes sendo usado para gerar discursos de ódio nas redes sociais. Uma nova publicação pode desencadear a formação de um tribunal virtual, onde sentenças são dadas e separam diferentes opiniões em diferentes trincheiras que disparam comentários carregados de rancor, preconceito e tudo o que mais perverso a mente humana possa imaginar. Essa situação obriga que a sociedade em geral tome consciência de seus atos e que as autoridades e gerenciadores dessas mídias tomem medidas mais efetivas conta o seu mau uso.', 'As pessoas devem ter em mente a consequência de suas publicações e comentários, pois podem gerar processos tanto na esfera cível quanto criminal, que além da dor de cabeça, podem gerar grandes prejuízos financeiros e a sua imagem pessoal e profissional . Além disto, o compartilhamento de publicações e ideias já foram responsáveis por tragédias ocorridas em várias partes do mundo, onde inocentes acusados injustamente por supostos crimes chegaram a serem mortos. Mesmo os casos ""mais simples"" podem ocasionar graves prolemas psicológicos nas vítimas.', 'Já as autoridades devem endurecer as leis já existentes, que apesar dos avanços, ainda pecam na punição dos autores desses crimes virtuais, não facilitam a busca dos verdadeiros donos dos falsos perfis que inundam a internet no Brasil e no mundo. Já as empresas que administram essas mídias tem o dever de dificultar a criação dessas falsas identidades, através de métodos que exijam algum documento pessoal para a criação de um novo perfil, por exemplo, e uma maior fiscalização do que é postado nessas redes.', 'Fica evidente a necessidade de inicialmente as pessoas repensarem suas atitudes nas redes sociais, tendo o discernimento do que publicam, pois podem gerar graves consequências tanto a elas quanto s pessoas que são suas vítimas. Mas o Estado também precisa mostrar que caso isso aconteça as pessoas terão punições severas e exemplares, cobrar dos gerenciadores destas mídias uma maior fiscalização para entrada de novos usuários e do que é veiculados nessas plataformas.']",120,120,120,120,120,600
43,O tribubal das redes sociais,"['A constituição brasileira diz que todos merecem respeito, porém nem todos têm. As pessoas negras, homossexuais e entre outras são alvos de piadinhas feitas na internet. Um meio que encontraram para combater isso nas redes sociais foi o cancelamento das pessoas que fazem comentários racistas, homofóbicos e que dilaceram a autoestima das pessoas . Consequentemente, aqueles que cometem isso sofrem com perda de fãns e chegada de críticas.', 'O meio em que vivemos nos torna pessoas cada vez mais vulneráveis á receberem críticas, sendo elas construtivas ou não. É correto corrigir um comentário desrespeitoso, esse é o objetivo do cancelamento . Um exemplo disso, foi o rejeitamento das pessoas após um comentário homofóbico feito pela cantora Marília Mendonça durante sua live. É nítido que a internet fez com que ela reconhecesse o seu erro e se desculpasse.', 'Esta cultura de cancelar pessoas desrespeitosas foi uma atitude para romper com o silêncio e dar voz queles que sofrem com piadas preconceituosas feitas virtualmente ou até mesmo pessoalmente. No entanto é crucial analisar, entender e formar uma opinião construtiva para que realmente esses comentários sejam combatidos de uma forma respeitosa e igualitária para que a pessoa perceba seu erro e corrija-o, e não apenas de uma forma julgadora com o intuíto de denegrir a imagem da pessoa para que ela fique desestruturada.', 'Assim sendo, o Ministério da Tecnologia  deve multar e banir as redes sociais de pessoas que fazem comentários que denigrem a humanidade, por meio de um projeto de lei que será entregue câmara dos deputados. A lei dirá que pessoas que fazem comentários racistas, homofóbicos e relacionados á beleza serão multadas, ou até mesmo presas, e sua conta na rede social será banida. Dessa forma espera-se que possa ser freado o preconceito e a falta de empatia, para que o cancelamento seja feito de forma correta e no momento exato.']",160,160,120,160,160,760
54,o melhor caminho para um país imunizado,"['Uma nação na qual, todos fossem vacinados, doenças como sarampo, catapora e caxumba seriam consideradas extintas. No entanto, o numero de pessoas vacinadas tem diminuído em todo o Brasil. Logo, doenças que uma vez já foram desconsideradas ameaças saúde, voltaram a assombrar o território brasileiro. Desse modo fatores como os movimentos antivacinas e a falta de verba para cobrir as campanhas disponíveis para todos, tem contribuído com a situação atual, onde a vacina tem sua importância desprezada, assim não esta conseguindo cumprir sua obrigação de prevenir doenças.', 'De certo, a oposição e a resistência da população brasileira em relação vacina, teve sua origem durante a presidência de Rodrigues Alves, no episódio conhecido como revolta da vacina, onde a importância da mesma era desconhecida pela população. Atualmente os brasileiros veem resistindo a vacinação, pelo fato de que surgiram notícias falsas originadas por um grupo de antivacina no qual afirma que esta atua como a doença propriamente dita, levando a casos mais sérios chegando até mesmo ao óbito. Estas noticias já foram desmentidas uma vez que tratava de casos extremamente isolados, além de que a vacina é uma imunização, que previne doenças que podem levar morte. Por tanto os movimentos antivacinas tem convencido muitas pessoas, consequentemente contribuindo para doenças reermergentes como, por exemplo, o sarampo.', 'Sobre tudo a carência de doses de vacina nos postos de saúde é uma das maiores responsáveis pela diminuição da procura desta , uma vez que durante o período de declínio da vacinação, a procura ainda sim, era maior do que a quantidade de materiais e substâncias fornecidas, contribuindo para que cada vez menos pessoas fossem a procura de mesma, pois sabiam que não a conseguiriam gratuitamente. É fato de que com a baixa procura pela imunização, muitos lugares estão com sobra destas substncias. Entretanto quando o problema supracitado for resolvido, a procura será maior do que a demanda, retomando ao antigo problema.', 'Desse modo, para que algumas doenças sejam extintas,  é necessário algumas mudanças, como: promover campanhas que conscientizem a população, seja por meio de novelas ou outros meios da mídia, como por exemplo o filme “ Uma razão para viver” no qual aborda sobre a doença poliomielite, evidenciando as consequências, os benefícios a importância da vacinação; o Unicef com uma parceria com o governo poderia promover palestras e implantar cuidadosamente campanhas dentro das instituições escolares, que incluíssem a família, fazendo com que assim cada vez mais pessoas fossem informadas sobre a imunização, desse modo aumentaria o numero de pessoas vacinadas, levando a erradicação de doenças, consequentemente o numero que hospitalizações diminuiriam e ocorreria reduções no gasto com medicamentos, assim sobraria dinheiro para investir mais nas campanhas de vacinação . Logo, o sonho de uma nação completamente imunizada não estaria muito longe de se alcançar.']",80,160,120,120,120,600
85,Sustentabilidade no meio ambiente,"['O sucesso no movimento Diretas Já a população brasileira tem o poder de votar em um “ícone” para representá-lo no meio Legislativo e Executivo. Além de conforme a Constituição , a sociedade ter (direito a) uma intervenção direta no plebiscito e nas iniciativas popular de leis populares.', 'Com a criação popular da lei “Sustentabilidade no meio ambiente”onde as indústrias, empresas e projetos devem plantar e reorganizar o que desmatou e o que gerou transtorno para animais em seu ciclo natural de vida (como alterações na terra, como na água), (;)terá um equilíbrio ambiental e na produção excessiva tendo como conseqüências menos impactos ambientais e no clima . Portanto o Governo poderá ter menos gastos em com problemas de saúde gerados por poluição do ar e dificuldades com água potável e afins.', 'A poluição das águas é uma conseqüência da rápida expansão industrial e do aumento demográfico que conforme as populações aumentam (e) a quantidade de dejetos lançados nos rios e mares crescem juntamente (com esses fatores). As indústrias por sua vez despejam nos rios e mares resíduos tóxicos podendo contaminar a vida biologia daquele lugar e poluindo as águas fluviais gerando problemas para a sociedade.', 'O ar é insubstituível para a existência dos seres vivos, sem o oxigênio morreríamos rapidamente. A poluição atmosférica causadas pelas indústrias e pelos veículos que utilizam combustível é altamente nociva a saúda da população, além de gerar ilhas de calor e mudar a temperatura.', 'O Brasil tem apenas quatro leis oriundas da iniciativa popular e nenhuma delas tem como base o meio ambiente. Os assassinatos, crimes e necessidade pessoal de um todo geram inúmeras leis e são importantes, porém a natureza pede socorro e a minoria a ouve. Se for ignorado inúmeros acidentes e alterações climáticas  gerada pelo excesso de poluição e desmatamento não será só o Brasil o que terá (como consequência) problemas graves.']",120,160,200,120,200,800
26,O profissional,"['Não é raro encontrar vídeos, relatos e matérias jornalísticas onde professores são ameaçados ou até mesmo sofrem algum tipo de agressão. Infelizmente, tal profissão no Brasil é considerada uma “segunda opção” para quem não consegue “fazer mais nada” . Porém como uma profissão tão necessária para a nossa formação como cidadão seja tratada de tal forma?', 'No Brasil, se preza muito pela melhoria na educação, sendo que os professores são extremamente desvalorizados, tanto pelos alunos quanto pelos pais. Uma pesquisa aponta que no continente asiático, os professores são mais renomados e possuem maior status, enquanto no Brasil, os profissionais recebem um tratamento oposto, onde nem os responsáveis querem ver seus filhos como professores. Um país onde um professor não consegue exercer o seu trabalho sem que se sinta ameaçado ou ridicularizado é realmente preocupante. Professores não só deveriam ser mais valorizados economicamente, mas também deveriam ser valorizados profissionalmente, como profissionais da educação e formadores de cidadãos. Todo profissional precisa ou já precisou de um professor.', 'Uma possível maneira de, aos poucos, melhorar tal situação, seria transmitir materiais publicitários e televisivos a respeito da profissão, exaltando sua importância em nossas vidas ou até mesmo em palestras fornecidas pelas escolas, onde os professores poderiam debater de maneira mais ampla diversos assuntos com os alunos e seus respectivos responsáveis.']",120,120,80,120,80,520
39,Impeachment nela,"['Dilma Rousseff não está em condições de governo . Não é necessário ser muito instruído para perceber que o país está passando por uma forte crise política e econômica.', 'Creio que a operação lava jato e o estado econômico atual são os principais motivos para o impeachment, hipótese afirmam que a presidente tem culpa diante dos escândalos da Petrobrás. A função de um presidente acima de tudo é fazer com que o país prospere, Dilma está no seu segundo mandato e pouca coisa mudou dez de que assumiu o poder.', 'O julgamento do impeachment é antes político do que jurídico, mas o que podemos esperar de um governo corrupto. Mas se os fatos de que a presidenta tem envolvimento com os escândalos da Petrobrás forem verídicos já é mais o suficiente para a perda do mandato.']",80,80,80,80,80,400
43,Linchamento de perfis,"['Precipuamente, segundo a filósofa Marilene Chauí, de forma sumária, cultura é qualquer costume da sociedade. Os internautas das redes sociais também possuem uma cultura que no auge do uso de redes sociais ficou conhecido como cancelamento, ato de excluir algum indivíduo por algum equivoco. Ação injusta e descomedida como muitos dos juízos de senso comum da população emergente de redes sociais.', 'Em primeiro lugar cabe uma analogia do cancelamento nas redes sociais com um linchamento na rua . Assim como no linchamento , não há oportunidade de o indivíduo se explicar , não há um julgamento formal, além disso a diferença é que num linchamento é atacado o corpo físico, mas no cancelamento é atacado o psco-emocional do indivíduo que do mesmo modo afeta a saúde do corpo, omo diz Augusto Cury, não há felicidade na incompreensão . Inclusive, muitas vezes o linchado na rua foi confundido pelo crime de outro. Na rede pode haver má interpretação. Alguém pode dizer: ""quem não quer ser repreendido pelo ato de ser cancelado que não erre ou não faça postagens que vão de encontro aos grupos sociais estabelecidos pela moda"", contudo quem é que não erra? E não é um direito democrático assegurado com todos os mecanismos da constituição a multiplicidade de pensamentos? Portanto, assim como um linchamento, o cancelar se torna desumano.', 'Na Roma antiga foi desenvolvido o Direito para que houvesse julgamentos de forma justa e comedida. Antes os indivíduos eram apedrejados ou assassinados por qualquer difamação e calúnia, com o direito passou a haver um juízo formal, onde seria cedido a oportunidade de o indivíduo difamado se expressar e de acordo com os fatos averiguados se defender e se justificar ou ser condenado. No entanto, o cancelamento que é uma ação emotiva do senso comum de um ascendente grupo de redes sociais não concede essa oportunidade e toma medidas emocionalmente violentas contra equívocos de um indivíduo. Chega a ir além não só por não conceder a formalidade citada, mas por agir de forma descomedida entre as ações e sentimentos. Deixa de ser assim uma atitude justa para ser um tribunal do ódio repressor.', 'Por fim essa injustiça sem equidade dos grupos de cancelamento, provenientes da terra sem lei que são as redes sociais, podem ser resolvidas do mesmo modo como foi padronizado na Roma antiga. Um tribunal cibernético que julgue determinadas atitudes e tome medidas de juízo proporcionais as postagens do indivíduo, como por exemplo faz o Facebook com qualquer publicação contra os direitos humanos. Ele impede a pessoa de publicar por determinado período. Traz assim uma reflexão construtiva sobre seu ato. Enquanto não for dado soberania a um órgão que atue na área cibernética através da determinação do Ministério da Tecnologia haverá vários linchamentos de perfis.']",160,120,120,160,120,680
52,A gravidez na adolescência e as influências da sociedade,"['É fato de que a cultura da mulher dona de casa e cuidadora dos filhos ainda é muito presente na sociedade - apesar dos avanços da atualidade, em todos os aspectos. É um modo de vida machista cultivado ao longo de vários anos e da história, em diversas realidades, religiões e modos de vida. Esse fator acaba se agravando quando as mulheres tornam-se maduras antes do tempo, por meio de uma gravidez precoce, por exemplo.', 'Uma gestação na adolescência pode ser ocasionada por diferentes motivos. Um deles é a falta de educação sexual nas escolas, que garante o entendimento por parte dos alunos sobre a importância da proteção durante as relações , dos riscos que a falta do uso de métodos contraceptivos pode causar, o conhecimento à respeito das Doenças Sexualmente Transmissíveis (DST), além de outros aspectos.', 'Outro motivo é a hipersexualização de menores , na qual as crianças acabam por amadurecer mais rápido - na maneira de se vestir e de agir - por conta de influências por parte dos amigos, família e, principalmente, pela internet. Acabam sendo persuadidas a agir de tal forma, mais adulta, por acharem mais interessante do que realizarem atividades de crianças propriamente ditas . Nessas condições, tendem a ter relações sexuais mais cedo, sem o mínimo conhecimento do assunto, resultando na gravidez.', 'Muitas vezes, o pai do bebê não assume seu devido papel na situação, deixando a mãe sem apoio paternal, na maioria das vezes tendo que esquecer-se dos estudos e focar-se somente na realidade de ter um dependente para cuidar. O fato de não ter concluído a escola acarreta na difícil procura por emprego, ainda mais com um recém-nascido - o que complica mais ainda.', 'Levando-se em consideração esses aspectos, é necessário que a educação sexual seja algo imprescindível nas escolas públicas e privadas, e que o apoio e suporte dos pais nessa fase de transição de pré-adolescência para adolescência seja muito forte . A sociedade também precisa mudar como um todo , não tolerando mais a ausência do pai na vida dos filhos (e vice versa).']",160,160,80,120,80,600
116,Mais ações e menos discursos,"['Com a chegada do ano novo, dentre as inúmeras preocupações que nos rondam, pode-se destacar a relacionada com as fortes chuvas. Esse evento climático provoca enchentes e não raras vezes mortes. Nos grandes centros, autoridades do         executivo         creditam ao excesso de chuva a culpa pelas catástrofes.', 'Presidente, governador e prefeito tentam esconder a falta de planejamento e investimentos para diminuir os efeitos das chuvas de verão que atormentam a população.                Essa população que financia a administração pública, ao pagar impostos, vê-se abandonada pelo poder público, cuja finalidade é propiciar o bem de estar de todos.', 'Falta ao administrador atual ações de prevenções contra as enchentes e deslizamentos.                Investir em infraestrutura e em sistemas de alertas contra inundações diminuirá o número de mortes no país. Isso é possível, uma vez que nações com índices de chuvas superiores, exemplo disso é a Austrália, registraram menos mortes.', 'Os governos devem priorizar o planejamento governamental                , a fim de evitar ocupações irregulares de morros, encostas e áreas próximas aos mananciais.                 A ocupação desordenada do solo precisa ser contida, já que disso depende o sistema de infraestrutura municipal.', 'Portanto, os governantes precisam deixar essa posição cômoda de atribuir a culpa pelas catástrofes ao excesso de chuvas. Priorizar a orientação à população e investir em obras públicas de urbanização         evitará         transtornos à sociedade e, consequentemente,         promoverá         o bem estar do cidadão.']",160,160,120,160,120,720
59,Inanição e outros maus hábitos,"['Segundo as teorias de Estratificação social de Karl Marx e Max Weber, a sociedade ao dividir-se em grupos de pessoas com interesse mútuo (políticos ou econômicos) sendo elas: castas, classes ou de estamento, inevitavelmente trazem o desnível da igualdade entre os indivíduos. Pode se dizer que essa desigualdade é oriunda apenas do dinheiro que falta no convívio diário do indivíduo, ou aparece também quando o que se tem pra comer já não alimenta?', 'Crimes conhecidos e bastante usuais nas grandes e pequenas cidades brasileiras são os de furto ou roubo de alimentos que sempre trazem tona a discussão de conceitos e pautas morais a respeito da linha tênue que configura o crime ou admite a necessidade.', 'Como visto no livro \'""The Power Of The Habit""\' em que o autor Charles Duhigg discorre em alguns de seus capítulos a respeito de como um único objeto (hábito) dito ""angular"", pode afetar centenas de outros fatores, como: indivíduos, corporações e até grandes redes, e que esses objetos ao serem revertidos e ou alterados, movem toda uma cadeia de adversidades próximas, mudando todo o corrente cenário por completo.', 'Roubo, furto, saúde prejudicada, cidadãos mais fracos e desinformados. Problemas sociais que poderiam ser amenizados com a distribuição correta de alimentos e administração do dinheiro público, seja baixando as taxas cobradas aos comércios das regiões de maior estatística ou voltado a leva de alimentos as zonas mais críticas, aos territórios de extrema pobreza e as famílias em risco.', 'Outrossim, como o psicólogo Abraham Maslow postulava em sua teoria da Pirâmide das necessidades  já no primeiro nível as necessidades fisiológicas (incluindo assim a fome) são imprescindíveis para o indivíduo, para que dessa forma, se sinta seguro e digno.']",120,160,80,80,40,480
83,,"['No contexto histórico, os jogos Olímpicos podem ser considerados uma forma de unir os países em uma disputa amigável e saúdavel em competições que abrangem várias competências. Países que estavam em guerra entravam em trégua na época dos jogos, na atual realidade, os jogos continuam sendo apreciados, mas deve-se ter em mente o papel do esporte na sociedade contemporânea.', 'Os esportes existem á muito tempo, na Grécia Antiga havia Maratonas em que apenas homens participavam e assistiam. Apesar de o esporte ser um hábito benéfico, é pouco praticado, ; o sedentarismo, somado ao excesso de comida industrializada, traz uma geração propensa a obesidade e doenças crônicas logo na infância e adolescência. Além disso, as novas gerações estão conectados e interligados apenas pela tecnologia, e se limitam ao universo virtual, sendo resistentes em praticar atividades físicas.', 'Muitos jovens só têm acessoá práticas esportivas nas escolas, e muitos outros não aproveitam ou ignoram os benefícios que estes trazem para a saúde, mantêm hábitos alimentares não-saúdaveis, e suas atividades são limitadas, (.) os relacionamentos interpessoais, que poderiam ser fortalecidos com o esporte e competição dão lugar a uma rede de conexão virtual, com relacionamentos que não são interativos e dinâmicos.', 'Portanto, medidas são necessárias para resolver esse impasse.  O Ministério da Saúde, em conjunto com o Mec, deve disponibilizar palestras com profissionais da saúde capacitados, afim de conscientizar os jovens sobre os maus hábitos alimentares e os problemas de saúde que o sedentarismo pode causar, (.) com isso, deve-se incentivar a prática de esportes e a interação dos jovens entre si. A competição saúdavel, além de estimular os adolescentes, podem ajudar no desenvolvimento destes, as várias lições que as modalidades trazem podem ensiná-los a obedecer regras, e respeitar seu adversário, ajudando no relacionamente  interpessoal. Além disso, o investimento nos esportes diminui o investimento em saúde e educação.']",160,160,160,120,200,800
49,A importância dos influenciadores na era da globalização,"['Com o advento da internet e a consolidação da globalização,  criou-se um cenário global no qual milhões de pessoas poderiam se conectar e ter acesso à informação acerca de diversos assuntos, o que permitiu, por exemplo, a criação de profissões como a dos influenciadores digitais. Através das redes sociais, esses usuários geram conteúdo e atraem seguidores, que muitas vezes têm confiança na informação divulgada pelos influenciadores e desse modo não os questiona.', 'No entanto, essa forma de pensamento pode levar à disseminação de notícias falsas se um influenciador não pesquisar as informações em fontes confiáveis antes de postá-las. Porém, caso seja feito um controle, esses profissionais podem usar sua influência de maneira contrária, combatendo a desinformação. Recentemente, devido à pandemia do novo coronavírus, a Cruz Vermelha contratou cerca de trinta influenciadores digitais para combater a desinformação do público através da divulgação de conteúdos essenciais acerca da doença. Essa medida foi tomada  pois, embora haja uma lista sobre as informações falsas em circulação no site da Organização Mundial de Saúde (OMS), essa não é acessível a todos e não impede a propagação dessas informações.', 'Atitudes como essa demonstram que, ao contrário do que alguns pensam, os influenciadores exercem um papel importante, o qual pode beneficiar grandes organizações ou pequenas empresas, visto que são uma boa estratégia de marketing. Porém, ao “formalizar” esta profissão, faz-se necessária a criação de uma legislação, proibindo a divulgação de conteúdos que desrespeitem os direitos autorais ou que contenham qualquer forma de discriminação.', 'Em suma, pode-se concluir que os influenciadores digitais exercem um papel de grande impacto na nossa  sociedade e, portanto, devem ser regulamentados, o que pode ser feito através de uma lei que determine regras acerca dos conteúdos publicados e que defina média salarial e carga horária para os influenciadores contratados por empresas . Outrossim, deve ser estabelecido um mecanismo de controle em redes sociais para evitar o compartilhamento de notícias falsas, como a exclusão de postagens após a denúncia ou confirmação de que seu conteúdo é ilegítimo e a realização de acordos com agências como a Lupa, que pesquisam e contradizem essas notícias. Desse modo, além de gerar empregos, seria assegurada a segurança e confiança dos usuários nas mídias.']",160,160,120,120,120,680
60,Não é apenas o sistema previdenciário o problema,"['A reforma da previdência deve ser feita para contribuir com o equilíbrio das contas públicas, e assim, distribuir da melhor maneira possível os recursos, porém a reforma que está em discussão é um verdadeiro ataque aos direitos já conquistados, e coloca a previdência como grande vilã do Estado, o que não é verdade.', 'A política no Brasil, é vista por muitos parlamentares como uma carreira, e não é difícil encontrar políticos que estão há muito tempo pulando de mandato, a cargos relacionados no cenário nacional. O que assusta é que este sistema político custa em torno de 70 bilhões de reais aos cofres públicos por ano, e em um país no qual o povo é tão descontente por seus representantes, uma reforma neste cenário seria muito mais atraente aos olhos do povo, e já seria possível economizar um bom dinheiro a partir disto.', 'Porém, não é o povo que tem a caneta na mão, e evidentemente é muito mais ""fácil"" começar os cortes nos direitos dos trabalhadores, os dados acima são referentes apenas aos salários e benefícios dos políticos, mas e o dinheiro destinado aos partidos? Sim, é o povo também que financia boa parte destes sistemas, que por sua vez, também direcionam verbas públicas gigantescas para a mídia.', 'Isso tudo, e ainda nem foi falado da corrupção. O rombo é bilionário, o MPF recuperou 11,9 bilhões de reais apenas da Lava Jato em 2018, e o dinheiro que não é recuperado?', 'A reforma da previdência como está proposta,  tem as suas vantagens, como por exemplo o ajuste nas arrecadações , de forma que aqueles que ganham mais, paguem mais. Por outro lado, não é justo obrigar trabalhadores de certas áreas a contribuir por mais tempo, como os trabalhadores rurais, sendo que a qualidade de vida destas pessoas é demasiada afetada por tal proposta.', 'Portanto, a reforma da previdência deve acontecer, a redução da população contribuinte e os rombos nos cofres públicos preocupam, mas a solução não deveria ser tão agressiva ao trabalhador, tendo em vista que a redução em outros setores do governo causariam um prejuízo menor ao povo.']",120,120,120,120,80,560
93,Escolha e Saúde,"['Segundo o dicionário Michaelis, “saúde” detém o significado de bem-estar físico, psíquico e social. Fora das páginas este termo parece necessitar de transformações, principalmente no que diz respeito à saúde e escolha de mulheres grávidas. Isso porque são cada vez mais utilizadas intervenções cirúrgicas em partos, como a cesárea, resultado de uma distorção cultural de que partos normais são primitivos, tal como o objetivo de alcançar mais lucro em vez de visar o bem-estar da gestante e de seu bebê. Este comportamento deixa claro a necessidade de humanizar os partos.', 'Ainda que o parto seja natural e faça parte da história de todo ser humano, ele ainda é um tabu na sociedade. Isso acontece porque, ao longo da história, o corpo feminino foi objetificado e o parto, por gerar modificações corporais que rompem os padrões estéticos vigentes, foi distorcido. E como dito por Freud, o tabu provém da relação do extraordinário com o misterioso e impuro, portanto, mesmo que exista o deslumbre da vida recém-nascida, a este é ligado um significado corrompido através do corpo da mulher, gerando este medo e até repulsão diante deste processo, o que leva muitas mães optarem por partos mais rápidos, porém mais ofensivos.', 'Também é válido ressaltar que o lucro é colocado como prioridade em detrimento da saúde da gestante. Pelo fato de ser possível que médicos realizem várias cesáreas em pacientes em apenas um dia, torna-se mais lucrativo e assim, o dinheiro sobrepõe-se ao bem-estar da grávida, que passa por um processo cirúrgico de maior risco, mais agressivo e de difícil recuperação . Um exemplo disso pode ser observado em um caso que aconteceu nos Estados Unidos, segundo o jornal The Sun um bebê sofreu um corte profundo durante uma cesárea e teve de levar treze pontos. Dessa forma, torna-se evidente como a humanização do parto é necessária, tanto para diminuir o número de cirurgias desnecessárias, quanto para promover mais segurança e cuidado à mãe e à criança.', 'Ademais, o parto humanizado é sim uma questão de saúde pública. A gestante deve ser assegurada pelo Estado para que ela e seu bebê estejam acima do lucro hospitalar. Por isso, o Ministério da Saúde  deve promover adaptações em hospitais públicos e privados para que possuam a infraestrutura necessária para atender mulheres que desejam possuir este tipo de parto . De forma que a vontade da grávida seja considerada e, acima disso, sua saúde e segurança sejam preservados e priorizados.']",160,160,120,160,120,720
76,Uma revolução inacabada,"['São várias as conquistas que as mulheres brasileiras conseguiram ao longo do século passado. Direito ao voto, a fazer faculdade, trabalhar independentemente da autorização do marido ou pai, decidir quando e quantos filhos ter graças ao advento dos remédios anticoncepcionais . Apesar de todas essas conquistas a equidade de gênero é uma revolução inacabada.', 'A sociedade do Brasil ainda está relacionada ao seu passado colonial. A formação familiar ligada ao patriarcalismo é aquela em que os pais e maridos tomam decisões, sustentam a casa enquanto a mulher cuida da criação dos filhos e do lar. Embora as mulheres trabalham o mesmo horário que os homens, elas ainda fazem tarefas domésticas, isso faz com que tenham rotinas muito estressantes e desgastantes.', 'Apesar dessas rotinas elas ainda conseguem tempo para estudar e ate formar em curso superior. O sexo feminino é maioria nas escolas de ensino fundamental e médio  além de serem maioria também em curso superior . Apesar da maior qualificação profissional delas,eles ainda têm maiores salários como se não bastasse suas taxas de desemprego são menores se comparado com as mulheres mesmo aqueles desemprego ligado ou não a qualificação profissional', 'Fica evidente, portanto, que a equidade de gênero é uma conquista ainda inacabada. Conquistas no âmbito social fizeram com que elas tivessem condições de buscar melhores empregos e garantir o direito aos estudos, mas para ela se tornar mesmo efetiva essas conquistas devem permear o seio familiar para que as tarefas domésticas sejam igualmente dividias além de as empresas também acabarem com o preconceito e garantir vagas e salários baseados na meritocracia. Fazendo assim com que a equidade de gênero seja mesmo ser efetiva.']",120,120,120,120,120,600
108,Como se tornar um consumidor consciente? Isso é possível?,"['Se tornar um consumidor consciente fica cada dia mais difícil, devido         as         propagandas exibidas pela mídia e         as         facilidades de pagamento. Quem nunca se sentiu atraído quando viu algum cartaz com a seguinte         legenda         “parcelamos em até dez vezes”? Muitas vezes as pessoas compram algo do que necessariamente não precisam somente para suprir seu ego em relação         a         comprar.         Umas         das maneiras de formar um cidadão consciente de tudo aquilo que         compra,  deve ser                   feito                  com uma educação         ainda na fase do consumidor criança.', 'As pessoas compram pelo simples fato de algo estar em promoção ou da facilidade de pagamento e não realmente se precisam do que estão comprando.                Para garantir a busca de novos consumidores e consolidar os que já são, muitas lojas aumentam suas vantagens nas compras para os clientes que possuam um cartão próprio da         loja, (Ex. Cartão Fidelidade).         Com este método as pessoas as são atraídas para o consumo com uma facilidade ainda maior.', 'Muitas vezes o consumidor não         avalia,         o quanto daquele investimento será prejudicial na hora de fechar as contas no fim do mês.                 O grande          numero          de pessoas com inadimplência no          Brasil,         se         da         na maioria das         vezes         pela falta de consciência do consumidor na hora da compra.', 'Portanto, ter consciência na hora da compra é possível, se a pessoa fizer uma avaliação atual da sua situação financeira, em relação a cada produto que ela quiser comprar. Outro modo de se formar cidadãos conscientes         é,         por meio dos pais em cada fase da formação de uma pessoa, seja ensinado, os princípios do consumismo, que é sempre comprar, com base em uma lista de prioridades e necessidades.']",160,160,120,160,120,720
145,"Brasil e sua política ""Pão e Circo""","['Temos neste ano a Copa do Mundo, que vai fazer do Brasil o centro das atenções por certo tempo, mas essa atenção deveria estar voltada para as escolas e hospitais que precisam de melhorias, e não para esse evento que está servindo apenas de fachada para os verdadeiros problemas. Oportunidades de desenvolvimento não virão com a Copa, os investimentos feitos irão sumir juntamente com os jovens sem oportunidades.', 'Todo o dinheiro gasto para a construção e reforma dos estádios não servirá para nada. Além                 de ser apenas temporário                , não ajudará nossas crianças se elas continuam a morrer na porta dos hospitais, se continuam analfabetas ou irão depender da sorte para         sobreviver         já que o governo só se importa com os lucros que         terão         com a Copa do Mundo. Afinal não se faz educação e saúde com estádios de futebol,                 já que                aos olhos o governo o futebol é mais importante do que o futuro da nossa nação.', 'A Copa não fará com que nossa economia cresça ou que nosso país se desenvolva. Se quisermos que o país melhore, devemos parar de nos concentrar em eventos como esse e procurar investir o dinheiro dos impostos em escolas e hospitais, em infraestrutura e segurança. Nós necessitamos de investimentos que sejam a longo         prazo         que possam nos                 assegurar                por mais tempo e não por alguns meses.', 'Precisamos acabar                 com isso                e reivindicar de verdade os nossos direitos, não adianta irmos para as ruas sem saber o que queremos, temos que saber pelo quê e por quem lutar. Poucos são aqueles que veem a Copa como ela realmente é. Estamos vivendo, em pleno século XXI, a política de ""Pão e         Circo"" onde         nós somos os                 telespectadores                que se iludem com um truque tão patético         que         é a Copa do Mundo.']",120,120,120,120,120,600
148,Tensão que assola o Brasil,"['Brasil, um país com expectativa de melhoria e influenciado por várias culturas. Hoje com novos objetivos e conquistas,         a         espera de um grande evento: A Copa do Mundo e a chegada do Papa Francisco.', 'O país ainda         esse         ano irá receber a Copa das Confederações, que será um torneio esportivo internacional                 com o objetivo de um treinamento para a Copa do Mundo em 2014 e as Olimpíadas em 2016                . Mas na realidade o que preocupa é a segurança das pessoas que estarão presente durante                 esse evento, e também com a segurança do Papa Francisco que virá ao Brasil ainda esse ano.', 'Sabemos que no Brasil há alto índice de assalto e criminalidade, mas o que deixa a organização desse evento tensa é o fato de acontecer um ataque terrorista,         embora que         não seja tão         evidente         isso acontecer. Mas precisamos                prevenir e ficar         atento         ,                 pois tudo estará voltado para o nosso país, pessoas importantes estarão aqui, isso pode ser um alvo muito grande para terroristas, a imprensa estará filmando e sempre haverá noticiários, que seria algo surpreendente para terroristas, que as pessoas assistam ao vivo o seu ataque.', 'O que esperamos é a segurança de todos, tanto         pessoas nacionais quanto internacionais         . Acreditamos que o Brasil está se estabilizando e                precavendo                tal situação, e disponibilizando militares e seguranças capacitados para garantir                 conforto                dos civis. Pois supostos acontecimentos sempre         vem         à tona quando se fala em um grande evento,                 mas prevenções          está          nos planos de quem pensa na possibilidade de algo acontecer (o chamado plano B).']",120,80,80,80,0,360
91,Negacionismo cientifico alimentado pela era da informação,"['Os avanços científicos das últimas décadas foram sem dúvida de riqueza imensurável para a construção da sociedade, entretanto, a história se repete com seus lados negativos, e, tal como durante a Idade Média a Igreja Católica condenou personalidades como Galileu Galilei por motivos ideológicos, o negacionismo científico, definido por desacreditar de fatos com comprovação científica encontrou um solo fértil na chamada atual era da informação, onde a todo momento pessoas do mundo inteiro se comunicam espalhando opiniões e mentiras fervorosas sem pudor algum.', 'Com o avanço da covid em 2020, o fenômeno das fake news pode ser observado ao redor do globo. A OMS precisou ir a público e pedir para que as medidas contra informações falsas fossem endurecidas. Não foi raro ver diversas falácias serem espalhadas enquanto fatos já comprovados pela ciência eram negados e ridicularizados sem pudor, até mesmo por personalidades de influência e líderes de Estado, como o presidente Jair Bolsonaro que mais de uma vez questionou a eficácia do uso de máscara e divulgou remédios como a Hidroxicloroquina como um suposto tratamento precoce, fato que nunca teve nenhum respaldo pela ciência. Atrelado a um algoritmo que prende as pessoas em suas próprias bolhas, as pessoas se veem rodeadas por opiniões iguais e se sentem indubitavelmente corretas, um solo fértil para acreditar em qualquer coisa que lhes são expostas.', 'Além do acima dito, há uma crescente desvalorização da ciência tanto no Brasil quanto em outros países nos últimos anos, tem sido comum o aparecimento de teorias mirabolantes como, até mesmo, o terra planismo. A educação vem sendo sucateada pelo governo, como os cortes de cerca de 18% para as universidades federais em 2021. Cientistas são vistos com desdém, apesar de ser necessário apenas uma rápida consulta à história para perceber que, sem os avanços científicos, a humanidade já teria sucumbido a doenças ou não teria sido efetuada a evolução tecnológica e globalização que vivemos hoje.', 'Se faz necessário, portanto, a urgência da aprovação do projeto de lei de 2020 contra as fake news pelo governo federal, além de propaganda e programas administrados pela SSECOM para conscientizar a população a importância da ciência, a fim de assegurar aos cidadãos que a mesma é sim confiável, não sendo retratada como um inimigo e, sim, um grande aliado de importância insubstituível para toda a sociedade']",160,160,160,160,160,800
92,Preconceito amarelo,"['O Brasil é um país conhecido pela sua heterogeneidade populacional. No entanto, mesmo com essa diversidade, o respeito ao diferente tem estado ausente nesse contexto, especialmente em relação a aceitação de grupos vindos de determinados países. Atualmente, este comportamento xenofobico tem assumido escalas exponenciais, principalmente contra as pessoas de origem asiática  resultando no chamado preconceito amarelo que vem sendo desencadeado por uma cultura intolerante, bem como por especulações econômicas e sociais.', 'Em primeiro lugar, é importante analisar o aspecto histórico imbuído na construção desse tipo de comportamento no nosso país. Como sabido, o Brasil foi redescoberto pelos portugueses, uma vez que o mesmo já era habitado por índios, estes estrangeiros trouxeram em sua bagagem a ideia de uma suposta supremacia europeia, em que seus costumes e sua cultura seriam preponderantes as demais. Esta ideologia foi fazendo parte do processo de constituição do nosso país, sendo processada até os dias atuais, principalmente na postura assumida por certos brasileiros em relação aos imigrantes de origem chinesa que vem sendo alvo de ataques por atrela-los a existência da covid-19 devido a seus hábitos alimentares e por ter registrado o primeiro caso da doença. Logo, a intolerância resultante de uma construção cultural tende a fomentar o preconceito amarelo.', 'Ademais, essa agressividade exacerbada contra os chineses vem sendo sustentada também por uma corrente de pensamento especulativo, a qual parte do pressuposto que a entrada de imigrantes chineses restringiria o número de postos de trabalho para os brasileiros. Mesmo diante dessa atitude xenofobica, o fluxo migratório entre os dois países tem se intensificado, especialmente quanto ao Brasil, influenciada em parte por acordos econômicos firmados entre ambos. Entretanto, quando em território brasileiro e tendo a prerrogativa constitucional de que todos são iguais perante a lei, os chineses são marginalizados social e economicamente por subterfúgios raciais preconceituosos baseados em diferenças culturais.', 'Sendo assim, faz-se necessário ações que possam evitar a ocorrência desse tipo de preconceito. Para tanto, o Ministério da cidadania junto com o Ministério da mulher, da família e dos direitos humanos deve realizar campanhas macivas sobre alreridade com o objetivo de conscientizar a população quanto ao respeito ao diferente, especialmente de outra nacionalidade. Paralelamente, o Ministério das relações exteriores deve fazer um trabalho conjunto com as embaixadas dos países em que os imigrantes são mais suscetíveis a discriminação, para dar visibilidade por meio de divulgações publicitárias da riqueza cultural desses povos visando estreitar relações de reciprocidade com os brasileiros e, assim, diminuir a incidência de xenofobia contra essas pessoas.']",160,160,160,200,160,840
76,,"['De acordo com a Biologia, O omem é diferente da mulher, mas na sociologia é discutida a questão de que ambos os sexos são iguais, pois são constituídos de ossos e possuem um fim mais cedo ou mais tarde. e ambos trabalham na mesma empresa, com as mesmas funções, deve-se receber o mesmo salário e ter os mesmos direitos.', 'Foi analisado pelo IBGE que profissões que são consideradas para mulheres, possui redução do salário. como por exemplo: manicure e dermatologista . ma mulher que possui as mesmas funções no mercado de trabalho recebe menos que o homem, foi analisado pelo IBGE que trabalhos como serviços domésticos, 94,8% são ocupados por mulheres e apenas, 36% em industrias ,  a mulher ser protagonista   superar estereótipos e enfrentar obstáculos.', 'A mulher tem que lutar pelos seus direitos e as empresas precisam questionar-se seus espaços são inclusivos e meritocráticos. O Governo é um agente que deve entrar nos direitos do trabalhador e criar uma politica como, por exemplo a licença paternidade, para que a mulher tenha seus direitos e para que a gravidez não seja um problema , a mulher precisa se questionar e mudar sua postura e os homens devem apoiar.']",120,80,120,120,120,560
83,Microcosmo da sociedade,"['Determinação, foco e sede de competição: nada poderia caracterizar melhor o espírito esportivo que se constatou nas Olímpiadas Rio 2016. As histórias de superação aliadas as singularidades de cada competidor trouxeram ao mais vasto público uma análise indireta da sociedade.', 'Em outras palavras, o esporte pode ser tratado como um microcosmo das relações sociais. Independente da modalidade, o atleta depara-se com o desafio da convivência, seja consigo mesmo, o adversário ou a própria equipe, de maneira análoga ao que enfrenta cada cidadão na sua própria realidade diária.', 'O velocista que faz uso do dopping para vencer, o maratonista que auxilia seu competidor numa queda, a determinação justa da judoca em vencer uma partida: todos esses atos transcendem os campos esportivos para a vida cotidiana. Aquele que burla as regras no jogo pode ser o mesmo que usa de artimanhas maldosas no trabalho para alcançar a promoção.', 'O esporte é, logo, meio de disciplina, desde que se atente às questões psicológcas e às relações sociais presentes na sua prática.', 'A Educação Física, muitas vezes negligenciada nas escolas, deve ser, pois, principal veículo para o esporte agir além de forma de diversão. Através dessa matéria, os professores podem acompanhar o comportamento de seus alunos, utilizando a prática esportiva como forma de análise e molde da personalidade de crianças e adolescentes, auxilando, até mesmo, no desempenho destes nas salas de aula. Assim, o esporte pode sair das quadras esportivas e ser determinante para polir futuros caráteres.']",160,200,200,200,200,960
69,Os frutos do agronegócio,"['Um dos planos maléficos da madrasta — personagem antagonista do conto Branca de neve e os sete anões — é o de assassinar a adorável Branca de neve através de uma maçã envenenada. Fora da literatura, o Brasil vem se destacando como um dos maiores utilizadores de agrotóxicos na agricultura, contaminando o organismo de milhões de pessoas e sendo responsável pelo surgimento e agravamento de diversas enfermidades.', 'Nesse contexto, uma pesquisa recente da Associação Brasileira de Saúde Coletiva apontou a relação entre substâncias agrotóxicas e doenças de cunho grave como, por exemplo, câncer, infertilidade e distúrbios hormonais ou neurológicos. Não obstante, a utilização de produtos tóxicos na alimentação brasileira — produtos estes que já foram banidos de países como China e Estados Unidos — mostra a lentidão do governo brasileiro em adoção de leis eficientes contra esses venenos.', 'Ademais, a baixa fiscalização, o fraco incentivo ao consumo de alimentos orgânicos e a conscientização precária da população consumidora favorecem o estado de inércia do país que, de maneira análoga à esta teoria do físico Isaac Newton, o país permanecerá com os mesmos problemas até que algo seja suficientemente capaz de parar o uso de defensivos agrícolas no agronegócio que, embora colabore com o sucesso das plantações, é comprovadamente prejudicial à saúde.', 'Portanto, medidas são necessárias para se resolver essa questão. Primeiramente, o Ministério da Agricultura, Pecuária e Abastecimento deve investir em adubamento natural, que é economicamente viável e pode lucrar até o dobro do agronegócio . Por conseguinte, esse mesmo ministério pode investir em programas sociais a fim de incentivar a cultivação de hortaliças nas residências populares e a visitação à feiras agroecológicas, aumentando o uso de adubamento natural e da agricultura familiar. Com essas medidas o Brasil estará garantindo que o primeiro setor econômico  do país seja saudável à população e ajudará a prevenir o surgimento de enfermidades de origem tóxicas no povo brasileiro.']",160,160,160,160,160,800
91,Sociedade negacionista,"['Define -se ""Negacionismo"" como um comportamento que tende a negar a própria realidade vivida. No caso do negacionismo científico, há uma negação da ciência com potencial de causar graves consequências para a sociedade, que afetam todos os seus eixos. Sendo assim, é necessário a análise das causas e consequências dessa tendência.', 'Primeiro, é importante é a análise do que pode causa o negacionismo em um indivíduo. A disseminação de Fake-News é uma delas. Segundo um estudo da Psafe, empresa de cibersegurança, 75% dos brasileiros já foram afetados por algum tipo de Fake-News, nos últimos anos. Isso mostra claramente que, a negação da realidade por parte da população está ligada disseminação de notícias falsas por parte das pessoas.', 'Ademais,as consequências do negacionismo afetam as diferentes esferas sociais, sendo isso terrível . Pra exemplificar, no Brasil, a disseminação de notícias falsas tem causado grandes atrasos para a sociedade nacional, como as errôneas informações de que vacinas não podem ser seguras, o que não procede, já que as mesmas passam pelo cuidadoso processo regulatório e sanitário em agências de saúde reconhecida mundialmente. Desfazendo assim, o comportamento negacionista.', 'Nesse cenário avassalador, medidas precisam ser tomadas para amenizar a situação. As entidades de governo, em parceria com redes de televisão, deve promover a cultura de anti-negacionismo na sociedade, por meio do rádio, tv e internet ,em um esforço de desestimular essa tendência. Tendo comercias de TV que estimulam as pessoas a evitar o negacionismo. Dessa forma, é possível resolver tal problema.']",160,160,160,200,160,840
59,O Brasil tem fome de igualdade,"['Quando se fala de fome no Brasil parece difícil acreditar que nosso  país ainda sofre desse mal, afinal no início desse século o índice de emprego aumentou e muitas pessoas saíram da pobreza, mas segundo relatório da ONU ( Organização das Nações Unidas)  entre 2016 e 2018, ainda 2,5% da população sofre de desnutrição, ou seja  entorno de 5 milhões de pessoas, precisa-se urgentemente criar políticas que favoreçam o emprego no Brasil, além de facilitar o estudo para os brasileiros.', 'É uma questão lógica que, se o cidadão estiver empregado , não irá passar fome, segundo o IBGE (Instituto Brasileiro de Geografia e Estatística) em junho de 2019, o índice de desemprego no Brasil era de 12%, quase 13 milhões de brasileiros, para melhorar esse número, precisamos de leis que facilitem as contratações, como diminuir os impostos para os empregadores, sem retirar os benefícios dos empregados, uma outra alternativa é um desconto no imposto de renda, para as empresas que contratem pessoas em extrema pobreza, ou ex dependentes químicos, que normalmente são descartados em entrevistas e acabam passando fome.', 'Porém não basta empregar a população apenas, é necessário ainda dar estudo e capacitação ao brasileiro, o sistema atual de ensino superior permite apenas que se forme as classes média e alta , com cursos caros e faculdades públicas que dificultam o estudante trabalhar, acaba que apenas os jovens com uma boa renda consigam chegar ao fim da graduação, o indivíduo que trabalha para ter o que comer no final do mês, acaba não tendo chances, com mais entidades públicas que ofereçam cursos à noite, e campanhas de incentivo ao estudo, mudaria esse quadro.', 'Assim, podese dizer que a fome no Brasil está ligada à desigualdade, visto que é diretamente proporcional ao desemprego e a falta de estudo, se agirmos  para diminuir essa desigualdade, podemos  acabar com a fome, como disse Nelson Mandela ""A educação é a arma mais poderosa que você pode usar para mudar o mundo"", para um problema grande como esse, precisamos de soluções eficazes e inovadoras, só assim estaremos em um país desenvolvido e livre da fome.']",120,120,80,120,80,520
101,População brasileira,"['Podemos analisar que as dimensões que a violência                 tem tomado                são alarmantes para a segurança da sociedade.                 A população está perdendo a batalha para o crime organizado.', 'Homicídios, tráficos de drogas e armas, assaltos a residência, assaltos à mão armada, entre outras problemáticas anteriormente vistas apenas nas grandes metrópoles, atualmente,         tem         atingido                 cidades do interior.                Ter o domínio de uma certa área ou cidade é uma forma         dos         traficantes e milicianos alimentarem essa violência.', 'Em geral, o principal gerador de violência é o tráfico de drogas. Este acarreta diversos crimes, que                 vão desde tráfico de armas até pequenos furtos                de usuários de drogas que o fazem para obterem recursos para alimentar o         vicio.', 'Por outro lado, os esforços da polícia, com         UPP’s         a exemplo do Rio de Janeiro,         tem         se mostrado eficientes no combate a “pequenos” traficantes e dependentes químicos. No entanto, há ainda traficantes com alto patrimônio que migram para outras regiões menos policiadas. Temos o exemplo também da Baixada Fluminense (perifeira do Rio de Janeiro) que teve um aumento considerável de crimes após a ocupação na capital.', 'Em suma, não há dúvidas que as cidades, principalmente capitais, do Brasil estão ficando mais violentas, com maior         números         de crimes. E a melhor forma de evitar isso é com intenso policiamento, combate ao tráfico e rigidez no cumprimento das lei.']",160,160,120,160,160,760
63,Quais as soluções para os impactos ambientais resultantes da ação de grandes corporações?,"['Antes de qualquer solução é necessário ter consciência . As tragédias que vêm acontecendo mostram o tamanho da ganância das grandes empresas. É lembrar que essas ações direta ou indiretamente, afetam a saúde, a segurança e o bem estar da população.', 'Porém  na busca por lucros, as empresas colocam em primeiro plano o desenvolvimento de suas corporações que  protegidas por seu poder  e muitas vezes por influência no governo deixam de lado as causas ambientais.', 'Algumas das soluções seriam: a busca pelo desenvolvimento sustentável das corporações, embargos econômicos às empresas que não tm compromisso com o meio ambiente, planejamento de suas ações para que os impactos causados sejam reduzidos o máximo possível. Dessa forma com certeza as empresas repensariam suas ações.']",120,120,80,120,120,560
91,,"['Com o surgimento do vírus da AIDS no século XX,vários movimentos contrários aos conhecimentos da ciência surgiram como afirmar que o HIV(Sindrome da Imunodeficiência Adquirida) era transmitida pelo aperto de mão e abraço,contrário ao que afirmava os estudos. Nos tempos hodiernos,a pandemia d COVID-19 trouxe tona os efeitos do negacionismo científico na sociedade,por exemplo a grande recusa de se submeter vacinação e crença de apenas uma ""gripezinha"", esse mal é fortalecido pela falta de tratamento do tema nas mídias e a escassa confiança nas instituições sociais.', 'Em primeiro plano,sempre que houve um grande evento de doenças no mundo,consequetemente existiu os grupos daqueles que negam a ciência. As mídias retratam pouco os pensamentos dos negacionistas de que a vacina feita para matar a população,no caso do coronavírus que é uma gripe comum, falta um debate,discussão confrontando esses pensamentos nos meios de comunicação, como consequência os números de mortes são elevadas,o surto  que era para durar alguns dias, demora anos por falta do seguimento das regras pela população e o retrocesso nos avanços da ciência na sociedade.', 'Além disso,a falta de confiança nas instituições sociais é outro fator que prejudica a ciência,outras áreas já deterioradas moralmente como a justiça e a política com casos de corrupção e enganos,colaboram com que esse problema agora afete a saúde que para muitos negacionistas é apenas um caminho para os objetivos de um governo corrupto. Por conseguinte,o Brasil já atingiu a marca de 400 mil mortes fruto do descaso dos governos e da população com suas ideias negacionistas.', 'Em virtude do exposto,cabe ao governo federal,que é a instância máxima de poder encarregada de tomar decisões públicas, em parceria com as diversas mídias como a TV,rádio e redes sociais,instituir debates e palestras mais incisivas,refutando os pensamentos negacionistas,com o fito de diminuir os casos de negação da ciência e consequetemente frear o número de mortes. Ademais,a falta de confiança no Sistema de Saúde poderá ser combatida pela punicão daqueles que corrompem a justiça e a política e reformar algumas regras das instituições sociais,só assim acontecimentos como os da AIDS no século XX serão minimizados no Brasil atual.']",160,160,120,160,160,760
83,Espírito Esportivo,"['O esporte é muito importante, as Olimpíadas, um evento mundial, prova isso,pois o esporte serve para unir as pessoas,mesmo que existam rivalidades pois o mesmo forma o caráter. O esporte estimula muitas áreas da vida.', 'Um de seus benéficios é para a saúde, que estimula o movimento do corpo,e sabemos o quanto é importante para o bem estar, (.) o esporte trás tantas coisas boas, como aprender a conviver em grupo, saber que você pode fazer o possível e o impossível, que muitas vezes você pode perder e ganhar também.', 'Mas o esporte também têm seu lado ruim, quando mexem com a cabeça das pessoas e elas acabam tornando o esporte muitas vezes uma atividade egoísta,ou quando agem de maneira desonesta apenas para ganhar,e quando profissionais como técnicos não ensinam o verdadeiro espírito esportivo aos teus alunos, (.) esses tipos de coisa ainda acontecem com frequência nas práticas esportivas.', 'Portanto, o esporte precisa ter mais visibilidade e ser valorizado,e ser o esporte que una países e pessoas em todos os lugares, e que as competições sejam respeitadas, e que o esporte possa continuar mudando pessoas, e trazendo melhoras para o mundo com o espírito esportivo.']",120,120,160,160,200,760
74,Quando o passado continua presente,"['Segundo o filsofo francês, Jean Paul-Sartre, a violência, seja qual for a maneira como ela se manifesta, é sempre uma derrota. E quando se trata da violência contra a mulher essa derrota se manifesta desde os primórdios da humanidade. Hoje o numero de mortes causadas por esse tipo de violência é exorbitante e não para de crescer a cada senso. O que nos deixa a mercê de uma grande problemática, que sob muitos prismas parece não ter solução na urgência que precisa, omo lidar com um problema com raízes históricas e ideologias tão fortes?', 'Em primeiro lugar, é importante ressaltar que medidas foram tomadas, leis foram criadas, como os casos nacionais da lei do feminicídio, quando uma mulher é morta pelo único fato de ser mulher  e a lei Maria da Penha, utilizada para todos os tipos de violência contra o sexo feminino. Efeitos benéficos foram surtidos de tais fatos , porém não foram o suficiente para erradicar ou mesmo diminuir as estatísticas fatais. O que não é de todo incompreensível, uma vez que vivemos numa sociedade, não só nacional, mas mundialmente tão machista.', 'Vale dizer também que a persistência dessa violência se dá pelo grande peso histórico-cultural que carrega. A história é marcada pela gigantesca diferença de gênero, e consequente inferioridade da mulher, seja para os religiosos, onde a bíblia mostra diversas vezes o papel inferior e submisso da mulher , seja para quem acredite em fatos científicos, onde inúmeros livros de história mostram as mulheres das cavernas sendo arrastadas, literalmente, por seus devidos parceiros, mais a frente, escravas sofriam rotineiros abusos sexuais e esses não são os únicos exemplos, que infelizmente só nos mostram de onde veio o que vemos hoje.', 'Desse modo, fica difícil pensar que evoluímos tão pouco e ainda mais assustador pensar o quanto falta para termos um mundo livre de todo essa maldade e mente retrograda. Porm sem luta não há ganho, e medidas complementares podem ser tomadas principalmente em âmbito escolar e familiar, onde se deve ensinar aos pequenos desde sempre o respeito às mulheres e a todos, a o governo junto as ongs pode organizar campanhas de conscientização à toda a população, assim como aplicar mais rigor as leis a vigentes. Só assim a derrota dita por Sarte deixará de ser nossa realidade.']",120,160,120,160,120,680
2,STF um órgão político ou jurídico?,"['Em 2014, durante o governo Dilma Rousseff, iniciava a operação Lava Jato Jato, que tinha o objetivo de investigar casos de corrupção envolvendo empresas estatais, como: a como a Petrobras. Em virtude disso, várias notícias relatando a participação de políticos em esquemas fraudulentos começaram a surgir e causar indignação na população. Por conseguinte, o anseio da sociedade em acompanhar os desdobramentos desses fatos ocasionaram ocasionou a notoriedade do Supremo Tribunal Federal.', 'Mormente, ao avaliar que, o que o papel desse órgão judiciário, consiste judiciário consiste na guarda da Constituição Federal e no julgamento de ocorrências concernentes ao Congresso Nacional ou há a casos que sejam relevantes para todo o país. Nessa conjectura, é indiscutível a importância das atribuições do Supremo Tribunal Federal, visto que algumas pautas, como: a como a criminalização da homofobia, trouxeram grandes avanços para a sociedade. Entretanto, processos envolvendo ex-presidentes, ministros e ex-assessores ganharam destaque em âmbito nacional devido a à postura dos membros da corte.', 'Ademais, convém salientar que, segundo o instituto Datafolha, 39% dos brasileiros desaprovam a conduta do Supremo Tribunal Federal, pois vereditos e decisões questionáveis questionáveis, homologadas pelo órgão, como: a como a suspensão de investigações contra políticos, absolvição e soltura de indivíduos presos em operações judiciais policiais e aprovação de habeas corpus controversos são fatores corroborantes para o resultaram no aumento da taxa de reprovação da corte.', 'Dado o exposto, faz-se necessário necessária, mediante o Ministério de Ciência e Tecnologia em parceria com o Supremo Tribunal Federal, a ampliação de fóruns virtuais para difundir as atribuições e deveres desse órgão público público, a fim de policiar e informar a sociedade sobre as pautas discutidas pela corte. Consoante ao ex presidente africano Como disse o ex-presidente sul-africano Nelson Mandela, ""Se falares uma linguagem que o homem compreenda, a tua mensagem entrará em outras mentes"", diante mentes"". Diante disso, é fundamental a parceria do STF com os veículos de comunicação, para propagar propagar, numa linguagem sucinta e objetiva objetiva, mensagens que visem a aproximação amigável entre a população e o Supremo Tribunal Federal.']",120,80,80,80,80,440
80,,"['Ao longo da história, aspectos físicos, principalmente a cor da pele, foram utilizados para sustentar uma política de supremacia dos povos brancos sobre os demais. Durante o século XX, a ciência extrapolou o conceito de raça para os seres humanos defendendo a inferioridade dos povos de cor, tendo como base interpretações deturpadas das ideias darwinianas.', 'No Brasil, o preconceito étnico vigorou-se  a partir do período colonial  com a escravização da população autóctone e dos negros trazidos para o país durante a diáspora africana. Movimentos de resistência surgiram nesse contexto    culminando na lei abolicionista e em leis contra o racismo . Exemplos mais recentes são as leis as de ação afirmativa e a lei de 1989 conhecida como Lei de Caó  que criminaliza qualquer atitude racista.', 'Embora essa minoria tenha conquistado um espaço significativo na sociedade brasileira, ela continua marginalizada  sendo destinada  a ela as piores vagas de emprego e os menores salários. Fato esse que aprofunda ainda mais as discrepâncias sociais e o racismo existente.', 'Não suficiente, a criação e manutenção de estereótipos dificultam o combate ao racismo. A associação, por exemplo, do índio a uma imagem comodista e a do negro, mais recentemente, a  violência tem colaborado para reforçar a exclusão social existente e a reprodução de atos de violência contra esses grupos.', 'Leis de proteção que garantam os direitos das variadas etnias a sua identidade cultural e a punição daqueles que a violem faz-se necessário, mas não basta.  O combate ao preconceito racial, também, deve se dar  por meio da conscientização social e da criação de políticas que visem incluir esse segmento na unidade social, para que  assim, o combate a essa forma de discriminação se atinja as raízes da problemática.']",160,120,160,120,160,720
56,Fábricas de ódio,"['É fato que o sistema prisional está completamente fora de controle do estado. A população está cada vez mais encarcerada e assustada. Os presídios são fábricas de ódio e organização criminosa, os policiais e servidores estão acuados, sem infraestrutura mínima para trabalhar e sem perspectiva de melhora.', 'Por um lado, o superencarceramento representa uma grande parte de negros, pobres e jovens com baixa escolaridade, onde a maioria dos detentos são por furto, roubo e principalmente o tráfico, apenas 2% representando homicídios. De acordo com o levantamento Nacional de Informações Penitenciárias (INFOPEN), o Brasil está em terceiro lugar com mais presos no mundo, apenas ficando atrás da China e Estados Unidos.', 'Por outro lado, temos a condição de vida precária e desumana, mesmo com 1456 presídios em todo território brasileiro a superlotação é cerca de 175%. Segundo dados do Conselho Nacional (CNS), atualmente 256 mil presos são provisórios no Brasil, ou seja, 1/4 da população carcerária brasileira não foi condenada definitivamente pelo judiciário. A ressocialização é uma ideia deixada de lado, tal quadro é indubitavelmente preocupante, pois estes fatos causam, uma sociedade perigosa e violenta ao receber tantos ex-presidiários que simplesmente cumpriram sua pena sem ter reinserção para retornar a comunidade.', 'Entende-se, portanto  que é necessário que a população entenda os riscos da não ressocialização do detendo. Desse modo cabe ao estado investir na humanização dos espaços prisionais, na contratação de servidores e qualificação dos mesmos . Também cabe a sociedade apoiar investimentos e aceitar o ex-detendo como ser humano novamente.']",120,120,120,120,120,600
11,Natureza e desenvolvimento sustentável,"['Estudos e levantamentos sobre o aquecimento global realizados recentemente, apontam recentemente apontam para um futuro alarmante em relação à sobrevivência das espécies. Dentre as inúmeras consequências do super aquecimento superaquecimento, uma delas já começa a ser percebida na Rússia, onde onde, devido ao derretimento das geleiras, foi diminuída a área de caça dos ursos polares, que, assim, passaram a invadir aldeias em busca de alimentos. Tal problemática problema, além de exigir uma solução imediata, leva-nos a pensar sobre os impactos nocivos da ação humana ao meio ambiente.', 'Segundo dados do Painel Intergovernamental sobre Mudanças Climáticas, até 2040 é possível que haja um verão sem gelo no hemisfério norte e e, de acordo com relatórios da ONU, a ação humana é uma das grandes responsáveis por essas alterações climáticas. Tais dados demonstram que é crucial para o futuro do planeta que os homens comecem a agir de modo sustentável.', 'Visto que, somente no No Brasil, a ruptura das barragens da empresa Vale em Minas Gerais e o desmatamento da floresta Amazônica em decorrência da expansão agrícola, demonstram agrícola demonstram que ainda investimos em um modelo de desenvolvimento altamente prejudicial à natureza e ao próprio ser humano. Tal conjuntura é observada também em muitos outros países em maior ou menor escala.', 'Sendo assim, é imprescindível que se invista em modelos de produção sustentável e que respeitem as áreas de preservação ambiental. Logo, é importante que sejam construídos santuários de espécies ameaçadas, como os ursos polares, a fim de controlar sua reprodução e garantir sua sobrevivência. Ademais, é fundamental implantar nas escolas, projetos sobre Educação Ambiental, tendo em vista a reflexão sobre os modelos de desenvolvimento atuais e a proposição de soluções sustentáveis.']",160,200,200,160,200,920
85,Jovem Democracia,"['Da antiguidade grega à história atual a democracia passou por transformações constantemente. Advinda das palavras “Demos” que significa povo e “Kratos” que significa poder, ela começa a representar a vontade ou comando de um grupo social. E foi fortemente ampliada por Clístenes, considero o pai desse modelo de governo.', 'Em sua origem a democracia foi estabelecida diretamente, ou seja, a Demos tinha a prerrogativa de escolher mudanças e representantes, sem a obrigação de seguir modelos definidos e apresentados. Entretanto, o atual sistema democrático Brasileiro não oferece tal autonomia aos cidadãos que, pelo voto, são destinados a escolherem entre candidatos e partidos estabelecidos.', 'Contudo, em 1988 cria-se a chamada, Constituição Cidadã, que traz mecanismos que forçam a participação popular na gestão política. São três esses institutos, o do referendo, do plebiscito e da iniciativa popular. Esse último, apoiado por mais de 1% do eleitorado nacional é capaz de inserir leis populares no arcabouço jurídico do Brasil.', 'Deste modo, ele é fundamental à manutenção da democracia brasileira e às medidas corretivas na estrutura falha desse sistema.', 'Todavia, não bastarão medidas corretivas para garantir um bom governo, haja vista, que elas atuam no fim e não na causa do problema, que segundo o Historiador Leandro Carnal, origina-se na microfísica do poder, nas diminutas relações de corrupção.', 'Imperioso, pois, atuar no combate à corrupção na base da cadeia hierárquica, começando da escola de base à graduação, que através de aulas voltadas à política, tornará jovens e crianças cientes do perigo desse mal. Essencial também, a criação de órgãos reguladores com maior autonomia e que atuem em conjunto com os Tribunais Regionais Eleitorais no combate ao molde corrupto de campanhas e partidos.', 'Do mesmo modo, uma mídia ativa e imparcial, que desenvolva em sua programação um espaço voltado à ética e moral cidadã promoverá a reflexão política da sociedade. Caberia à lei de iniciativa popular, propor ao poder Legislativo uma lei que crie e regule todas essas medidas, só então a democracia do Brasil sairá da mais tenra maturidade.']",160,200,200,200,200,960
89,A mediação da economia com o isolamento social,"['A partir do século XX, com a ascensão da globalização, o mundo inteiro tornou-se interligado por meio da economia mundial ou então pela facilidade de deslocamento de pessoas. Hodiernamente com o advento da pandemia causada pelo vírus Covid-19, foi necessário realizar o isolamento social como forma de prevenção para a doença. Entretanto, a prática do afastamento social origina déficit nas finanças em vista da atual crise brasileira, dificultando assim, a conscientização da população perante as normas ideais de precaução da enfermidade.', 'A Organização Mundial da Saúde estabeleceu no início de 2020 medidas adaptativas ao combate do coronavírus, sendo uma delas, a isolação coletiva. Todavia, essa prática contrapõe o artigo 23 da Declaração Universal dos Direitos Humanos, qual assegura que todo cidadão tem direito ao trabalho e a livre escolha de emprego em condições justas de exerce-lo. Desta forma, uma parte significativa da sociedade não atende as normas estabelecidas  visto que necessitam do trabalho para seu sustento. Além disso, o auxílio emergencial recebido pelo governo federal é de valor muito desprezível e as consecutivas altas nos preços do mercado financeiro, a exemplo do dólar e do petróleo, causam descrença econômica no país', 'Contudo, segundo pesquisas realizadas pela Universidade Estadual de Campinas (Unicamp) e da Universidade do Texas, denota-se que nas cidades em que houve o procedimento eficaz da isolação populacional, além de preservar milhares de vidas, as economias reagiram da mesma forma que nas cidades que adotaram métodos errôneos, entendendo-se  assim, que é acertadamente mais vantajoso para os setores da economia e da saúde implantar o isolamento em casa.', 'A partir do que foi citado, conclui-se que as medidas estabelecidas pela OMS são vantajosas e necessitam ser aplicadas de forma eficaz urgentemente. Deste modo, o governo federal juntamente com os estados e municípios  devem aprimorar o isolamento social buscando mediar-se com a economia, por meio de verbas para sustento dos trabalhadores e cursos gratuitos de Home office para a especialização e inovação dos mesmos. Além disso, deve-se criar recompensas para as cidades que conseguirem planejar um sistema de controle adequado, gerando motivação para os cidadãos respeitarem o projeto. Somente assim, o planejamento do isolamento social irá ser posto em pratica perfeitamente.']",160,160,160,160,160,800
119,Saúde e bem estar ,"['Nos dias atuais, as notícias e os fatos         à         respeito da busca pelo corpo perfeito tem         sido         em sua maioria,                 catastróficas                . Isso indica                conflito em relação às         ideias: perfeição e bem estar         .                 Estamos vivendo na era do consumismo,          onde          a felicidade baseia-se          ao          ato de ter ou conquistar algo.', 'Não existem limites para aqueles que buscam a perfeição, nem mesmo quando         trata-se         da própria saúde. Pessoas apelam por medidas drásticas para estarem dentro do padrão, padrão que é imposto pela mídia,                 de maneira          sutil          porém muito convencional.', 'Existem aqueles que estão insatisfeitos com seu corpo por si só, mas a maioria das pessoas que          submetem-se à          cirurgias e tratamentos estéticos o fazem por medo de não serem aceitas da maneira que são.                  Falsos profissionais aproveitam a oportunidade e a falta de bom senso de algumas pessoas para oferecer serviços que prometem milagres,          em          baixo custo, para que tenham acesso facilitado.', 'Temos então um ciclo interminável de consumidores inconsequentes e fornecedores irresponsáveis. Se fizéssemos uma autoanálise, listando aquilo que realmente é relevante para saúde e         bem estar         próprios, chegaríamos         a         conclusão de que cuidar do corpo é muito importante, porém a busca excessiva pela perfeição pode causar resultados indesejáveis ou até mesmo consequências irreversíveis. Saúde e         bem estar         devem ser prioridade.']",160,160,160,120,120,720
74,,"[""O livro ''Hibisco Roxo'', da escritora nigeriana Chimamanda Ngozi, revela uma sociedade africana em que a mulher que sofre violência no ambiente familiar acaba tendo um final diferente do que ocorre fora do plano ficcional, ou seja, o agressor acaba sendo punido pelo seu crime. É inegável que na sociedade pós-moderna ainda permeia o feminicídio, fazendo com que o enredo do livro da Ngozi seja quase insonhável na realidade, necessitando de medidas para que esse crime seja extinto da sociedade e o ambiente social passe a ser saudável e harmônico."", ""Em primeiro lugar, é imprescindível que a herança cultural patriarcal do Brasil afeta o cotidiano de varias mulheres, já que desde o Período Colonial o homem tem tomado uma postura que deixa a mulher subalterna a seus atos. Segundo o escritor francês Victor Hugo,  ''as vezes naufragamos quando acreditamos desembarcar'', isto é, quando relacionado ao feminicídio, não adianta criar varias leis que barram essa concepção patriarcalista e não fazer a devida fiscalização de modo correto, gerando um feito vago, já que deixa os agressores impunes e as mulheres vulneráveis, sendo as leis sem supervisionamento o verdadeiro “náufrago” moderno."", ""Consequentemente, os assassinatos de mulheres no Brasil ganharam pauta com os veículos de disseminação em massa , já que antes não tinha tanta visibilidade pela falta de cobrança da população por medidas que acabem com essa violação. O filósofo alemão Christoph Turcke afirma que ''quem não faz propaganda não comunica''. Nesse contexto, é de extrema importância a televisão e o rádio como canais que informem a população sobre a relevância de medidas contra esse crime, ou seja, por meio de debates públicos e eventos culturais que incitem não só a valia acerca do questionamento do feminicídio na contemporaneidade, como também a divulgação de como agir caso ocorra alguma agressão ou violência ."", 'Torna-se evidente, portanto que medidas do Governo e das mídias sociais precisam ser estabelecidas para que o feminicídio seja extinto da sociedade. Para isso, o Governo, por meio do Ministério da Justiça adjunto com a Política Nacional de Enfrentamento à Violência contra as Mulheres, têm o débito de garantir que aqueles que praticam tais atos sejam devidamente punidos no Brasil. Além disso, os meios de comunicações em massa associados a voluntários, juntos, podem distribuir panfletos em locais de grande movimentação de pessoas informando a importância da denúncia como meio de chegar a um bem estar social. Só assim, o livro de nigeriana sairia do plano da ficção e passaria a designar a sociedade atual, tendo como efeito uma sociedade acolhedora e, principalmente, altruísta.']",160,200,160,160,160,840
106,(Sem título 012),"['Toda boa relação, seja ela amorosa, ou mesmo entre indivíduos de culturas diferentes, é baseada em respeito. Isso tudo não poderia ser diferente na convivência entre pessoas e animais domésticos, embora não se generalize.                 A linha tênue entre o respeito nessas relações esbarra na ideia de ""superioridade"" dos seres humanos que, por sua vez, é conflituosa, mediante a supervalorização do animal.', 'Constantemente, a mídia                 noticia exemplos                de maus tratos a animais de estimação.                 Nesse aspecto,                configura-se a ideia relativa de ""superioridade"" dos seres humanos, que não reconhecem esses animais como merecedores de respeito.                 São ignoradas quaisquer possibilidades de afeto e carinho em detrimento do sofrimento do animal. Muitas destas características reproduzidas em sociedade por parte dos agressores com seus semelhantes.', 'No entanto, em outros casos,         estes         animais são elevados a uma condição de não mais inferiores aos seres humanos,                 mas como integrantes de um novo meio social, de regalias e privilégios.                Embora, quase que imperceptível para seus donos,                 a domesticação e todas essas regalias vão gradativamente substituindo o instinto natural desses animais, que perdem suas características naturais.', 'Em ambas as situações,         prevalecem à         desarmonia na convivência com o animal. Desrespeito sem fundamentos, já que se deve manter uma relação de afeto e carinho, sem exageros. No próprio âmbito biológico,         estes         animais, incluindo os indivíduos racionais, diferenciam-se pelo desenvolvimento da comunicação e da consciência, compartilhando de variadas características que, biologicamente, lhes são comuns.', 'Portanto, a relação entre pessoas e animais domésticos deve ser afetuosa, sem privilégios e agressões. Deve-se cultivar o amor para que a relação prospere e que a convivência seja benéfica para ambos e, assim, construa-se uma relação de fidelidade.']",120,120,80,80,80,480
94,,"['Na série estadunidense “The good doctor”, o Dr. Shaun Murphy por ser autista  encara vários desafios durante sua residência no Hospital San José, sua capacidade é diversas vezes questionada, tanto por outros profissionais quanto por pacientes. De forma análoga com a realidade, no Brasil, as dificuldades para inclusão de autistas, fato evidente no contexto atual, são provenientes de falhas no sistema educacional e da falta de representatividade. Nesse sentido, é necessário considerar as causas dessa problemática.', 'O Transtorno do Espectro do Autista (TEA), nome técnico para autismo, afeta principalmente as habilidades de comunicação e possui diversos subtipos, onde cada um requer diferentes cuidados, tornando necessária a presença de profissionais capacitados para fornecerem uma educação de qualidade, como vigente na legislação brasileira . Dessa forma, educação especial tem papel fundamental na inclusão dessas pessoas na sociedade, a escola possibilita a convivência desse indivíduo com outras pessoas, feito benéfico para ambas s partes. Entretanto, segundo Inep (Instituto Nacional de Estudos e Pesquisas Educacionais Anísio Teixeira), no Brasil, cerca de 1.250.975 de pessoas matriculadas em 2019, usufruíam desse tipo de educação, apesar do número ser maior, comparado aos anos anteriores, a falta de investimentos na estrutura escolar acarreta falhas nesse sistema que muitas vezes deixa de fornecer uma educação de qualidade ou abranger todos os estudantes.', 'Ademais, é possível notar a falta de pessoas com TEA ocupando espaços de destaque no mercado de trabalho, na política e nas mídias. Logo, a escassez de representatividade demonstra uma falha na inclusão desses indivíduos, que por tal motivo,  podem apresentar uma sensação de não pertencimento. Esse problema gera também certa ignorância da população, o autismo por ser pouco apresentado, deixa dúvidas e ocasionalmente, por desconhecer sobre o assunto, as pessoas agem de forma equivocada ou preconceituosa. Visto isso, é de suma importância que autistas ocupem lugares de visibilidade.', 'Por conseguinte, são fundamentais medidas para inclusão dos autistas na sociedade atual. O Estado deve garantir a ampliação de projetos que incentivem e auxiliem na formação de profissionais especializados, investir na educação inclusiva e implementar programs que incluam autistas no mercado de trabalho e na política. Ao desejo de, dessa forma, conseguir que a realidade brasileira seja modificada e mais autistas se tornem médicos como o Dr. Shaun Murphy e diferentemente dele, sejam respeitados.']",160,160,120,160,120,720
119,(Sem título 079),"['Miscigenação, essa palavra define as características físicas e culturais das pessoas ao redor do mundo.                São inúmeras formas corporais, tons de pele, cores de olhos e atributos que se         pode         encontrar, porém, toda essa variação vem sofrendo uma certa repressão dos novos padrões estéticos que surgem a cada momento.', 'O desejo de ter corpos com determinadas medidas ou cabelos com formato específico, por exemplo, faz com que pessoas saiam em busca de formas cada vez mais rápidas para atingir seus objetivos. Essa rapidez, entretanto, acaba tornando atraentes métodos que trazem maior risco à saúde dos indivíduos.', 'Injetar substâncias no corpo, passar por cirurgias e mudar a alimentação são alguns desses meios, e demonstram uma incessante busca dessas pessoas por autoestima e aceitação da sociedade.', 'Tentando acabar com essa ideia de insatisfação com o próprio corpo, grupos como ""Orgulho Crespo"" e ""Gordinhas Assumidas"" promovem passeatas nas quais afirmam seu orgulho em fugir dos padrões e encorajam outros cidadãos a assumir suas próprias formas.', 'Esse tipo de iniciativa é o que realmente faz a diferença, pois                 interage                com a sociedade e mostra que a                 miscigenação não assume padrões                .']",120,200,160,120,160,760
86,Impactos do uso das redes sociais na saúde mental,"['Dentro os inúmeros motivos que levaram a ciências constatar que as redes sociais atinge com muita consistência a saúde mental do indivíduo ,foi o aumento da depressão e ansiedade entre os jovens  . Tento em vista que os impactos não escolhem classes sociais.', 'Tudo que é usado em demasia , causa um dano físico ou mental ,as redes sociais em um contexto pode ser bem útil sabendo usá-la ,mais no geral, mais presisamemte as pessoas com uma carência e baixa estima já que a internet tem um mundo aparentemente perfeito .', 'No meu ponto de vista a solução pra esse problema seria estreitar as horas nas redes sociais e inteder que pessoas perfeitas não existem ,corpos perfeitos e beleza .em posta..Com tudo saber o que é real e imaginário .']",120,80,80,120,40,440
69,"O uso de agrotóxicos, uma discussaõ social","['Segundo a Agência Nacional de Vigilância Sanitária (ANVISA) o Brasil é líder mundial no uso de agrotóxicos. Essa totalidade discute uma questão de saúde pública, porque os relatórios anuais da Organização das Nações Unidas (ONU) alertam para os perigos dessas substncias ao organismo humano. Dessa forma, tem-se uma discussão econômica, ambiental e de saúde, na qual geram argumentos a favor do agronegócio e outros contra pela hostilidade tóxica à saúde. Então, a questão é colocar em equilíbrio as problemáticas futuras e viabilizar a seriedade da situação frente sua população.', 'Nesse contexto, percebe-se um debate contínuo no cenário brasileiro quanto ao uso de herbicidas, fungicidas e outros. Mas, embora o cientificismo normatize artigos que provam os malefícios aos seres humanos e o Sistema de informação de Agravos de Notificação (SINAN) e a própria ONU relatem os prejuízos hormonais, psicológicos e neurais aos humanos, o que prevalece é a ausência de ações administrativo-política  pelas quais venham inibir essa demanda tóxica crescente nos alimentos e, consequentemente, à fisiologia dos seres bióticos e abióticos de modo geral.', 'Ademais, é notória a precisão em aumentar a produtividade e eliminar pragas em plantações, todavia, essas iniciativas não são ecologicamente viáveis por gerarem hostilidades em longo prazo, começando pela contaminação de mananciais, peixes, e toda cadeia produtiva subaquática. Então se a questão em utilizar agrotóxicos é mais barato frente técnicas, também polêmicas, como o uso da biotecnologia, transgênicos e alimentos geneticamente modificados, a contradição estará em gastos maiores pelo aparecimento de novas doenças, ainda mais difíceis de curar no futuro. Portanto, precisa haver um diagnóstico de situações concretas, buscando equacionar os impasses causados aos ecossistemas e seus constituintes.', 'Com base nessas considerações, a necessidade em diminuir gradativamente o uso é permitir cuidados ecológicos junto à fauna e a flora, e pensar num futuro mais promissor. Entretanto, soluções ainda precisam integrar medidas qualitativas e eficazes no combate ao excesso de agrotóxicos. Para tanto, o Ministério da Saúde e seu ministro Gilberto Occhi devem revisar as leis que viabilizam a entrada desses produtos a fim de torná-las justas à saúde humana. Realizando essas medidas, os indivíduos em sociedade terão uma vida mais próspera e isenta de malefícios.']",200,200,160,200,120,880
63,Um problema irreversível,"['Pode ser afirmar que os impactos ambientais vem acarretando transtornos irreversíveis a diversos fatores, prejudicando o planeta . Esse problema na maioria dos acontecimentos, é causado por grandes corporações. Um modelo de destruição recente,  foi ocorrido em Minas gerais, na cidade de Brumadinho, onde decorreu o rompimento da barragem de minérios deixando famílias desabrigadas, rios cheio de rejeitos minerais,  e a fauna brasileira devastada.', 'Em virtude dos fatos mencionados é decorrente estabelecer uma solução, tal como uma fiscalização mais rígida respeito das situações de barragens, projetos sociais de conscientização sobre o problema, com o apoio da divulgação da população em redes sociais.']",120,80,80,80,80,440
84,Uma forma de se defender,"['Após o atentado na boate gay em Orlando, o presidente dos E.U.A resolve dificultar a venda de armas para pessoas com histórico criminal ou doenças mentais, enquanto no Brasil entra em pauta a autorização de porte de armas para a população civil. Muitos criticam esta lei, afirmando que o número de mortes aumentaria devido ao fácil acesso em armas de fogo, enquanto uns apoiam em busca de segurança.', 'A lei diminuiria a idade mínima para a compra de armas, além de dar a qualquer cidadão o direito de comprar e portar armas de fogo, não haveria necessidade de renovação do certificado de registro e  permitindo até mesmo compra e porte de armas aqueles que foram condenados por crime culposo.', 'O pesquisador e sociólogo Julio Jacobo afirmou que mais de 160 mil vidas foram poupadas durante os últimos anos com o maior controle de armas decorrente ao antigo estatuto, e segundo o mapa da violência 2015, no Brasil encontra-se com 8,5 milhões de armas ilegais tendo 3,8 milhões na mão de criminosos.', 'Com o aumento da criminalidade, é mais do que direito do cidadão poder se defender e não ficar a mercê de massacres que podem ocorrer a qualquer momento, mas ao mesmo tempo que garante segurança, pode ser perigoso ter tantos cidadãos com armas em casa sem o treinamento necessário.', 'Dado da Organização das Nações Unidas, mostra que 71% dos casos de homicídios são causados através armas de fogo, e mesmo a lei não sendo aprovada os homicídios continuariam a existir, isso devido ao porte ilegal. Com a lei em vigor, os crimes seriam mais controlados, pois o governo teria noção de quem porta arma em casa além de ser uma forma da sociedade garantir segurança.']",120,160,160,120,160,720
24,Protagonistas e coadjuvantes,"['O usuário de drogas, está ligado direta ou indiretamente com à violência, porque ao comprar quaisquer tipos de drogas ilícitas estará financiando o tráfico, o dinheiro arrecadado com o tráfico de drogas por sua vez, alavanca o tráfico de armas, armas usadas para matar milhares de pessoas no mundo inteiro.', 'Por isso, o consumidor de drogas tem sua parcela de culpa na violência. No Rio de Janeiro o problema foi tão além que precisou da intervenção militar, aprovada no dia 21 de fevereiro de 2018, segundo o: BBC Brasil em São Paulo .', 'Sem dúvida, se não houvesse compradores, a violência despencaria, pois como se entende no texto:  violência, drogas e armas estão ligadas diretamente .', 'Portanto, devem ser aplicadas pelo governo responsável;  leis que punirá o usuário de drogas mais severamente, o traficante e ou qualquer um que faça apologia às drogas. Além disso, promover juntamente com a mídia palestras a respeito , como houve em 2017, nos dias 25 e 26 de abril no auditório do Supremo tribunal de justiça (STF).']",120,80,80,80,80,440
81,,"['No inicio  do século XVI  com a chegada dos portugueses ao Brasil, padres Jesuítas instruíram índios ao catolicismo cristã  ignorando ? assim ? suas crenças religiosas ? que era  baseadas especificamente a  elementos da natureza. Dessa forma, percebe-se que ainda hoje no Brasil existe  pessoas que não são respeitadas na sua escolha religiosa ? tornando-se a cada dia vítimas de violência verbal ou física.', 'Apesar de o Brasil ser uma república laica ? há muita intolerância religiosa atribuída à violência verbal e física, no entanto, essas práticas se devem não só a   falta de respeito ? mas também por falta de conhecimento relacionados a   tais religiões e atribuições que são dadas a elas como práticas demoníacas e uma das que mais sofre  com esse tipo de ofensa é o candomblé.', 'Logo, muitos são os problemas que contribui  para esses preconceitos, como a falta de diálogos entre os líderes religiosos ? que tem  como dever o ensino do respeito ao próximo, pais que não se interessam em conhecer outras religiões e assim passar os valores para seus filhos, como também as escolas não se interessam em debater sobre o mesmo, sendo assim, se torna  difícil cada vez mais diminuir as estatísticas de violência.', 'Portanto, medidas são necessárias para a resolução do impasse. É preciso que o ministério de educação  ? em parceria com as escolas  ? instrua professores e líderes religiosos a darem palestras a pais e filhos no intuito de mostrar que todas as religiões têm seus valores e devem ser respeitadas. Existe a necessidade que o ministério da justiça aprove projeto de lei como o amor acima de tudo,visando a diminuição da violência. E como disse o filosofo  Jean Paul Sartre , a violência independente de como ela se manifesta é sempre uma derrota.']",80,120,120,120,120,560
90,A transfobia no Brasil,"['No brasil, diariamente, pessoas transgênero morrem. O Brasil estruturalmente é um país preconceituoso, em relação ao ano passado os casos aumentaram, fora os casos que não são denunciados, então esse número, provavelmente seja bem maior.', 'Denúncias de violência sexual, violência psicológica e discriminação aumentaram ao decorrer dos anos contra a comunidade LGBTQIA+ . A transfobia é estrutural a anos, pessoas trans não conseguem empregos ou terminar a escola por causa do preconceito que passam.', 'Todo grupo LGBTQIA+ sofrem preconceito e morrem por serem quem eles querem ser. O governo e muitas bancadas religiosas, que tem muita visibilidade, são preocupantes para a luta, com falas discriminatórias.', 'Existe sim transfobia no Brasil, pessoas heterossexuais não são assassinadas, desclassificadas de uma vaga de emprego, são expulsas de suas casas ou sofrem preconceito por serem heterossexual . Se você fica quieto diante de uma transfobia, você compactua com o opressor.', 'No Brasil poderia existir mais casas de abrigo e acolhimento, sustentada pelo governo, para a comunidade (LGBTQIA+), que são expulsos de casa por causa de sua sexualidade, por não serem aceitos pela sua família. Em empresas poderia haver uma lei que uma certa porcentagem dos funcionários, sejam trans ou LGBTQIA+. Programas de aprendizado para aqueles que não conseguiu concluir a escola e tentar ingressar em uma faculdade.', 'Vamos ser feliz, e respeitar as pessoas. Nem todo mundo tem a mesma religião, ideia ou criação que você, não vamos destruir a vida da pessoa com falas homofóbicas. A vida é igual um papel, se você amassa o papel e desamassa, ele nunca vai voltar a ser o mesmo. Mais amor por favor.']",120,80,80,120,80,480
76,Luta por Igualdade,"['É indubitável que o sexo feminino é alvo de desigualdade. Nesse contexto, em decorrência da vulnerabilidade das mulheres, em quê são consideradas inferiores aos homens, além de terem uma visão arcaica de quê o seu único papel na sociedade é o lar, entre outros fatores, o preconceito tem ultrapassado os campos físico e moral gerando irreparáveis danos para as mesmas .', 'Não obstante antiga a ideia filosófica e sociológica de  Marx se identifica no campo hodierno, haja vista a luta das mulheres decorrente da inferiorização. Assim, a busca pelo empoderamento da mulher nas relações de trabalho é evidente, uma vez que, ainda com a ocupação de algumas mulheres para realizar o mesmo tipo de trabalho dos homens, padecem com a diferença salarial, o preconceito, em que são discriminadas tanto por serem mulheres, quanto por serem negras, e dupla jornada que se estende ao volta para a casa e realizar as suas tarefas.', 'Na sociedade antiga, as mulheres viviam sobre os domínios do homem, ou seja, eram submissas a eles, além de satisfazerem os seus desejos, ainda tinham que cuidar da casa e dos filhos. Em contrapartida, para mudas esse tipo de visão, surgiu o feminismo para equiparar os dois sexos, e assim a mulher ganhar ainda mais espaço em todos os aspectos, já que as mulheres do século XXI são mais independentes, não satisfazem aos caprichos do homem, e conseguem equilibrar a sua vida profissional com as atividades da casa.', 'É evidenciada a desigualdade de gênero que permeia a população canarinha, mesmo após séculos de sistemas patriarcais propriamente ditos, em que precisa ser combatida . Cabe ao Ministério da Cultura desenvolver campanhas publicitárias que estimulem o respeito a igualdade de direitos, como forma de garantir a coletividade do corpo social. Assim, a sociedade brasileira poderá garantir o exercício da cidadania de todos os setores sociais e, finalmente, ultrapassar antigos paradigmas.']",120,160,160,120,120,680
60,A previdência,"['A reforma da previdência é um assunto bastante discutido nos últimos dias,a mesma teve sua aprovação em julho desse ano pela câmara com 379 votos a favor e 131 contra .Está reforma não será válida para quem já recebe o benefício,as mudanças serão para aquele que não recebem ainda a aposentadoria.', 'Com essa nova reforma a idade mínima de aposentadoria para as mulheres é de 62 anos, já para os homens é de 65,o tempo mínimo de contribuição é de 25 anos;porém há algumas exceções para os trabalhadores rurais,professores e policias federais quer terão o tempo de contribuição reduzida. A proposta foi aprovada pela câmara e vai para o senado para receber a votação definitiva,essa proposta foi enviada para a votação para ser analisada e aprovada pelo nosso atual presidente Jair Messias Bolsonaro.', 'Segundo o dite1  o presidente da câmara Rodrigo Maia afirmou que o segundo turno da votação acontecerá em Agosto. A PEC(Proposta De Emenda  Constituição)que se trata da reforma vem causando grande tumulto entre os brasileiros por que serão reduzidos alguns benefícios como pensões e auxílios; com essa redução o nível de pobreza vai crescendo relativamente no Brasil.', 'É notório que a reforma da previdência é um tema que está trazendo preocupação a todos no país ,como o o líder indiano pacifista Mahatma Gandhi dizia  ""Portanto temos de nos tornar a mudança que queremos ver"".Portanto medidas cabíveis devem ser tomadas pelas autoridades de estado para que o índice de pobreza não aumente no Brasil.']",120,160,120,120,120,640
93,,"['Saúde é um estado de completo bem-estar físico, mental e social. Porém, não é o que acontece na realidade brasileira, onde mulheres tem a sua saúde mental afetada na hora do parto . Esse problema ocorre, pela falta de gestão do médico na hora do parto e a falta de investimento do governo.', 'Sob essa perspectiva, vale ressaltar que a falta de administração na hora do nascimento do bebê agrava a questão. Confúcio afirmou que: ""O homem joga sua saúde fora para conseguir dinheiro, depois, usa o dinheiro para reconquistá-la novamente. Dessa maneira, para se ter uma melhor gestão no parto, tem que pagar. Portanto, é inaceitável que essa entrave persista no século XXI.', 'Ademais, convém enfatizar que a falta de investimento do governo na saúde pública, prejudica mais a questão. Segundo a constituição federal, a saúde é um direito social. Assim, cabe s instituições públicas,  investir na saúde pública, criando opções para a gestante, na qual ela não saia traumatizada do hospital. Desse modo, o governo deve agir imediatamente.', 'Depreende-se, ainda, que a saúde pública é uma preocupação para a sociedade. O governo, por meio do Ministério da Saúde  (parte do governo responsável pela saúde), deve construir maternidades com estruturas melhores , com o intuito de receber melhor as gestantes . Feito isso, a problemática será amenizada.']",160,160,120,160,160,760
44,Dignidade feminina,"['De acordo com a declaração universal dos direitos humanos (DUDH), todos os homens nascem livres e iguais em dignidade e direitos. Porém, sabe-se que na sociedade contemporânea, não é bem assim que funciona, pois, uma mulher ter que provar que realmente é mulher, é algo humilhante, principalmente em sua área profissional, que está lutando para ser uma mulher independente, como no caso da atleta sul-africana Caster semenya, que foi banida das competições, por apresentar testosterona muito alta.', 'O movimento ""let her run"" (deixe ela correr), foi levantado em consequência desta situação. A maioria das pessoas se revoltaram, e foram atrás dos direitos das mulheres, além disso, a discriminação é algo imperdoável, pois no mundo atual, esta situação era pra não existir mais. Nesse contexto, a atleta Caster semenya, além de ter sua dignidade violada, foi impedida de participar das competições, o que é muito importante em sua carreira e para representar inúmeras mulheres, que lutam pela liberdade e independência.', 'Desse modo, não só atletas, mas também todas profissionais femininas, sofrem com a discriminação em esportes,e em outras áreas de serviço. Logo, a humilhante situação com Caster semenya, apenas por ter hormônios em excesso, foi um grande problema, que causou uma série de obstáculos em sua vida.', 'Portanto, tais medidas seriam suficientes para combater este impasse. Cabe, a wada ( agência mundial antidoping) ,  fazer recomendações aos laboratórios, para regular exames antidoping nos esportes femininos. A fim dessa medida, evitar punições desnecessárias no esporte.']",160,160,120,160,120,720
32,O Direito e seu fato gerador,"['O sociólogo Zygmunt Bauman afirma que vivemos em um mundo pós moderno onde as relações sociais estão cada dia mais complexas e ramificadas. O Direito, tendo como uma das suas principais fontes a opinião pública, é a ciência social que tenta harmonizar tais relações. Todavia, muitas vezes há conflitos entre aquilo que tal ciência impõe como é no caso a questão da liberdade de expressão e a intimidade.', 'Em primeiro momento é valido ressaltar que a intimidade é algo relativo e pessoal. Não é possível usar estatísticas para saber até qual ponto a intimidade do outro esta sendo tangenciada. Um dos principais problemas do Direito enquanto ciência é que, ao contrário da Matemática e da Química, ele se configura como uma ciência humana. Sendo assim, a margem de erro pode, por muitas vezes, ser sentida de uma forma mais intensa por algumas pessoas do que por outras e daí que se vem o relativismo a respeito da intimidade.', 'Em segundo momento podemos salientar que ao contrário da intimidade, a liberdade de expressão pode ser mensurada através de exemplos práticos. Dessa forma ela pode ser mais fácil de ser analisada quando se pensa em um problema social. Satre afirma que somos condenados á liberdade. Sendo assim, quando utilizamos algo que já nos convém como base para criar normas e regras, isso auxilia o direito á alcançáveis estabilidades jurídicas e, portando , redireciona a condutas éticas não só possíveis de ser estabelecidas, mas também cumpridas.', 'Portanto, o conflito entre a liberdade de expressão e intimidade deve começar a ser solucionado através de uma análise a respeito de qual delas é mais possível de ser utilizadas como um “fato gerador” do Direito. Dessa forma, leis seriam criadas e, paulatinamente, melhoras em prol da harmonia social.']",160,160,120,160,120,720
64,,"['Um assunto bastante polêmico entre a população brasileira  e principalmente entre os pais, é a educação sexual na escola. Por falta de noção, adolescentes engravidam antes dos 18 anos ou contraem doenças sexualmente transmissíveis .', 'A educação sexual visa ter uma maior conscientização de crianças e adolescentes, sobre o modo de prevenção, contra a gravidez e doenças sexualmente transmissíveis. Porém há um receio entre os pais sobre esse assunto na infância. Muitos alegam ser inapropriado e incentivo a iniciação sexual precoce. Mas, um exemplo é na Alemanha que é um compromisso do Estado e não somente dos pais ensinar sobre a sexualidade desde o primário. Em países como esses os problemas que a ausência de informações sobre a vida sexual causa são relativamente menores do que em países existe essa privação de informações.', 'Desse modo, o ensinamento a repeito da vida sexual pode levar a compreensão da sexualidade e assim reduzir os índices de gravidez precoce e a transmissão de doenças como do HIV. Além da necessidade de uma união entre pais e escola para que haja um entendimento sobre a importância da educação sexual na escola.']",120,120,80,120,80,520
93,Parto às pressas,"['Atualmente, é crescente o número de mulheres que optam pelo parto humanizado no Brasil. Visando garantir a autonomia da mãe e do bebê, o uso de procedimentos não cirúrgicos que respeitem o tempo e o lugar do nascimento entra em conflito com o alto índice de cesáreas no país. Neste panorama, deve-se analisar as causas dessa disparidade e os benefícios que a humanização do parto oferece.', 'Segundo dados da OMS , o Brasil é o segundo país com maior taxa de cesarianas do mundo . O número supera 50% do total de partos realizados no SUS e quase 85% em unidades de saúde privadas. Isso se deve em virtude da popularização do parto operatório nos anos 80, o qual prometia segurança e indolência, além de diminuir a chance de óbito no parto. Levando em conta que, nessa época, o cientificismo estava em alta, não demorou para muitas mulheres grávidas preferirem a operação. Dessa forma, os métodos cirúrgicos e invasivos enraizaram-se na cultura brasileira.', 'Paradoxalmente, a cesárea demonstrou-se ser incapaz de, por diversas vezes, garantir o pleno bem-estar do recém-nascido. Sem as contrações do parto normal, por exemplo, a água nos pulmões do bebê não é retirada por completo, gerando complicações futuras. Ademais, o parto humanizado faz do momento mãe e filho mais especial, com toda calma e acompanhamento necessários.', 'Em suma, os procedimentos cirúrgicos no parto, apesar de necessários em uma gravidez de risco, tornam-se hostis quando são realizados preferencialmente ou sem o consentimento da paciente. Sendo assim, é necessário que o Estado promova essa humanização por meio da criação de mais casas de parto espalhadas pelo território brasileiro . Além disso, o Ministério da Cultura deve promover, através da televisão e internet , campanhas informacionais  capazes de desmistificar e alertar acerca da cesárea e demais operações. Somente assim, dando espaço para um nascimento natural e tranquilo.']",200,160,120,160,160,800
8,É notório o aumento da discussão,"['É notório o aumento da discussão acerca da influência da ciência na era da pós-verdade. Devido a à existência de diversos grupos com pensamentos opostos, bem como o ao aumento da divulgação de informações a partir do advento da internet, há diversas teorias, consagradas no meio científico, sendo contestadas.', 'Observando esse cenário, é possível perceber uma crescente divulgação de pensamentos divergentes de ideais antes tido tidos como dogmas. Alguns grupos tem têm apresentado versões diversas que trazem a à tona discussões acerca de algumas verdades historicamente construídas, tais como as que refutam a necessidade de vacinar as pessoas, evitando para evitar a proliferação de doenças. Quem se opõe, garante a não segurança opõe garante a insegurança da imunização, pois pode tornar os microrganismos responsáveis pelas doenças ainda mais resistentes. No entanto, de acordo com dados da Organização Mundial da Saúde, em 2017, quanto maior a cobertura da população com vacinações, menor é a chance do fortalecimento dos vírus e bactérias no ambiente.', 'Além disso, é importante destacar o papel das redes sociais e outros meios de comunicação virtual na divulgação de dados nem sempre com respaldo científico. Essa ampliação maciça de notícias traz dúvidas pelo excesso de informações às pessoas, que não conseguem formar sua opinião a respeito dos fatos a partir de fontes imparciais.', 'Logo, é importante que o governo amplie a divulgação, através de fontes oficiais, de dados e informações verídicas a respeito, sobretudo sobretudo, de temas importantes, como questões relacionadas à saúde pública, definindo a partir de evidências e comprovações científicas o que é verdade, evitando a disseminação de notícias que possam diminuir a segurança de todos.']",120,120,120,120,80,560
52,Casamento arranjado,"['Convivemos diariamente com as consequências de meninas grávidas na adolescência,que vem desde a civilização antiga.', 'As meninas casavam e iniciavam sua vida assim que acontecia a menarca , o casamento arranjado pelos pais e a gravidez precoce era uma prática comum.', 'A taxa mundial de gravidez na adolescência é estimada, em 46 nascimento para cada 1 mil meninas de 15 a 19 anos.', 'Portanto a gravidez na adolescência é uma cousa que já vem de décadas, e conforme se passa o ano o índice só aumenta.']",120,80,40,80,0,320
49,O papel dos influenciadores digitais,"['No Brasil existem inúmeros influenciadores digitais dentre eles, destaca-se Rafaella Kalimann, mineira, nascida em Campina Verde no triângulo ineiro, embaixadora da ONG missão África e madrinha do hospital de câncer de Goiás e residencial JK. Atualmente ocupa o posto de uma das influenciadoras digitais mais conhecidas do Brasil com cerca de 14 milhões de seguidores em suas redes sociais, os mesmos estão espalhados no Brasil e no mundo. Fora das redes sociais, Rafa kalimann apresenta um lado humanitário de Grande valor, ela segue com seu propósito de vida que é influenciar e ajudar pessoas para o bem.', 'Há cerca de 7 anos atrás Rafa kalimann iniciou sua participação na ONG missão África, tendo como objetivo final promover justiça social, saúde e educação em países africanos. A visão do projeto é mudar a situação de pobreza e vulnerabilidade da sociedade presente lá. É perceptível que alguns países da África vivem em situações de pobreza extrema, dentre eles está Níger, país da África com expectativa de vida de até 50 anos devido à renda per capita da população.', 'A partir do exposto, percebe-se que a situação de vulnerabilidade se aplica em vários países espalhados pelo mundo. As autoridades diante de todos os fatos apresentados deveriam promover campanhas sociais com o intuito de sensibilizar o lado humanitário presente na sociedade, as mesmas diante dessa situação promoveriam a união e realizariam missões em todas as partes do mundo para ajudar aqueles que estão necessitados.']",120,80,80,120,0,400
43,A cultura do cancelamento nas redes sociais.(h),"[""A internet sem dúvida é um dos maiores viés de comunicação da sociedade atual, pois oferece da informação até o lazer com redes sociais que deixam navegar na web ainda mais divertido e diversificado .No entanto, com a grande quantidade de acessibilidade é comum ver opiniões positivas e negativas sobre indivíduos que decidem expor sua vida nas redes, os chamados ''cancelamento'' ou ''hates'', nas quais objetificam pontos de vista diferentes e por vezes cruéis a respeito dos tais afetando a saúde mental e física de milhares de brasileiros."", ""O artigo 19  da constituição dos Direitos humanos, diz sobre todos terem o direito de liberdade de expressão e opinião contanto que não afete o outro, isto é a pontuação decorrente da sua visão sobre algo ou alguém é livre até a partida que fere e desrespeita o próximo em seus direitos da mesma forma, que é e exatamente o que ocorre nas redes sociais onde as pessoas se consideram ''juízes'' e julgam todos os tipos de atitudes, jeitos, falas, posicionamentos, corpos e medidas, sexualidade, raça e etnia ou seja estes tais usam de forma erroneamente sua arbitrariedade de fala para deteriorar a saúde psicológica com pressão de todas as partes e até a saúde física cancelando pessoas que não se encaixem no padrão imposto por eles."", ""Com essas práticas o lugar que era para ser de desopilação acaba virando um jogo de quem consegue derrubar e cancelar julgando o que é mostrado superficialmente levantando ''hashtgs'' alastrando cada vez mais o ''ciberbully''.Como a grande polêmica da famosa lipoaspiração de alta definição em outras palavras a lipo LAD  como é popularmente conhecida no qual foi o alvo de diversas influenciadoras digitais no ano de 2020, onde muitas delas receberam críticas e foram canceladas por cederem e influenciarem adolescentes a fazer tal procedimento cirúrgico ''romantizando'' o tal, criando esse linchamento virtual cobrando responsabilidade efetiva de quem possui um público vasto."", 'Todas essas questões levantadas urgem a necessidade de intervenção governamental que assegurem a liberdade do indivíduo em se posicionar e não martirizar outros por não possuírem a mesma linha de pensamentos e ideais. É necessário que o Ministério da Cultura juntamente com o Ministério da Saúde, promova palestras relacionadas ao físico e psicológico. além de criar leis e manifestos com o intuito de por abaixo tais cancelamentos por meio de recursos midiáticos e sociais, tornando assim as redes de comunicação um recurso sem preconceitos e contribuindo para um país justo e igualitário que assegura todos em direitos e deveres.']",120,160,120,120,160,680
61,,"['A atividade policial requer grandes responsabilidades que perpassam por questões de segurança pública e pessoal, as quais apresentam riscos inerentes a profissão. Contudo, é perceptível que o suicídio, é uma das principais causas de morte dos agentes de segurança pública do Brasil, muitas vezes por conta do estresse ocupacional, pelo qual derivam vários outros fatores, e de conflitos institucionais.', 'Em primeiro plano, vê-se que as condições de risco da profissão desencadeiam o estresse ocupacional, o qual pode muitas vezes levar ao sofrimento psíquico. Sabe-se que os policiais diariamente lidam com as expressões mais violentas da humanidade, além das exigências da população e da mídia, que imprimem a imagem dos agentes ora como heróis, ora como vilões. O que idealiza a atividade do profissional, e induz a corporação a uma dedicação extrema ao trabalho, desenvolvendo em muitos agentes problemas de saúde, pessoais e psicológicos.', 'Em segundo plano, nota-se que a cobrança institucional, a disciplina rígida, e o descaso corporacional para com os oficiais que adoecem, são aspectos que aumentam as ocorrências de suicídio entre policiais, as quais são três vezes maior do que a população em geral. Outrossim, desamparo dessas instituições policiais deixam os agentes em situações vulneráveis, pelas quais o indivíduo sente-se fragilizado, e muitas vezes com aversão a represália da corporação, encontra dificuldades para pedir ajuda, e além do mais permanecem com o fácil acesso ao armamento.', 'Portanto, levando em consideração esses aspectos, medidas devem ser tomadas para a prevenção do suicídio entre policiais. É necessário que desde o treinamento dos oficiais na academia de polícia haja um programa de ensino de inteligência emocional, e acompanhamento psicológico ao longo da carreira, para coibir o adoecimento dos agentes. E também que as instituições policiais com o apoio do GEPeSP implantem uma política de tratamento e suporte aos profissionais adoecidos mentalmente. Além disso, o Ministério da Justiça e Segurança Pública conjuntamente com o Ministério do Trabalho produzam um vídeo em seus canais no Youtube que humanize a imagem do policial como trabalhador e cidadão.']",120,120,120,120,120,600
50,A necessidade de inovação e incentivos fiscais à ciência e tecnologia no Brasil,"['Após um período de 11 anos  desde a última crise de saúde, o mundo está novamente vivenciando uma pandemia,causada pelo novo coronavírus. No Brasil,com o passar dos anos as universidades e institutos de pesquisa vêm sofrendo  com a redução de verbas. Fator que compromente pesquisadores da ciência e tecnologia.', 'Dessa forma, quando surge uma grave doença como essa, a população necessita de profissionais capacitados para estudá-la, rastrear sua origem e depois combatê-la. Papel que não é e nem pode ser desempenhado apenas por médicos ou enfermeiros. devido ao desempenho no trabalho de pesquisadores e cientistas que o Brasil conseguiu uma posição significativa no cenário internacional.', 'Diante disso, a sociedade brasilera não pode aceitar que essas áreas do conhecimento sejam desprezadas, e sim prezar pela manutenção dos mesmos .  Pois, esses trabalhos auxiliam indiretamente todos.', 'Portanto,não somente o governo,mas empresas privadas devem financial e custear as pesquisas. E é preciso uma inovação nos campus, para que as estruturas sejam capazes de comportar todos e o acesso à informação deve ser ampliado para que mais estudantes se interessem pela ciência e a tecnologia.']",120,120,120,120,120,600
48,SUS,"['Basta acessar os canais de comunicação como os telejornais, que diariamente temos pautas a respeito do nosso Sistema Único de Saúde. Pessoas desesperadas por atendimento, pacientes em corredor, profissionais reivindicando por seus salários e condições de trabalho. São cenas que estamos “acostumados” a ver.', 'Sabe-se que,  este sistema foi criado com intuito de atender a população brasileira, ou seja, tanto as pessoas menos favorecidas quanto aquelas que podem optar por procurar clínicas particulares . Porém, a realidade do Brasil é muito diferente do que o que foi idealizado nos países mais desenvolvidos , onde esse sistema realmente funciona.', 'A capacidade reduzida nas unidades de atendimento, a falta de profissionais qualificados e a alta demanda da população, faz com que esse sistema não suporte tamanha procura e entre em colapso. No caso de uma pandemia, o maior medo do Estado, era justamente o colapso do SUS . É de conhecimento de todos, que devido a falta de investimento do governo, muitas unidades de atendimento são construídas e abandonas, ficando em estado crítico e total descaso.', 'O governo deveria rever sua posição em relação ao Sus, e entender que como está na constituição , é um direto de todos e ser mais ativo na fiscalização do investimento dessas unidades de atendimento, valorizar o profissional da saúde publica e principalmente garantir que os mais necessitados terão direto a um serviço publico de saúde de qualidade.']",160,120,120,120,80,600
64,Falando sobre sexualidade na escola,"['Desde antigamente falar de sexo era um tabu na sociedade. Ainda que não falavam abertamente na escola . Hoje em dia ela está se expandindo no mundo todo, e são falas dentro da sala de aula. O comportamento sexual tem que ser abordados por professores e informados sobre as doenças trasmissiveis, contraceptivos que podem ser usados, gravidez na adolescência, para que eles não pratique cedo.', ""preciso que os jovens fiquem informados com isso na sala de aula  ou seja para que eles não entregue o seu corpo ao algum precosimente, evitando uma gravidez indesejada e ou DST's . Alem disso è dever da escola falar sobre o assunto e para que se percam a vergonha de falar com as familìa sobre qualquer assunto relacionado ao sexo. Porem alguns adolescente pesquisa na Internet e ainda que se deparam com informações que não seja verdadeira . Entretanto os professores têm que falar das doenças trasmissìveis como o HIV e a AIDS, e aborto, gravidez. Embora os educadores devem aconselhar sobre os metodos conceptivos que protegem contras doenças sexualmente trasmissiveis e gravidez como :preservativos, injeções, DIU,pìlulas,"", 'Por conseguinte è necessário que os professores fale mais disso, realizando palestra educativas, atividades em grupo, seminário, e que os pais participe expondo suas opiniões. dever principalmente do Estado impôs práticas nas aulas de sala para o profissional fale disto com os alunos e se informem da sexualidade antes de praca-lo .']",120,80,80,120,40,440
70,Responsabilidade,"['A responsabilidade é a palavra chave para resolver qualquer impasse na vida. Com as DSTs não seria diferente. O aumento das doenças sexualmente transmissíveis no Brasil entre jovens é a consequência disso. O mundo inteiro vive a era digital, da informação rápida, do imediatismo, logo, não se pode afirmar que é culpa do governo, da escola, da família ou da sociedade como um todo. E tirar do debate a noção de responsabilidade de cada um, com seu corpo, sua vida e sua moral. E muito, além disso, com o próximo.', 'O governo brasileiro faz a sua parte muito bem feita nesta área, nos postos de saúde distribuem preservativos, pílulas ante- concepcional e profissionais da saúde treinados para ajudar qualquer cidadão que queira ter uma vida sexual segura e feliz, sem risco com sua saúde nem com a saúde do parceiro . As escolas também fazem palestras e esclarecimentos desse tema. A T,  rádio, os jornais e a internet também sempre estão por força do governo federal falando e alertando a população sobre as DSTs.', 'As escolas públicas e privadas vacinam meninos e meninas com idade entre 11 e 15 anos contra o vírus HPV que é transmitido pelo ato sexual e pode causar câncer do colo do útero muito comum em mulheres brasileiras. Infelizmente, mesmo com todas as informações e propagandas para combater o vírus da AIDS que é a mais terrível de todas as DSTs, ela ainda é crescente, o número de infectados entre 15 e 19 anos aumentou 187 % , segundo o Ministério da saúde. O maior inimigo do ser humano não é a doença, é a estupidez! Contra ela não há nem preservativos nem vacinas. Só a dor.', 'Todo ser humano busca encontrar a felicidade da maneira possível, é muito mais inteligente buscar de forma responsável sem risco e sem dor para si e para o outro . Cada um tem que ter a noção da responsabilidade individual de seus atos. Afinal, é seu corpo, sua vida, sua saúde e a de quem você ama. Com o simples hábito de usar camisinha. A ciência ajudou a humanidade, agora falta os humanos se ajudarem. Com o uso do preservativo, higiene pessoal e visita anual ao médico, é possível ter uma vida sexual tranquila, saudável, feliz e longeva. Com esses cuidados se combate as DSTS, gravidez indesejada e até a morte. Vontade de fazer sexo dá e passa. Sem segurança não faça sexo, faça planos de ter uma saúde perfeita.']",120,120,120,120,40,520
119,Em busca do corpo ideal,"['Algum tempo sempre         se defendeu         a ideia         de                mente sã         e         corpo         são, infelizmente         em pleno século         XXI         esse ensinamento tão                 antigo                parece estar cada vez mais         distante         . Em uma sociedade de         consumo         que ""vende modelos inatingível de perfeição"", é natural que ocorram                 danos físicos e psicológicos                .', 'O indivíduo cada vez mai se         submetem          a padrões inalcançáveis         como; tratamentos, cirurgias         .                 Causa                danos reais         á         saúde ou até mesmo         á         morte. Um         exemplo é caso         que chamou bastante atenção da mídia foi                Andressa         urach         vice-miss bumbum,                ficou entre a vida e         á         morte após ter colocado         hidrogeu         nas         coxa         .                 Nessa perspectiva o indivíduo cuja não está adequado sofrem como vítimas isoladas.', 'Depressão, distúrbios alimentares, bulimia e anorexia são alguns                 efeitos psicológicos de um ideal não alcançável para aqueles que não obtiveram seu objetivo                , muitas vezes proposto pela mídia ou por amigos que buscam essa perfeição de qualquer maneira.', 'É preciso, portanto, que se reflita sobre esses padrões corporais que nos         é imposto         cada dia. É preciso que o indivíduo seja mais flexível consigo mesmo. A escola pode levantar esses questionamentos sobre os                 estigmas corporais                . A         mídia         por sua vez, deve assumir uma responsabilidade e promover         umas         reflexão. Quem sabe assim a sociedade compreenda que a beleza         esta          no seu aspecto plural.']",120,120,120,120,120,600
65,A romantização do crime,"['Na série “La casa de Papel” ( A casa de papel), lançada na Netflix em 2018, um grupo de criminosos é reunido com objetivo de realizar o maior assalto da história. Essa série ficou muito famosa entre os jovens, mas, de certa forma, mostra a realidade da mídia atual que segue romantizando a criminalização e a violência, tendo grande influência e poder de alienação sobre a juventude.', 'A taxa de criminalidade entre os jovens se agrava continuamente . Pelo grande aumento da urbanização e da desigualdade social, aqueles que se encontram em situações socioeconômicas precárias, acabam recorrendo ao tráfego de drogas para ganharem seu dinheiro, muitos acabam se tornando dependentes químicos, e se aprofundando na vida do crime.', 'Com a lei da maioridade penal, crianças e jovens menores de 18 anos , tem um papel importante no ato criminal, pois, não podem ser totalmente privados da liberdade, os tornando alvos de organizações criminosas que planejam assaltos entre outros delitos.', 'Visto que a problemática da criminalidade juvenil se estende, cabe ao Ministério da Educação (MEC) administrado pelo governo federal, a implantação de debates nas escolas, visando conscientizar e orientar os alunos do ensino fundamental e médio,  sobre a questão da criminalização e da violência, incentivando programas como o PROERD (programa educacional de desistência as drogas e violência) ampliando o senso crítico, e alertando sobre os perigos oriundos do crime e do uso de drogas']",120,160,120,160,120,680
22,Prerrogativa de função ou privilégio pessoal,"['Recentemente, a pauta do foro especial por prerrogativa de função, mais popularmente conhecida como foro privilegiado, tem sido bastante discutida com as novas medidas que restringem a sua amplitude em relação àqueles que dele se beneficiam. O foro determina que ocupantes de certos cargos públicos sejam julgados por instâncias específicas do judiciário, como o supremo tribunal federal , e não pela primeira instância, como os cidadãos comuns.', 'Diversos intelectuais e pesquisadores defendem a extinção de tal foro, como ocorre em países como a Suíça e os Estados Unidos, em que não há essa especialidade. Segundo eles, o foro é herança de uma cultura de privilégios que data desde a colonização do país e a escravatura, da qual necessita-se uma urgente reforma, assim como em todo sistema político brasileiro.', 'Por outro lado, defensores do foro especial, justificam seus pontos de vista ao dizerem que a primeira instância não teria condições e a especialidade para julgar crimes e conflitos cometidos por determinadas autoridades, como os senadores e deputados federais, no período de exercício parlamentar. Além disso, o foro se destinaria a proteger o cargo, função e a atividade pública e não a pessoa que a exerce.', 'O que ocorre é que o foro de prerrogativa de função que tem essa intenção de proteção ao cargo e função pública, por desvios do sistema político brasileiro, acaba se tornando um foro de privilégios pessoais. Assim, deputados e senadores se beneficiam, não por exercerem tais atividades, mas por questões particulares que não deveriam se tornar políticas.']",200,200,200,200,0,800
150,Violência na escola,"['O ambiente escolar se tornou uma vítima da violência física e moral. Com o         avento         da tecnologia para propagar esse tipo de violência, um problema que já existia agravou-se, trazendo                 insegurança                a pais e         filhos         que já                 não se sentem seguros                em um lugar feito para         acolhe-los         .         Cresce         então, a preocupação sobre         o qual         será o futuro dos jovens que estão expostos a esse tipo de problema diariamente.', 'As escolas, sejam elas públicas ou particulares, servem como fator determinante na formação social do indivíduo. Quando não se tem controle sobre essa formação, o problema deixa de ser algo individual e passa a ser um problema coletivo, de toda a sociedade.                  O que antes eram problemas como, nota vermelha no boletim, os diretores de escolas estão tendo problemas cada vez maiores como, por exemplo, formação de gangues, uso de drogas, pichações, porte de armas, e inclusive, tráfico.                Consequentemente, tem-se uma inversão de valores no cenário escolar. Alunos estão pouco preocupados com sua formação acadêmica e profissional, passando a valorizar o exibicionismo da violência na Internet.', 'É necessário expor         a         comunidade que isso não é apenas um problema da escola, mas de todos que estão relacionados                . E com a ajuda da comunidade e dos pais, as escolas podem começar um projeto         participativo trazendo         a importância da formação profissional do indivíduo. Isso pode trazer de volta aos estudantes o valor da educação e o papel da escola na sociedade,         fazendo com que estes, entendam         que escola é lugar para         estudar, e         não para brigar.']",160,120,120,80,120,600
47,.,"['Há mais de duas décadas, a internet surgiu como a esperança para a democratização da informação. No entanto, tal recurso não foi amplamente acessível no Brasil. No contexto educacional atual, o problema é semelhante, visto que a inclusão da tecnologia na educação pode excluir determinados grupos que encontram-se desprovidos de renda e técnica para se enquadrar às mudanças', 'Em primeiro plano, é importante dizer que a inserção do EAD (Ensino à distância) gerará um processo de exclusão, já que, de acordo com o escritor Pierre Levy, ""toda nova tecnologia cria seus excluídos"" . Assim, esse modelo poderá atuar como um segregador no ambiente educacional, pois nem todos terão a devida condição financeira para se enquadrar ao novo método de ensino.', 'Outro fator determinante, é que a falta de contato com as inovações tecnológicas promove o surgimento de ""Analfabetos Digitais"", termo utilizado para exemplificar pessoas que, por não terem contato com as novas tecnologias, não possuem o seu domínio técnico. Segundo o IBGE , cerca de 63,3 milhões de pessoas ainda não estão conectadas à internet no Brasil, ou seja, todas elas estão vulneráveis a se enquadrarem nesse novo termo.', 'Diante do exposto, fica evidente que a inserção do EAD na educação sem o devido cuidado pode gerar uma falsa democratização. Para que isso não ocorra, o Ministério da Educação , em conjunto com escolas de informática, deve auxiliar os alunos com menores condições, fornecendo materiais em locais públicos apropriados, é necessário que esses materiais venham acompanhados de aulas gratuitas que instruam os alunos que não possuem esse histórico de contato com esses aparelhos. Desse modo, espera-se que a inserção das tecnologias, como o EAD, afete os menos favorecidos e realmente promova uma democratização na educação.']",160,160,160,160,160,800
52,O real problema,"['Dados da Organização Mundial de Saúde (OMS) revelam que a adolescência corresponde ao período de vida entre 10 e 19 anos, onde o corpo começa a demonstrar mudanças e o indivíduo pode começar sua vida sexual.', 'Apesar da grande quantidade de informações sobre sexualidade e métodos anticoncepcionais as adolescentes continuam engravidando, o que gera implicações sociais, psíquicas e econômicas. Sociais pois abandonam os estudos, psíquicas pois muitas não possuem a condição mental de cuidar de um filho e econômicas pois tm a preparação para mais um gasto na sua vida, como disse Isaac Newton – “Toda ação tem uma reação”.', 'A deficiência dos serviços de saúde pode ser apontada como outro fator relevante com relação não utilização dos métodos contraceptivos, é associado principalmente ao acesso à informação e a escolaridade precária de tais adolescentes aonde também os hábitos culturais vem a ser creditados.', 'Dentre os fatores apresentados também é presente a classe social, onde em regiões mais precárias tal como, norte e nordestes, a falta de acesso à informação em conjunção com o índice demográfico dessas áreas também causam grande taxa de gravidez precoce diminuindo mais ainda o Índice de Desenvolvimento Humano (IDH) da região, tendo maior necessidade de projetos sociais para a conscientização, matérias escolares, acesso à informação e adaptação de inúmeros pontos de saúde já existentes.']",120,80,80,120,80,480
131,Democrácia pela democrácia,"['A                 grande descoberta do marketing e          propagandas publicitárias alavancaram e fomentaram o comercio         mundial, que passou a vender quantidades                de produtos – que eram divulgados pela mídia –         exorbitante         , sendo não mais         vendido         pela a utilidade e sim pela marca.         Nesses         contexto, a propaganda         eleitoral política         gratuita e obrigatória mostra-nos         que esta não passa         de publicidade e marketing, em que         ""vendes-se""         o político e não a proposta de campanha, fugindo assim                 ao objetivo de expansão da proposta política do partido ao eleitor, em que é inutilizada a propaganda política.', 'Umas das principais causas para a propaganda política não funcionar efetivamente vem do exagero do         numero         de partidos, em que o tempo para a apresentação da proposta política é consumido pelos candidatos que         limitam-se         a anunciar seus nomes e números. Assim, surge o sentimento no eleitor de que assistir a propaganda não adianta, deixando-se                 o programa eleitoral para          crianças          que, muitas          vez          , só aguardam o retorno da programação normal.', 'Com isso, o prejuízo         financeiro         sem surtir o efeito esperado no eleitor, faz do horário político uma piada, vista por         muitos, como         uma programação a ser ignorada.         Sendo também, ignorada         os 840 milhões de reais vindos de nossos         bolsos         que pagam por um programa ineficiente         ao         qual não queremos         vê-lo         .', 'Sendo assim, é necessário introduzirmos uma política que faça com que o político pague         pelo o seus         tempo de programação, pague para expor a sua         ideia. E, assim, valorizemos         o horário político fazendo com que         ele seja         levado a         serio         e surta o efeito         que         o eleitor precisa.', 'Outrossim, é                 sine qua non                realizarmos um plebiscito nacional em que toda a população opine acerca do horário         político         se deve ser gratuito ou não, fazendo com que                 direitos democráticos sejam utilizados para         democracia. Pois, só         a com a democracia efetivaremos nossa democracia.']",120,160,120,120,160,680
68,não existe futuro sem passado,"['É muito importante preservar o patrimônio histórico nacional. Porque é nossa memoria, nossa  historia e nossa raiz. Sem passado a civilização não tem futuro. É esse acervo que conta toda a evolução das gerações. A história é responsável por toda memoria de um povo. Sem a preservação não há civilização  ela a responsável da cultura humana no mundo.', 'É obrigação do povo preservar seu patrimônio com zelo, com amor e com orgulho . Porque é a população que será beneficiada com toda sua cultura. Os costumes, a culinária, a ciência, o folclore, a musica, as manifestações popular, e toda arquitetura de prédios públicos e privados deve ser mantidos e cuidados por governos municipais, estaduais e federais. Não pode faltar verbas para manter a memoria nacional.', 'O Brasil tem um grande acervo cultural, cabe a cada um cuidar. Ele pertence ao seu povo e a humanidade. É de grande importância que se crie a cultura da preservação como no Japão. Lá eles ensinam aos seus filhos a importância da preservação desde o jardim da infância. Eles são treinados a cuidar do bem público com amor e zelo. É assim que deve se comportar todos os outros países cuidando de todo bem público. O que é público é de todos. Não só para usufruir, mas para cuidar também.', 'O Museu Nacional no Rio de Janeiro foi destruído em um grande incêndio por falta de cuidado público e privado. Um museu é um seleiro de beleza e conhecimento. Lá se encontra o conhecimento do passado, presente e futuro. É importante para a humanidade. O governo deve ser responsável por toda manutenção dos patrimônios históricos e cultura. E a população deve aprender a valorizar seus patrimônios para que no futuro todos tenham memorias vivas do passado.']",120,160,120,160,120,680
49,O papel dos influenciadores digitais,"['Durante o período nazista na Alemanha, os homens eram influenciados pelo comportamento de Adolf Hitler, imitando  os gestos e até mesmo o corte de cabelo do líder. Na atualidade, foram designadas novas pessoas para esse papel: os influenciadores digitais, tais indivíduos fazem um trabalho muito importante e ao mesmo tempo perigoso na vida de seu público. Pelo lado positivo, possuem a capacidade de trazer ás questões sociais mais visibilidade, entretanto, algumas atitudes desse conjunto acabam por mudar o comportamento dos espectadores de forma drástica.', 'Em primeiro lugar, esses influenciadores possuem um papel de representação e comunicação para com seus seguidores. Desse modo, eles conseguem ser fortes transmissores de benefícios sociais, apresentam desafios frequentes, desenvolvem movimentos de ajuda mútua, e com suas atitudes ajudam a reparar as disparidades econômicas e sociais do cotidiano, como um dos maiores “influencers” do Brasil na atualidade: Carlinhos Maia, que consegue promover campanhas entre seus colegas famosos, para ajudar pessoas de baixa renda, principalmente no Nordeste do país.', 'No entanto, as influências desses blogueiros nas vidas de seus seguidores acarretam em consequências infelizes. Segundo Napoleão Bonaparte “a multidão procura o líder não por sua causa, mas por sua influência”; Dessa forma os “influencers” adquirem milhões de espectadores, pois o público está mais interessado na forma como essas pessoas vivem e exibem-se, do que com suas reais personalidades. Além disso, muitas pessoas seguem veementemente as publicações, a ponto de tentar copiar os ídolos em tudo, nos corpos, nas rotinas, nas viagens, nas roupas, surgem assim doenças como: anorexia, bulimia e depressão, por mérito de expectativas não condizentes com a realidade.', 'Em razão do que foi dito, para que famosos nas redes não se tornem más influências, e para que menos pessoas desenvolvam doenças em virtude do mau uso das mídias sociais, são necessárias medidas, para atenuar o impasse. Assim sendo, a primeira atitude deve ser exatamente de onde vem o problema: dos influenciadores, estes devem através de postagens nas redes sociais conscientizar as pessoas sobre a originalidade, enfatizar a relatividade da beleza de cada um, afim de tornar as pessoas mais naturais nas suas exposições midiáticas.']",120,160,120,160,120,680
84,Engatilhar não é solução,"['O numeroso índice de crescimento da violência vem transmitindo uma sensação de insegurança. o resultado dessa sensação e o pensamento de autodefesa com arma de fogo, em contrapartida, esse pensamento pode ser um acréscimo nesse numeroso índice.', 'Durante uma troca de tiros, tanto o meliante quanto o policial tem armas. A principal vantagem do policial é seu treinamento e sua experiência em campo. Tal experiência um portador legal de arma de fogo não possui, deixando-o sujeito à imprevistos, originalizando uma troca de tiros, na qual pode haver vítimas que não estavam no contexto da situação, portanto, apenas o treinamento não é suficiente para ter o porte de uma arma na rua.', 'Fatos imprevisíveis podem ir além de troca de tiros, pode haver casos de que o usuário esteja acompanhado e nessa situação o procedimento mais seguro -Entregar qualquer patrimônio, inclusive a arma, para evitar riscos vitais- deve ser seguido. Pois, nessa situação sem saber se o infrator armado pode estar acompanhado, qualquer reação mal interpretada pode gerar perda de vidas inocentes. Contudo, a arma na mão do criminoso permitirá o surgimento de novas vítimas.', 'Horários noturnos tendem à ser propícios a assaltos, e por legítima defesa, induziria usuários à andar armados, entretanto, O mesmo horário e utilizado para eventos de lazer, como festas e encontros. Apesar de necessitar de exames psicológicos para conseguir a posse e porte  (de armas), os mesmos não previnem contra o alcoolismo, afinal, ser alcoolátra não é fator determinante para ""Passar da dose"". Um indivíduo alcoolizado tem grande tendência para arrumar problema, se ele possuir uma arma, pode provocar várias mortes, e isso não se limita apenas ao seu ""alvo"". Com a pontaria e o reflexo bagunçado (como consequência do efeito de álcool) em um ambiente cheio, ocasionaria a baixa de várias vítimas.', 'Para diminuir a sensação de insegurança,é necessário mais políticas de segurança como introdução de box da PM em vários pontos e leis mais rígidas para o furto. Em casos de violência à mão armada é importante não reagir, porém, promover a defesa pessoal através de artes marciais e facilitar o acesso à armas de defesa pessoais como gás lacrimogêneo, bastões e pistolas elétricos, são importantes medidas contra meliantes que utilizarem armas brancas em seus atos. Todos têm o direito à defesa mas andar armado põe em risco a vida do portador da arma e dos civis ao redor, o que agrava o atual índice de violência.']",120,160,120,160,200,760
57,Democratização em questão,"['Um dos primeiros cinemas tupiniquins, o Cinépolis, originado na ""Bela Época"" paraense,  surgiu como uma opção de lazer à elite tangente à produção da borracha, não sendo alcançado por toda a população. Não obstante à época, o imbróglio perdura. Portanto, torna-se fundamental identificar as causas e possíveis soluções para a problemática.', 'Em consonância com a Declaração dos Direitos Humanos, os hominídeos têm direito informação e lazer. Logo, figura como um i=entrave a carência da democratização do espaço cinemático, haja vista que somente 17% da população brasileira frequenta o cinema , ocorrendo também devido à concentração de salas de cinema nos pólos industriais do país.', 'Outrossim, a pirataria configura-se como uma problemática pertinente ao meio cinematográfico. A recorrência de tal prática se dá em virtude da impossibilidade do acesso às obras ou à carência de recursos financeiros; A massificação do acesso ao cinema seria uma possibilidade de diminuir índices de tal prática criminosa, aumentando vertiginosamente o lucro das empresas cinematográficas.', 'A democratização do cinema é imprescindível para a elucidação de problemáticas como a pirataria de filmes e para abranger o acesso à cultura, logo, são necessárias medidas governamentais ou parcerias publico-estatais para ampliar salas em regiões como Norte e Nordeste.']",120,160,80,120,80,560
69,,"['O uso de defensivos agrícolas representou o fim de uma teoria, proposta por Thomas Malthus, que afirmava que a população estava crescendo mais rápido do que a produção de alimentos, assim haveria perdas de vida devido à fome. Atualmente estamos  perdendo vidas devido à intoxicação ocasionada pelo excesso de produtos químicos usados nas plantações.', 'Os pesticidas têm causando danos de grandes proporções à pessoa que aplica que muitas vezes ignora as recomendações do rótulo e faz uso excessivo do produto na plantação, o mesmo  não age em uma praga específica, age também em espécies benéficas, como as abelhas, que são responsáveis pela polinização.', 'Ao redor do mundo temse falado no extermínio das abelhas, elas desempenham um papel importante na reprodução das plantas trabalho esse que seria inviável se feito manualmente. Sem as abelhas o custo de produção seria maior e fala-se, inclusive, em crise alimentar.', 'Fazendo um comparativo das legislações europeia e brasileira, vemos  que a nossa é menos rigorosa,  por ser flexível em relação ao uso de químicos que são proibidos em outras nações mais desenvolvidas. O setor agrícola e ambiental brasileiro vive em conflito, o primeiro ignora o segundo focando no enriquecimento e despreza os prejuízos que podem causar ao meio ambiente e consumidor .', 'Portanto precisamos  de mais engajamento político e diálogo sobre as legislações no campo, buscando ser mais transparente para a sociedade. Ministrar curso para o agricultor, falar dos riscos provocados pela exposição aos agrotóxicos como câncer, depressão  e dos prejuízos ambientais como a poluição dos lençóis freáticos e extermínios de insetos benéficos à plantação.']",120,120,80,120,80,520
138,Coragem X Covardia,"['Na sociedade em que vivemos hoje                , necessitamos de um certo cuidado com nossas atitudes, nossas virtudes, pois tudo que fizermos ou dissermos, poderá ser usado contra nós mesmos em algum período de nossas vidas. Em nosso país como descrever coragem ou covardia, frente a tanta corrupção, tanto roubo, lavagem de dinheiro... Em que podemos nos agarrar como exemplo?', 'Covardia, que têm como sinônimos fraqueza e medo, vai muito além         destas          palavras que causam tão pouco impacto na sociedade, perante          aos          atos observados em nossa sociedade democrática, tomadas pelas autoridades          nacionais  ; A         cada instante que passa, uma nova notícia... É mensalão, é desvio de verba da saúde, da educação, parece até mesmo um vulcão em erupção! Ética no trabalho, cadê? Aqueles que deveriam lutar em prol de um país melhor, sem fome, sem miséria, uma sociedade em paz, sem guerras, não         os faz         . Existe covardia maior?', 'Coragem, é         daqueles que acordam bem cedo, cumprem seu papel corretamente na         sociedade; Trabalhadores         , educadores, servidores do bem, que educam seus filhos da melhor maneira possível, mesmo em meio de tanta ""turbulência"",                 pessoas que assumem seus próprios atos, sem precisar de gastar tempo nem dinheiro público com uma CPI para averiguação dos fatos.                Gente que enfrenta cada dia com bravura e não prejudica ninguém, sabe que sua liberdade         acaba, onde         começa a de seu próximo.', 'Difícil descrever, porém se nos espelharmos nos bons exemplos de coragem, pode ser que         teremos         uma amanhã mais ensolarado, com novas oportunidades e melhores recompensas. O mundo é uma selva, onde infelizmente nem sempre os que são providos de coragem, bravura e valentia         saiam         vivos e vitoriosos.']",120,80,80,80,80,440
70,O combate as DSTs no Brasil,"['Sabe-se que grande parte dos jovens brasileiros estão cada vez mais propensos a contrair qualquer doença sexualmente transmissível. Mas nos últimos anos,  houve um aumento acelerado dessas doenças. Isso ocorre, porque muitos não possuem conhecimento dos métodos de prevenção ou não procuram o médico para realizar o diagnóstico dos sintomas.', 'O uso de preservativos durante a relação sexual é importante, pois não só evita os riscos de contrair doenças, como também uma gravidez indesejada. Mas muitos consideram o seu uso desnecessário e afirmam que com o tratamento, podem ter uma vida feliz e saudável, levando a acumular os índices dessas doenças . Segundo dados do ministério da saúde  em 2016, 85% da população entre 15 a 24 anos eram portadores do HIV ou de outras doenças, em consideração que de 10 pessoas, 6 não fizeram o uso da camisinha, o que chama atenção dos profissionais de saúde.', 'No Brasil, as doenças mais comuns são a sífilis, o HIV e as hepatites virais (A, B, C), que se não receberem tratamento imediato, o paciente poderá ter sérias complicações, como a baixa imunidade do organismo. Elas podem ser transmitidas não só durante o ato sexual, como também durante transfusões de sangue, contato físico com uma pessoa infectada e uso de objetos pessoais (tesouras, alicates de unha e barbeadores).', 'Perante a isso, para diminuir os riscos de contaminação à outras pessoas, é importante que todos previnam-se e quando possível, procurar a unidade de saúde mais próxima para receber orientações. Órgãos públicos podem intervir com a criação de palestras em instituições de ensino, para que os jovens saibam não só os conceitos das DSTs, mas saber com quem andam, para evitar qualquer risco a sua saúde.']",120,160,120,120,40,560
73,Desafios encontrados pelos negros atualmente,"['Brasil mesmo após a Abolição da Escravatura em 1888 cogita-se, com muita freqüência  o preconceito e a desigualdade no mundo, todavia no Brasil muitos pontos necessitam de mudança, tanto na cultura quanto nas oportunidades.', 'De acordo com recentes dados estatísticos  somos o segundo país com maior população negra do mundo só superado pela Nigéria, contudo não quebramos as barreiras da desigualdade social e da cor até os dias atuais, onde a tradição é o principal fator de influência, cultura trazida da Europa na época da colonização onde os negros eram escravizados.', 'Também a lei de cotas instituída em 2003 fez com que aumentasse dezesseis pontos percentuais pessoas que se declaram negras em instituições privadas, ajudando nas oportunidades e na igualdade, mas necessitaria dessas cotas em outros ramos como em empresas e cargos públicos, não apenas nos trabalhos pesados e sim na parte administrativas onde são muito pouco vistos.', 'Dado o exposto entende-se que é preciso mudar o modo de pensar da população em relação aos negros, instituindo mais oportunidades como na parte política e em propagandas quebrando padrões tanto estéticos quanto históricos e implantações de ONG´s de conscientização.']",120,120,120,120,80,560
150,Sociedade e escola contra a violência,"['A escola é um ambiente que se relaciona com áreas de conhecimento e seus profissionais,          mas          também influencia e é influenciada pela sociedade.                A violência nesse ambiente é um indicador         social         já que na escola existe uma amostra dos         valores coletivos         .                 A escola não é um espaço de neutralidade uma vez que não existe imparcialidade na sua função.', 'Os índices de violência, no nosso país, cresceram em relação às décadas anteriores, isso se                 justifica                pelo aumento de uso de drogas,         aos         grupos paramilitares que utilizam jovens para iniciarem o tráfico e a facilidade de compra de armas. Todos         os         desvios sociais impactam diretamente os centros educacionais que são envolvidos                 pelo cenário de violações que cercam os seus prédios                . De forma que, hoje, com frequência                 somos noticiados com                casos de brigas e disputas, uso de drogas ilegais dentro dos educandários.', 'Com o avanço do                 pensamento da educação                , chegou-se a conclusão         de que:         é                 impossível dissociar a realidade escolar do cotidiano estudantil                . Paulo Freire introduziu a didática de alfabetizar utilizando palavras do dia a dia do         aluno         a fim de que essas palavras tomem novo significado na sua ação. Dessa forma, a escola é um agente de transformação que pode atuar em diversas áreas, inclusive, na prevenção da violência.', 'É importante que haja uma interação entre a sociedade e a comunidade escolar a fim de diminuir os casos de agressões.                 A escola deve influenciar positivamente a sociedade e a retribuição é que existirão escolas melhores                . Deve haver palestras sobre o tema de                violência e das consequências da utilização de         drogas, orientação         psicológica para alunos         agressivos e descobrir suas causas das brutalidades são         algumas medidas que podem ser exercidas pela escola a fim de contribuir para uma                sociedade.']",120,120,120,80,120,560
91,Negacionistas na atualidade,"['No mundo atual há muito de negacionismo, que iniciou-se no final do século XX. E o que é isso? São as pessoas contra meios científicos como a vacina, que a Terra é plana em formatos circular, falam que o aquecimento global é mentira, e também pessoas que vão em milhões de médicos que dizem a mesma coisa mas a pessoa não confia nos médicos e ainda pode acabar morrendo por isso e assim por diante.', 'Na atualidade todos temos liberdade para expressar todos os nossos pensamentos e opiniões sobre qualquer assunto, desde que começamos a ter essa tal liberdade de expressão, surgiram os negacionistas.', 'Somos nações que o povo vota da suas opiniões nas redes sociais escolhem seus lados e nessa época que estamos passando em meia pandemia temos o tal negacionismo pela vacina do Corona vírus, que muitas pessoas não aceitam a vacina e fazem brincadeirinhas como nosso presidente ”se você virar jacaré, é problema seu ” diz ele sobre quem tomar a vacina. Mas é direito de qualquer de qualquer um escolher no que acredita e no que apoia e nisso acontece as divergências de opiniões, brigas, desentendimentos familiares e até mesmo as redes sociais . E nisso o povo deixou de ter um bom senso e acabam se desentendendo.', 'Portanto percebemos que com essas pessoas que não acreditam que são negacionistas elas podem acreditar em páginas fakes de fofocas e por coisas assim que não acreditam em certas coisas em vez de o verdadeiro esse é um modo de diminuirmos com o negacionistas , também tem o modo como os debatedores dizem combater com a educação, e estão em profunda cisão do mentiroso com a própria identidade.']",160,120,120,160,120,680
50,O meio científico e suas soluções contra pandemias.,"['Por que o investimentos na área científica poderia mudar o numeroso índice de casos de uma pandemia no Brasil? Uma vez que, a proteção e o conhecimento de situações semelhantes fossem premeditadas.', 'A consciência da existência de ameaças virais e infecciosas anteriores, poderia ajudar no combate de situações epidêmicas futuras, já que haveria  uma noção mais transparente proeminente de contágios análogos . Dito isso, o emprego monetário no setor científico,  não se refere apenas à um pré-conhecimento das devidas situações, mas também, ao procedimento padrão para a prevenção de retorno e uma pandemia, a vacina. Buscando  a possível erradicação de pragas altamente contagiosas.', 'Ademais a criação dos medicamentos, resultantes de uma profunda pesquisa sobre os patógenos, irá servir como forma de tratamento para o paciente infectado, visando  sua cura. Paralelamente, a criação de vacinas e campanhas de vacinação, originárias desse estudo científico, agirá como uma forte aliada no combate contra as pandemias ainda não erradicadas e, futuras.', 'De acordo Organização Mundial da Saúde (OMS), pandemias são doenças infecciosas que se espalham de forma rápida e brutal, de modo em que esta possa atingir a tudo e a todos ao mesmo tempo. Quando há um conflito entre cientistas despreparados  e algo que não se conhece, pode haver 50% de chances ou mais, para que a doença seja extinguida ou não, ou seja, quando a prévia é inexistente, se torna impossível saber o quanto, ou quem ela atingirá. Em intermédio à uma anarquia o que mais se instala é o medo, vigente às ambiguidades anunciadas pelo meio tecnológico para as aglomerações sociais, isso que, pode ser fruto resultante das más informações obtidas com o tempo, por falta de investimento no setor científico e educacional.', 'Sendo assim, é conspícua a relevância das riquezas inseridas no âmbito técnico, profissional, informacional e acadêmico.  Pois,  esses tornam possíveis as descobertas que ocasionam mudanças na sociedade proporcionando na maioria das vezes soluções para arrepelar enfermidades existentes na comunidade.']",120,160,120,120,0,520
51,País escolarizado,"['O analfabetismo no Brasil é um problema que afeta principalmente indivíduos das classes menos favorecidas, porém,  o número de analfabetos no país diminuiu nos últimos anos. Ademais, é importante abordar o fato da existência de analfabetos funcionais, isso se dá devido a educação de baixa qualidade oferecida em escolas públicas.', 'Em uma primeira análise, é notório que a adesão da Lei 9.394/96, que proíbe a reprovação de alunos, causa deficiências no ensino, fazendo com que esses não tenham uma boa capacidade de interpretação . Isso ocorre principalmente em instituições não privadas, o que leva ao aumento da desigualdade social na nação.', 'Nesse contexto, é inegável que, para que haja um maior ingressamento no mercado de trabalho, a população deve ter um nível básico de conhecimento na área de leitura e compreensão da mesma. Isso mostra que a alfabetização dos cidadãos pode causar também melhoras na economia do Brasil', 'Em suma, é indubitável que, para que o país tenha melhores condições socioeconômicas, o Governo Federal, através do Ministério da Educação (MEC), invista em ensinos de maiores qualidades nas escolas municipais e estaduais. Outrossim, cabe aos responsáveis uma cobrança maior para que sua prole tenha em resultado melhor nos seus estudos.']",120,160,120,160,80,640
44,Por quer provar que é realmente mulher,"['Qual a necessidade de uma mulher se submeter a provar que é realmente mulher ? Não tem porque uma pessoa provar se é ou não mulher. Idependente de seu porte físico ser parecido ou ate mesmo maior que o de um homem.', 'Quando nascemos esta ali registrado em nosso documento qual nosso sexo,cor e entre outros. O fato de uma mulher ter uma mutação genética que a deixa com maior resistência,entre outras coisas não a faz ser menos mulher.', 'Então antes de julgar, se uma pessoa é o que é, pare e se coloque no lugar dela , pois seus atos ,mesmo q não pareça ofensivo podem ferir uma pessoa emocionante,muitas vezes colocandoa pra baixo ou ate mesmo deixandoa em depressão.']",160,80,80,80,0,400
89,Como conscientizar a população acerca do isolamento social em meio a crise econômica? (et,"['De acordo com o que é previsto no artigo 6o da constituição federal, é de garantia de todo cidadão o direito ao trabalho. Conquanto, tal prerrogativa foi suspensa diante do cenário de precariedade do sistema de saúde em relação ao controle da pandemia, fez-se necessário assim, a cooperação da sociedade por meio do isolamento social.', 'Em primeira análise, a má administração governamental para o combate das mortes ligadas à transmissão do vírus, tornou a conscientização da população acerca do isolamento ainda mais dificultosa, mesmo sabendo-se que o isolamento em níveis regionais estabiliza e em seguida diminui o número de óbitos', 'Ademais, é fundamental apontar que a falta de políticas e suportes socioeconômicos, contribuiu para que a incerteza e o questionamento sobre a conservação dos postos de trabalho impulsionassem esse problema. Diante de tal exposto, a partir do lockdown, a implementação do auxílio emergencial não evitou o exponencial aumento do desemprego. Logo é inadmissível que esse cenário continue a perdurar.', 'Depreende-se, portanto, a necessidade de se combater esses obstáculos. Para isso, é imprescindível que o governo federal juntamente com o Ministério da Economia,  crie um pacote de resgate econômico para pequenos empresários e desempregados, além do desenvolvimento de plataformas digitais para cadastramento e candidatura de vagas ociosas do mercado - incluindo home office - para manter o máximo de pessoas empregadas, juntamente com a', 'flexibilização de jornada daqueles já empregados, a fim de diminuir os impactos das desigualdades e sustentar corretamente o isolamento social.']",160,160,120,200,160,800
83,Prática de esportes,"['A prática de esportes está se tornando um assunto muito importante para todos, seja por influência das olimpíadas ou não, sabemos que é um meio muito cativante e encantador, de se tornar uma pessoa mais feliz e saudável. Mas e aqui no Brasil? São todos os que se conscientizam e praticam os esportes?', 'Várias pesquisas apontam que 45,9% dos brasileiros não praticam atividades físicas. Ou seja, quase metade da população brasileira, seja por falta de interesse ou incentivo, está apta á ter mais chances de possíveis doenças, sejam cardíacas, respiratórias, entre outras, do que pessoas que praticam esportes.', 'Para se ter uma vida longa e cheia de saúde, é essencial fazer exercícios, com eles, aprendemos que é divertido cuidar do nosso corpo e até da nossa parte emocional, uma vez que a prática de esportes, nos dá sensações de bem-estar e relaxamento. O Brasil é um país com diversas culturas, o que facilita o acessoá vários meios de exercícios, temos capacidade de mudar estas estatísticas para  melhor. Jogar futebol, vôlei, tênis, entre tantos esportes, nos motivam a ter gosto por cuidar da nossa saúde.', 'A maioria das pessoas está sempre buscando formas melhores de se beneficiar com uma boa alimentação. Porém, hoje em dia, elas buscam não só alimentos de boa qualidade, como também, relacionam isso com exercícios físicos, com objetivos de aumentar sua saúde.', 'Logo, percebemos que fazer caminhadas, beber muita água, são pequenas coisas que podemos fazer para começar a zelar pela nossa vida. Devemos ignorar  o que chamamos de um certo “comodismo”, que atrapalha não só os brasileiros, como também pessoas de outros países, e até nos inspirar nos jogos olímpicos para se ter uma meta de benefícios.']",160,160,160,200,200,880
85,Se o povo se reunir,"['Alguns acusados de corrupção ativa no governo, já se encontram presos, porém, a maioria só apenas está cumprindo o regime aberto e em contrapartida, segue o povo tendo que sofrer em diversas área do setor público devido ao ato desses acusados. Isso pode mudar se a população se reunir por meio das leis de iniciativa popular e apresentar ao Congresso Nacional, uma lei que puna os acusados como criminosos qualquer.', 'Devido aos escândalos de corrupção no governo, uma grande parcela dos acusados foram presos , todavia, os mesmos só estão cumprindo o regime aberto, que é quando o réu é deposto a cumprir prisão domiciliar e, só poderá sair, por motivo de extrema importância ou para trabalhar. Os mesmos, tambêm estão sendo monitorados, através por uma tornozeleira eletrônica, que a mostra a localização dos indivíduos por meio do rastreiamento . E o que mais choca a todos, é  que, esses acusados deveriam estar sofrendo punições mais severas, pois os atos deles custou o país inteiro.', 'E no oposto disso tudo, quem acaba sofrendo é a sociedade que paga por uma deficiência em divéras áreas do setor público, como por exemplo: nos hospitais que carescem de insumos, na educação que a cada dia decai ainda mais, na segurança pública que está comprometida por falta de verba e o pior de tudo, uma inflação sem precedentes e tudo por culpa desses atos corruptivos no governo. Enfim, o povo é quem está sofrendo a verdadeira pena e a sensação sentida por todos é de impunidade imposta pela justiça a esses acusados, pois eles só estão cumprindo uma pena branda.', 'Isso poderá mudar se a sociedade se reunir atraveis do sistema de leis de iniciativa popular e apresentar uma lei ao Congresso nacional, no qual os acusados fossem punidos com uma pena mais severa, igual a imposta a presos comuns. Isto tambêm inclui remanejá-los para presídios de segurança máxima. Só assim eles terão uma pena mais adequada e o povo ficará mais satisfeito.']",120,160,160,200,200,840
65,Caminhos para diminuir a criminalização entre os jovens brasileiros,"['A criminalidade entre os jovens no Brasil vem aumentando continuamente ao longo dos anos e resulta de diversos fatores que estão sendo negligenciados, dentre os quais destaca-se: a falta de estruturação familiar, o aumento da evasão escolar e a falta de programas sociais voltados para o desenvolvimento intelectual dos jovens.', 'É comum hoje em dia a desestruturação familiar, que reflete em mães ou país solteiros tendo a difícil tarefa de trabalharem e cuidarem da educação de seus filhos, condicionando que uma das tarefas seja colocada de lado, normalmente a criação dos filhos, visto que os país tendem a passar a maior parte do tempo no trabalho. Sozinhos em casa esses adolescentes passam a maior parte do tempo em ociosidade, em muitos dos casos abrindo margem para que se envolvem com o mundo do crime.', 'Seja pela falta de supervisão dos pais nas atividades escolares ou por necessidade de trabalharem para ajudar no sustento familiar, muito desses jovens têm um mal desempenho escolar o que reflete no aumento o número de evasão escolar . Para que isto não ocorram é muito importante o papel do Estado, com a criação de programas sociais que venham a ocupar a ociosidade desses jovens, com atividades culturais, de esporte ou lazer e programas que venham a monitorar tanto o desempenho com a frequência escolar.', 'É necessário ainda incentivos para iniciativa privada para ampliação de políticas de inserção dos jovens no mercado de trabalho, sem que isso interfira na sua carga horária escolar, como é caso dos sucedidos programas de jovens aprendizes, no qual o jovem pode trabalhar sem que necessariamente tenha que abandonar a sala de aula, visto que a jornada de trabalho é reduzida. São alternativas como estas que possivelmente diminuirão a criminalização entre os jovens brasileiros.']",120,120,120,120,120,600
95,Originários sem terra.,"['O chamado arco temporal é uma tese atrelada ao Projeto de Lei 490/2007, onde os indígenas só podem reivindicar as terras sob seu uso em 5 de outubro de 1988- quando a Constituição federal brasileira foi promulgada-, aos passos que, vai contra o artigo 231, que diz sobre os direitos dos indígenas . Como resultado, muitos acontecimentos vem ocorrendo  apresentando que muitos são a favor, a bancada ruralista, e os que são contra, os indígenas. Demonstrando-se uma preocupação dos originários em dificultar o processo de demarcação de suas terras.', 'Nesse sentido, conforme um ocorrido em 2009, após um conflito entre indígenas e arrozeiros, disputavam a Terra Indígena Raposa Serra do Sol, em Roraima. O Supremo Tribunal Federal (STF) foi favorável aos originários, pois que estes já estavam no território quando foi promulgada a Constituição se 1988, entretanto, ao contrário do texto do artigo 231, onde reconhece que são territórios que pertencem aos indígenas, que podem explorar seus recursos naturais e desenvolver suas culturas .Também pode ser habitados por uma ou mais etnias, e os direitos dos indígenas ao território é exclusivo e permanente, a justificativa pelo STF em 2009, não diz nada a respeitos de datas. De tal forma que, ao usar a data no processo de demarcação de terras indígenas, fatores ligados à colonização são desatendidos. Visto que,  vários povos foram expulsos sob violência, por conta da expansão rural e urbana, a proliferação de doenças. Logo, essa é a visão dos originários em relação ao marco temporal.', 'Ademais, em contrapartida, a tese é fortemente apoiada pela bancada ruralista no Congresso Nacional- como é bem conhecida-, com a justificativa da agropecuária e de que os indígenas reivindicariam o tudo até mesmo a Praia de Copacabana, porém, que reivindicariam áreas que ainda têm significado para os indígenas . As demandas de marcação são concretas, específicas, delimitadas e bem localizadas como explica Juliana de Paula Batista, advogada do Instituto Socioambiental (Isa). A tese ganhou força em 2017, quando a Advogacia-Geral da União (AGU) atendeu um julgamento de um caso específico de uma erra indígena valendo para todos os outros, assim também contrariando o acontecimento de 2009, no STF. Com esse aparecer, estima que 27 processos de demarcação estão parados na AGU, segundo o Ministério Público Federal (MPF). Mas, também outro ocorrido também influenciou a volta da discussão do marco temporal, foi em 1992 e posteriormente, em 2019 , sobre os Xokleng, que o ministro Alexandre de Moraes, do STF, decidiu que a ação que envolve essa etnia serve pra todos os outros casos. Item, a votação do Projeto de Lei 490, se aceita, contemplará a criação do marco temporal, que é um grande medo para os povos originários, pois dificultará a de marcação de terras.', 'Portanto, a fim de que se garanta os direitos e as demarcações, Fundação Nacional do Índio (Funai) deve continuar o processo de identificação e demarcação junto com os estados e municípios, o Mistério da Justiça aprovar os processos e garantir que nenhum não indígena cometer grilagem. E também, os que são a favor a tese do marco temporal aceitando ou não, deve respeitar, pois os direitos de terras demarcadas como é proposto no artigo 231 da Constituição.']",120,120,120,120,120,600
91,EFEITOS DO NEG4CION1SMO CIENT1FÍCO N4 SOCIEDADE,"['Os efeitos do negacionismo cientifico pode ser observado cotidianamente. Por exemplo no começo da campanha de vacinação contra o Covid-19, foi possível observar diversas fake news sobre os efeitos colaterais e se realmente prevenia conta o vírus, movimentos antivacina não ocorreram só com as vacinas contra o coronavírus, mas também com todas as outras, como a poliomielite e a tríplice viral. Temos também a ideia do terraplanismo, que vai contra tudo que a ciência já comprovou.', 'Por consequência de movimentos antivacinas, os marcos alcançados e os riscos de aumentar casos de paralisia infantil, sarampo, caxumba e rubéola são enormes. Pois uma vez que tomada a vacina, você cria uma imunidade que combate aquela doença, e caso você contraia, os sintomas e a força serão menores . Mas se movimentos desse tipo persistirem a chance de mais crianças ficarem doentes será maior, e depois para reverter isso ficará mais complicado. As campanhas contra as vacinas da Pfizer, de Oxford ou CoronaVac, prejudica a todos, pois quanto mais tempo levar para a população se vacinar, maior será o tempo que levaremos a combater o novo vírus da covid.', 'Além dos movimentos contra vacina temos também o terraplanismo que implica com toda a evolução cientifica que tivemos no decorrer dos anos e prejudica o desenvolvimento que poderíamos ter se mais pessoas acreditassem que a Terra é realmente um globo. Sobretudo temos fotos do planeta visto do espaço comprovando que é redondo, e as viagens feitas na época do “descobrimento” da américa que foram feitas em barcos, que também comprovam que a Terra tem o formato de uma esfera.', 'Portanto, para combater o negacionismo as instituições cientificas deveriam ter um diálogo melhor com a sociedade por meio das redes socias e campanhas, a fim de informar o certo e errado s pessoas e retirar dúvidas que fazem elas ter ideias contra tudo que é cientificamente comprovado. As escolas também deveriam não somente falar que se está no livro é verdade, mas passar por um processo de ensinar e explicar os métodos e conceitos de como se chegou até aquele resultado, fazendo assim a criança e ou adolescente ir atrás de explicações do porque aquilo seria o certo e não aceitar tudo que se lê sem algum embasamento cientifico. Desse modo combateríamos também o avanço de fake news e a frase “Educação nunca foi despesa. Sempre foi investimento com retorno garantido”  de Sir Arthur Lewis se concretizaria.']",160,120,120,160,120,680
105,Biografias,"['O Brasil todo,         atraves da midia         , pode presenciar um         contronto         de opiniões sobre o direito de autores         para a públicação de         biografias não         autorizada         . De um         lado o biografado         que não quer que sua vida particular seja exposta ao         público,         de         outro lado os biografos         que alegam que não é preciso autorização para a criação de biografias, uma vez que é um direito de expressão e informação.', 'Fica claro a para nós, que estamos nos         bastidos         , o quanto é descabido impor uma lei que permita uma publicação não autorizada pelos biografados.', 'Seria uma agressão         a costituição,                   artigo 20         ,                .', 'Um desrespeito         a         privacidade do indivíduo. Um extremo mal gosto em levantar fatos         das         quais pessoas não querem lembrar, reviver.', 'Uma agressão aos familiares que         por ventura          tiverem que conviver com fatos passados de pais, irmãos, filhos, etc                .', 'Podemos perguntar a esses indivíduos que estão puramente movidos a ganhar         dinheiro,         “Imagine se seus pais, irmãos ou até filhos tiverem que conviver todos os dias com um livro acusando familiares queridos por tempo         indeterminado, ”', 'Ha          quem diga ah e o motivo informar o mundo sobre a história do seu povo, eu posso argumentar o seguinte: de quem estamos falando? De um          politico          famoso? De um          idolo          que mudou a história? De uma pessoa relevante          a          história do país? Pois bem, se estamos falando de tais pessoas, então que          estas          biografias sejam feitas          postumas          , para preservar seus familiares.                  Ha quem diga: “e nós cidadãos temos que ficar alheios aos acontecimentos dos nossos          politicos          , artistas, cantores favoritos? Quem sabe criando uma imagem diferente da realidade          dele          ?”', 'Posso garantir que para sermos informados de algum fato relevante sobre essas pessoas podemos contar com os jornais e revistas que         faz este         trabalho         com tanta eficiencia e exaustão         .']",0,80,80,0,0,160
37,Estupro,"['Muitas mulheres, das quais já sofreram assédio, não denunciam tal crime, o que nos permite concluir que as taxas de abusos sexuais, na verdade, são bem maiores do que pensamos, fazendo disso um problema que deve ser combatido fortemente.', 'Dentre as causas principais, apontamos uma sociedade extremamente machista que age com normalidade e até mesmo estimula o cidadão a cometer atrocidades contra a mulher, uma pequena possibilidade do infrator sofrer as devidas consequências pelos seus atos, já que estes crimes são constantemente camuflados e ignorados, e um certo medo das mulheres em reagir ao crime.', 'Por conseguinte cidadãs se sentem culpadas por serem vítimas, evitando sair às ruas, usar roupas de certa forma vulgares e também de ""dar a entender"" que a qual deseja algo similar. Estas também terão que lidar com este trauma para o resto de suas vidas, evidenciando um grande atraso da sociedade neste aspecto.', 'Estupros devem ser combatidos e também prevenidos. As vítimas devem denunciar imediatamente após o ato, facilitando a prova contra o criminoso e, assim, causa um receio deste para realizar o crime. Também é essencial uma educação, desde a infância, pregando igualdade entre os gêneros tanto em casa quanto em escolas para que assim o indivíduo cresça sem ideias erradas de superioridade masculina ou feminina.']",120,120,120,120,120,600
6,somos responsável ,"['Ao falar sobre a floresta amazônica amazônica, ela vitima vítima de irresponsabilidade do governo e dos grupos criminoso criminosos que explorar exploram de maneira irregular irregular, sem o devido processo de sustentabilidade sustentabilidade, tanto que somos observado observados diariamente mundo lá fora.', 'inicialmente Inicialmente, a negligencia negligência do governo quando se fala na questão ambiental e é tratada de modo relaxada relaxado, além disso as à legislação já existente existente, não e é dada a atenção correta correta, o que deixa todos preocupados ocorrido dentro do pais país revela na qual não estamos fazendo nossa obrigação correta para sua preservação já imaginamos uma floresta sem arvore árvores, com rios poluído poluídos de metais pesado pesados, devido à extração de ouro e outros matérias outras matérias, pois é possível se essa essas medidas não for colocada forem colocadas em prioridade em pouco tempo não teremos essa biodiversidade de características única únicas que países como a França alertou não só o brasil Brasil como também Colômbia, Bolívia, Peru. levantou Levantou uma hipótese sobre a internacionalização, evidente que França tem uma colônia na floresta amazônica localizada na Guiana francesa e maior área protegida não só pelos franceses mas da união europeia União Europeia são modelo para outras nações.', 'é É importante ressaltar que sustentabilidade poderá ser um dos requisito requisitos para um pais ser país se desenvolver economicamente com outra nação diverso acordo comercial uma vez afirmado sinaliza estamos comprimindo as nossa leis interna internas porque somos os responsável responsáveis pelo ato que produzimos não podemos terceirizar as nossa responsabilidade nossas responsabilidades.', 'por Por fim as consequências devastadora devastadoras de uma politica política ambiental obsoletada obsoleta mostra que mundo tão acompanhado está acompanhando atenciosamente as atitudes tomada tomadas teremos muitos desafio desafios para cumprir ser um pais país em que possa preservar é crescer de forma sustentável.']",0,0,0,0,0,0
128,O enigma do crescimento econômico,"['Continuar com o crescimento econômico será mais fácil e vantajoso do que se preocupar com o meio ambiente se nem pesquisas verdadeiras de órgãos encarregados são repassadas à população mundial. O próximo presidente terá que saber aproveitar bem a ótima situação da economia deixada pelo governo Lula como a estabilidade econômica, o controle da inflação e a ampla distribuição de renda.                  Além desses fatores, continuar crescendo economicamente será imprescindível para melhorar a preparação do país para a Copa do Mundo de 2014 e para os Jogos Olímpicos de 2016. A atual situação política é tão favorável ao crescimento econômico que até na Câmara e no Senado brasileiros, o Partido dos Trabalhadores (PT)          têm          a maioria de          constituintes          entre integrantes e aliados, ou seja, contribuindo mais ainda para a aprovação de leis.', 'Inclusive, o controle da inflação, por exemplo, é uma                 característica                muito mais difícil de ser conquistada do que proteger o meio ambiente. Com uma economia forte, a redução das emissões de carbono e a resolução do problemático desmatamento amazônico poderão ser realizadas rapidamente.', 'Portanto, aproveitar a combinação de diversas características favoráveis ao desenvolvimento econômico poderá até levar o país a uma posição entre as cinco maiores economias mundial.']",200,80,80,120,0,480
43,cancelando opiniões,"['Na música “Alexandria”, do cantor Tiago Iori, é retratada uma sociedade sem conhecimentos, que prefere mostrar apenas seu ponto de vista. Analogamente, no Brasil, a cultura do cancelamento nas redes sociais tornou-se o principal alvo de discussão, seja pelo comportamento da sociedade, seja pela negligência estatal . Nesse sentido vale analisar as causas que envolvem e potencializam essa realidade.', 'A priori, destaca-se o comportamento da sociedade como impulsionador do problema. De acordo Durkheim, o fato social é a maneira coletiva de agir e de pensar. Entretanto, observa-se que a população está indo contra o pensamento do sociólogo, tendo em vista que a cultura do cancelamento é fruto da variabilidade de opiniões, mas por não concordarem,  os usuários se unem para “cancelar” uns aos outros na internet, quando há uma atitude diferente ou que não agradam aos demais. Infelizmente, essas atitudes de não pensar de maneira coletiva contribuíram para o drástico aumento dessa prática nas redes sociais, local no qual as pessoas mais manifestam seu ponto de vista.', 'Ademais, é fulcral pontuar que a persistência da cultura do cancelamento deriva da baixa atuação dos setores governamentais, que concerne na criação de mecanismos que coíbam tais recorrências. Segundo Friedrich Hegel, é dever do Estado proteger seus filhos. No entanto, é fato que isso não ocorre no Brasil, visto que a falta de atuação das entidades estatais apresenta uma não preocupação com os cidadãos que estão sendo cancelados, sem ao menos ter o direito de se redimir ou se explicar . Tudo isso retardada a resolução do empecilho, já que a negligência estatal contribui para perpetuação desse quadro deletério.', 'Portanto, diante do problema exposto faz-se necessárias medidas para combater a cultura do cancelamento nas redes sociais. O Estado, o papel do Ministério da Educação e o Poder Legislativo,  criador de leis, deve investir na contratação de palestrantes para explicar, nas escolas, sobre as consequências da cultura do cancelamento, e mande para votação na Câmara dos deputados, uma proposta de lei que criminalize tal ato. Destarte, a cultura do cancelamento nas redes sociais não será mais um problema para a sociedade brasileira.']",200,160,160,200,160,880
120,Sem papas na língua,"['A liberdade de expressão é algo que vem sendo conquistado         a         várias         gerações, poder         dizer o que                 se                pensa sem se preocupar com o que vão pensar, ou com o que isso         me  trará         como consequência, é algo perigoso pois         caba         por ser vítima das opiniões         alheias, e         de julgamentos de quem está a observar                 seus         atos, isso         ocorre todos os dias, milhares de vezes nas redes sociais e em meios de         comunicação, já         virou rotina e costume                 dizer                no que está pensando e qual a opinião sobre determinados assuntos, porém a questão é o modo de dizer e o assunto a ser discutido, pois nem todos estão dispostos a compartilhar, aceitar e seguir                 seus                ideais.', 'Existem questões que devem ser pensadas duas vezes antes de serem         ditas pois         mesmo com a liberdade de         expressão         ofender e ultrapassar os limites dos outros já passa a ser imoralidade, isto é, saber onde         acaba         seus direitos e começam os do outro é fundamental para convivência numa sociedade onde todos querem se expressar.', 'Uma simples brincadeira, um simples comentário sobre um assunto que divide         opiniões         pode causar brigas         desnecessárias,          e bem                  como diz um ditado popular brasileiro ""Mulher, religião e futebol são assuntos que não se discutem"" por gerarem muita polêmica.', 'É necessário cautela quando vamos expressar                 nossas         opiniões         pois sempre haverá alguém que não compartilha                 suas                propostas e explicações.']",80,80,80,80,80,400
52,Os problemas da gravidez precoce.,"['Ultimamente  no Brasil, cada vez vez mais é possível observar um aumento no índice de gravidez na fase da adolescência.', 'O fato ocorre muitas vezes por falta de informação, que leva garotas entre 10 e 19 anos a iniciarem uma vida sexual precocemente ou sem a maneira correta de prevenção.', 'Nessa idade, as meninas não estão psicologicamente preparadas para tal responsabilidade de ser mães assim como seus corpos, que ainda em formação se encontram despreparados.', 'Além do tempo exigido com atividades maternais  levando muitas adolescentes a abandonarem os estudos  fazendo com que as taxas de desemprego aumentem  já que o mercado de trabalho se encontra cada vez mais exigente.', 'A gravidez precoce não é o único problema dos adolescentes, mas também as infecções sexualmente transmissíveis que sem as devidas informações vem tendo seu percentual aumentado a cada ano.', 'Por esse motivo, é muito importante o incentivo do diálogo nas famílias realizado pela Organização Mundial da Saúde. Além de campanhas informativas com intuito de divulgar o planejamento familiar na idade correta e com a devida estabilidade financeira.', 'Com isso, conclui-se que conhecimento sobre o próprio corpo, métodos contraceptivos e educação sexual,  são essenciais na vida dos adolescentes e faltam nas escolas do país.']",120,120,80,120,40,480
45,"Abuso de autoridade, como abordalo.","['Na musica “obstáculos”, feita pelo rapper Pira7a, ele cita uma triste realidade do nosso país, “quem é pago para me proteger só me oprimiu, essa é a realidade das favelas do Brasil”. Analisando o trecho da música percebe-se o desabafo de um morador da periferia. O fato relatado pode ocasionar problemas como a sensação de insegurança quando próximo a agentes de segurança pública e o desconhecimento das abordagens de um abuso de autoridade.', 'Uma cena do icônico filme brasileiro “Tropa de elite” que mostra o capitão e sua guarnição invadindo a casa de um morador, que por sua vez ainda estava dormindo e é acordado com tapas em seu rosto . Esse é um claro exemplo de abuso de autoridade que se tornou comum em periferias, fazendo com que a população crie um sentimento de insegurança e revolta. E como consequência deste sentimento, surjam movimentos e protestos contra órgãos de defesa pública, que é o principal meio de segurança da população.', 'Nota-se que, normalmente os casos de abuso de autoridade, são feitos por pessoas com um ego inflado e que contem um sentimento de superioridade com relação a vítima, seja um policial ou advogado... etc. Que está lidando com um civil que não tem “poder”, e por isso eles abusam de sua autoridade. Há muitas formas de identificar um caso de abuso de autoridade, por exemplo utilizar algemas em alguém que não põe a sua própria integridade física e nem do agente, e que não apresenta risco de fuga, porém isso é algo que acontece com muita frequência.', 'Tendo em vista os argumentos citados para o combate ao abuso de autoridade no Brasil, podemos fazer mais relatos e denúncias sobre este tipo de acontecimentos. Além de informar a população as características desse tipo de acontecimento, e utilizando a internet para a divulgação, pois é um dos meios mais eficientes de comunicação.']",160,160,120,120,80,640
76,,"['É notório que, no Brasil, no século XXI, existem desafios no tratamento igualitário entre os gêneros masculino e feminino, contudo, vale salientar que com as mulheres é mais propício em diferentes âmbitos, apesar de que mulheres de outros períodos tenham feito reivindicações para garantir seus direitos.', 'Nesse contexto, várias datas  foram marcadas por mulheres que buscavam assegurar sua inclusão, pois a mulher somente poderia ser considerada dona do lar, diferente dos homens que possuíam direitos mais aprazíveis , o que incentivaram-nas, por exemplo, a conquista do voto feminino decretado durante a década de 1930, um marco na história da mulher brasileira.', 'Atualmente a mulher continua sendo vítima da iniquidade. Pode-se encontrar esse ato cotidianamente no mercado de trabalho, em redes sociais, em comentários machistas, aproximações infratoras no transporte público, xingamentos e até mesmo com crianças na qual são padronizados os esportes, brincadeiras e brinquedos de meninas e meninos.', 'Diante disso,é importante ressaltar que todas as pessoas possuem deveres e direitos e apesar de várias realizações de inserção feminil na esfera global, há uma precariedade na evolução dos meios introdutórios na qual, deveriam impulsionar a preservação igualitária e cumprir o objetivo da cidadania.', 'Diante do apresentado, o Poder Público deve aplicar penalidades mais severas e conjuntamente com a mídia, implantar publicidades e propagandas, a fim de induzir os cidadãos a honrar os anos de luta das mulheres e eliminar os esteriótipos femininos. Cabe ao Ministério da Educação  a concepção de áreas de conhecimento com a temática dos desafios e a interrupção da falta de igualdade de gênero para formar cidadãos capazes de deixar o problema com solução mais justa.']",120,120,120,120,120,600
74,a concepção de igualdade de gênero precisa ser revista,"['O feminicídio caracteriza-se por ser a última instância da violência contra a mulher exclusivamente pela condição de ser mulher . No Brasil é comum a ocorrência de assassinatos, estupros e inúmeras outras agressões a pessoas do sexo feminino. De acordo com o site UOL em 2016 o numero de homicídios chegou a 61.619 casos  cerca de 4% a mais que no ano anterior. Nesse contexto deve-se analisar as bases da sociedade brasileira que se moldaram no patriarcalismo e na desigualdade de gênero.', 'O patriarcalismo é um fator culminante para os crescentes casos de violência contra a mulher. Devido ao fato de que este fundamenta a ideia de supremacia do sexo masculino nas relações sociais, dessa forma o homem teria poder sobre a esposa, filhos e empregados podendo tomar decisões cruciais em qualquer âmbito de forma inquestionável por seus subordinados. Assim, o patriarcalismo construiu uma relação desigual e hierarquizada que colocou o homem com um status superior ao da mulher, resultando em um machismo exarcebado vivenciado atualmente e utilizado como justificativa para agredir, desrespeitar e até mesmo matar namoradas, esposas, companheiras e desconhecidas pelo simples fato das mesmas serem mulheres.', 'Engatado ao patriarcalismo está à desigualdade de gênero que também pode ser vista como um fator motivador aos constantes casos de feminicídio no país. Isso decorre dos moldes históricos que caracterizam a mulher como inferior ao homem. Ao longo dos anos elas vieram conquistando seu espaço e tentando mudar essa concepção de inferioridade em relação aos homens , contudo ainda é evidente que o sexo masculino lidera os cargos nas empresas, os salários mais elevados e a representação política.', 'Torna-se evidente que o patriarlismo e a desigualdade de gênero contribuíram para os constantes casos de feminicídio no Brasil. Dessa maneira é preciso que o governo juntamente com os meios de comunicação em massa crie propagandas, novelas e até mesmo programas infantis que derrubem essa concepção de que existe um sexo superior ao outro. É preciso também que as empresas disponham de vagas igualitárias para homens e mulheres e que os processos de seleção assim como a distribuição salarial sejam feitos de acordo com a capacidade de cada indivduo independente do seu sexo. Assim será possível viver em um país menos violento e mais igualitário, pois essa ideologia do homem como ser superior é extremamente equivocada, já que todos independente de sexo, religião, ou condição econômica possuem o mesmo potencial .']",120,160,160,160,120,720
78,A solução é o debate,"['Pode-se perceber nitidamente que a educação no Brasil sempre esteve mais voltada para o ensino tradicional . Fato que contribui para o aumento das já elevadas taxas de evasão escolar , bem como para o desinteresse do aluno em estudar determinada disciplina. Dessa maneira, a reforma do ensino tem, entre outras finalidades, o intuito de solucionar ou diminuir o problema citado .', 'Em um parâmetro global, alguns países já abandonaram o ensino clássico para adotar a forma contemporânea de aprendizado . A Escola da Ponte, em Portugal, se tornou modelo em educação atualmente, uma vez que a mesma investe não só no conteúdo teórico, como também se preocupa em formar pessoas capazes de respeitar as diferenças e de exercer a cidadania dentro dos conceitos ético-morais. realidade diferente nas escolas brasileiras.', 'Além disso, uma das questões que se tornou preocupante é quanto ao número de adolescentes fora da escola . Nesse sentido, faz-se necessário analisar o cerne desse contexto, visto que a resistência em solucionar o problema da evasão se mostra não na quantidade de matérias, mas na forma em que são abordadas', 'Sendo assim, a nova proposta de ensino trouxe mudanças que causaram uma bipolarização da sociedade entre aqueles que são ou não a favor de tal medida . O ensino profissionalizante e o horário de aula integral são outros temas que merecem ser debatidos, posto que grande parte das escolas públicas ainda não têm infraestrutura adequada para adotar tal mudança.', 'Torna-se evidente, portanto, que medidas são necessárias para resolver o impasse. A essência da democracia é debate. Dessa forma, o Governo deveria organizar centros de discussões com profissionais da educação entre outros, como também permitir a participação popular a fim de chegar a um consenso sobre as propostas que a reforma prevê. Por fim, os professores poderiam procurar métodos para deixar seu ensino mais didático, bem como a apresentação de filmes e documentários aos alunos para assim,minimizar as taxas de evasão escolar.']",120,120,120,120,120,600
96,Aids sem Medo,"['A população brasileira continua esquecendo da prevenção contra a Aids. Muitos já não se lembram mais que a doença ainda existe e está camuflada, e o pior,                 muitas delas                em seus próprios lares.', 'O medo parece não intimidar as pessoas                , elas estão cada vez mais preocupadas em se divertir e                 se iludir com as práticas ilusórias                que o mundo oferece.', 'As drogas correm soltas pelas ruas, as famílias já não conseguem mais controlar e suportar esse problema, pois sabem que com as más companhias                 acabarão                caindo                 nas mãos da doença maligna                .', 'Hoje         a medicina avançada e as pesquisas         mostram, que         a Aids pode ser controlada e não curada.         Sendo assim         a população se ilude pensando que         podem         continuar com suas práticas ilícitas                não         correm riscos algum         .', 'As divulgações de prevenções contra a Aids poderiam estar mais presentes em meios de comunicações diárias e não perderem tanto tempo com dilemas sem interesses algum                  Portadores da doença sendo jovens e adultos, lutando juntos para um futuro melhor para as gerações seguintes.']",80,120,120,80,80,480
84,,"['O atual sentimento de impotência da população brasileira diante do aumento dos índices de violência à níveis alarmantes trouxe à tona a tentativa de revogar o Estatuto do Desarmamento tendo em vista possibilitar o porte de armas pela população civil. No entanto, a abertura para a livre circulação de armas de fogo no país apenas visa o lucro da indústria bélica mascarado por uma falsa ideia de que o cidadão estaria legitimando o seu direito de defesa.', 'Não é papel do cidadão ""fazer justiça com as próprias mãos"", afinal, seguindo a premissa de Max Weber, o Estado é o único que detém o poder legítimo da coerção. Vale ressaltar que países em que o porte de armas é aceito legalmente não estão livres da criminalidade, estando ainda sujeitos a assassinatos de grandes proporções como foi o caso dos massacres ocorridos nos Estados Unidos em uma boate de público LGBT em 2016 e em um cinema em 2015. Fica claro que as armas não foram feitas para defender, e sim para matar.', 'Entretanto, é visível a fragilidade e ineficiência do Estado quanto a  à regulamentação do uso de armas e quanto ao controle do contrabando no Brasil, o que facilita a circulação de armas ilegais que apenas contribuem para o aumento da criminalidade, enquanto a população apenas assiste ao descaso da segurança pública do país.', 'Portanto, medidas são necessárias para resolver o impasse. Cabe ao Estado investir em políticas públicas de segurança, apreender armas que não estão de acordo com a legislação, e investir no órgão responsável por combater a violência: a polícia, seja ela militar ou civil. E à Polícia Federal cabe extinguir o contrabando de armas tanto nas fronteiras como dentro do país, com o fito de legitimar o direito de segurança e defesa da população civil brasileira.']",160,160,200,200,200,920
74,Quando isso irá acabar?,"['No Brasil atual  algo que infelizmente acabou se tornando comum ao nosso redor são noticiários trazendo casos de feminicidios , onde o indivíduo do sexo masculino acaba se sentindo superior a mulher, sendo capaz de controlá-la, violenta-la e até possivelmente se achando no direito de tirar à vida da mesma.', 'São inúmeros casos e inúmeras histórias relatadas, cheias de dor e sofrimento contadas pelas vítimas, a cada 20 minutos uma mulher é violentada verbalmente ou fisicamente em nosso país, na maioria das vezes por seus próprios familiares e parentes, os julgamentos da sociedade são sempre associados a roupa curta ou o modo como a mulher se comporta, nunca o homem é visto como “culpado “ pelo ato.', 'Por lei qualquer tipo de agressão contra mulher é crime, em cada cidade se situa uma ou até mesmo duas delegacias da mulher, porém ao denunciar corresse o risco de nada ser feito, ou do agressor ser preso por apenas alguns dias e poder pagar fiança, restando apenas o sentimento de mais corpo “ sujo “ de mais uma vítima.', 'Portanto, medidas são necessárias para resolver o impasse. Não só a população  mas também órgãos governamentais como polícia militar e polícia civil deveriam por sua vez amadurecer sua forma machista de pensar e notar o quão são altos e sérios os casos de feminicidios relatados e não levarem isso como algo normal e comum em nosso cotidiano.']",120,80,80,80,40,400
43,TEMA,"['Em abril de 2020, usuários das redes sociais se juntaram em um mutirão para dar deslike na música nova da cantora Luísa Sonza após ela anunciar o fim de seu relacionamento com o humorista Whindersson Nunes. A cultura do cancelamento é cada vez mais severas com as celebridades que tem suas vidas expostas nas redes sociais, e por alguns deslizes acabam sendo alvo de muitas criticas.', 'A princípio, é possível observar que o cancelamento é extremamente radical, visto que, apenas quem tem seus erros expostos nas redes sociais são cancelados, enquanto anônimos cometem crimes graves que passam despercebidos nas redes . Todavia, vale ressaltar a frase do filósofo Polonês Zygmunt Bauman, no qual diz “Vivemos tempos líquidos, nada é feito para durar”, frase essa que se encaixa nas redes sociais, onde as noticias são facilmente esquecidas depois de um tempo.', 'Por outro lado, as redes socais também podem ser usadas para divulgar noticias importantes, como o caso do jogador Robinho que foi acusado de estrupo, e cancelado na internet pelos usuários . Esse cancelamento fez com que empresas patrocinadoras do time Santos se unissem para que o jogador não fosse contratado depois da acusação ser exposta nas redes, ajudando a trazer a conscientização que estrupo é crime e deve ser divulgado e noticiado, independente do estuprador ser famoso, ademais, incentivando as vitimas a denunciarem.', 'Portanto, para amenizar o problema é necessário que a mídia  utilize seus canais de comunicação promovendo campanhas contra a disseminação do ódio virtual, conscientizando os usuários a usarem as redes sociais para divulgar casos graves, e incentivar denúncias. Também se faz necessário lembrar que qualquer pessoa que se sentir ofendida por comentários nas redes sociais podem denunciar.']",160,200,160,200,160,880
78,caminhos para a melhoria da educação,"['A reforma do ensino médio proposta pelo governo federal busca melhorar a qualidade da educação básica , que a cada ano vem sendo mais negligenciada .', 'Entretanto  essa mudança não é suficiente para que o nível da educação nessa etapa seja elevado,pois apenas aumentar a carga horária e dar a opção aos estudantes de se aprofundarem em uma área do conhecimento ou fazer um curso técnico  não melhorará em nada o ensino , que a  há anos anda deficiente  . Prova disso é o lugar que o Brasil ocupa no ranking mundial da educação, sempre nas últimas colocações. Para haver um aumento da qualidade faz-se necessário uma melhor preparação dos professores , que em alguns casos não sabem praticamente nada da matéria que lecionam . O caso do inglês é emblemático. Os alunos saem do ensino médio sem terem aprendido nada da língua inglesa depois de passarem mais de sete anos estudando. Isso se deve não só a má qualificação dos professores mas também ao método de ensino aplicado , que prioriza o aprendizado da gramática antes mesmo do estudante saber falar qualquer coisa do idioma . Além disso para que essa reforma realmente tenha algum efeito ,os professores , diretores e secretários da educação precisam ser cobrados pelos desempenhos das escolas ,  dessa maneira haverá uma maior preocupação com o aprendizado do corpo discente e consequentemente uma melhora do ensino.', 'Sendo assim, o governo deve de aprimorar essa proposta para que ela realmente surta algum efeito e se alcance os resultados almejados se tornando uma solução para o problema educacional brasileiro.']",80,40,80,80,40,320
120,Exercendo a liberdade com responsabilidade,"['Por 21 anos,                 os brasileiros                viveram sem a liberdade de dizer e fazer o que queriam. Nesse         periodo         de ditadura militar,                 dava-se                valor a cada         minima         oportunidade que se tinha de expor                 seus         pensamentos, e         oportunidades eram usadas com extrema responsabilidade. Hoje, não há reflexão antes de falar,         deixando         , muitas vezes,         esquecido         os limites da liberdade de expressão.', 'Embora conquistada a liberdade da palavra, muitos abusam dela, usando-a para                 definir                seu pensamento como verdade absoluta. Isso acontece com algumas religiões, que dizem que suas crenças são as únicas verdadeiras                 e satirizam          de outros          preceitos, como          esta          acontecendo com o islamismo.', 'Além disso, vê-se a         negligencia         das próprias autoridades, que abusam do seu poder sobre as         midias         para aniquilar qualquer coisa que         a         ponha em perigo.         Com          foi o caso de Canudos, onde se pregou que          o povo          queria reinstalar a          monarquia          mas na verdade só          buscavam          uma vida melhor          baseados          numa crença de salvação milagrosa da exclusão social pela qual          passavam          , como relata Euclides da Cunha em                   Os sertões                  .                  Portanto, sabendo usar a liberdade com responsabilidade e ética e sem abusar da autoridade ou ir de encontro com a liberdade dos outros cidadãos, todos podem viver em harmonia.']",120,80,0,160,0,360
147,(Sem título 005),"['O Brasil tem o processo de votação mais desenvolvido do mundo,         porem         a sua democracia ainda é fraca se comparada         a         outros países. A população         Brasileira         está a cada dia perdendo a vontade de votar, não se importando com futuros representantes, resultando em toda a corrupção que vemos na         politica         brasileira.', 'Nos últimos meses estamos vendo em telejornais, revistas e jornais propostas para a reforma         politica         no Brasil, que seria uma mudança no modelo de         votação, existem         duas propostas: o voto proporcional misto         e         voto distrital. Mas não é o modelo de votação no Brasil que deveria mudar e sim a consciência da população brasileira ao eleger seus representantes e não lembrar do seu candidato apenas na época de         eleição, as          pessoas devem fiscalizar seus candidatos após as eleições, mostrar a eles que não somos apenas um número, e sim somos um voto que deve ser valorizado.', 'Dentre os dois modelos apresentados pelos políticos, o que tem mais proximidade com o modelo nosso já adotado é o do Voto Distrital,                 que tirará o excesso de candidatos facilitando o eleitor a fazer uma escolha mais consciente. Esse novo modelo diminuirá o número de candidatos facilitando a escolha dos candidatos                , também         a         deputados que afirmam que o custos de suas campanhas cairiam                 cerca de 50% - 70%                por não precisarem investir em viagens e mídias por todo o território estadual.', 'O novo modelo de voto distrital proposto com certeza trará grandes benefícios para a população e também para os candidatos, porem o mais importante é o povo brasileiro se conscientizar da importância do seu         voto e         que é uma arma poderosa para acabar com a corrupção no         pais.']",120,120,120,120,120,600
126,Benefício para poucos,"['Pagar menos num ingresso de um filme, de uma peça teatral ou de um museu realmente é irresistível, porém                 existem estudantes          nos quais nem precisem          desse beneficio. Por exemplo, um casal de adultos          têm          uma renda baixa, e por não serem estudantes eles pagam mais do que um estudante de classe média alta para ir ao cinema                . Além disso                 fazem                com que as pessoas que trabalhem em cinemas, museus, peças de teatro ganhem menos do que outros tipos de comércio que não optam em dar desconto e também                 faz com as pessoas que não desfrutem desse benefício acabe pagando por quem têm o desconto.', 'Muitas pessoas acreditam que a carteirinha de estudante é um grande benefício para os estudantes e que eles podem         adquirirem         mais cultura                 e divulgar o cinema nacional.                Olhando         nesse ponto         realmente faz sentido, porém,         olhando de outro ponto de vista         , as pessoas que não estudam         mais acabam pagam         a mais por quem só paga meia-entrada.', 'Ocorreu uma mobilização de artistas e alguns estudantes, para que houvesse a diminuição de 50% do desconto para 40%.                Alguns atores falaram sobre se ter menos lucro para                 o cinema                por causa da carteirinha, e que só eles saem perdendo, pois em outros setores comerciais não existem descontos para carteirinha do estudante.', 'Além de parecer injusta e baixar os lucros dos produtores de cinema, essa carteirinha faz com que as pessoas que não são estudantes paguem pelas que são estudantes. Se não houvesse essa carteirinha, talvez o ingresso seria mais baixo para todos, pois quem não estuda acaba pagando pelas pessoas que estudam.                  Mais de 90% da população é a contra a diminuição do desconto da carteirinha, porém poucos têm outro ponto de vista em relação ao desconto, e não reconhecem que esse desconto não é tão maravilhoso como parece ser.']",120,80,80,80,80,440
81,Intolerância religiosa no Brasil,"['O Brasil sempre foi um país laico, onde todos os povos possuem a liberdade de seguir, cultuar e celebrar conforme os dogmas da sua religião, diferente  de países que têm o histórico de conflitos, como o Oriente Médio e Índia, onde um cidadão é obrigado a seguir aquela religião. Até que  ponto as pessoas precisarão chegar para entender que é necessário respeitar uns aos outros, independente  de cor, raça ou credo?', 'Desde a Idade Média, época da Inquisição, todos que eram Cintra os seguimentos  da Igreja Católica ou algumas mulheres que praticaram obras de feitiçarias eram queimados vivos. Na Europa, um fato que marcou aquele século foi a noite de "" São Bartolomeu"" , onde a rainha Elizabeth mandou exterminar todos os ""Huguenotes"" , como eram chamados os cristãos, cerca de três mil pessoas  vítimas daquele massacre.', 'No ano de 2015, umma criança candomblecista, que havia acabado de sair de um culto religioso, foi apedrejada por dois homens que estavam passando por aquele local,  ainda com a Bíblia nas mãos, denegriram a sua integridade chamando_a  de demônio e que ela iria para o inferno. Nas Escrituras Sagradas, no capítulo 2  em Tiago  está escrito: "" ame o teu o próximo como a ti mesmo "". Se foi um ensinamento bíblico, porque  as nações estão se de digladiando?', 'Desse modo, é necessário respeitar uns aos outros, independente  da sua fé ou credo, porque todo ser humano tem liberdade de expressão, de crer ou não em algum tipo de deus, sem ser visto como um rebelde ou uma aberração por não ser devoto de uma determinada crença.']",120,120,120,120,80,560
72,Fake News suas causas e consequências,"['Em tempo de eleições todos procuram estar informados sobre os partidos e seus representantes a presidente, governador e deputados, s meios de comunicação possuem grande influencia nas eleições e  inclusive nos candidatos, a intenção dos meios de comunicação é deixar o povo atualizado com informações, algumas verdadeiras e outras não.', 'Informações diluídas pelos meios de comunicações à população em geral , muitas vezes não coincidem com a verdade, as falsas viajam na mesma rapidez que as verdadeiras e muitas vezes até mais rápido  e os dias atuais chegam com facilidade ao povo, e como muitas vezes os mesmos aceitam o que primeiro veem sem antes pesquisar acabam tendo a informação errada.', 'E não é só na política que existem as fake ews, figuras privadas também sofrem,  com mentiras e difamação postadas na web e quando uma outra pessoa qualquer compartilha algo parecido está confirmando que aceita isso', 'A responsabilidade de combater as fake news é de todos. Os meios de comunicação precisam parar com a produção de notícias falsas e inibir a propagação destas, os órgãos públicos precisam fiscalizar e punir os responsáveis pelas fake news. E os usuários precisam ter senso crítico para identifica-las, procurando as noticias em sites diferentes, ouvindo pessoas diferentes, esse senso critico deve ser incentivado pelo governo e pelas empresas.']",120,80,120,120,120,560
84,O Estatuto ameaçado,"['A notícia de que o Estatuto do Desarmamento, aprovado em 2003, está prestes a ser alterado, vem provocando embates entre vários grupos da sociedade civil. Quando se trata de segurança pública, preocupar-se nunca é demais, já que este é um dos fatores mais importantes para a qualidade de vida em um país.', 'A polêmica da mudança é que, se aprovada, a compra e o porte de armas de fogo serão facilitados. Pessoas que respondem por homicídio ou tráfico de drogas poderão comprar e portar armas, além disso, a idade mínima para adquirir uma arma será reduzida de 25 anos para 21 anos.', 'A questão da segurança já foi matéria de estudo de muitos pensadores, como Thomas Hobbes. Para ele, com a criação do Estado pactou-se que o uso da violência passaria a ser exclusivo deste. Partindo desse pressuposto, o projeto de regulação do armamento que tremita na Câmara, seria uma grave falha do Estado.', 'Nos E.U.A, onde as leis que permitem o porte legal de armas são mais brandas, ocorreu recentemente um massacre com arma de fogo em uma boate gay. Tal situação levou o presidente Barack Obama a pedir ao Congresso medidas mais rígidas de acesso às armas.', 'É preciso cautela ao se pensar num projeto de lei desse tipo no Brasil, pois cerca de 71% dos homícidios no país são causados por armas de fogo, e com a aprovação deste os índices poderão piorar.']",160,200,160,200,200,920
90,Transfobia,"['Causadora de inúmeras vítimas ao longo dos anos a transfobia tem aumentado cada vez  no brasil fazendo que o mesmo figure como um dos países que mais mata pessoas trans no mundo, reflexo de um sistema que não conscientiza e educa a população a respeito do assunto, fazendo com que menos pessoas estejam aptas a debater sobre direitos desse grupo de pessoas na sociedade acarretando assim principalmente falta de empregos para esse grupo.', 'Estatísticas mostram o crescimento exponencialmente de morte por todo país, fruto principalmente da prostituição por parte dessas pessoas, moradia em lugares inadequados, já que muitas delas não conseguem empregos, empregos que não são ofertados simplesmente pelo preconceito de que pessoas assim são marginais, não tem qualidade de trabalho entre outros aspectos. Preconceitos criado por uma sociedade que não tem ou que não instruída a buscar informações sobre o assunto  já que não algo que as atinge.', 'O governo brasileiro por sua vez de maneira nenhuma intervém para que pessoas trans possuam principalmente direitos de trabalho e aprendizagem, e de forma nenhuma age com criação de leis que protejam e guarde os direitos para que crimes sejam evitados  evitando assim o índice de morte no país. Não possui programas de acolhimento a transgêneros, acompanhamento psicológico, programas de apoio financeiro, não busca distribuir informações e deixar claro a população sobre o que essas pessoas passam e precisam para se recuperar e adentrar a sociedade novamente.', 'Ações de combate a transfobia poderiam começar por simples propagandas televisionarias por parte do governo, como já existem para outras causas, dando maior visibilidade a causa, criação de leis trabalhistas especificas juntas de programas sociais trabalhistas para esse grupo, fazendo com que empregadores se sentissem mais aptos a receber essa comunidade já que teriam apoio e orientação a respeito do assunto.']",160,120,120,120,80,600
82,,"['A automedicação é praticada pela maioria das pessoas, principalmente em casos  de desconfortos fisícos  como a dor de cabeça, febre, dor muscular, gripe, entre outros. Quando se trata em  prescrição de medicamentos,  à  mídia, amigos e familiares sempre indica  aquele remedinho para alívio imediato da dor. Mas até que ponto a automedicação não apresenta riscos?', 'Todo medicamento sem orientação médica pode oferecer riscos a  sáude.  Sendo os principais riscos a intoxicação, alérgias  e  resistência bacteriana  que podem até provocar a morte. Os casos mais comuns de automedicação provém  do estresse e cansaço fisíco, sintomas como dor de cabeça e dor muscular. Assim o individuo recorre a  forma mais rápida de aliviar o desconforto, comprado  e ingerindo medicamentos  vendidos sem receitas médicas  e administrando dosagens desconhecidas .', 'Mas quando á persistêcia  dos sintomas, ao invés de procurar ajuda médica, a pessoa tende a aumentar dosagens dos medicamentos ou  fazer coqueteis  de medicações. Em virtude a isso , devemos considerar que  à  persistência de determinados sintomas pode ser sinal de doenças graves e que a composição de medicamentos populares podem  agravá-las. Dessa forma, a consulta médica é indispensável para prescrição de medicamentos e pedidos de exames para diagnosticar e combater o mal pela raíz', 'Contudo, devemos considerar que todo medicamento tem suas restrições e devém  ser indicados por profissionais da área médica. Assim  para combater a automedicação  é necessário campanhas aonde concientizam  a população dos riscos que essa prática pode trazer a  saúde e que os medicamentos podem apresentar reações diferentes em cada pessoa.']",80,120,120,120,120,560
122,Primeiramente somos humanos,"['O Brasil não tem histórico de conflitos religiosos como aconteceu na Europa entre católicos e protestantes ou como acontece na índia e oriente médio. A intolerância religiosa fere não só a moral de qualquer religião, ela também destrói qualquer vestígio de humanidade e sanidade, pois além de ser uma violência é um ato bastante desumano. Acabar com esse mal antes que ele se enraíze talvez seja a melhor solução.', 'Uma menina de 11 anos praticante         do         candomblé foi         vitima         de insultos e pedradas por homens com         bíblias na mão no Rio de Janeiro, provavelmente cristãos, ela         chegou a desmaiar e ir parar no hospital. Os homens fugiram de ônibus. Esse fato causou bastante revolta da população brasileira,                 por se tratar de uma violência comum apenas em outros países                . O que não se         sabe na verdade         é que o índice de intolerância religiosa no Brasil está aumentando significativamente nos últimos anos. O que causa revolta é principalmente o fato de uma religião que prega principalmente o amor ao próximo ser capaz de tamanha brutalidade.', 'A escolha religiosa é um ato de                 liberdade de expressão que inclusive é uma lei que rege o          País         . Qualquer ato que fere a isso é considerando crime, não só por se tratar de um crime de         ódio         como também por ser um ato desumano e de tamanha violência.         Independe          de alguém acreditar ou não em algo, ninguém tem o direito de impor ou querer julgar por isso.                Todo mundo tem direito de escolher ou seguir         o que         acredita. A violência, o ódio ou a perseguição não         ajuda         em nada a         sociedade         muito pelo contrário, o que ajuda mesmo é                amor, o respeito, o ajudar o próximo e principalmente a tolerância entre as pessoas.']",160,160,160,120,120,720
43,A bipolarização e o discurso de ódio nas redes sociais,"['Em outubro de 2015 a atriz Taís Araújo foi vítima de ataques racistas criminosos nas redes sociais, acontecimento esse que escancarou uma realidade velada na sociedade brasileira: o discurso de ódio. Embora as empresas do ramo digital estejam mais cautelosas em relação aos seus usuários, inclusive censurando contas e restringindo nomes considerados ""negligentes"", ainda há um eminente contingente que incitam palavras impróprias e afligem os direitos humanos, sentido-se protegidos por traz de uma tela de computador ou de aparelho celular.', 'Primordialmente, é preciso acentuar que o Brasil é um país preconceituoso, e isso está enraizado por diferentes situações. Ainda em 2011, quando as redes sociais já ocupavam um espaço significativo, diversos grupos eram criados em uma rede específica no intuito de disparar ofensas e promover constrangimento a uma determinada parcela de internautas. Com a polarização e o fácil acesso a criação de perfil ""Fake"", a cada ano as falas carregadas de ódios tornara-se corriqueiras nas plataformas digitais. A questão das ""Fake News"" também é um fator atrelado a isso, levando vítimas a pagar por situações das quais não estão envolvidas.', 'Conquanto, outrossim, foram criados nas delegacias policias setores que apuram esse tipo de crime virtual. Em 2016 nas eleições dos Estados Unidos, o presidente, então eleito veio a ganhar aquela disputa, justamente por ter o apoio das redes falsas, fato esse repetido no Brasil nas eleições presidencias em 2018, que não só veio a ter muita ""Fake News"" como também um discurso de ódio mais forte, passando dos limites de repeito entre cidadãos. Recentemente, o Youtube Felipe Neto foi alvo desses ataques de apoiadores ativistas, sofrendo também ameaças de morte.', 'Nessa perspectiva, portanto, é necessário que medidas paliativas sejam criadas em parceria do governo federal e organizações privadas, donas de plataformas digitais. Ações e medidas mais severas devem corroborar para uma erradicação ou diminuição brusca desses crimes virtuais. Ferramentas acessíveis que incentivem as pessoas a denunciarem os crimes devem se fazer mais presentes e acessíveis. Assim, com um alcance que se torne mais abrangente será cada vez menos comum os ataques ""preconceituosos"". Imbricado a essas projeções eficazes é preciso incluir criações de aplicativos que contribuam para o encorajamento e repassem esses atos criminosos. Desse forma, com tais providências haverá uma diminuição de bipolarização e participação ativo de ódio nas redes sociais.', 'Redação']",120,40,80,120,40,400
51,Seu campo de visão com os do mundo,"['Segundo Zygmunt Bauman, sociólogo polonês, a falta de solidez nas relações sociais, políticas e econômicas é característica da “modernidade líquida” vivida no século XX. Nesse viés, a frase do autor, reflete à necessidade das mudanças de pensamento em relação ao anafalbetismo funcional no Brasil, visto que, a sociedade atual anseia por informações instantâneas sem observar a veracidade dos fatos .Dessarte, deve-se atenuar esse entaro por meio do hábito de leitura diária e da busca por informações confiáveis nos meios de comunicações.', 'Mormente, é valido ressaltar que todos os homens têm, por natureza, desejo de conhecer. Tal afirmação, destacada pelo filósofo Aristóteles, evidencia que os seres humanos têm uma natureza tendenciosa de buscar conhecimento e, indubitavelmente, a leitura é o melhor meio para se alcançar esse desejo. Em contrapartida, pesquisas revelam dados extremamente baixos de uma população que não possui o hábito de ler. Dessa forma, fica claro que,  apesar de os indivíduos desejarem conhecimento, há diversos obstáculos sociais que impedem esse crescimento, e aqui nos cabe entender as motivações dessa deficiência na sociedade.', 'Outro ponto importante a ser destacado é que todo homem toma os limites de seu próprio campo de visão como os limites do mundo. Tal premissa, defendida pelo filósofo alemão Arthur Schopenhauer, fundamenta-se ao se observar que o indivíduo atual obtém a informação e a transfere sem tomar os limites de seu campo de visão com os do mundo. Sendo assim, percebe-se uma sociedade incapaz de observar e perceber uma informação incoesa a sua realidade, e que informações errôneas tendem a permanecer.', 'Infere-se,por conseguinte, que é imperiosa a mudança de pensamento em relação ao analfabetismo funcional no Brasil. Nessse sentido, é necessário que as mídias forneçam notícias confiáveis a população, através da verificação de sites, programas, rede sociais, a fim de que o indíduo saiba distinguir a informação verdadeira. Por conseguinte,o governo ratificar leis de proibição a sites de publicações de notícias não verificadas. Assim, será plausível a gradativa inserção dos alfabetizantes funcionais em nosso país.']",120,160,120,160,80,640
58,,"['O aumento grandioso do número de focos de queimadas na floresta amazônica mostra um estado omisso em suas políticas ambientais e o encorajamento de agentes agropecuários em aumentar seus territórios de cultivo.', 'É possível observar que nos últimos dez anos o número de incêndios na floresta amazônica vem crescendo vertiginosamente, sem acompanhamento adequado dos poderes políticos . Um dos atos praticados pelos líderes governamentais - com o intuito de gerar riqueza em uma floresta que não possui recursos suficientes para o desenvolvimento da agricultura e pecuária - foi o afrouxamento do código florestal sobre as áreas reservadas para a conservação do ecossistema e bioma.', 'Com tal feito, grandes latifundiários, buscando aumento da produtividade, realizaram de forma de inconsciente o desmatamento de áreas que abrigam riquezas da fauna e flora da Amazônia;  transformando grande espaços de mata virgem em pastos para o gado. Outro fato importante para a grande irresponsabilidade ambiental é o escasso recurso financeiro que órgãos reguladores da área possuem para realizar feitos que controlem a situação de preocupação não somente ambiental e, também, social.', 'Portanto, com a grave expansão territorial sobre a floresta amazônica e o descaso governamental, a independência de órgãos reguladores ambientais e uma reserva do valor do PIB para a conservação ambiental, traria para a sociedade a segurança e resultados de um país que busca um desenvolvimento sustentável.']",120,120,120,120,80,560
52,Evoluções sociais e seus efeitos,"['Compreende-se que a vida é dividida em fases, estas por sua vez, possuem transformações nas quais o indivíduo é submetido a passar . Uma dessas fases é chamada de adolescência, período entendido entre os 10 e 19 anos, segundo a OMS (Organização Mundial da Saúde).', 'A partir da segunda metade do século XVIII, na Inglaterra, ocorreu o início da Revolução Industrial, que garantiu o surgimento da indústria, e consequentemente, a inserção das mulheres no mercado de trabalho. Tal fato gerou para as famílias, uma perda em parte do tempo que antes, era destinado ao eixo familiar. Assim, sendo esta a instituição responsável pelo asseguramento de informações morais e pela transmissão de valores, os pais, se tornam falhos para com os filhos nestes requisitos.', 'Segundo o princípio Kantiano,  “o homem não é nada além daquilo que a educação faz dele” . Desta forma, o não investimento em orientação para os adolescentes,  tem como resultado mais previsível,  o crescente número de gestações precoces.', 'Destarte, torna-se indubitável a intervenção de ações governamentais neste caso, promovendo campanhas e palestras, principalmente em escolas, para pais e filhos, com o propósito de expandir cada vez mais o conhecimento sobre o assunto e sobre métodos de prevenção, visto que este é hoje,  um problema de saúde pública.']",80,40,40,80,80,320
44,Caster Semenya,"['A campanha ""Let Her Run"" pede o fim de exames abusivos em mulheres atletas. O movimento teve início com o caso da sul-africana Caster Semenya, que apresentou nível de testosterona além do permitido, consequência de uma disfunção hormonal com a qual ela nasceu. Desde então, a atleta tem enfrentado essa situação humilhante na qual a deixou a World Athletics, sendo proibida de competir caso não se medique.', 'Violando os direitos humanos no que se trata de não discriminação, tal regulamento nega s atletas com variações nas características sexuais um direito igual de participar de esportes . São homens controlando os corpos das mulheres. É um problema atual, mas nasceu há muito tempo atrás. É inaceitável que mulheres sejam excluídas dessa forma, expostas cruelmente, sendo tratadas como se estivessem doentes e colocando sua saúde em risco para poderem se auto afirmar, provando que são do sexo feminino.', 'A questão social, a saúde mental dessas atletas e a integridade delas são fatores muitíssimos importantes, mas, aparentemente, completamente descartados quando se trata de ""justiça"" na competição. Segue o comentário de um homem favorável ao regulamento da World Athletics: ""Tem \'homem\' que não tem vigor pra disputar com outros homens, então se camufla de mulher pra trapacear e conseguir vencer no meio feminino. Isso é um absurdo."" Sonhos sendo dilacerados, mulheres que nasceram para fazer o que fazem sendo impedidas, ouvindo de terceiros que elas não podem ser quem são. Esse é o maior absurdo.']",160,160,120,120,0,560
62,O problema do discurso de ódio,"['Para que serve o discurso de ódio? O discurso de ódio é utilizado para insultar, perseguir e justificar a privação dos direitos humanos e até mesmo homicídios.', 'Como por exemplo na segunda guerra mundial, Hitler usava o discurso que a Alemanha precisava voltar ao que era antes, ter o sangue alemão de volta, culpando os judeus, ciganos, homossexuais, deficientes físicos e mentais pela crise econômica e os problemas dela para poder exterminar essas ""raças inferiores"" e manter a raça pura alemã.', 'Hoje em dia esse discurso de ódio  tem aumentado significativamente pela rapidez da internet e das redes sociais. Que o principal intuito é insultar ou até mesmo intolerância religiosa, e o anonimato deixa uma brecha muito grande, fazendo ser mais fácil fazer esse tipo de discurso, por causa que sai sem nenhuma punição e assim crescendo o número de discursos.', 'Uma possível solução seria o Ministério da Justiça criar delegacias e centros de investigação em crimes virtuais, assim diminuindo os crimes virtuais sem punição e a poderia mídia promover campanhas socioeducativas na TV sobre o discurso de ódio, para que possa instruir a população a evitar esse tipo de ação e minimizar esse tipo de ato.']",120,120,80,120,80,520
87,o problema da erotização infantil,"['Atualmente o tema da erotização infantil vem tendo um grande destaque devido ao filme da Netflix “lindinhas” que mostra garotas de onze anos de idade sendo sensualizadas em danças e posições o que gerou uma grande polemica e fez muitas pessoas a fazerem boicote e cancelarem suas assinaturas, a diretora e a própria Netflix se manifestaram e disseram que a obra não tem intenção de sexualizar menores de idade.', 'No brasil  tempos atrás também houve um debate sobre esse tema com crianças de 12 a 14 anos que cantavam músicas de funk com conotações sexuais e dançavam em posições apelativas com os cantores mc melody, mc brinquedo e mc Pikachu. Foi –se comentado se eles já teriam idade o suficiente para cantar músicas com essas mensagens, mas esses casos geraram menos polemicas do que o do filme da Netflix, ouve outros casos de erotização que são parecidos com os já citados acima.', 'Pelo meu ponto de vista não deveria ser permitido esse tipo de trabalho a crianças no cinema e em outras mídias  pois isso seria problemático para a criança que poderia desenvolver um problema futuro em vida adulta, a diretora do filme lindinhas disse que seu objetivo era justamente criticar como as crianças são sensualizadas desde muito cedo em propagandas e comercias, mas para mim ela poderia achar um outro jeito de fazer sua crítica sem envolver menores de idade nesse contexto', 'Poderia existir uma lei que proíba esse tipo de serviço a crianças multando os responsáveis delas por deixarem que elas façam esses trabalhos assim poderemos preservar a inocência e a juventude dos menores de idade.']",160,120,120,120,120,640
93,Um Momento Sagrado,"['Ter um filho com certeza é uma das melhores coisas da vida, um momento único vivenciado por um casal que se prepara mentalmente, materialmente e fisicamente para receber aquele ser novo que está por vir porém antes de tudo é preciso passar por um procedimento imensamente delicado, o parto.', 'No Brasil muitas mulheres perderam suas vidas no período de gestação, parto ou pósparto fora os momentos em que o bebê também perdeu a vida, nessas condições vemos a necessidade de fazer um procedimento bem feito pois só assim é possível garantir a saúde da mãe e do filho, por isso também é bom considerar as escolhas da paciente para que a mesma se sinta bem ao realizar o parto, que sem dúvidas é o momento mais delicado na vida de uma mulher.', 'Sabe-se que no Brasil se faz o parto principalmente por cesárea,  número de cesáreas no Brasil é quase o dobro comparado ao de países desenvolvidos um dado chocante considerando que para OMS a cesárea é um procedimento emergencial mas como pode um processo considerado emergencial ser feito com tanta frequência? Como pode um momento tão lindo se tornar um momento tão trágico? Por ser um procedimento delicado, com certeza deve ser feito de maneira delicada, afinal sabemos que diante de um cenário tão tecnológico existem recursos suficientes para evitar essas mortes.', 'O parto deveria ser um processo levado muito mais a sério,de maneira que a paciente se sinta bem, com profissionais amplamente qualificados e com um local acolhedor de forma que a paciente se sinta acolhida e respeitada por todos, nessas horas a saúde pública e educação de qualidade faz enorme diferença, com cursos preparatórios de qualidade se formam profissionais de qualidade preparados para lidar com momentos como esse da melhor forma e isso aliado a um hospital limpo, bem cuidado, organizado e com um bom atendimento ajudaria muito as mulheres pois confiariam em quem está por lá e pessoas não teriam medo de ser mães, afinal ser mãe é um momento muito sagrado e por isso deveria ser levado como um momento sagrado']",160,120,120,120,80,600
55,Salve o índio,"['A máxima do Filósofo Blase Pascal ""é justo que o que é justo seja seguido e é necessário que o que é forte seja seguido"" tem sido ignorada por nossas  autoridades federais, quando no quinto maior país do mundo, com mais de 7 milhões de quilômetros quadrados, o índio tem perdido seu espaço. Índio é ser humano, índio também é cidadão e como tal,  tem seus direitos garantidos pela carta magna do Brasil.', 'Esse ano de 2019 o índio começou perdendo seu espaço na política quando pelo decreto do então presidente Jair Messias Bolsonaro, pela MP 87 foram transferidas as atribuições da Funai para um conjunto de ministérios do meio ambiente . Fica evidente o descaso com esse grupo social que deveria ter máxima atenção em respeito a sua história e simbologia para o povo Brasileiro . O índio é um pesonagem imortalizado nas obras de tantos escritores brasileiros como  por exemplo o grande Gonçalves Dias em I-Juca pirama. As páginas do livro revelam justamente um povo guerreiro e corajoso que não desiste de sua luta.']",120,120,120,120,0,480
48,A Falta de Qualidade no SUS,"['Promulgada pela ONU (Organização das Nações Unidas) em 1948, a Declaração Universal dos Direitos Humanos garante a todos os indivíduos o direito à educação, saúde, segurança e ao bem-estar social. Posto isso, o SUS (Sistema Único de Saúde),  promete a sociedade brasileira um tratamento de qualidade, e acessível a todos. Porém, a falta de comprometimento do Governo brasileiro , relacionada ao sistema púbico de saúde impossibilita que a população desfrute desse direito de qualidade na prática.', 'Em primeira análise, é evidente que grande parte da população brasileira, depende do SUS, pois de acordo com a pesquisa de 2013 do IBGE (Instituto Brasileiro de Geografia e Estatística), dois terços da população brasileira usam o sistema. Contudo, a situação das estruturas dos hospitais públicos, centros de atendimento,  e postos de vacinação é precária e insatisfatória, e requer um melhoramento imediato.', 'Faz-se mister salientar, que a falta de médicos, leitos e até mesmo medicamentos nas instituições públicas de saúde, é presente, e ocasiona filas espera enormes, diagnósticos tardios, falta de recursos para tratamentos e até mesmo mortalidades por conta da insuficiência do SUS . Nessa perspectiva, de acordo com Marcos Ferreira, um país onde falta saúde, educação, segurança e ainda pagamos os impostos mais altos do mundo precisa ser repensado . Sob está ótica, a falta do comprometimento governamental, e investimentos, é refletida problemas na saúde pública brasileira, e assim ocasionando tais complicações.', 'É necessário, portanto, que medidas sejam tomadas, para que a realidade no Sistema Único de Saúde seja modificada. Para isso, a Receita Federal em parceria com o Ministério da Saúde, deverão designar uma maior parte de impostos para a área da saúde, de modo a proporcionar uma melhoria nas estruturas dos hospitais, leitos, contratações de novos médicos, e até mesmo construções de novos hospitais . A partir dessa ação, espera-se promover uma melhoria nas condições públicas de saúde e que a insatisfação da sociedade brasileira seja revogada.']",160,160,120,160,160,760
84,Não as armas*,"['No Brasil, o uso de arma de fogo  é ilegal, mas é possível ver pessoas utilizando esses objetos, e a sociedade questiona as leis que não estão sendo cumpridas. Os governantes queriam implantar a legalização de armas pelo aumento de violência, contudo o Brasil é despreparado, pois a segurança e a educação precisam ser reformuladas.', 'Nos últimos acontecimentos é possível ter uma arma de fogo a cada homicídio**, muitos possuem para se defender, outros para cometer agressões, então é difícil equilibrar a sociedade para que (se) possa chegar a um acordo. Os jovens são os grandes atuantes desses crimes, pois a educação brasileira é deficiente em qualidade, e eles serão o futuro da nação e o Brasil precisa de jovens intelectuais para melhorar o mundo.', 'A segurança pública precisa ser investida para que os agentes estejam preparados para  combater as violências  e o crescente índice de armas que estão sendo instaladas serem apreendidas. Alguns políticos são intolerantes, porque a falta de investimento que eles não fazem resulta em uma má administração e atrapalha o avanço do país.', 'A necessidade é de pessoas que estejam à disposição de mudar o país, pois para que todos esses fatores aconteçam tem que reformular as leis e implantar boas campanhas de não ao crime, trocar armas por objetos atraentes que ajudem na educação, como: tablets, notebook, livros, jogos e outros. O Porte de arma de fogo não irá trazer benefícios ao país, pois se reestruturar as leis e a segurança, o Brasil iria conseguir viver em harmonia e não teria necessidade de armas.']",120,120,120,160,200,720
79,Das rupturas imprescindíveis ao sistema carcerário brasileiro,"['As péssimas condições atuais da maioria dos presídios brasileiros apresentada a nós pela mídia, em vários aspectos, quais sejam: superlotação, rebeliões, estruturas antigas, falta de segurança interna, falta de limpeza e ar arejado, entre outros, só reforçam a necessidade de ser repensado o sistema carcerário.', 'O constante aumento de reclusos no nosso país a cada dia de condenação,   ou até mesmo presos provisórios (que são aqueles mantidos em cárcere na fase de investigação criminal e ou no curso do processo, antes de serem condenados) implica na  condição desumana experimentada pelos presos no que tange à superlotação.', 'A média de presos por cela não é observada e ficam amontoados em míseros metros quadrados como se fossem animais numa gaiola.', 'Ademais, a superlotação não se resume somente em pessoas amontoadas, mas também em exposição à  doenças respiratórias como a tuberculose por exemplo, bem como o calor intenso suportado pelos presos ora pelo pequeno espaço dividido, ora pelo baixo fluxo de ar arejado presente.', 'Não obstante os problemas acima mencionados, os presos convivem ainda com climas de tensão existente  entre reclusos que pertencem à  facções criminosas distintas e rivais. Vale o destaque recente sobre a matança de mais de 50 presos num   presídio em Manaus.', 'É notório que não há vagas para todos os presos do país, razão pela qual a primeira solução para amenizar ou minorar a gravidade do problema,  seria a construção de mais presídios,  ou a ampliação dos que já existem,  por razões de interesso público.  E  é claro, todos com condições básicas para um ser humano.', 'Outrossim, considerando a desproporção entre o número de presos e de agentes para fiscalizar e manter a ordem, seria necessário também a realização de mais concursos para o aumento do efetivo de agentes penitenciários. Tais medidas também não teriam o condão de findar os problemas, mas certamente reforçaria a manutenção da ordem nos presídios e tornariam estes dignos para a mantença  de presos.']",120,120,120,120,160,640
49,Padrão subconsciente do comportamento,"['A reflexão acerca dos influenciadores digitais é assunto relevante para discussão no cenário atual. Pessoas com habilidades para influenciar ou persuadir outras, sempre tiveram espaço na sociedade, utilizando-se dos mais variados meios de comunicação para transmitirem seus pensamentos, ideias ou comportamentos. Ocorre que com o advento da internet, especialmente as mídias sociais, surgiu a modalidade do influenciador digital, uma pessoa que externaliza aos seguidores, por vezes com resultado maléfico, sua rotina diária e é recompensada financeiramente pelos patrocinadores para expôr os nomes dos lugares que frequenta e as marcas que usa.', 'De início, vale destacar que a mídia social estreitou a relação entre aquela pessoa que possui algum destaque na sociedade e seus admiradores/seguidores. Essa proximidade virtual faz com que os influenciadores digitais exerçam um papel significativo na vida de quem os acompanham, pois estes querem vivenciar,  e muitas vezes copiar, o estilo de vida de seus ""ídolos"". Acontece que tentar viver uma vida que não é sua pode desencadear diversos problemas, como tristeza e depressão, por exemplo, quando se percebe que aquele padrão de vida dos influenciadores está longe da sua realidade e que, talvez, nunca o alcance . Assim, o indivíduo é tomado por um sentimento de impotência e se julga fracassado por não atingir o ""padrão ideal"" de vida no contexto social.', 'Um outro ponto a se evidenciar é que, por vezes, a sociedade é levada, por intermédio dos influenciadores digitais, a se alinhar à premissa de que é mais importante o ter do que o ser . Esse é o meio subconsciente que as grandes marcas encontraram para tentar modelar as atitudes e comportamentos das pessoas, sem que elas se deem conta dessa mudança. Nesse sentido, o inocente ato de imitar o influenciador, seja por mera simpatia, está criando  padrões societários, principalmente, no quesito consumo. Fato esse que é extremamente bem-vindo às marcas patrocinadoras, especialmente quando o patrocinado é alguém que consegue atingir milhões de seguidores, de forma a replicar a marca para um maior número de pessoas, consequentemente gerando um maior nível de consumo do produto exposto pelo influenciador.', 'Por fim, diante desse contexto, vale destacar que as pessoas devem se questionar até que ponto é salutar seguirem as orientações e padrões dos influenciadores digitais, que muitas vezes estão mais preocupados com os cachês recebidos pelas propagandas do que com o bem-estar de seu público . Portanto, o uso das redes sociais deve ser priorizado para lazer e descontração e não como um padrão de vida a ser seguido cegamente, pois uma sociedade com sã e independente é uma sociedade próspera.']",160,160,160,160,120,760
88,Estigmatizando à saúde,"[""Na obra ''Utopia, do escritor britânico Thomas More, é retratada uma sociedade perfeita, na qual o corpo social padroniza-se pela ausência de conflitos e problemas. Contudo, essa sociedade proferida pelo autor está muito distante da realidade brasileira, visto que inúmeros problemas, como o estigma associado às doenças mentais, dificultam o país alcance o patamar proposto por More. Nesse contexto, fatores como o preconceito e a negligência familiar agravam essa situação."", 'Diante disso, é fulcral pontuar o preconceito com os indivíduos como impulsionadora do imbróglio. Segundo o pensador francês Jean Paul-Sartre: ”O preconceito, seja qual for a maneira que se manifesta sempre será considerado uma derrota”. Sob tal ótica, é fato que os brasileiros estão praticando o mal exposto por Sartre, já que há a prática do preconceito com parcela da população que apresenta problemas com a saúde mental. Consequentemente, tal prática cria estigmas para que haja o tratamento adequado, pois, infelizmente, há uma falta de apoio e o julgamento com as pessoas que buscam por uma ajuda psicológica para uma melhor qualidade de vida. Dessa forma, é indubitável a mudança dessa postura social para a reversão dessa conjuntura.', 'Ademais, é imperativo ressaltar que o estigma associado s doenças mentais deriva da negligência familiar. Nesse sentido, consoante a Constituição federal de 1988 - Lei de maior hierarquia jurídica do país- é dever dos pais a garantia do direito à saúde das crianças. Entretanto, isso não ocorre no Brasil, tendo em vista que as famílias contribuem com o surgimento da ansiedade e depressão, por exemplos com os maustratos e a falta de apoio. Tudo isso retarda a resolução do empecilho, já que a negligência familiar contribui com a persistência de quadro deletério.', 'Portanto, diante do problema exposto, medidas são necessárias para conter o estigma associado às doenças mentais na sociedade brasileira. Por isso, o Estado, no papel do Ministério da saúde, responsável pela Saúde pública do país, deve investir em projetos que contratem mais profissionais da saúde e nas campanhas sobre doenças mentais. Essa ação deverá ser realizada por meio da disponibilização de médicos e psicólogos nos postos e nas escolas, para que as pessoas com problemas de saúde mental possam se tratar, além de campanhas que alertem as consequências da prática do preconceito com os indivíduos. Destarte, o estigma relacionado às doenças mentais não será mais um problema e o Brasil se aproximará da sociedade perfeita de More.']",160,200,160,200,200,920
9,Universidade pública e gratuita para o bem dos estudantes,"['Em uma sociedade desigual como a que esta em que estamos inseridos, é comum que muitas pessoas, especificamente de renda baixa, tenham a universidade pública e gratuita como uma das principais possibilidades de uma vida melhor. Tendo em vista melhor, visto que o estudo é o principal fator necessário para construir uma vida profissional de maior reconhecimento sucesso financeiro e social e que o preço de uma faculdade privada não é acessível a todos.', 'Além disso, a universidade pública é preferível por a grande parte dos estudantes por seu investimento em pesquisas - objeto de estudo fundamental para o desenvolvimento de novos fatos -, característica que só é possível graças à sua gratuidade, já que o dinheiro que seria recebido através de mensalidades não alcançaria o valor que é custeado pela sociedade.', 'Ainda é possível reforçar que as vagas que são conquistadas na universidade não se devem apenas ao dinheiro gasto com ensino fundamental e médio privado, já que as vagas destinadas aos oriundos de escolas públicas não poderão, de forma alguma, ser ocupadas por ricos que desfrutaram de privilégios desde a infância.', 'Tendo em vista os âmbitos fatos acima e os gastos altos de uma universidade pública gratuita, a mais viável solução a solução mais viável seria não cobrar mensalidades de nenhum aluno, visando a igualdade como todos devem ser tratados, mas criar campanhas de incentivo tanto à doação de dinheiro quanto à a serviços comunitários por parte dos alunos a fim de arrecadar dinheiro para a instituição.']",120,160,160,160,120,720
89,Economia VS saúde,"['No livro “Os miseráveis”, de Victor Hugo, narra a vida de uma personagem chamada Fantine, uma mãe solteira que devido à sua precária condição financeira se submete à prostituição para conseguir sobreviver. Dessa forma, quando observamos a realidade brasileira nota-se que há muitas pessoa que, devido à necessidade, se submetem a trabalhos onde não há cuidados adequados. Isso ocorre devido o descaso do presidente e a falta de condições financeiras da sociedade.', 'Em primeiro plano, os comentários feito pelo atual presidente do país colaboram para que o isolamento não se cumpra, priorizando assim a economia. Desse modo, a população é manipulada abertura de lojas, consequentemente é gerada a aglomeração e proliferação do vírus.', 'Ademais, a falta de dinheiro por uma parte da população dificulta a obtenção de alimentos e higienização. Dessa forma, estas pessoas se veem obrigadas a ir em busca de formas de trabalho autônomo sem regras de restrição, o que faz as pessoas ficarem vulneráveis a contrair o vírus.', 'Visto o exposto, medidas são necessárias para a efetiva conscientização acerca do isolamento social em meio à crise. Portanto, o presidente da República deve se conscientizar por meio do agravamento de mortes que está acontecendo , e dessa forma incentivar o cumprimento do isolamento. Além disso, o Ministério da Educação deve investir na disponibilização de cestas básicas para aqueles de baixa renda. Dessa forma, espera-se a diminuição de pessoas na rua e o aumento do distanciamento.']",200,160,120,200,160,840
44,"""Let Her Run","['As mulheres são criticadas mundo a fora ao praticarem de competições, por não terem competência igualitária a do homem.', 'De fato,  que as mulheres  as quais praticam atletismo ter uma vantagem no desempenho do esporte . Pois,  com grande nível de possuir testosterona suficiente para uma competição sucessiva.', 'Então, devido tecnologia a qual mudou o esporte nos últimos anos, cada indivíduo possui competência igualitária independentemente do seu sexo.']",120,40,80,120,40,400
144,Por um país sem desigualdade entre os sexos.,"['No Brasil, atualmente, temos um cenário muito favorável às mulheres.                 Como nunca, o país tem em cargos públicos e de maior evidência com Elas no poder. Esta é uma tendência                , visto que a mulher sempre esteve em segundo plano e hoje pode mostrar suas qualidades e competências em qualquer campo de atuação.', 'No passado a mulher sempre esteve escondida atrás de uma sociedade injusta e machista, consolidada por uma opinião que         as         limitava e restringia. Era improvável uma mulher conseguir atuar em carreiras predominantemente masculinas.', 'Com o passar do tempo o chamado “         Sexo         frágil” entrou em universidades, adquiriu                 competências                , independência, e o principal         expuseram-se. Mergulharam         sem medo em um universo de paradigmas e opiniões contrárias, mostrando sua capacidade de construir, consolidar, gerenciar, presidir...', 'Portanto, é necessário que compreendamos o crescimento do papel da mulher. Uma vez que o nosso país precisa de          mão-de-obra          qualificada e cada vez mais elas buscam conhecimento e aperfeiçoam suas habilidades. Devemos nos orgulhar de termos conseguido evoluir tanto nas últimas décadas, e este cenário é reflexo disto. Reconheçamos o esforço e o trabalho quando alcançam setores antes jamais ocupados por          Elas          . Por fim, como dito pela primeira          presidenta          do país: “Sim, a mulher pode!”.']",120,160,120,80,0,480
125,Paz no mundo das drogas?,"['""A guerra contra as drogas                além de ser cara e inútil, está produzindo uma tragédia?, diz o deputado Jean Wyllys, a                 liberação da guerra da maconha                é um projeto de lei, que provocou muita polêmica, devido ao fato da droga provocar danos à saúde. Descriminalizar, manter a proibição, ou liberar""', 'A maconha pode acarretar sérios                 problemas de saúde, dependência                que traz muitos problemas tanto para o usuário quanto para a família.                 Os contra também                citam a falta de estrutura no sistema de tratamento. Também alegam que estas drogas                pode ser porta para outras, como o crack.', 'Outros especialistas que                são contra a legalização, mas a favor da descriminalização, por julgarem que um usuário não comente crime ao usar, só se causar danos a sociedade.                 Inclusive a ONU fez um relatório, dizendo que as lutas                  contra a drogas não teve muitos resultados, assim o usuário não irá parar em uma cadeia congestionada e que de fato é uma escola pro                  crime.', 'A legalização, não                significa estar                 entregando elas                nas mãos dos jovens, é [jovens. É] como o                 secretario                [secretário] do Uruguai explica, é                 tirar arma                e regularizar os pontos de vendas. Isto acabaria com uma guerra que mata mais do que a droga, segundo dados                56% dos assassinatos no país                 são                diretamente ligados ao tráfico e                 na maioria jovens de 15 a 25 anos                .', 'Concluímos, que                continuar a proibição é manter a guerra, o certo seria regularizar,                com isso livrar-se de gastos, dar uma nova chance os usuários. E devemos sempre batermos                na mesma tecla,                 investir em educação,                principalmente nas regiões mais carentes.']",120,120,120,120,80,560
112,Brasil. Um país de todos ?,"['Na mídia                muito tem se falado sobre a redução da maioridade penal em nosso país. O que deixa a população mais revoltada                 com isso tudo                é que                 esses                criminosos não são punidos como         se deve ser         , só pelo motivo de ainda não terem completado 18 anos.', 'Muitas pessoas - crianças, adolescentes, adultos, idosos – morrem na mão desses                 criminosos. Eles, os criminosos,                sabem que não são presos e por isso, muitas vezes, cometem o crime.         Alguns dias atrás         mais uma mãe chorava, agoniadamente, pela morte de sua filha,         13         , que foi morta por um         garoto, 16,         que tinha roubado um carro, e foi com esse carro que ele atropelou a garota “acidentalmente”. E como de costume, ele está livre.', 'O Brasil tem                 uma Constituição onde são os criminosos que ganham e são as vítimas que perdem. Portanto, uma lei que reduza a maioridade penal tem de existir.']",120,80,80,80,0,360
54,,"['A varíola, doença que matou milhões de pessoas no mundo  foi erradicada do planeta graças a criação da vacina. Isso mostra o quanto a vacina é importante para a a sociedade. Infelizmente hoje em dia a cobertura vacinal vem caindo ano após ano no Brasil, situação que preocupa a UNICEF . Com esse cenário é necessário a tomada de medidas que resolvam definitivamente essa problemática.', 'A vacina é essencial para prevenir doenças e salvar vidas, mas infelizmente a vacinação no Brasil está em queda nos ultimos anos. Isso é um problema porque doenças que foram erradicadas podem voltar a tona e gerar a morte de muitas pessoas.', 'Entretanto, muitos problemas dificultam a resolução do impasse . Por não haver monitóramento necessário muitos estados deixam de vacinar uma boa parte da população . E pela falta de informação muitas pessoas acham que a vacina pode causar maleficios deixando de vacinar seus filhos e de se vacinar.', 'Portanto, medidas são necessárias para resolver o impasse. O Governo junto com o Ministério da Saúde devem aumentar o número de funcionários da área da saúde para ter um maior monitóramento da cobertura vacinal, vacinando as pessoas que não tem acesso a mesma. O MEC em parceria com o Ministério da Saúde  devem realizar campanhas e palestras nas escolas para pais e alunos falando sobre a importância da vacina para o bemestar de todos. Assim, doenças como o sarampo podem ser erradicadas como foi caso da varíola.']",120,120,80,120,120,560
58,,"['Proteger, recuperar e promover o uso sustentável dos ecossistemas são alguns', 'dos objetivos relacionados à vida terrestre da Agenda 2030, criada em 2015, e as-', 'sinada por 193 países. Entretanto, de forma análoga, nos dias atuais, o número de', 'desmatamentos e queimadas na floresta amazônica tem crescido, ao longo dos', 'anos, de maneira assustadora. Precisamos , portanto, analisar as causas e consequências dessa problemática, como também possível medida em nosso  país.', 'Inicialmente, segundo as palavras do filósofo, teólogo, organista e médico alemão Alber Schewitzer, entre o século XIX e XX, vivemos  em uma época perigosa.', 'O homem domina a natureza antes que tenha aprendido a dominar a si mesmo .', 'Concernente a esse pensador, inevitavelmente, em pleno século XXI, vemos  terrivelmente ações do ser humano contra um bem precioso, que é o meio ambiente, pois não cuida de forma eficiente, de maneira que evite problemas futuros. Necessitamos, logo, mudar esse posicionamento da sociedade brasileira.', 'Consequentemente, de acordo com os dados do Instituto Nacional de Pesquisas', 'Espaciais ( Inpe ), publicado no G1, agosto desse ano foi o pior mês para a Amazônia desde 2010. O número de queimadas na região triplicou em relação ao mesmo', 'período do ano passado. É inadmissível, que num país o qual faz parte de um con-', 'trato tão importante da Organização das Nações Unidas, permaneça nesse desleixo com algo essencial para a vida, respiração, umidade do clima, entre outros.', 'Sendo assim, a fim de que alcancemos desenvolvimento sustentável na prática,', 'convém ao governo, investir e implementar fiscalizações nas áreas da floresta amazônica, com profissionais do meio ambiente, de modo que orientem as pessoas as', 'quais administram o local sobre a importância de conservá-la, como também a pena que receberá de multa, caso ultrapassem os limites permitidos de queimação e', 'desmatamento. Desse modo, certamente teremos diminuição de tal problemática', 'no Brasil.']",120,120,80,120,120,560
85,A base de um governo é seu povo,"['Dentre as três formas de governar um país: (monarquia, parlamentarismo e presidencialismo),nosso país optou por esse ,visando maior participação da população nas decisões políticas,entretanto,não é isso que realmente vemos e vivemos.', 'A voz de destaque é a do presidente da república,com o maior poder de persuasão do cenário político,seguido pelo Congresso Nacional e seus deputados federais,que em suas campanhas  prometem estarem atuando em favor do povo e de seusenteresses ; (.) desde que a constituição de 88 foi promulgada,tecnicamente o povo agiria na política de forma explícita,todavia,não há abertura política para o enganjamento da população.', 'Nas brexas da Constituição deveria haver uma cláusula que colocasse o povo em lugar de destaque,dando a esses o direito de decidir de forma direta n os assuntos do governo,desde que, fossem representados por pessoas capazes de mostrar que entendem de política e de administração pública e que esses representantes fossem escolhidos pela massa popular.', 'No contexto democrático, o governo deve centralizar suas decisões sob  a aprovação do povo,tendo em vista que, esses têm o poder do voto e consequentemente são os que decidem o futuro da nação, devem  de fato, decidirem pelo que melhor convir, visando sempre que essas decisões não agridam os direitos dos cidadãos.', 'A forma de resolver o impasse é permitir o acesso da nação às decisões que (a) envolvem diretamente  a cada um deles ,buscando a unidade e a melhoria do Estado como um todo e diminuindo a rixa entre partidos políticos e movimentos sociais,buscando a igualdade entre o povo.']",120,160,160,160,200,800
93,Re-conhecer a importância,"['Na canção ""Reconhecimento"", de Isadora Canto, a gestação e o cuidado da mãe com o filho é cantado de modo a sensibilizar com a chegada de um novo ser. No entanto, essa realidade não é comum a todas as experiências com o parto, na medida em que são frequentes os casos de violência obstétrica. Dessa maneira, surge a necessidade da humanizar toda a gravidez da mulher, para evitar problemas inerentes à conduta médica nos casos. Por isso, torna-se fundamental analisar qual contexto macrossocial contribui para essa mudança de pensamento e qual o desafio para implementar a humanização como uma política pública.', 'Em primeira análise, cabe destacar a importância dos movimentos feministas no combate à violência obstétrica. Conforme a filósofa Simone de Bevouir, no livro ""O Segundo Sexo"", a construção da feminilidade na sociedade capitalista e patriarcal é atravessada por opressão e inferioridade. Embora escrito no final da década de 40, até hoje as formulações da escritora continuam repercutindo, uma vez que promove a emancipação das mulheres e a busca por direitos legítimos. Assim, diversas mulheres passaram a reivindicar a necessidade de gestacionar sem que haja invasões desnecessárias ao seu corpo, tal como defende o projeto de lei 878, de 2019, que tramita na Câmara dos Deputados. Esse exemplo demonstra a necessidade de institucionalizar o cuidado às mulheres gestantes como um direito legal.', 'Em contrapartida, ainda é necessário quebrar a barreira da comunicação para que a proposta de humanização adentre nas discussões entre gestantes e equipe de saúde. Nessa perspectiva, torna-se imprescindível popularizar o debate em torno do parto humanizado e autonomia da mulher, o que ainda é visto com receio e desconhecimento. Segundo a teoria da Comunicação Não-Violenta, proposta pelo psicólogo Marshall Rosenberg, a forma de se comunicar com o próximo pode promover mudanças nos problemas enfrentados ou agravá-los. Dessarte, é fundamental que os profissionais envolvidos sejam empáticos, acolham as necessidade das mulheres grávidas e informem sobre todos os procedimentos envolvidos. Por meio disso, o perspectiva da humanização será difundida, adentrando na discussão política com maior notoriedade.', 'Diante do exposto, fica explícito que a humanização no parto vem sendo uma demanda social recorrente, ao passo que carece de popularização por parte da equipe de saúde. Portanto, cabe ao Ministério da Saúde , através de políticas públicas do SUS - Serviço Único de Saúde -, implementar o cuidado e humanização como prerrogativa obrigatória de todos os atendimentos obstétricos , com a finalidade de preparar os profissionais de saúde para se relacionar com as pacientes e suas família, o que poderá resultar em democratização do debate e redução das violências comumente relatadas . Assim, a música supracitada será uma inspiração a outras mulheres.']",160,160,160,200,160,840
87,A Cultura da Erotização Infantil,"['A cultura da erotização infantil é um problema que está cada vez mais presente na sociedade, via momentos não são percebidos pelos adultos, como cenas sensuais de novelas, séries ou filmes, letras de músicas que depreciam e vulgarizam o ato sexual ou algum gênero específico, principalmente o feminino, que estimulam comportamentos e pensamentos impróprios para crianças. São situações que merecem a devida atenção dos pais ou responsáveis para que sejam evitados transtornos futuros para si mesmos e para a prole.', 'Séries, filmes e novelas são produtos de entretenimento consumidos por todas as idades e perfis. Essas produções têm classificações etárias, que nem sempre são respeitadas, por conta principalmente da negligência familiar. Nesse cenário, as crianças têm acesso amplo a conteúdos com forte apelo erótico, que de alguma maneira os inspiram a reproduzirem certos comportamentos que não condizem com a idade que possuem, sendo manifestado na vestimenta ou na forma de falar, por exemplo. A família deve monitorar o que os filhos assistem para evitar que esse tipo de situação ocorra em suas casas, prevenindo danos para o desenvolvimento físico e mental da criança.', 'Letras musicais são outra maneira de fomentar a cultura da erotização infantil, em que muitas delas depreciam e vulgarizam o sexo e um gênero, sobretudo feminino, utilizado palavras de baixo calão em alguns casos. São composições que podem introjetar na mentalidade das crianças comportamentos de cunho machista e misógino que hipersexualizam o corpo humano, principalmente de mulheres, que podem prejudicar na forma com que elas, na fase adulta, se relacionarão com o sexo oposto. Novamente, é preciso que os pais monitorem as músicas escutadas pelos seus filhos e dialoguem com eles, de forma a desconstruir qualquer pensamento negativo oriundo de tais composições musicais.', 'Um caminho que pode ser adotado na luta contra a cultura da erotização infantil pelo governo são campanhas publicitárias voltadas para as famílias das crianças que conscientizem elas da importância do monitoramento do conteúdo consumido por seus filhos, de forma que estimulem esses familiares a serem mais atuantes na vida das crianças, evitando que esse processo continue a estimular a adoção inconsciente de comportamentos inapropriados para determinadas faixas etárias.', 'A cultura da erotização infantil é um problema recorrente na sociedade atual, sendo fomentadas através de alguns momentos que passam despercebidos dos adultos, como cenas sensuais de novelas, séries ou filmes, letras de músicas que depreciam e vulgarizam o ato sexual ou algum gênero específico, principalmente o feminino. É um problema que tem solução, basta o governo auxiliar os pais a tomarem consciência da importância deles na vida dos seus filhos.']",160,160,120,120,120,680
95,Marco temporal e a discriminação contra os indígenas,"['O marco temporal é uma tese que determina uma terra indígena, somente, se eles estivessem no território dia 5 de Outubro de 1988, quando foi promulgada a constituição brasileira. De modo que, na defesa desse sistema ruralistas argumentam que os indígenas poderiam reivindicar qualquer terra brasileira se não haver demarcação. Entretanto, a tese não oferece apenas benefícios, por isso é lícito destacar como principal causa do problema; omo o marco temporal ajuda a fortalecer o preconceito contra os índios e o apagamento territorial desses povos. Com isso, convém analisarmos as consequências desses fatos.', 'Em primeiro plano, cabe destacar que o marco temporal é uma forma de preconceito contra os indígenas e é fator determinante para a persistência do apagamento territorial e cultural desses povos no Brasil. Acrescente que, de acordo com,  Chirly Pankará, militante do movimento indígena""Quando sou discriminada, eu não sei se é porque estou lutando por território ou pelo direito e educação e saúde dos povos indígenas. Eu não consigo nem identificar"". Dessa forma, é licito na citação que a luta por território dos indígenas é uma das causas da discriminação e por isso o marco temporal piora essa situação. Enfim, é inaceitável essa tese no Brasil.', 'Em segundo plano, é importante destacar que no artigo 231 da constituição brasileira está escrito: ""são reconhecidos aos índios sua organização social, costumes, línguas, crenças e tradições e os direitos originários sobre as terras que tradicionalmente ocupam, competindo a união de demarcá-las, proteger e fazer respeitar todos os seus bens"". Ademais, é explícito na citação que não existe nenhuma referência ao marco temporal, sendo assim, não é cabível que essa tese seja aceita em pleno século 21.', 'Portanto, algo precisa ser feito com urgência para erradicar essa tese. Logo, é necessário que o governo, por meio do poder legislativo, deve elaborar uma lei que defenda o direito ""originário da terra"" para os índios, como por exemplo, a lei funcionária para proteger territórios indígenas de invasores. Nesse sentido, o intuito de tal ação é assegurar os direitos territoriais dos indígenas e evitar um apagamento histórico desse povo. Somente assim, esse problema será gradativamente erradicado.']",120,160,120,160,120,680
139,Daqui um  tempo,"['Novamente,         nos vemos          entretidos                pela ideia de fim do mundo. Presente em nossa história de maneira relevante, ela nos intriga e interfere em nossas vidas, mesmo que indiretamente.', 'Geralmente, o ""saber"" quando todos nós morreremos se faz importante         porque,         traz consigo a reflexão         de         efemeridade da vida,         de         como a         vivemos,          etc.                  Certamente a nossa necessidade de sentimentalizar tudo que vivemos desemboca em medo e dúvida;          é          minoria aqueles          que ao cogitar          [que, ao cogitarem]                sobre a         vida percebe         que de fato                 ela pode estar sob controle, ou não, simultaneamente.', 'Assim, cria-se um espaço no cenário social: mudanças comportamentais, manifestações diversas, em especial para aqueles que vivem em função         desta          previsão.', 'Torna-se claro, então, que o fim do mundo pode ser agora, daqui         um         mês, daqui         um         século, ou pode não ser,                 variando de acordo com seu paradigma.', 'Portanto,         esta         ideia nada mais é que a de certeza de fim temporal aleatório, que passa a ser pré-estabelecida e determiná-la faz com que todos enxerguem e reflitam sobre as incertezas que vagam entre nós, como quando morreremos, por exemplo, e que saná-las é sem dúvidas tarefa árdua.']",160,120,120,80,80,560
76,,"['Uma famosa frase do filosofo Karl Marx é “A história da humanidade é a história da luta…” e essa luta se dá ainda mais quando se trata de igualdade de gêneros, desde os primórdios  da sociedade a diferença entre homens e mulheres se fez nítida, hoje ainda estigmatizadas como sexo frágil e submetidas rotineiros atos machistas, milhares de mulheres ao redor do mundo são descriminadas. Lembrando que quando se trata de equidade de gênero, a população feminina não é a única afetada, a comunidade LGBTQ também sofre com esse mal. O que acaba por ser controverso, uma vez que a própria constituição está sendo infringida.', 'Primeiramente, é importante salientar que, historicamente, a mulher vem sendo subjugada , desde as primeiras civilizações o homem é posto como principal pilar não só da família, mas da sociedade como um todo. A própria religião, em seus principais livros, trata a mulher como inferior e submissa ao marido. Tais fatos históricos apenas refletem a situação do mundo atual, onde mulheres não só ocupam menos cargos no mercado de trabalho, como também recebem absurdamente menos, pelos mesmos serviços.', ""É de grande importância ressaltar também,  que há oposição para essa característica que é inerente à sociedade contemporânea. Há séculos mulheres vem lutando por igualdade, como o histórico exemplo das sufragistas, mulheres britânicas que lutaram por direitos políticos e sociais e inspiraram mulheres brasileiras a lutarem e conquistarem certos direitos. Nos dias atuais as campanhas são inúmeras, o manifesto mais recente se iniciou com atrizes estadunidenses, lutando pelo fim do assedio e diferença salarial em hollywood, o movimento intitulado “time's up” já tem adeptas em todo o mundo ."", 'Dessa forma, portanto, podemos ver que, apesar das conquistas, há muito que ser feito para que possamos ter uma sensação de igualdade e igualdade de fato. Para isso, cabe à mídia como formadora de opinião difundir movimentos igualitários em parcerias com s. Cabe também à escola junto com a família e sociedade, aplicar ensinamentos de respeito e combate ao sexismo desde a infância. Por fim, cabe ao Estado reforçar e aplicar os direitos políticos e civis a todos independente do gênero. Mostrando assim que a segurança, justiça e igualdade de minorias é um direito e não um privilégio.']",120,120,160,120,120,640
36,Entre a liberdade e a escravidão,"['Embora a escravidão tenha sido abolida em 1888, com a Lei Áurea, ainda hoje percebe-se a continuidade do trabalho escravo no Brasil. Tal persistência tem relação com a ineficiência das políticas públicas destinadas a combater os diversos tipos de escravidão no país. Sob essa perspectiva, nota-se que, para melhor coibir as práticas escravistas, o governo deve investigar as causas e consequências desse tipo de crime na sociedade brasileira.', 'A princípio, pode-se relacionar a continuidade do trabalho análogo à escravidão ao interesse capitalista das grandes empresas. Na prática, isso significa que, para tornar seus produtos mais competitivos no mercado, as indústrias diminuem seus preços. Dessa forma, para manter o lucro, as fábricas recorrem à mão de obra barata, instalando unidades de produção em locais onde usufruem de leis trabalhistas brandas, possibilitando, assim, a exploração do trabalhador.', 'Além disso, é importante notar que a pobreza e a baixa escolaridade contribuem para aumentar o número de escravos no Brasil. Nesse cenário, muitos trabalhadores, por serem empobrecidos demais ou dependentes de seus exploradores para sobreviverem, acabam não denunciando as condições insalubres a que estão submetidos. Prova disso, são os imigrantes haitianos que vêm para o país. Sem perspectivas trabalhistas , muitos desses cidadãos acabam sendo escravizados no Brasil.', 'Por tudo isso, é fundamental que o Estado adote medidas efetivas para diminuir os índices do trabalho escravo no Brasil. Para tanto, o governo deve não só intensificar as leis já existentes, punindo com rigor os criminosos, como também ampliar o sistema de educação para um maior número de jovens e adultos. Ademais, é importante que a mídia crie campanhas incentivando a população a denunciar os casos de trabalho escravo. Com isso, poderá ser formada uma sociedade mais justa e igualitária, respeitando os direitos humanos.']",160,120,160,160,120,720
63,Por debaixo da lama.,"['É irrefutável dizer o quão impactante foi o crime que ocorreu em Brumadinho, mobilizando e gerando comoção em âmbito internacional, aonde vimos total agonia daquelas famílias e a perda de uma área ambiental  na qual era o lar de vidas de animais, vegetações e era para os moradores o motivo de sua renda.', 'Esse desastre foi, até então, um dos maiores crimes ambientais já ocorridos no Brasil, ultrapassando o também rompimento da barragem de Mariana, ocorrido em 2015 com cerca de 19 mortes confirmadas. Brumadinho se vê em estado de alerta, pois como já citado, os moradores da pequena cidade viviam em torno daquela área, tirando o sustento de onde hoje está totalmente devastada e consumida pela lama tóxica . Assim, tirando qualquer oportunidade de sobrevivência para as pessoas e animais que não perderam suas vidas e terão que se reconstruir novamente.', 'Pesquisas apontam o quão grave esse crime é para o meio ambiente, decorrente da lama ter matado maior parte da vida vegetal. O ecossistema naquele lugar se tornou deficiente e inabitável, animais sobreviventes ou aves que estão em busca de alimento não tem como tirar proveito daquilo. Com isso, o ciclo natural é rompido, já que se tirar de algum lugar, se torna difícil depois complementar em outro. Fazendo a situação se tornar mais preocupante, e pedindo total atenção e alerta.', 'Casos como esse se tornarão algo normal se não tomarmos  uma providência o mais rápido possível, o rompimento de barragens nunca deviriamm acontecer e todas as medidas devem ser tomadas antes. A fiscalização feita por profissionais quantas vezes forem necessárias  é de extrema importância, revisando não só a estrutura mas também a localização. Junto, implantar leis mais rigorosas para crimes como esse, aonde vidas são perdidas, famílias destruidas e a nossa natureza é tratada com tanto desdém.']",120,160,120,160,120,680
22,A lei (não) é para todos,"['As formas de corrupção no mundo, seja na esfera social, política ou econômica adquiriram ao longo dos anos um caráter mais complexo e com elas as formas para se livrar da justiça. No Brasil, o uso do foro privilegiado foi deturpado e usado como forma de driblar a lei, além de ferir uma diretriz básica e fundamental da constituição do país.', 'O autor George Orwell escreve em A revolução do bichos “os animais são todos iguais, mas alguns são mais iguais que outros”. Nesse sentido a obra não fica muito distante da realidade brasileira, visto que uma das vantagens englobadas pelo foro é o não julgamento do indivíduo em primeira instância , ficando acima do direito comum a todos, e isso contraria a constituição de 1988 que garante isonomia para todos os cidadãos. Desse modo, fica evidente que a igualdade jurídica é mera ilusão.', 'Ademais, convém frisar que, mesmo sendo fundamental para o exercício de alguns cargos públicos o uso desse mecanismo como entrave ao sistema judiciário eleva o quadro de impunidade e contribui para a perpetuação de ações ilícitas. Comprova-se com um estudo da FGV, esse aponta que 68% dos casos de ações penais de quem tem foro privilegiado prescrevem ou caem para instâncias inferiores além de demorar anos para ser julgado . Dessa forma, pode-se inferir que diversos crimes ao longo dos anos não foram julgados devidamente resultados da lentidão de tal sistema o que contribui para fomentar a descrença do funcionamento do mesmo .', 'É necessário, portanto, que medidas sejam tomadas para atenuar a problemática. É imprescindível que o congresso junto ao senado restrinjam o uso do foro privilegiado em crimes cometido durante o exercício do mandato para assim evita o crescimento da impunidade e de ações corruptivas. É essencial, também, que o Ministério da Educação invista na melhoria da infraestrutura das escolas, para que os alunos tenham um ambiente salutar para estudar, e nos profissionais da educação, através de cursos de aperfeiçoamento, para que se tenha um ensino de qualidade, além disso deve ser ministrados por professores debates acerca do combate a corrupção, pois segundo o filósofo e matemático Pitágoras “eduquem as crianças e não será necessário castigar os homens”.']",160,160,160,160,80,720
102,Um fluido vital,"['Essa molécula tão importante          a vida  , vem         sendo                 deixada de lado                por uma parcela da sociedade.                 Na Antiguidade                , muito antes de Sócrates, Tales de Mileto acreditava que tudo era formado de         água, e         conhecia sua importância.                 Essa substância imprescindível          a          vida                está se tornando escassa em um país com tantos recursos hídricos.', 'Certas regiões do Brasil, por serem áreas muito secas, enfrentam a falta de água                 desde quando ninguém se importava. Como escrevera em seu famoso livro,          O Sertão          , Euclides da Cunha afirmava                ""O sertanejo, é antes de tudo, um forte"".                 Quando o sertão enfrentava a seca          sozinho          a importância pela falta hídrica era apenas sertaneja.                Com isso,                 continuavam                utilizando a água de maneira inadequada,                 esbanjando um recurso tão rico                .', 'Nessa perspectiva, a falta da água em novas regiões acordou a sociedade que enfim percebeu que o problema é         grave, e         de todos. Um país como o Brasil, com dois ricos aquíferos, o Guarani e o         Álter         do Chão, com inúmeros rios e com a                 energia hidrelétrica                , entrar em uma crise hídrica é um paradoxo e tanto.         Concomitantemente         a sociedade joga a culpa no governo e         mantem         a postura de poluir e desperdiçar a água. Indústrias,         carros, lixos         poluem o meio ambiente         e         sobretudo, a água.', 'Dentro de novas          necessidades         o governo deve começar novos investimentos visando                recuperar os rios         poluídos         as         aguas         das hidrelétricas e         uma maior exploração nos         aquíferos. A sociedade precisa se conscientizar, mas                 a falta de água é muito pouca para o ser humano que o homem se faz.                Em conclusão, é imprescindível que a população comece                 a temer e a aproveitar a água da melhor forma possível                , talvez um aumento no valor da água mostre a população o quanto a água não pode ser desperdiçada, absolutamente só         aprenderam         tocando “no bolso”.']",120,120,120,120,120,600
86,06 - FBS,"['Funcionando conforma a primeira Lei de Newton, a Lei da Inércia, a qual afirma que un corpo tende a permanecer em seu movimento até que uma força suficiente atue sobre ele mudando-o seu percurso. No entanto, os impactos do uso das redes sociais na saúde mental é algo evidentemente alto no Brasil, a combinação de fatores como a ansiedade e a depressão, acabam por favorecerem esse percurso.', 'Primeiramente, é fulcral analisar os impactos do uso das redes sociais na saúde mental na sociedade brasileira são enormes podendo desencadear, principalmente, a ansiedade que, por sua vez, está relacionada ao sentimento de sempre estar conectado atualizado sobre a vida de amigos e seguidores. De acordo com uma a pesquisa realizada pelo Instituto Nacional de Psiquiatria do Desenvolvimento para Crianças e Adolescentes apontou que das pessoas entre 6 e 16 anos, 7% apresentavam transtornos mentais de ansiedade.', 'Ademais, é imperativo ressaltar depressão como promotor do problema. Segundo o Pensador Thomas Hobbes o estado é responsável por garantir o bem-estar da população, entretanto, isso não ocorre no Brasil. Devido à falta de atuação das autoridades governamentais de saúde, a depressão se torna uma consequência do impacto do uso das redes sociais na saúde mental. Logo, a depressão, considerada ""mal do século XXI"" pela Organização Mundial da Saúde, atinge 10% da população mundial e esse índice tende a aumentar a cada ano.', 'Assim,é preciso defender portanto que alguns impactos sociais constituem desafios a superar. Dessarte com intuito de militar os impactos do uso das redes sociais na saúde mental, necessita-se, urgentemente, que o Tribunal de Contas da União direcione capital que, por intermédio do Ministério da Saúde será revertida na criação de projetos sociais de atendimento psicológico, através de profissionais e estudantes de psicologia e psiquiatria de forma ajuda a população menos favorecida. Desse modo, atenuar-se-à, em médio e longo prazo  o embate nocivo dos impactos do uso das redes sociais na saúde mental, e a coletividade alcançará um Brasil melhor.']",160,160,160,200,160,840
83,,"['É inquestionável que, na atualidade, a atuação dos brasileiros na área esportiva, são de baixos índices, pelos brasileiros, tornando-se um problema. Isso deve ser enfrentado, uma vez que, os esportes são maneiras de educar e reeducar a sociedade.                                                   Nesse sentido, o aspecto histórico-cultural, faz-se relevante, segundo a história, a segunda guerra mundial, causou muitos prejuízos as  cidades, tornando-as, totalmente destruídas por esse conflito, (.) entretanto, a Grécia, visualizou o transtorno em sua pátria e deu estrutura aos jogos olímpicos, com o objetivo de obter paz, respeito, solidariedade e bons princípios entre os homens. Nações, compreenderam o fenômeno do esporte e o organizaram em seus países.   Em consequência disso, vê-se, a todo instante, os atletas sendo reconhecidos pelo seu trabalho, e combatendo para se obter um mundo melhor, seguindo o que Mário Sérgio Cortella disse: \'\' É necessário cuidar da ética, para não anestesiarmos a nossa consciência e começarmos a achar que tudo é normal"", porém, há paises não desenvolvidos, e não tem rercursos de preparar um evento como esse e são vítimas de preconceito, intolerância e do etnocentrismo, sendo preciso ampliar essas diferenças.                                                  Diante dos argumentos supracitados, é dever do estado, estimular essas habilidades com valores morais, por meio das escolas, capacitando os professores de ensino fundamental e médio, a fim de formar esportistas educados. Some-se a isso, oportunidades para engressarem nessa profissão, com projetos que busquem por esses indivíduos, no intuito de expandir jogadores, excelentes e brasileiros no esporte.']",0,0,0,0,0,0
23,"Ouro preto , 01/04/2017","['De E. C.', 'Para,  Senador C. D.', 'Ouro preto , 01/04/2017', 'Direito a informação.', 'A PROPOSTA DA EMENDA', 'Altera a Lei de Biossegurança para liberar os produtores de alimentos de informar ao consumidor sobre a presença de componentes transgênicos quando esta se der em porcentagem inferior a 1% da composição total do produto alimentício.', '', 'A proposta em questão, golpeia a código do consumidor que “A “informação adequada e clara sobre os diferentes produtos e serviços, com especificação correta de quantidade, características, composição, qualidade, tributos incidentes e preço, bem como sobre os riscos que apresentem”.', 'Atualmente, a população está cuidando melhor da saúde, investindo na qualidade de vida, sobretudo verificando a origem do alimento, se as empresas cumprem as leis trabalhistas.', 'Não é simplesmente “matar a fome”, é ter conhecimento sobre o alimento, O cidadão tem o direito de saber o que está comendo; Informação sobre característica do produto, e quais riscos inerentes sobre o alimento consumido. É de suma importância para a tomada de decisão da compra.', 'Enfim, a proposta é incabível, uma vez que lesa o consumidor no conhecimento e no poder da decisão de compra.']",120,120,120,120,120,600
133,Benefícios individuais estragam uma nação,"['O conceito Estado só começou a ser empregado no Renascimento e na Idade Moderna. Hoje, é difícil imaginar um país sem Estado, sem comando político e sem líderes superiores dirigindo as questões que interessam a população em geral.', 'Todavia, o Estado deve ter um papel específico na sociedade. Deve zelar pelos direitos e bem estar do cidadão em toda e qualquer hipótese. Manter a ordem é o papel mais sublime direcionado ao Estado                 e dificilmente acatado pelo mesmo                .', 'O Estado é formado por milhões de         encarregados         públicos e                 ali corre muito dinheiro                . É                 inevitável imaginar que não haja                nenhum tipo de corrupção.                 O que era pra ser valorizado, no caso a vida dos cidadãos, acaba em detrimento sendo valorizado a vida individual dos funcionários do Estado, formando uma elite rica e uma nação miserável.', 'Logo, para um país ser consideravelmente         estabilizado         e seus cidadãos satisfeitos, o Estado deve manter seu papel estrito de assegurar a ordem comum.                 Sem benefícios individuais.                Só assim a nação pode se desenvolver gradualmente.']",120,120,80,120,80,520
68,NOSSAS HÍSTORIAS,"['Uma nação não é feita apenas de pessoas. Mas é feita de histórias, memórias,  que, com o passar do tempo  enriquece a cultura de um povo tão privilegiado.', 'Preservar o que os antepassados nos deixou é mais que responsabilidade social, é uma forma de agradecer pela nossa  historia, pelo incio dela. Entender e compreender de onde viemos , quem veio antes de nós  é uma graça incalculável. Só o fato de termos um vasto patrimônio histórico-cultural podemos  nos considerar hiper-privilegiados . Porém, nem tudo são rosas , infelizmente a gestão pública não se d conta da riqueza desses bens, e com isso, el fica a mercê de maus cuidados, vulnerável a incêndios, furtos e entre outros fatores. Exemplo desse desse descuido com a nossa  bagagem foi o incêndio com o Museu Nacional,no Rio de Janeiro, na Quinta da Boa Vista, que deixou toda uma historia em cinzas.', 'Com tudo, criar leis de preservação desses locais antigos, em que haja uma vistoria minuciosa de pelo menos 6 em 6 meses, para que os riscos de desabamentos e incêndios sejam reduzidos e uma reforma seja feita nas estruturas dos museus . Assim, não perderemos  mais nossa herança.']",120,80,80,80,80,440
49,O papel dos influenciadores digitais,"['O termo influenciador digital está associado a uma pessoa que expressa sua opinião através das redes e mídias sóciais, com o propósito de influenciar outras pessoas acerca do seu conteúdo exposto. Geralmente estes conteúdos se encontram em formas de postagens de texto ou em gravações on-line para um público alvo.', 'Com relação ao conteúdo proposto, eles se diversificam em gêneros como: jogos, música, esportes, saúde dentre outros. Determinados influenciadores preferem divulgar conteúdos que outros já fazem , mas só mudando a maneira de propagar. Vale lembrar, que o influenciador digital ele visa não somente emitir sua influência através da opinião, ele influencia até mesmo atitudes e comportamentos de seus seguidores.', 'Podemos destacar também os impactos positivos e negativos que os influenciadores causam em seus seguidores por meio de suas atitudes e dois exemplos são: O jogador de futebol Neymar e a blogueira fitness Gabriela Pugliesi.', 'O jogador Neymar como um exemplo positivo de influência, ao assumir a identidade natural de seus cabelos, gerando  uma autoestima em crianças e jovens futebolistas que possuem o mesmo tipo de cabelo e são o seu público alvo após anos de aparições públicas com penteados variados. Já o lado negativo, fica por conta da blogueira Gabriela Pugliesi que recentemente publicou um video que gerou muita polêmica quando ela agradece ao Corona Virus por quebrar as barreiras da desigualdade social e por não cumprir com a quarentena para participar de uma festa , pois a mesma  foi uma das primeiras celebridades diagnosticada com Covid19.', 'Contudo  o papel do influenciador digital não deve somente se restringir a influenciar indivíduos através de opiniões, mas analisar com cautela a grande responsabilidade que tem . O influenciador digital precisa demonstrar na prática a opinião que ele divulga, e isso é possível através de bons exemplos que venham causar impactos benéficos em seus seguidores para que situações como de Gabriela Pugliesi que após a divulgação do vídeo  perdeu seguidores e contratos publicitários, não se repita, pois um influenciador que expõe seu conteúdo de forma negativa gera consequências que refletem não somente em seus seguidores, mas no próprio influenciador.']",120,160,120,120,120,640
146,O Racismo no Brasil,"['O racismo no          Brasil, tem          suas bases fundamentadas historicamente na sociedade.                A         priori         no período de colonização,         onde  a Igreja         considerava negros (escravos) como seres sem alma (portanto sub-raça).         A posteriori         teve suas características agravadas pela Lei Áurea cuja criação fora puramente para fins econômicos,                 onde                a partir da abolição da escravatura inseria o negro à sociedade, apenas com direito         a         liberdade (ou seja,         sem: trabalho         , saúde e educação).']",120,160,160,120,120,680
86,Prejuízos do uso das Redes Sociais,"['Como diz a frase de Albert Einstein ""Torna-se chocantemente óbvio que a nossa tecnologia excedeu a nossa humanidade"".Com essa frase podemos associar com os dias de hoje,com usuários navegando excessivamente nas redes sociais,tendo como consequência, fatores que prejudicam a saúde mental como a ansiedade e o distanciamento social.', 'A princípio,o fator que cresce a cada dia mais entre a população é a ansiedade,de acordo com a Organização Mundial da Saúde (OMS),cerca de 9,3% das pessoas sofrem de ansiedade,e um dos fatores dessa estatística é o uso das redes sociais,acreditando que a vida de todos nas redes sociais é perfeita e a sua não,isso de leva a pensar que você não é capaz de ter a vida dos sonhos,fazendo com que se questione sobre o estado do mundo e da sociedade,isso irá induzir a ansiedade em você sobre o futuro.', 'Outrossim,é o distanciamento social,muitas pessoas deixam de viver o mundo real para viver o mundo virtual,passando horas nas redes sociais,interessados em ver o que o outro está fazendo no mundo virtual,como diz na frase de Carlos Heitor Cony  ""A internet é poluidora,não no sentido ecológico,mas sim espiritual"", esse uso excessivo pode abalar as relações com as pessoas do mundo real,pois deixa de viver experiências da realidade,para ficar horas navegando na internet,deixam de viver sua vida,para ver o que está acontecendo na vida do outro através da mídias.', 'Torna-se,evidente,portanto,para que a problemática da ansiedade acabe,o Ministério da Saúde,junto com o Instagram e Twitter, deve  por meio de reuniões e debates, criar centros de apoio a pessoas com ansiedade relacionada ao uso das redes sociais,conscientizando-as,a fim de que o uso excessivo causa danos a saúde mental. Como também, para acabar com a outra problemática,a sociedade deve por meio de reuniões e campanhas,criar atividades para o lazer, para que possa envolver todos a fim de diminuir o uso das redes sociais.']",160,160,120,200,160,800
91,Catarina Reis - Os efeitos do negacionismo científico na sociedade,"['Em 2016, o estado brasileiro chegou a receber o certificado da Organização Panamericana de Saúde de país livre de sarampo. Porém, com o surto atual dele, pressupõe-se que, nos últimos anos, a relevância científica vem perdendo espaço para o negacionismo dela na sociedade. Nesse sentido, cabe propor um debate referente aos efeitos negativos do cenário em questão, como a volta de doenças já erradicadas e a invalidação da ciência, a fim de superá-los por meio de intervenção estatal.', 'A priori, pode-se afirmar que,  o retorno de doenças já erradicadas é um dos graves impactos do negacionismo. Isso porque, muitas vezes, a população desacredita das medidas preventivas a saúde, como a importância da vacina, contribuindo para que determinados parasitas humanos se manifestem novamente. De modo contrário a esse panorama, no início do século XX, no Brasil, o desaparecimento da varíola se deu através da busca da vacina pelos indivíduos, o que levou, anos depois, a 100% da cobertura vacinal além da superação da taxa de natalidade sobre a taxa de mortandade da época. Logo, tal comportamento social prejudica, comprovadamente, a própria qualidade de vida do sujeito somado ao desenvolvimento da nação.', 'Outrossim, a anulação da ciência configura a problemátima do tema em pauta. De forma lamentável, a grande circulação de informações sem fundamentos fomenta ideias antagônicas ao embasamento científico. Gera-se, em consequência, um movimento sociocultural marcada pela anticiência. De maneira análoga, segundo o ministro da propaganda nazista, Joseph Goebbels, uma mentira repetida mil vezes torna-se verdade. Assim, partindo da reflexão do autor, é preciso uma manutenção dos valores comportamentais da sociedade que valide o conhecimento empiríco, sob o risco de que a propagação de notícias inverídicas acerca da ciência vire uma máxima na sociedade.', ""Em suma, o negacionismo científico traz sérios efeitos no corpo cívico. Para mudar essa realidade, o governo federal, juntamente com o Ministério da Ciência e Tecnologia, deve criar o logotipo ''A Verdade testada'' destinado ao povo brasileiro. Esse algoritmo oficial estará atrelado nas plataformas digitais, obrigatoriamente, em cada publicação dos sites de notícias. Ademais, o seu intuito é separar as informações com embasamento científico daquelas que não vierem com o logotipo, possuindo também um link com os dados da pesquisa ao pressionar. Estimulará, portanto, as pessoas a lerem fontes confiáveis cada vez mais, diminuindo a disseminação das opniões alheias sobre a ciência. Feito isso, a invalidação científica será combatida, e o sarampo poderá ser erradicado no país futuramente.""]",160,160,160,160,160,800
51,A alfabetização e participação escolar,"['A alfabetização é um fator imprescindível na vida de um ser humano,ainda que está se reduzindo,os indíces de analfabetismo são preocupantes,principalmente quando se trata do analfabetismo funcional,fato que consequentemente ocorre com a falta da presença de crianças,adolescentes e jovens dentro da sala de aula.', 'Dados educacionais medidos pela Pesquisa Nacional por Amostra de Domicílios(PNAD)(IBGE/2008),revelam que o número de analfabetos entre 10 e 24 anos caiu 8% entre 2007 e 2008, já o atendimento escolar cresceu de forma significativa o que justifica a redução do analfabetismo.', 'Mesmo com esta redução, muitas crianças e jovens ainda se encontram longe das escolas,a desmotivação pode ser um dos agentes causadores desta catastrofe,a falta de inovação,acolhimento e incentivo transforma o prazer de aprender em inseguranças e medo.', 'Além disso a própia realidade desses alunos os impossibilitam, muitos jovens largam a escola para trabalhar e ajudar nas despesas da familia,também há aqueles que vivem nas zonas rurais,que constantemente pelas más condições das estradas e dos veículos que atuam no transporte escolar,  não conseguem ter acesso à instituição de ensino.', 'Cabe aos governos monitorar e estar atento  presença dos alunos,manter estradas em dia,transportes revisados periodicamente, e às escolas e famlias motivarem as crianças e jovens a buscar pelo conhecimento,impondo inovações e atividades diferenciadas. Lugar de crianças e jovens é dentro da escola,aprendendo,evoluindo e superendo suas barreiras.']",120,120,80,120,80,520
92,preconceito amarelo,"['Existem varios tipos de preconceito. Isso vem crescendo aceleradamente! Boa parte da sociedade procuram motivos para ser preconceituosos, e se legitimarem por trás de alguma situação.', ""Com o decorrer do tempo isso só veio aumentando, ainda mais nos dias atuais com a chegada do C-19. Os asiáticos sofrem muitos ''ataques'' verbais no mundo em ''geral''. Não só por esse motivo mas por vários outros."", 'Uma sociedade de julgamento, onde são divididos por cor e raça. No brasil moram descendentes e asiáticos, que relatam vivência no dia a dia o preconceito constantemente dentro de ônibus, metro e outros demais espaços.', 'Entretanto, no brasil foi criado um instituto sociocultural em parceria com a hina. O IBRACHINA para denúncias de discriminações por cor, raça e origem. São crimes que quem pratica tem que pagar e aprender com isso.']",160,120,80,120,0,480
24,Sem demanda não há oferta,"['Conflitos ocasionados pelo tráfico de drogas não são uma exclusividade desse período, um exemplo disso é a guerra do ópio, que aconteceu em meados do século XIX. Porém, na atual conjuntura, uma nova questão deve ser abordada: Será que o usuário é culpado pela violência causada pela venda de drogas?', 'De acordo com a lei da oferta e demanda redigida pelo economista Adam Smith, as drogas só são vendidas porque há quem compre. A violência advinda do consumo de drogas, não é diretamente ocasionada pelos usuários, porém, o dinheiro que os traficantes arrecadam com a venda, é utilizado financiar a compra de armas e instrumentos que viabilizam as brutalidades que o tráfico produz, sendo assim, mesmo que indiretamente, os compradores também têm sua parcela de culpa.', 'Apesar de, economicamente, ficar claro a culpabilidade do consumidor de drogas, as leis no Brasil os isentam da responsabilidade, pois um usuário que for pego consumindo será julgado por um tribunal especial e receberá como pena a realização de serviços sociais, enquanto que em países que seguem o contrário disso , como a Suécia, que de acordo com a revista época previu prisão para usuário e vendedor, o número de consumidores diminuiu consideravelmente, o que, como consequência, enfraquece o financiamento do tráfico.', 'Portanto, fica claro que para resolver a problemática da violência ocasionada pelo uso de droga no Brasil é necessária uma mudança nas leis, para que usuários possam ser punidos com mais severidade, além disso, deve ser considerada a legalização do uso das drogas, para que o tráfico perca o capital arrecadado com as vendas e fiquem sem meio de financiar suas brutalidades.']",160,120,120,120,80,600
78,"Reforma do Ensino Médio – Consertando a base, Corrigindo o erro","['As escolas da rede pública brasileiras  não atrativas e apresenta deficiências . O ensino engessado mostra-se pouco eficiente para o novo mundo dinâmico e tecnológico . Uma das maiores consequências disso é a evasão escolar, que se torna cada vez mais frequentes . Recentemente,  o Governo Federal lançou uma proposta de inovação do ensino médio, que propõe uma melhoria nesse âmbito. No entanto, os meios pelos quais a proposta tem sido direcionada mostram-se precipitado e simplista para surtir efeitos positivos de que realmente necessita.', 'A proposta da reforma propôs: o aumento da carga horária em sala de aula, unificação das disciplinas, sendo de escolha do aluno qual dessas áreas vai seguir, e o ensino técnico profissional. A primeira vista parece ser excelente a proposta, Porém  ao olharmos com uma visão mais aprofundada e critica  perceberemos que há contrapontos bastante significativos para torná-la eficiente .', 'A precarização do sistema educacional brasileiro é notória. Á  maioria das instituições não possuem estrutura adequada para possibilitar curso técnico. Além disso, os profissionais da área precisam estar capacitados para desempenhar a tarefa, como também necessitam de reconhecimento. Outro fator existente que está em pauta é o ensino unilateral, fragmentado. ou seja, viabilizar aos alunos escolherem apenas uma das áreas do conhecimento para estudar e não abordar as outras disciplinas. Sabe-se que cabe a escola a responsabilidade de forma  cidadãos conscientes do seu papel na sociedade, e não apenas preparar para mão de obra do mercado de trabalho. Então, é importante que o conhecimento seja amplo e multilateral para que o senso crítico seja fomentado.', 'Embora a proposta possua uma medida de inovação em uma área que é extremamente carente dessa atenção, ela também se mostra simplista e generalizada para uma rede que possui diversas deficiências básicas . Antes de tudo, é necessário que se faça uma inovação no perfil dos profissionais da educação , adaptação da estrutura escolar e uma abordagem melhor sobre a questão da unificação das disciplinas, sendo apresentada aos alunos um pouco de todas as áreas com os assuntos mais relevantes,  e  logo após, a escolha possa ser efetuada. Nesse sentido, consertando as brechas e reavaliando as medidas, a proposta quando implantada poderá contribuir muito para a sociedade como um todo.']",80,80,80,80,80,400
134,Ninguém pode calar a voz do povo,"['O         protesto expressa uma reação, solitária ou em grupo, contra ou a favor de determinado         evento         . Nesse contexto e conforme a         constituição         brasileira, a população tem o direito de se manifestar em relação à garantia dos direitos sociais, os quais englobam a         saúde, a         educação,         dentre         outros.                 Os protestos no Brasil não trazem                tantas mudanças quanto as desejadas. Para isso, deve-se protestar sempre, mesmo que objetivo principal ainda não tenha sido atingido.', 'No Brasil a educação está ficando cada vez mais esquecida. O poder político investe em coisas menos         importante         , como a         copa das confederações         , quando deveria investir em educação. Por mais que a população se manifeste,                 as autoridades fazem o mínimo possível para que os protestos acabem                e não para solucionar os verdadeiros problemas.         Os manifestos         devem continuar, mostrando assim que os brasileiros não desistem tão facilmente.', 'Os hospitais públicos do nosso país estão em situação alarmante.                 Os profissionais de saúde são desqualificados                , a fila de espera é enorme e não existem                 macas                suficientes para todos os pacientes. No entanto, os assentos do         maracanã         são os melhores e mais confortáveis e as autoridades policiais fazem a segurança com         mais         eficiência possível. Percebe-se aí o descaso do governo com a saúde pública.                 Manifestar-se contra essas atitudes indevidas e clamar por saúde são formas de pedir mudanças no país.', 'Por conseguinte, é fato que as manifestações populares não mudam muitas coisas no Brasil.                As autoridades não se importam com os reais objetivos dos protestos, elas querem acabar com a “bagunça” que eles proporcionam. Porém, a população não deve se calar, ela deve persistir nos objetivos das manifestações para que eles tragam benefícios ao povo brasileiro.']",120,120,80,80,80,480
107,Evoluímos ou involuímos?,"['É sabido que a criminalidade tornou-se algo presente em nossa sociedade,                 rompendo com todos os conceitos que se tem dela                . A presença da camada infantil no mundo delinquente está crescendo cada vez mais, acarretando problemas para toda a população.', 'A sociedade nada mais é do que um conjunto de indivíduos que possuem relações socioeconômicas e culturais. Ser                 social                é respeitar cada         individuo         de igual para igual, assim como as leis impostas a todos. Muitos não sabem ou não respeitam isso, levando         a  pratica          de atos demasiadamente reversíveis.                O que pasma é saber quem são os infratores: crianças e jovens.                 Literalmente infantis.', 'A criminalidade cresce em uma progressão assustadora e mais assustador ainda é saber que existe, dentro da ala criminosa, um         numero         considerável de                 menores infratores. A classe infantil é de causar repugnância quando diz respeito a ações praticadas por eles.                São                 acidentes                dos mais ínfimos até os fatais, assim levando problemas e constrangimentos a toda a população. Crianças e jovens                 sem educação que não têm respeito por nada.', 'Diante dos fatos mencionados é preciso que haja uma forte         politica         de educação para os menores infratores, amenizando, assim, a criminalidade,                 uma vez que essa não pode acabar definitivamente, sendo uma característica inerente ao homem.                Além disso, é importante que                 eles sintam-se amados por seus familiares; outro fator essencial é extinguir o abandono. Acabar com a impunidade é interessante. por em pratica essas diretrizes é fundamental para construir uma nova sociedade, que dentro dela não haja mais criminalidade.']",120,120,0,80,80,400
72,Combate as notícias falsas,"['Informações falsas na internet estão cada vez mais frequentes, muitas delas não causam nenhum problema grave, mas outras ocasionam problemas gigantescos, como nas épocas de eleição presidencial. Nesta época a maioria procura se informar em sites, televisão, rádio, entre muitos outros meios de comunicação.', 'Sendo que em algumas das fontes buscadas são falsas e acaba manipulando o leitor ou ouvinte, criando um grande problema, por conta de poder eleger uma pessoa leiga ou corrupta para nos governar.', 'Todos os eleitores precisam combater s chamados fake news, ou seja, notícias falsas, procurando sites ou tele jornais de veridicidade e de confiança, para que não se erre nas urnas e prejudique o país.', 'O combate ao fake news não é fácil, pois tem milhares de sites mal informados ou inverídicos, mas a população precisa parar de compartilhar e ouvir mentiras que vem de lugares que não nos mostra pesquisas e dados confiáveis, pois a verdade na eleição é o que vai fazer toda a população votar corretamente e levará a um bom presidente para o país.']",120,80,120,120,80,520
84,,"['Assaltos, assasinatos, sequestros. Eis o cenário no qual encontra-se inserida a soceidade brasileira quando (o) assunto em questao é o índice de violencia no país. Devido o Estado não conseguir coibir a violência. Está em trâmite um projeto de lei no Congresso Nacional na tentativa de anular o estatuto do desarmamento, provocando assim, discussões acerca do tema, tais como o possível armamento da população civil como forma de dimunir a frêquencia de episódios violentos.', 'É importante ressaltar que o estatuto do desarmamento põe em risco a vida de inocentes. A media que da a certeza ao ladrão (de) que na tentaivva de um assalto ao abordar algum cidadão esteja a frente de alguém desarmado, indefeso. Levando assim ao aumento dos índices de homicídios no Brasil, local onde o porte de armas é proibido .', 'Ao analisar os chefes de estado, estes por sua vez estão sempre como seguranças arrmados ao redor, tona-se irônico da parte deles invibilalizar a democratização do acesso  a armas, pela população. Se o problema reside em ter uma socieddae onde apenas a minoria tennha instrução de tiros, que se esse quadros se reverta e que assim como em paises como a Suiça, onde a cultura e mais armamentista, haja instrução de tiros, pois assim diminuem as taxas de acidentes por armas de fogo.', 'Fazem-se necessario portanto, medidas eficazes para que a violência contra inocentes não mais persita na socedade brasileira. Exemplo de medidas é a formação de uma cultura armamnetista no Brasil,onde as crianças possam ter instrução para evitar possíveis acidentes. a permissão do porte de armas é necessário pois é uma solução eficaz no combate e vitimização dos inocentes.']",80,160,120,160,160,680
86,Resultados positivos e benéficos,"['Motivação.Autoconfiança.Interação humana.Fortalecimento dos laços sociais. Tais situações pessoais e coletivas fazem parte da vida de todo homem,no entanto,há indivíduos que possuem certas dificuldades mentais de expressar essas características gerais. Assim sendo,as redes sociais têm contribuído no auxílio da saúde metal dos cidadãos,elevando a autoestima e a expansão da comunicação e do relacionamento pessoal.', 'Primeiramente, as redes sociais têm somado para o crescimento e a melhora da autoestima do indivíduo em razão do acesso aos grupos de apoio e ajuda de pessoas as quais sofrem com problemas mentais,como depressão e estresse. Os médicos da alegria são exemplos de grupos que prestam assistência,em hospitais e em asilos,aos idosos que apresentam baixa autoestima .Esse fato evidencia a participação humanitária dos canais coletivos na vida do homem contemporâneo. Diante disso,o resultado dessas redes têm sido benéfico para a recuperação da saúde mental da população.', 'Outro fator é a possibilidade de aumenta a comunicação e o relacionamento humano, visto que as redes sociais permitem este cenário do cidadão pode interagir com várias pessoas simultaneamente ,além de gerar uma sensação de segurança e privacidade,fato o qual ajuda os tímidos e aqueles que possuem dificuldades de lidar com público e multidões. Segundo a fala do pensador Paulo Freire,""Não há saber mais ou menos,há sabereis diferente."" Nesse contexto,os grupos coletivos tornam-se uma opção a mais e diferente do convencional para a recuperação mental do homem,além de obter certo sucesso e benefícios pontuais.', 'Percebe-se,portanto,que as redes sociais causam impactos positivos para a melhora da saúde psicológica do ser humano,seja por meio de ajuda coletiva,seja por meio das interações humanas. essa forma,os canais de comunicação tornam-se instrumentos necessários ao bem-estar da população,porém estudos e análises precisam ser feitos pelo Estado a fim de mensurar a influência das redes sociais na sociedade contemporânea.']",160,160,120,200,120,760
112,Maioridade penal no Brasil,"['A maioridade penal é um dos assuntos mais questionados atualmente. É crescente o número de crimes cometidos por indivíduos considerados                 pela justiça menores                . Mas será que                 punir                é a grande solução?', 'Atualmente, os jovens         tem         sido         o grande alvo da violência em nosso país,          cometidos pelos mesmos                .                 Em muitos casos, o menor é considerado o infrator responsável por crimes                , porém, devido         à justiça         brasileira,                 o tal                não pode ser preso.         Com tudo         , a idéia de reduzir a         menoridade         no país acaba não sendo                 plausível. Os fatos da mente dos jovens estarem em processo de transformação e aprendizagem, tornam influenciados nas decisões tomadas, no qual os levam ao crime e a sensação de impunidade por serem menores.                Se o estado criasse uma “clínica de reabilitação” na qual os menores que ali viveriam tivessem recursos como estudo, lazer, entre outros, talvez as coisas mudassem. É clara a necessidade de                 punição                , porém, não só em termos jurídicos, mas também, comunitários,                 éticos e morais                .', 'Por fim,                 a maioridade penal tem uma boa proposta                . Entretanto, a falta                investimentos sociais da parte do Estado acaba fazendo com que         a mesma         seja em vão.']",120,80,80,80,80,440
146,Somos todos iguais,"['Em pleno século XXI,                 grandes evoluções,                os seres humanos         vem         superando         seu         próprios limites em se tratando de tecnologias e em muitos outros setores. Embora         seres         tão         inteligêntes         , pararam no tempo quando o assunto é                 igualdade social                .', 'Mesmo          hoje          com várias mudanças, ainda existe o preconceito racial, no Brasil, país com diferentes etnias, tem mostrado que o preconceito existe, pessoas sendo agredidas moral e fisicamente por causa de sua cor, vivemos em um país onde a própria sociedade impõe um padrão de pessoas aceitáveis, sociedade essa que ainda          vivem          no tempo das ""cavernas""                .', 'Um dos grandes fatores para essa desigualdade e cultura do          país,  vamos         mudar essa tal cultura e para isso é necessário que os vários meios de         comunicações         , como um dos fatores que tem grande influência sobre grande parte da sociedade,         exponha         mais         sobre o         assunto                de forma a         conciêntizar         que vivemos em um mundo onde existe uma única raça, raça de seres humanos.']",80,120,80,80,80,440
56,,"['“O homem é fruto do meio em que vive”, afirmava o filósofo ilumininista Jean Jacques Rousseau. Os apenados brasileiros, que em sua maioria já não vinham de bons ambientes antes de sua reclusão, encontram na prisão uma precariedade extrema. A mentalidade de que criminosos são desumanos e “tem que sofrer” na cadeia ainda é muito difundida, o que colabora para que não sejam tomadas providências para reverter a situação.', 'Em um experimento realizado na universidade de Stanford pesquisadores simularam uma experiência de confinamento. Voluntários sem antecedentes criminais, após submetidos a tratamentos desumanos, apresentavam comportamento agressivo e desordenado. Os presídios brasileiros apresentam problemas de superlotação, falta de recursos, exposição a doenças, dentre outros. A reclusão, que além de penalizar devia colaborar com a ressocialização do apenado, acaba por deixá-lo em condições psicológicas piores das que ele tinha quando entrou. Não é toa que há um grande índice de reincidências.', 'Ademais, a mentalidade de que o criminoso “tem que sofrer” é muito difundida em nossa sociedade. Infelizmente é comum ouvirmos  expressões como “bandido bom é bandido morto”. Não comum entre os brasileiros a disposição para sondar o ambiente social que influenciou um condenado a cometer um crime. As estatísticas apontam: quanto maior o nível de competências como alfabetização, conhecimento, dentre outras qualidades que se podem ser desenvolvidas pela educação, menor a probabilidade do indivíduo praticar comportamento subversivo . Porém é mais comuns pessoas interessadas em combater a criminalidade aumentando a severidade das penas ao invés da melhora da educação.', 'Apenados também são seres humanos. Levando isso em conta, o governo deve usar a verba pública para garantir que os direitos humanos de presidiários sejam respeitados, e que o presídio tenha condições aceitáveis de saúde, higiene, privacidade e respeito. É urgente também que se invista mais recursos públicos na educação primária, pois a boa educação é fator de proteção contra atos criminosos. A questão sobre a falta de educação e pobreza serem fatores que influenciam indivíduos a cometer crimes tem que ser debatidos na mídia e nas escolas a fim de combater o atual estigma que existe contra criminosos.']",120,120,120,120,120,600
78,,"['Desde a pré-história a espécie humana vem absorvendo conhecimento e este evolui ao longo do tempo. O Brasil, no entanto  não está acompanhando este desenvolvimento na sua educação média como mostra o indice de desenvolvimento da educação básica (IDEB). Com isso o governo federal propôs uma reforma no ensino médio  que irá melhorar a qualidade do ensino . Alguns pontos desta proposta são: a flexibilização da grade curricular e a opção de realizar um curso técnico enquanto cursa o ensino médio.', 'Com a flexibilização o ensino ficará mais qualitativo, já que o estudante poderá se dedicar mais as disciplinas de seu maior interesse e isso pode ajudar a combater um grande problema a evasão escolar que ainda acomete milhões de jovens no brasil .', 'Outro ponto de extrema importância para alunos pobres ou que não pretendem prestar algum vestibular é o ensino técnico,apos a conclusão do curso o estudante está pronto para adentra o mercado de trabalho fazendo a taxa de desemprego ser reduzida gradativamente.', 'A reforma do ensino médio, portanto, é uma medida de aprimoramento da educação todavia ela precisa ser atrelada a investimentos em infraestrutura, capacitação de professores e o indispensável apoio familiar ao colégio om essas mudanças a educação terá uma progressiva melhora.']",80,80,80,80,80,400
32,Privilégio à informação,"['Sabe-se que o cidadão tem direito à privacidade, a ter sua intimidade preservada e àquele que ousar desrespeitá-la está sujeito à punição, e isso pode ser comprovado na Constituição, que diz o seguinte : ""São invioláveis a intimidade, a vida privada, a honra e a imagem das pessoas, assegurado o direito a indenização pelo dano material ou moral decorrente de sua violação"".', 'Porém, vale lembrar que certas pessoas estão sempre expostas a críticas, principalmente quando se trata da vida de uma pessoa pública, como por exemplo o presidente da República, e é imprescindível ressaltar que o cotidiano de alguém de tamanha importância, diz sim, respeito aos brasileiros, e neste caso,  a imprensa não deve se omitir de forma alguma a manter o povo bem informado, ainda mais se o assunto em questão também for público.', 'Sendo assim, pode-se perceber que certas entidades articulam-se de meios ""lícitos"" para dissimular e manipular o povo, de modo que, estes, só venham a ter conhecimento daquilo que lhes é conveniente.']",120,120,80,0,0,320
98,Fast-Food da morte,"['A obesidade é um dos grandes problemas de hoje em dia, e precisamos ficar conscientes dos males que ela nos traz.                 O governo deveria criar alguma lei para controlar as propagandas de Fast-Food?', 'O Ministério da Saúde promove campanhas para a sociedade                , com a finalidade de informar os altos índices de gorduras, açúcar, e sal.                 E com isso houve propostas de limitações de comerciais, com as informações dessas “bombas calóricas”.', 'A obesidade nos Estados Unidos tem um índice mais alto, por causa das redes de         Fast-Food localizada         nos centros das cidades,         e a vista          desses alimentos gordurosos chama a atenção da população para uma vida menos saudável, chegando a causar até o sedentarismo.', 'Sanduíches,         Batata Frita, Milk-Shake é um         dos grandes “amigos” das crianças,         mas         um grande malefício para o organismo, provocando a obesidade, diabete, alto teor de insulina, chegando a provocar a morte.                 E os pais vivem se preocupando com os filhos, e vejam como solução a proibição desses alimentos ou a regulação, e incrementar sucos, saladas e frutas no dia a dia delas, pois assim terão um organismo mais saudável.']",160,120,120,80,80,560
55,,"['Desde o Iluminismo, entende-se que uma sociedade só progride quando um se mobiliza com o problema do outro, No entanto, quando se observa a falta de importância de acompanhamento do governo com os povos indígenas, no Brasil, atualmente, verifica-se que esse ideal iluminista é constatado na teoria e não desejável na prática e a problemática persiste intrinsecamente ligada realidade do país, seja pela falta de responsabilidade de órgãos responsável de garantir os direitos desses povos, seja pela falta de políticas públicas.', 'É indubitável que a questão constitucional e a sua aplicação estejam entre as causa do problema. Segundo o filósofo grego Aristóteles , a política deve ser utilizada de modo que , por meio da justiça, o equilíbrio seja alcançado na sociedade . De maneira análoga , é possível perceber que, no Brasil, a falta de investimentos nos órgãos que tem como virtude proteger os direitos desses povos vem ocasionando impactos principalmente nas suas áreas territoriais e também nas estradas não pavimentadas dificultando cada vez mais o deslocamento desses povos.', 'Outrossim, destaca-se políticas públicas como, por exemplo transporte para facilitar o deslocamentos dessas tribos, como impulsionador do problema  . De acordo com Durkheim, o fato social é uma maneira coletiva de agir é de pensar, dotada de exterioridade, generalidade e coercitividade . Seguindo essa linha de pensamentos , observa-se que também é necessário também alimentos e ferramentas de estudos como, escolas para melhorar na educação desses povos', 'É evidente que, portanto, ainda há entraves para garantir a solidificação de políticas que visem à construção de um mundo melhor . Destarte, a Fundação Nacional do Índio (FUNAI) deve melhor na responsabilidade de segurança dos direitos desses povos, promovendo igualdade para todos. Como já dito o pedagogo Paulo Freire, a educação transforma as pessoas, essas mudam o mundo . Logo, o Ministério da Educação (MEC) deve instituir, nas escolas palestras ministradas por profissionais que discutam o sobre o mecanismo de direitos desses povos , a fim de que tecido social se desprenda de certos tabus para que viva a realidade das sombras, assim como na alegoria da caverna de Platão.']",120,80,80,120,80,480
127,Aprendendo a apreciar o idioma.,"['O português brasileiro é uma língua                com infinitas particularidades. Isso o torna complexo, mas também belo. Cabe a cada um de nós saber apreciar e usar essa beleza.', 'A escola tem papel fundamental na formação do aluno. E o uso correto do idioma é com certeza uma das matérias mais importantes a ser aprendida. É algo que estará presente na vida do estudante em todos os momentos.', 'Um país com tanta diversidade cultural, com tantas raças e formas de falar, é um país riquíssimo. E todos deveriam ter o direito de aproveitar e crescer com isso. Um vocabulário diferente em cada região, uma forma alternativa de se falar correspondente ao lugar ou situação. As informações, hoje mais do que nunca, estão em todas as partes. A escola deve introduzir as diferentes formas de linguagem desde o começo da vida escolar das crianças. Depois crescemos, surgem novos desafios. E então como impor uma língua estrangeira a quem não domina completamente nem mesmo a sua própria?', 'As escolas e a família devem ensinar. Ensinar o português culto, suas variantes e como se portar com cada pessoa e em cada momento. Mas a aprendizagem virá com a prática e apenas se o próprio indivíduo se dedicar. Há numerosas formas de se comunicar, há infinitas formas de aprender. A escola deve apresentar a literatura e a gramática ao aluno. Mas o prazer de                 compreendê-la                , de falar, de ler e ouvir, só depende de nós mesmos.']",200,80,80,80,0,440
43,Cultura do Cancelamento,"['A cultura do cancelamento nas redes sociais é uma prática muito comum, cujo principal significado é destituir a pessoa – ou empresa - de sua posição de influência por causa de suas atitudes questionáveis. Entretanto, essa cultura do cancelamento pode, às vezes, está ligado a um julgamento improdutivo e pautado em críticas desconstrutivas e xingamentos. Nessa perspectiva, convém avaliar os aspectos positivos e negativos da cultura do cancelamento, para assim inserir intervenções viáveis para essa problemática social.', 'Em primazia, vale ressaltar que o cancelamento de indivíduos que cometem atos prejudiciais é uma forma de redimi-los perante as suas atitudes errôneas e/ou nocivas. Dessa forma, o cancelamento priva os influenciadores digitais – em maioria – de cometerem atos que podem ser consideradas improdutivas para a sociedade. Consoante a isso, essas pessoas tendem a perderem monetização, contratos e, o mais importante, visibilidade. Logo, a cultura do cancelamento possui o seu caráter positivo quando ela está associada a inviabilizar os indivíduos – físicos ou jurídicos – que por ventura cometerem atos nocivos ou preconceituosos para a sociedade.', 'Outrossim, muitos casos de cancelamento podem estar atrelados a um julgamento improdutivo. Dessa maneira, muitos usuários de redes sociais tendem a possuir um caráter depreciativo mediante a algumas atitudes das pessoas. Ou seja, ao invés de a sociedade evoluir nos conceitos de diálogos e discussões civilizadas, observa-se que há uma espécie de repressão e polarização em virtude da cultura do cancelamento. Assim sendo, os indivíduos cancelados são vítimas de xingamentos e insultos gratuitos na esfera virtual sem, às vezes, terem a oportunidade de defesa. Por isso, esse comportamento origina, para Kant, no julgamento analítico, pois ele elucida apenas o que já se conhece do sujeito sem ter uma discussão mais ampla e diálogos mais bem estruturados. Por essa razão, é viável promover intervenções para esse problema social.', 'Verifica-se, portanto, que a cultura do cancelamento possui aspectos positivos e negativos para a sociedade e, por isso, precisa de intervenções para conter esses aspectos nocivos. Dessarte, as escolas, instituições responsáveis pelo ensino formal, devem promover um ensino digital para os seus discentes, com o intuito de promover uma educação digital mais crítica. Dessa forma, os alunos poderão melhor se relacionar com a cultura do cancelamento e, com isso, aprender a dialogar com as pessoas ao invés de somente promover um xingamento gratuito. Somando a isso, o governo federal, em parceria com as mídias digitais, como Facebook e Instagram, deve elaborar propagandas que visem melhor informação a respeito do cancelamento nas redes sociais; essas propagandas informaria a população sobre as consequências do mal uso das redes sociais e de como isso pode acarretar na cultura do cancelamento. Isso posto, diante dessas medidas, as consequências negativas da cultura do cancelamento seriam cerceadas no Brasil.']",160,200,160,200,200,920
89,Como promover a conscientização a população que mais se infecta pelo Covid-19 e pela desigualdade social,"['É indubitável que o isolamento social cria aspectos positivos no combate ao covid-19, no entanto a maior parte da população infectada são pessoas com dificuldades financeiras, moradoras de periferias e sem educação de qualidade , o que evidencia a desigualdade social. Para promover a conscientização do isolamento social de tais pessoas é necessário um auxílio financeiro contínuo, e em seguida argumentar (com campanhas) o risco que essa gente está se expondo ao ir trabalhar e enfrentar transportes públicos lotados.', 'Segundo a Secretaria de Saúde de São Paulo, é nas favelas onde ocorre o maior número de contágios e mortes pelo coronavírus. Os problemas nas comunidades periféricas são antigos, e é fato que o manejo incorreto de investimentos governamentais implica em: falta de compreensão do coletivo na atual situação, desigualdade social e descumprimento do distanciamento social. A desobediência das medidas de seguranças impostas pelo Ministério da saúde, muitas vezes são quebradas pela necessidade de trabalho e remuneração.', 'Para promoção do isolamento social a estes moradores de periferia na atual crise econômica é necessário um auxílio financeiro do governo ou cestas básicas de alimentação e produtos de limpeza, esta ajuda deve ser contínua enquanto perdurar a pandemia, desta maneira evita-se o contágio no ambiente de trabalho e em transportes públicos lotados. Logo após a sustentação das necessidades básicas pelo governo, torna-se possível o período de reclusão, e compreensão da atual situação.', 'Tal que para a disseminação e cumprimento das medidas de segurança em plena crise econômica, é necessário: além do benefício, múltiplas campanhas que compartilhem a verdade e a evolução da medicina no combate a pandemia, produzidas pelo Ministério da saúde e reproduzidas em redes sociais, telejornais e rádios; além de combater as diversas “facknews” que são criadas e compartilhadas diariamente.']",160,120,120,120,120,640
75,,"['Devido à violência e criminalidade características da realidade social brasileira, atualmente, o cidadão é obrigado a submeter a própria liberdade a padrões de conduta comuns a fim de preservar sua integridade física, psicológica e patrimonial, constantemente ameaçada pela ação criminosa. Contudo, naturalmente, tais imposições só alimentam frustração e indignação, a ponto de o porte de armas de fogo para autodefesa da cidadania, principal bandeira da famigerada Bancada da Bala, ganhar cada vez mais adeptos. Porém, derrubar o Estatuto do Desarmamento, que desde 2003 proíbe o porte por civis, é estender para o âmbito pessoal a mesma lógica beligerante das atuais políticas de segurança, que nas últimas décadas se mostraram ineficazes e letais.', 'Primeiramente, armas de fogo são vetores de violência e tê-las em maior circulação só aumentará o arsenal do crime. Caso alterações na lei permitam  livre comércio de revolveres, pistolas, munições e congêneres, os esquemas clandestinos, como os ligado ao narcotráfico, além do mercado negro de armas roubadas, contarão também com a via legal de acesso a tais artefatos. Com isso, estaria se dando instrumentos para o crime proteger sua territorialidade e expandir sua influnecia nos presídios e sobre a população jovem, negra e periférica. E, no contexto da política de confronto, implicaria o aumento do poder bélico dos criminosos nos conflitos diretos com as forças de segurança, perpetuando o ciclo vicioso de mortes de civis em fogo cruzado e de violação sistemática aos direitos humanos.', 'Contudo, talvez o fato mais relevante é que portar armas de fogo não assegura a legitima defesa. Ao sair armado, o dito cidadão de bem  tem maiores chances de morrer, já que a arma o encoraja a reagir à uma situação mais favorável ao bandido. Na constatação simples mas objetiva do sociólogo Júlio Jacobo, enquanto o sujeito comum anda distraído, com a arma no coldre, o criminoso a porta arma nas mãos, disposto a matar caso a vítima resista à imposição da sua vontade. E a maior vulnerabilidade do cidadão armado fica ainda mais evidente caso levada em consideração a hipótese de que, se o porte de armas de fogo estiver ao alcance de todos, o todos inclui tanto pessoas honestas quanto mal intencionadas.', 'Portanto, pelo que foi exposto, pode-se concluir que a defesa do porte de armas de fogo como forma de garantir a cidadania em meio à violenta e hostil realidade brasileira, é uma falácia;  fruto da ação cooptativa e enganadora daqueles que são, no Congresso Nacional, especialmente tutelados e financiado pela indústria armamentista, cujo único interesse é obter dividendos com a exploração econômica do medo e da insegurança dos brasileiros. Assim, a preservação do Estatuto do Desarmamento já é um meio, embora não único, de limitar o poder econômico, social e coercitivo da criminalidade, e, portanto, de restringir a mortalidade na esteira dos conflitos violentos nas cidades e no campo. É, sobretudo, uma forma de não lançar o cidadão brasileiro na linha de frente na guerra cotidiana contra o crime.']",160,160,160,160,160,800
84,Porte de amas,"['Atualmente, no Brasil, com o aumento da violência há uma proposta para diminuir a restrição ao porte de armas. Porém liberar armas para que os cidadãos possam se defender é perigoso e pode aumentar os casos de homicídio e acidentes domésticos.', 'Armas só deveriam ser legalizadas para pessoas que trabalham na defesa e que tenham as habilidades necessárias para utilizá-las, pois seria muita irresponsabilidade deixar qualquer pessoa ter uma arma em casa, porque sem treinamento e os devidos cuidados ela pode ser deixada ao alcance de crianças ou ser usada em brigas domésticas causando acidentes graves ou a morte.', 'E mesmo com a dificuldade policial em combater os criminosos, armar o cidadão, provavelmente, só aumentará a violência. Pois os brasileiros vão saber a hora de usar a arma? Nem todos saberão! Por isso pode ocorrer o crescimento dos tiroteios nas ruas, além de que muitos irão querer fazer justiça com as próprias mãos.', 'É essencial que o governo invista mais na defesa do país, pois armar a população não é uma solução. É necessário melhorar a estrutura física das delegacias e presídios e contratar mais policiais, além de pagar melhores salários, já que os soldados arriscam suas vidas para proteger os cidadãos. Também é indispensável a criação de leis mais severas para punir os criminosos bem como os policiais corruptos. E é dessa maneira (que) diminuiremos a violência no Brasil.']",160,160,120,160,200,800
48,PALOMA MARIA SANTOS,"['Criado em 17 de maio de 1998, o sus tem como objetivo oferecer serviços de qualidade para a população, como um sistema universal, vale refletir sobre os desafios enfrentado, ao longo da sua historia e sua importância.', 'Em primeira análise convém lembrar que ao longo dos anos deste a sua existência, o SUS foi deixado de lado , com baixos investimentos, uma vez que a constiuição de 1998 previa que a verba para o sistema seria de 30%, mas com o passar dos anos essa verba foi diminuído, e consequentemente gerou falta de recursos como a falta de profissionais, infraestrutura, e novas tecnologias o que gera desafios para aquele tem o sistema único de saúde como uma única forma de ter acesso a cuidados com sua saúde.', 'Além disso são 162 milhões de pessoas que dependem unicamente do SUS, por ser destinado principalmente a pessoas de baixa de renda, visto que tantas pessoas dependem desse sistema ,faz ser necessários e importante a manutenção diária para que a população realmente usufrua da qualidade que constituição prometer', 'Fica evidente que medidas deve ser tomada. Portanto o governo  deve ter como foco para maior investimentos público o SUS, contratado novos profissionais capacitados , tecnologia de ponta e em infraestrutura. Afinal  somente assim as dificuldades serão driblada , e um sistema de saúde de qualidade será oferecida.']",120,120,120,200,120,680
94,Investir na qualificação de professores para diminuir as dificuldades da inclusão de um autista,"['Define-se o Transtorno do espectro do autismo (TEA), como uma condição neurológica que afeta a interação social, comunicação e o comportamento da pessoa afetada. A partir disso, é evidente que ao tratar se da inclusão de autistas, há diversas dificuldades, tornando o processo muito mais complexo do que o simples acolhimento.', 'A princípio, é importante ressaltar o fato de que há vários subtipos do autismo, enquanto uns possuem como característica o déficit na interação social, outros afetam o comportamento como o interesse restrito e movimentos repetidos. Logo, nem todo autista demanda os mesmos cuidados, fator que dificulta ainda mais a inclusão.', 'Por certo, nesse processo a escola, como a instituição responsável pelo desenvolvimento intelectual e social de todas as crianças, possui um papel fundamental. Portanto, a inclusão de uma criança autista na escola, além de melhorar seu desenvolvimento, ensina seus colegas a conviver e não descriminar quem é diferente.', 'Dessa forma, a fim de enfrentar as dificuldades de inclusão de autistas, é necessário que os órgãos públicos invistam na qualificação dos professores, para que estes estejam aptos para trabalhar no processo de inclusão de uma forma que além de eficaz ao desenvolvimento da criança, transmita segurança, se, causar sentimento de ameaça e pressão.']",160,120,120,120,80,600
46,A necessidade da privatização do saneamento básico,"['Ao criar o conceito original de EPCOT (sigla em inglês para “Protótipo Experimental da Comunidade do Amanhã”), Walt Disney assertou que o maior desafio enfrentado pelas sociedades modernas é encontrar soluções aos problemas das cidades e, com a finalidade de realizar tal objetivo, deve-se começar atendendo às necessidades do público. Contrastante a isso, nota-se que o Estado brasileiro não compartilha desta mesma ideologia, visto a abundância de complicações urbanas no país, principalmente no que tange ao saneamento básico. O serviço vital a sobrevivência humana é feito desleixadamente, enquanto a população vê-se sem acesso à água salubre. Dado que o Governo não é capaz de exercer esta função, é imperativo que privatize-a.', 'A priori, o pensador britânico Thomas Hobbes afirmava que a natureza do homem é egoísta e, para funcionar em sociedade, é imprescindível que um governador reja sobre os mesmos. Nesta mesma lógica, é um axioma que, no modelo econômico capitalista, uma empresa é obrigada a seguir as normas impostas pela obtenção do capital se deseja persistir. Dessarte, no âmbito da concorrência no mercado, as companhias privadas apelam a preços baixos e maior cobertura de áreas, com o propósito de garantir seus consumidores em relação aos seus competidores, o que contribuirá para a expansão do acesso ao serviço oferecido, especialmente às camadas mais pobres e marginalizadas da sociedade.', 'Prosseguindo nas ideias de Hobbes, as corporações privadas sempre precisam satisfazer seu comprador, o que implica num excelentíssimo atendimento ao cliente. Este é o estopim essencial para os capitalistas aprimorarem suas firmas ao máximo, utilizando seus lucros em investimentos nas mesmas, a fim de agilizar e melhorar a maneira que fornecem o saneamento ao povo. As companhias teriam, neste contexto, superado o Estado no que se diz respeito a seguir os princípios do Humanismo — escola de pensamento da filosofia pertencente ao ramo da ética que defende o fato de todos terem o direito à dignidade humana; observado que apenas 17% da população tem acesso à água tratada atualmente, no momento em que este serviço depende do poder público, como relatado num levantamento feito pelo Sistema Nacional de Informações sobre Saneamento (SNIS).', 'Analisados todos os benefícios, é nítido que o saneamento básico tem de ser, pelo bem da nação, privatizado. O Governo Federal  deve implementar essa ação de modo integral no país e evitar quaisquer interferências na economia das organizações privadas que responsabilizar-se-ão pela limpeza de esgotos e purificação da água, permitindo-lhes crescer livremente e alcançar entre si o modelo de concorrência pura. Uma vez que este ato se concretizar, a qualidade do saneamento básico aumentará comunalmente.']",160,160,120,160,160,760
47,Defafios,"['Vivesiano no Brasil um do problema que é educação a cesó a ela com a andemia ficar ainda mais de difícil com o desafio de implanta educação a distância', 'Em primeiro análise distâncianto escola leva aula até casa do aluno pois não tem acesso internet e desigualdade entre escola pública e privada.', 'Em seguida análise os alunos de escolas básico são os mais afetadas segundo estudos festo pelo G1 (portal de notícias ) os afetados como a 48,5milhos é o número de cursam a educação básica no Brasil além disso algus alunos que frequenta escola a única refeições que tem são na escola.', 'E necessário portanto que medidas sejam tomadas para o acesso aula a distância  para isso da ministério da educação e governo trabalho junto para facilitar aula a distância como utilizado os aplicativos de educação fazer ele sem cobrança de internet e distribuição de sacolão todos família carentes por instituição que fazer distribuição igual.']",80,80,80,120,80,440
91,,"['Na Idade Média, Galileu Galilei, cientista italiano, foi perseguido pela Igreja Católica ao discordar das ideias que circulavam na época, propondo o Heliocentrismo. Segundo esse teoria, já iniciada por Copérnico, os astros giravam em torno do Sol, e não da Terra. Assim como o negacionismo científico na época trouxe atraso na humanidade, hoje ele faz o mesmo, dando ênfase a movimentos antivacina e à precariedade de investimentos na ciência.', 'Em primeiro plano, nota-se que essa aversão aos estudos científicos traz instabilidade a um processo essencial: a vacinação. Embora esse método tenha trazido a erradicação de muitas doenças , ainda há quem duvide de sua segurança, o que nada mais é do que um resultado da rápida circulação de notícias falsas. Em 1904, por exemplo, a chamada ´´Revolta da Vacina`` levou moradores do Rio de Janeiro, Brasil, a confrontar a vacinação obrigatória, baseados na ideia de que, caso tomassem o imunizante contra a varíola, seriam ´´transformados em vacas``. Desta forma, é crucial que se evite a difusão de notícias de caráter falso.', 'Por outro lado, vê-se a queda de recursos destinados às pesquisas científicas no Brasil como consequência disso. Por mais que o Art. 218 da Constituição federal de 1988 estabeleça esse tipo de investimento como algo prioritário, as verbas que auxiliam estudos científicos brasileiros vêm caindo. Segundo a Acadmia Brasileira de Ciências, o país reduziu em 8,3% os recursos científicos, ocasionando um atraso técnico na sociedade brasileira.', 'Nessa perspectiva, portanto, medidas que evitem movimentos contra a medicina e que deem mais assistência aos cientistas tornam-se necessárias. Para tanto, as mídias sociais podem  diminuir a disseminação de teorias falsas, por meio de filtros que mostrem quais delas possuem respaldo científico, a fim de que menos pessoas acreditem no inverídico. Por fim, esses fatos não ganharão notoriedade e, muito menos, ameaçarão o conhecimento verdadeiro.']",200,200,160,200,160,920
69,Alimentação toxica,"['É inegável que com a revolução verde e o desenvolvimento tecnológico, o agronegócio vem se expandindo de forma exorbitante no Brasil. Porém com esse crescimento, cresce também a quantidade de insumos e fertilizantes utilizados nas plantações. Desse modo, é visível que esses agrotóxicos vem prejudicando os solos brasileiros e a saúde de comunidades e trabalhadores.', 'É perceptível que os remédios  aplicados em plantações são prejudiciais para o próprio meio ambiente. Isto é, todo o remédio  utilizado em plantações é um grande poluente além de ser perigoso para a saúde humana . Ou seja, é retratado como um veneno tanto para plantas como para pessoas  como é retratado pela DC comics na história da personagem hera venenosa que ganha poderes após ser envenenada por remédios para plantas.', 'Além disso, é nítido que parte do PIB brasileiro se dá a essa prática, cerca de 30%. Porém, é evidenciado no documentário ,  veneno está na mesa, os riscos que os trabalhadores se submetem diariamente, com o contato direto com os produtos químicos colocados nas plantas, que sem o equipamento correto podem vir a levar uma pessoa a óbito . Em suma, o intuito dos patrões em arrecadar cada vez mais lucros, é decerto prejudicial para seus colaboradores.', 'Desse modo, o Congresso Nacional deve implantar uma lei trabalhista que designe aos patrões o pagamento de planos de saúdes de qualidade a seus funcionários, para que possam monitorar sua saúde e assim ter uma vida de qualidade. E,  o ministério da saúde deve fazer o monitoramento dos produtos utilizados nas plantações, com fiscais e funcionários qualificados, para que assim possa ser controlado o que é vendido no comércio e assim a população poderá contar com uma alimentação saudável e de qualidade.']",120,120,120,120,120,600
87,Desafios e novas perspectivas da cultura da sexualização de menores,"['Em ""Lollita"", Vladmir Nabokov denuncia a pedofilia através de uma trama que chocou público e crítica na época de sua publicação, em 1955. No entanto, inúmeras adaptações e tributos na cultura pop deram ao livro nova roupagem por meio de uma iconografia sensual que, sob muitos aspectos, deturpa a mensagem do original. Este é apenas um dos muitos exemplos da cultura da erotização infantil e seus efeitos insidiosos, que até hoje estão altamente presentes na sociedade contemporânea.', 'Analogamente, o filósofo Herbert Marcuse tinha receios, já no início do século XX, quanto à dependência da indústria cultural do erotismo exacerbado e comercializado do corpo jovem. Já nos primórdios da Sociologia, Émile Durkheim identificou a cultura como um dos principais instrumentos da construção identitária que se inicia na infância. A criança internaliza os valores da sociedade em que vive e busca se adequar a eles, o que muitas vezes acarreta sérios danos, tanto na psique quanto na auto-estima ainda em formação do menor.', 'Outro risco é a introdução prematura ao sexo, e as doenças que podem surgir como consequência. Em artigo divulgado pela revista ""Vida e Saúde\'\', o câncer de colo de útero, que chegará a mais de 49 mil casos até 2022, é apontado como mais comum em pessoas que tiveram atividade sexual precoce . Doenças Sexualmente Transmissíveis, como a AIDs, são especialmente perigosas para crianças e adolescentes, que em muitos casos ainda não possuem um sistema imunológico bem desenvolvido.', 'Assim, pode-se concluir que a cultura da erotização de menores de idade é altamente prejudicial, e deve ser corrigida. Cabe ao governo  regulamentar mais eficientemente a distribuição de conteúdo em canais e plataformas voltadas ao público infantil, bem como financiar campanhas de conscientização em escolas, cujo currículo academico deve ser formulado de maneira a dar mais atenção a estes problemas. Se combinadas com a educação de pais e responsáveis para tratar destes assuntos de maneira adequada no ambiente doméstico, bem como incentivos públicos e privados para que os veículos de mídia busquem uma abordagem mais sensível, estas ações trariam uma mudança neste cenário para melhor.']",160,160,120,200,160,800
90,O combate à transfobia,"['Segundo a Lei n° 7716/1989, no Brasil, a transfobia é classificada como crime de preconceito contra raça e cor. Todavia, denota-se o atraso do sistema legislativo com a segurança dos direitos dos transgêneros, visto que,  a lei somente foi promulgada no ano de 2019. Deste modo, torna-se perceptível a importância do encontro de métodos eficazes para combater esse crime que viola os Direitos Humanos e assombra a milhares de cidadãos brasileiros.', 'Visando a proteção das pessoas trans, a partir dos anos 2000 criou-se a Associação Nacional de Travestis e Transexuais, também chamada de ""Antra"". Essa organização procura estabelecer o engajamento da sociedade em direção às minorias, objetivando assim, a quebra do preconceito estrutural e a inclusão deles nos diversos setores sociais, como por exemplo, a política, o comércio, publicidade e marketing, cultura e esporte. Entretanto, confere-se hodiernamente a gradual diminuição da relevância da entidade, julgada pelas pessoas, pois ainda é desconhecida pela maior parcela da população, necessitando urgentemente, de maior auxílio da comunidade e do Estado.', 'Nesse viés, manifesta-se assim outro setor presente na luta contra a transfobia, as emissoras televisivas. Por meio de programas direcionados s minorias, destacando suas dificuldades e seus anseios pessoais, possui o intuito de conscientizar a igualdade de todos os indivíduos. Além disso, as novelas também expõem a dura realidade da transfobia no Brasil. Desse modo, esse meio de comunicação também é uma alternativa para o fim do óbice.', 'A partir dos argumentos supracitados, concluí-se que há a necessidade da valorização da classe transgênero no Brasil, pois são fundamentais na cidadania atual. Desta forma, o governo federal juntamente com a Secretaria de Direitos Humanos, devem auxiliar a Antra por meio de incentivos financeiros, propondo estabelecer projetos visando a disseminação dos direitos dos trans atuando rigorosamente contra o preconceito. Além disso, as principais emissoras televisuais devem atuar de maneira severa contra o preconceito, por meio de programas educacionais que objetivam a consciência da população. Somente assim o óbice será resolvido.']",160,160,160,200,160,840
83,,"['As Olimpíadas e as Paralimpíadas Rio 2016 deixou legados como infraestrutura,mobilidade urbana  e estímulo a prática esportiva, principalmente entre os jovens. O esporte  é uma ferramenta de inclusão social e de formação de valores indispensáveis  para a socialização,além de proporcionar melhor qualidade de vida.', 'A prática do esporte pode transformar a vida de jovens e adultos ,estimulando a superação de barreiras e limitações. Além disso,ele atua como fator de inclusão e de construção de valores fundamentais como autoestima e coletividade, principalmente  entre os portadores de deficiência, que na maioria das vezes se sentem excluídos socialmente,quebrando, assim,o censo comum de atletas idealizados.', 'Destaca-se ainda a importância do esporte na prevenção de doenças como a obesidade, que afeta 51% da população brasileira,segundo levantamento do Ministério da Saúde. A prática de exercícios  físicos auxilia no combate ao stress,ansiedade e de doenças crônicas. O sedentarismo é um dos  principais vetores desses distúrbios.', 'Levando em consideração esses aspectos,é imprescindível  que o Governo, em parceria com as escolas estimulem a prática desportiva,promovendo a inclusão social dos estudantes,juntamente com Instituições que apoiem e invistam  em projetos socioeducacionais através do esporte. A mídia também deve contribuir enfatizando campanhas que  incentivem atividades físicas. Assim ,o esporte, aliado a educação,pode ser um caminho de transformação da sociedade.']",160,200,160,160,200,880
105,A importância de biografias autorizadas,"[""Reivindicando privacidade, artistas                 encontram-se presentes                em debates no Supremo Tribunal Federal, retratando sua insatisfação perante a publicação de biografias não autorizadas. O controle de exposição de informações, de acordo com os                 ''personagens''                , é                 um dos fatores que merecem destaque                ."", 'As biografias que hoje circulam no mercado podem ser         reconhecidas         por alguns artistas como indiscretas                 em relação a estes. Envolvendo invasão no poder                de resguardar informações pessoais do retratado, sem uma autorização prévia, a obra pode tornar-se inapropriada                 de acordo com o objeto de seu tema                .', 'Outro fator relaciona aspectos financeiros: o biografado envolve-se na busca pelo direito à parte da rentabilidade do produto. Verifica-se a                 necessidade                de tal direito, desde que o personagem é tema e fonte de atração do mesmo.', 'Analisado         as situações, é         visível         que o autor da obra encontra-se violando o direito do artista de não expor certas informações pessoais publicamente e aproveitando-se de sua imagem para gerar lucro. Seria importante que este possuísse a autorização do biografado                 para evitar maiores transtornos                .']",120,160,160,160,80,680
137,"A Produção de Alimentos - transgênicos em questão, fatos e perspectivas","['No meio da produção de alimentos                , a evolução científica e         industrial, possibilitou         uma maior facilidade no cultivo de vegetais e na criação de animais, levando a um incremento significativo de produtividade. Contudo, o aumento,                 na linha de consumo                , de produtos transgênicos apresenta problemas, principalmente pelo fato de                 fugir a projeções de risco                , podendo resultar em problemas à saúde.', 'A                 velocidade                e quantidade de alimento, tanto vegetal, quanto animal, aumenta progressivamente.                 Porcos e leguminosas em geral tornam-se, a cada dia, mais e mais resistentes e mais eficientes na questão produtiva. Por esse motivo, há mudanças significativas no preço final.                Nesse sentido, o transgênico torna-se, pois, motivo mais que suficiente de uso. Como sempre, as leis de mercado são obedecidas.', 'Contraditoriamente à imposição de transgênicos                , não há regras, controle ou estabelecimento de                 relações satisfatórias de segurança desses alimentos                . Mesmo que a curto prazo a opção por transgênicos seja economicamente mais atrativa, tanto para o produtor, quanto para, consequentemente, o consumidor,                 projeções de longo prazo tornam-se difíceis, ou até mesmo desconhecidas.                É com esse viés que         necessita-se         buscar por maior controle sobre alimentos geneticamente modificados.', 'Ressalta-se que o desconhecimento de possíveis problemas à saúde          deve-se          ser analisado e enfatizado como um importante tópico na comercialização e produção de alimentos geneticamente modificados,          afim          de evitar riscos quaisquer.', 'A concentração da produção de alimentos feitos                 a partir de transgênicos                é, em maior parte,                 vinda de produtos de larga escala, voltados para a agro-indústria                . Com essa perspectiva, ressalta-se a                 possibilidade de incetivo aos pequenos produtores, evoluindo o número da produção de produtos orgânicos                .']",80,120,80,80,0,360
26,A grande desvalorização dos educadores do país.,"['O Brasil atual é, de fato, um dos países com sua situação educacional mais precária do mundo. Isso se confirma com a gritante banalização e desvalorização dos professores nas escolas do país, que, neste conceito deveriam ser os mais valorizados.', 'Não é incomum, infelizmente, observar através de fontes informativas, alguns casos de desrespeito, agressões verbais e até mesmo físicas aos mestres dentro das escolas brasileiras, e isso pode ser confirmado através da pesquisa da OCDE (Organização para a Cooperação e Desenvolvimento Econômico), que afirma que o Brasil é o país com maior número de agressões aos professores no mundo. Nesse sentido, pode-se observar o grande medo dos educadores em exercer suas próprias profissões .', 'Vale salientar que, embora a grande desvalorização aos educadores venha, em sua maioria, diretamente de seus próprios alunos, este ato se deve também aos próprios pais dos mesmos, e até mesmo do Estado. Tendo em vista outros países com seus pisos salariais bastante superiores ao do Brasil, como, Coreia do Sul que, os professores são uns dos membros mais respeitados pela sociedade, pode ser afirmado que, o Estado brasileiro desvaloriza seus educadores até mesmo salarialmente.', 'Ao executar uma junção de todos esses problemas, pode se concluir que, a primeira ação que deve ser tomada para redimi-los ao máximo deve ser do Estado, conscientizando todas as pessoas sobre o problema. Esta medida pode ser tomada pela inserção do assunto dentro das escolas, destinado aos pais, alunos e funcionários. Podem promover também campanhas por meios publicitários e jornalísticos, e claro, o aumento salarial destes profissionais de tanta importância para a educação do país.']",160,120,120,120,120,640
0,A afronta carnavalesca,"['Durante a colonização do Brasil, o índio foi sujeito a à imposição portuguesa de forma grotesca que apesar da sua bravura e resistência acabaram sendo contidos e escravizados. Nos dias atuais, depois do romance indianista, tal figura ganhou popularidade e debates nas redes sociais sociais, juntamente com outros símbolos culturais, a fim de que possam esclarecer se é correto o uso de fantasias que não façam parte do seu âmbito cultural.', 'A #índionãoéfantasia ganhou notoriedade quando a indígena Katú Mirim postou um vídeo nas redes sociais afirmando que tal fantasia é desrespeitosa e racista contra o seu povo povo, além de enaltecer o estereótipo do índio folclórico. É nesse período de que que as lojas começam a vender loucamente esse tipo de fantasia e que o brasileiro logo faz uma referência com a colonização e compra na tentativa de homenagear, mas quando perguntam aos ao mesmo, que povos estão sendo homenageado? não saberão responder e logo a fantasia deixa de ser um ""singela homenagem"" para se tornar mais uma peça de roupa que está apenas seguindo o rumo da moda.', 'Essas discursões discussões variam de época para época, não podemos confundir artifícios usados com o objetivo de trocas culturais a exemplo de intercâmbios, com essas tentativas banais semelhantes a de Alessandra Negrini de usar a cultura indígena para a autopromoção. Ainda no mesmo contexto há o ""blackface"", a prática de pessoas fenotipicamente brancas pintarem suas caras com tintas pretas, além da utilização de artifícios afro-americanos afroamericanos como turbantes, perucas blackpower, entre outros, na mesma ideia de homenagear, mas acaba sendo traduzido como apropriação cultural.', 'Diante dos fatos expostos, o homem branco já conquistou muito espaço e interferir dentro da cultura que não lhe pertence é algo inadmissível. Cabe a nós nós, a longo prazo prazo, educarmos as nossas crianças a dar valor a sua cultura e respeitar o espaço onde não lhe representa, a fim de que haja uma harmonia cultural além de repelir o uso exclusivo para a auto exaltação autoexaltação, sem relação com a realidade com a intenção de evitar possíveis afrontas.']",40,120,80,80,80,400
71,,"['A série 13 Reasons Why narra a história de uma estudante que se suicida após várias falhas culminantes. Fora da ficção, o suicídio entre os jovens também é um problema no Brasil onde, segundo dados do Sistema de Informação sobre Mortalidade, em 2015 o número de mortes causados por esse ato chegou a ultrapassar os 10000. Assim, o tabu e a falta de tratamentos psicológicos tendem ao agravamento desa questão da saúde pública.', 'É indubitável que o bullying encontrado, principalmente, nas escolas e nas redes sociais podem acarretar problemas psiquiátricos, como a depressão. Influenciando, dessa forma, a prática e os pensamentos suicidas. Além disso, a falta de diálogo e de intervenções demonstram o despreparo e a desinformação encontrados nos ambientes escolares e familiares.', 'De acordo com as informações divulgadas pelo Ministério da Saúde, o suicídio é a 4ª maior causa de morte entre jovens no Brasil. De tal modo, pode-se notar o efeito manada, que provoca em alguns indivíduos a mesma reação, devido ao pensamento de o suicídio ser um ato de bravura, como ocorreu em 2016 no jogo Baleia Azul, “romantizando” a autoquíria.', 'Contudo, vê-se a necessidade de produções de campanhas educacionais e informacionais feitas pelo Ministério da Saúde. Estas podem ser transmitidas através da imprensa e das redes sociais no mês de setembro, dando ênfase ao período de prevenção ao suicídio. Em soma, é importante que o Governo intensifique os investimentos nas formações de profissionais. Dessa forma, será possível a identificação de tendências depressivas.']",120,120,120,120,120,600
77,Homofobia,"['Existe um provérbio que diz que a educação vem de berço , assim, levando em conta a semântica da oração, os responsáveis da formação étnica das crianças é a família, mais especificamente os pais. Pode concluir-se então que os culpados pela homofobia no Brasil são os responsáveis do agressor.', 'O preconceito acontece primeiramente dentro da família quando os pais não aceitam que seu filho se relacione com outra pessoa do mesmo sexo. Somando com o preconceito da sociedade , o homossexual acaba por por ter preconceito consigo mesmo, quando este vai contra seus sentimentos e mantém um relacionamento heterossexual para ser aceito.', 'Tendo em vista esta problemática de cunho social, cabe ao governo lançar uma campanha de conscientização e aceitação para toda a comunidade em geral, priorizando os pais e crianças, disponibilizando psicólogos, palestras e diminuição dos impostos a empresas que possuam funcionários homossexuais a fim de estimular a interação de todos sem discriminação.']",160,120,120,120,120,640
72,,"['s “ ake ews ’’ vão além de notícias falsas veiculadas em redes sociais ou aplicativos de comunicação, esses tipos de rumores podem ter objetivos de ganhos políticos e financeiros. Em ano de eleições, elas podem causar grandes impactos, por isso são necessárias medidas governamentais diferentes das proposta até então.', 'Em primeira análise, iniciativas adotadas até então pelo governo para combate às notícias falsas é a criação de leis que criminalizam quem divulga e compartilha esses tipos de rumores. As leis ainda não foram aprovadas, mas já podem ser consideradas contraditórias, pois resolveria apenas o problema da elite política que passaria a controlar o conteúdo disponível a respeito de si. Além disso, incriminar quem compartilha tais mentiras é transformar qualquer usuário ( das redes sociais) em criminoso, logo essa medida beneficia apenas uma minoria da sociedade brasileira.', 'Em segunda análise, a legislação não tem a mesma velocidade com a qual as notícias são compartilhadas. Como exemplificação, o jornal O Globo mostrou que o primeiro caso de indiciamento por “ ake ews ’’ ocorrido no Espírito Santo em 2014, teve o inquérito concluído somente agora  três depois . Enquanto as notícias falsas se espalham 70% mais rápido que as verdadeiras e alcançam muito mais gente, resultado de um estudo levantado pelo Instituto de Tecnologia de Massachusetts (MIT), o estudo foi realizado nos Estados Unidos, mas as conclusões podem ser aplicadas ao Brasil.', 'Conclui-se , que a criação de uma legislação não é o bastante no combate às “ ake ews’’. Com isso, o combate começa na escola, portanto o Governo, por meio de envio de recursos ao Ministério da Educação , promova uma “alfabetização midiática”, através de aulas e palestras sobre a importância de procurar fontes confiáveis, identificação de uma notícia falsa, profissionais que ajudem os jovens no desenvolvimento de opinião crítica. Além disso, é necessário que haja parcerias com ONGs que desenvolvam as mesmas estratégias em comunidades, pois desenvolve o senso crítico da sociedade é a melhor medida a ser tomada.']",120,160,120,160,120,680
95,Segurança jurídica e o marco temporal,"['Ao se falar sobre a tese do marco temporal é importante analisar alguns aspectos que envolvem essa temática. Nesse sentido, é necessário discorrer sobre o conceito e o objetivo do Projeto de Lei (PL) n.º 490/2007, refletir sobre os direitos dos povos indígenas e apresentar sugestões de implementação de ações ou projetos que possam contribuir para o aprimoramento da democracia brasileira.', 'Primeiramente, é importante destacar que o mencionado PL, em julgamento há algumas semanas no Supremo Tribunal Federal (STF), visa determinar que devem ter direito às terras consideradas ancestrais somente os povos que as estivesses ocupando no dia da promulgação da Constituição federal (CF), ou seja, em 5 de outubro de 1988. Desse modo, tal tese defende que somente sejam efetuadas novas demarcações de terras indígenas para aqueles que se enquadrarem nas regras dispostas na referida norma jurídica, respeitando, por exemplo, aqueles produtores rurais que adquiriram legalmente a posse de terras em data posterior ao “marco temporal”. Esse é um dos pontos mais defendidos por aqueles que estão a favor da aprovação do PL, pois alegam ser necessário para contribuir com a economia brasileira e preservar a segurança jurídica.', 'Posteriormente, é imprescindível refletir sobre os direitos sociais dos povos indígenas, relacionando-os com os direitos humanos. De acordo com o artigo 231 da CF, são reconhecidos a esses povos originários os direitos sobre as terras que tradicionalmente ocupam, destinando-os a sua posse permanente e usufruto exclusivo. Em oposição ao previsto no PL do marco temporal, essa etnia tem se manifestado em defesa dos seus direitos, alegando sentir-se ameaçada emperder suas terras de forma arbitrária, contrariando o que está previsto na Carta Magna e excluindo os povos que, porventura, foram expulsos de suas terras e não estavam presentes na data de 5 de outubro de 1988.', 'Por fim, é necessário apresentar algumas sugestões de implementação de ações ou projetos que possam contribuir para o aprimoramento da democracia brasileira. Uma dessas ações poderia ser a consulta por meio de imagens aéreas disponibilizadas no aplicativo Google Earth Pro, bem como a análise de registros e documentos comprobatórios, a fim de verificar a existência e ocupação de povos indígenas nas áreas objeto de futuras demarcações. Ainda, o marco temporal não visa proibir futuras demarcações legais de áreas pertencentes aos povos originários, mas sim,  colocar uma limitação para que haja isonomia entre primitivos e produtores rurais.  Assim, tornar-se-á possível a construção de uma sociedade mais democrática, onde o Estado desempenha corretamente seu “contrato social”.']",160,160,120,200,160,800
11,Em busca de um novo lar,"['Com o aumento do aquecimento global, várias espécies de animais de todo planeta vem vêm sofrendo, como é o caso das espécies que vivem em no meio polar polar, que veem literalmente, suas casas derreterem, veem suas casas, literalmente, derreterem, ficando assim encurralados encurralados, já que que, com as grandes áreas congeladas que vão se desfazendo no mar vai mar, desaparece o seu alimento.', 'Não tendo condições para que possam para sobreviver no seu habitat habitat, algumas espécies migram para as áreas urbanas, em busca de um novo lar e de uma fonte de alimentação que não vá embora junto com as geleiras, isso então geleiras. Então, isso acaba se tornando um grande problema para a população população, já que se trata de animais selvagens que não vão ter a preocupação em diferenciar um ser humano de uma presa fácil, até por que crianças não conseguiriam encontrar uma maneira de se defender dos ataques desses animais que estão em busca de uma nova morada. É percebido que o fato desses O fato de esses animais estarem migrando para as regiões habitadas pela sociedade se deve também ao fato de um crescimento desenfreado em direção às suas ""casas"".', 'Tendo isso em vista, pode-se dar conclusão de concluir que um engajamento maior dos países em acordos como o Acordo de Paris de Paris, que traz metas que preveem a diminuição da temperatura do planeta, poderia ser uma boa alternativa para evitar que animais não sejam sejam obrigados a se deslocar até os centros urbanos mais próximos em busca de alimento.']",120,120,120,120,120,600
16,Inversão política,"['Ao se refletir sobre a questão de referências políticas é importante destacar que o país vivenciou, por mais de 12 anos, um Estado de esquerda com tendências comunistas. Durante esse período, o Brasil apresentou acréscimos nos índices de violência, desemprego e corrupção. Nesse sentido, a eleição do candidato Jair Bolsonaro - adotante de uma reforma política no país - nada mais é que um pedido de socorro por parte da população brasileira.', 'Inicialmente, a visão conservadora ganhou grande repercussão com a transparência das operações Lava Jato, que fez transparecer crimes dos mais diversos contra a Administração Pública . Dessa forma, a má gestão por parte dos representantes no Congresso Nacional – grande maioria envolvida em esquemas de corrupção e lavagem de dinheiro com o Partido dos Trabalhadores (PT) – incentivou ideias opostas e aproximou seus eleitores de um posicionamento de direita e liberal.', 'Além disso, é imprescindível a reforma da previdência social, a qual em uma posição conservadora e liberalista poderá inverter o atual cenário de déficit de mais de 150 bilhões de reais, adotada pelo candidato eleito.  Ademais, algumas ideias adotadas por essa onda conservadora são: diminuir o custeio da máquina pública, corte de gastos com “super salários” e remanejo do orçamento público.', 'É, portanto, lícito constatar que um novo padrão de vida surgirá nos próximos anos. Assim, a fim de se obter um mundo isonômico, com igualdade de valores sociais e econômicos, não só as pessoas devem criticar o governo de forma construtiva, sem ódio, como também permitir, com mais tolerância e respeito, ideias que divergem das suas visões de mundo.']",120,120,80,120,80,520
81,A história é o grande exemplo,"['Uma boa nação é aquela onde cada integrante da população respeita um ao  outro independente  da cor, raça, classe social e  principalmente  religião; entretanto, no Brasil percebemos não apenas discriminações quanto as  opções religiosas que as  pessoas optam, mas também ocorrências de agreções físicas por uma não aceitação de alguns indivíduos.', 'Tais fatores que recentemente vem  ocorrendo,  nos fazem questionar.  Discriminar uma pessoa independentemente da sua escolha religiosa, sendo por redes sociais ou até mesmo pessoalmente, fará com que esta  mude religião? E se partindo para uma agressão física, mudará a escolha dos indivíduos, de tal forma que o agredido, seja exemplo e os demais não sigam o mesmo caminho.', 'São Através  dessas reflexões que vemos a grande dificuldade para se tornar uma boa nação, e relatos históricos só mostram que a opressão, agressão e desrespeito, igual ocorrido na segunda guerra mundial, por um ser que se achava supremo e não respeitava principalmente a religião dos outros , só resultará numa grande derrota para si próprio e para o seu país.', 'Sendo assim  o Brasil tem uma grande caminhada a fazer, e ela deve começar principalmente dentro das escolas, onde desde bem cedo as crianças aprendam  a respeitar uns aos outros e entender que cada um deva  seguir a religião que lhe convém, sem medo de ser julgado. E para que isso se torne mais forte, deve-se buscar soluções para diminuir tais discriminações, seja desenvolvendo leis mais rigorosas, realizar palestras comunitárias, campanhas públicas e estimular as escolas à  incorporarem disciplinas que abordem assuntos como ética e respeito.']",80,80,80,80,80,400
43,A cultura do cancelamento nas redes sociais,"['No seriado “You”, produzido pela Netflix, é abordado como a superexposição na internet pode ter um efeito negativo. Fora da ficção a realidade não é diferente, a internet tem se tornado uma ferramenta de justiça social, e isso vem ocorrendo tanto pelo aumento da exibição na busca pela popularidade, quanto pela falta de regras para o controle do mundo virtual.', 'Primeiramente, deve-se destacar que a excessiva exposição da vida privada na internet tem sido um fator determinante para as redes sociais se tornarem uma espécie de “tribunal”. Nesse sentido, o surgimento exponencial de “influenciers”, que compartilham seu dia a dia para obterem cada dia mais seguidores, os deixaram mais expostos a críticas e manifestações de ódios, por parte dos usuários que se sentem no direito de cobrar a perfeição por parte daqueles que os influenciam. Ademais, a prática de comportamentos não toleráveis pelas celebridades vêm implicando seu cancelamento nas redes sociais como forma de punição .', 'Além disso, outro fator existente é a falta de uma regulamentação efetiva do uso da internet. Sob essa ótica, convém pontuar que apesar de em 2014 ter sido estabelecido o Marco social da internet com algumas diretrizes para o uso, ainda prevalece a ideologia de que o mundo cibernético como uma “terra sem lei”. Tal fato, reflete na dificuldade de identificação dos responsáveis por ataques e das condutas puníveis, tendo e, vista que apesar de muito popular, o mundo virtual ainda está “engatinhando”.', 'Portanto, levando-se em consideração os aspectos apresentados, é necessário que haja o desenvolvimento de mais leis que abordem a temática da internet, versando sobre o assunto com mais detalhes e rigor, juntamente com a capacitação de profissionais para atuarem identificando os autores de crimes virtuais, a fim de que o hábito de usar as mídias sociais como um ambiente sem limites não se perpetue.']",160,160,120,200,120,760
88,estigma doenças mentais 111,"['Assunto de grande relevância na sociedade moderna, trata do estigma associado às doenças mentais no país. Nesse contexto, é considerado natural que os indivíduos busquem tratamento para doenças físicas, enquanto, por outro lado, é inimaginável que pessoas ""normais"" necessitem de tratamento psicológico. Diante disso, uma interpretação mais tolerante dos transtornos psicológicos pela sociedade em geral se faz imprescindível para o desenvolvimento de um povo mais mentalmente saudável.', 'Primeiramente, tem-se que a população brasileira está psicologicamente doente. Assim, uma pesquisa realizada pela Vittude mostrou que 86% dos brasileiros tem algum transtorno mental. Só as pessoas que têm depressão somam mais de 11,5 milhões no Brasil, segundo a OMS . Além desta, existem várias outras doenças, como o transtorno bipolar e Borderline, ansiedade, esquizofrenia, entre outras. Com isso, devido à seriedade desses problemas, evidenciam-se as mais diversas consequências para o indivíduo e para a sociedade, que vão desde o afastamento do trabalho até o suicídio.', 'Apesar disso, ainda há uma grande estigmatização dos transtornos mentais por parte do corpo social, devido à ignorância gerada por uma cultura obsoleta, em que se acreditava que pessoas com doenças mentais estavam possuídas ou eram apenas ""loucas"". Fica claro, portanto, que esse tipo de concepção prejudica o progresso social, na medida em que dificulta o tratamento adequado àqueles que necessitam, e, portanto, impede a melhora na qualidade de vida do indivíduo, que muitas vezes passa a vida toda sem descobrir que tem uma doença. Assim, a estigma diante de doenças metais acaba por contribuir para a manutenção de uma sociedade deprimida, ansiosa e potencialmente suicida.', 'Por fim, é importante notar que existem saídas para a resolução do problema. Uma delas envolve a atuação do Poder Público nas escolas, desde o primário até o ensino médio, fornecendo educação emocional para os alunos. Nesse sentido, os estudantes receberiam orientações para lidar com diferentes problemas que poderiam surgir ao longo de sua vida. Outra possibilidade é o oferecimento, pelo governo, de tratamento psicológico gratuito quando comprovadamente necessário, contribuindo para o bemestar mental dos cidadãos.']",160,160,120,200,160,800
64,O Estado (que deveria ser) Laico,"['Convém lembrar que a partir dos nove anos de idade, quando se inicia a puberdade, a criança/jovem começa a desenvolver seus desejos sexuais e a usar de meios para satisfazê-los, e, com o acesso a conteúdo (inclusive pornográfico) ilimitado de hoje eles não ficam passando vontade e por isso precisam da tutela de alguém experiente para saber o que devem ou não fazer para evitar problemas, atuais e muito comuns, como a gravidez na adolescência ou contração de DSTs . O grande problema é que a maioria das crianças não recebem auxílio dos pais para se descobrirem, muito menos na escola, uma vez que os professores podem sofrer consequências de pais que não acham normal falar disso.', 'É claro que o trabalho nesses assuntos vem aumentando, só por causa da influência de minorias, mas não o suficiente; não de uma forma mais direta . Um grande agente dos problemas mencionados acima é a cultura cristã, que, como todos sabem, trata o sexo, ou qualquer ato sexual, (antes do matrimônio) como “pecado”, ou seja, algo errado que deve ser punido...  E como a cultura brasileira tem embasamento cristão, raramente algum pai e filho brasileiro vão conversar abertamente sobre isso. Esses mesmos pais que têm vergonha de falar sobre algo da natureza humana são as pessoas que estão “acima de nós”, os governantes, ministros – pessoas que controlam o que vai ser ensinado na instituição formadora de opinião: escola. Ou seja, se nem as “autoridades” (claro que há exceções) consideram normal falar sobre sexo, então é muito difícil que professores e pais tragam isso pro cotidiano de suas crianças, pois possuem as mesmas raízes e fundamentam suas opiniões também na Lei.', 'Concluímos que , se o Estado criasse leis e regulamentações para o trabalho do assunto “sexo” na Escola, de uma forma mais concreta, como a criação de uma matéria específica, com o tempo os pais também iam se conscientizar e perceber que isso é normal e até certo, diminuindo, assim, a influência de uma religião em problemas éticos e garantindo a saúde e bem-estar físico e psicológico do futuro da humanidade.']",120,120,80,120,80,520
8,O fato de negar os fatos,"['A palavra ""pós-verdade"" foi definida como o termo do ano segundo o dicionário de Oxford em 2016. Ela representa uma época em que os fatos objetivos têm menos influência e importância que os apelos às emoções e crenças pessoais. Dessa forma, grandes veículos de comunicação estão passando por uma crise de credibilidade, onde em que as pessoas passam a duvidar e questionar fatos sólidos. Nesse contexto, nem mesmo a ciência passa despercebida e acaba tendo uma desconfiança popular, culminando na disseminação de notícias falsas e na desinformação da sociedade.', 'À medida que as pessoas passam a dar mais valor à sua subjetividade, a circulação de notícias falsas tendem tende a aumentar, já que elas se constroem muito facilmente nas redes sociais que são muito presentes na vida moderna. Para ilustrar o tema, temos como exemplo o movimento terraplanista, propagado pelo norte-americano Eric Dubay. As primeiras ideias começaram a ser discutidas no YouTube e Facebook nos Estados Unidos, que alcançou alcançando mais de 100 mil seguidores. Fica nítido que as conquistas científicas que comprovam a esfericidade da Terra são superadas por um discurso persuasivo, através do qual vários indivíduos julgaram correto de acordo com sua percepção.', 'Com a avalanche de notícias e opiniões que nos cercam todos os dias nas mídias, tornou-se automático distinguir o verdadeiro do falso, gerando desinformação na sociedade. Para o historiador Leandro Karnal, a pós-verdade é uma ""seleção afetiva de identidade"", em que as pessoas se identificam com as notícias que melhor se adaptam aos seus conceitos. Ou seja, ainda no exemplo do movimento terraplanista, mesmo a esfericidade da Terra sendo refutavelmente comprovado irrefutavelmente comprovada pela ciência, há quem leia os argumentos de Eric Dubay e os abrace como verdadeiros de acordo com seu atual nível de noção. Dessa forma a sociedade vai ficando desinformada uma vez que cada um chega em um consenso diferente.', 'Portanto Portanto, é necessário necessária a construção de uma hierarquia de saberes que seja respeitada por todos todos, para que não haja uma exacerbação de ideias e conceitos distintos que possam atrasar a evolução tecnológica da ciência. É inegável que a informação chega a muitas pessoas e, com tantas opções de escolher uma veracidade, as escolhas individuais acabam sendo influenciadas com base no conforto e acolhimento de um grupo social. Por isso é importante que pessoas qualificadas em conhecimentos determinem minunciosamente através de métodos e técnicas as verdades, para que elas possam ser globalmente confiáveis.']",80,120,120,120,80,520
90,*COMO COMBATER A TRANSFOBIA NO BRASIL*,"['O filósofo São Tomás de Aquino defendeu que todas as pessoas devem ser tratadas com a mesma importância. Entretanto, a questão da transfobia contraria o ponto de vista do pensador, já que, no Brasil, indivíduos transgênero são vítimas de discriminação constante. Diante dessa perspectiva, percebe-se a consolidação de um grave problema, em virtude da lenta mudança de mentalidade e do silenciamento.', 'Convém ressaltar, a princípio, que o preconceito é um fator determinante para a persistência do impasse. De acordo com o sociólogo Durkheim, o fato social é a maneira coletiva de pensar e de agir. Sob essa lógica, é possível perceber que a não-aceitação da expressão identitária é fortemente influenciada pelo pensamento coletivo, uma vez que, se as pessoas crescem inseridas em um contexto social intolerante, a tendência é adotar esse comportamento também, o que torna sua solução ainda mais complexa.', 'Além disso, outra dificuldade enfrentada é a falta de debate. Nesse sentido, o intelectual Habermas traz uma contribuição relevante ao defender que a linguagem é uma verdadeira forma de ação. Desse modo, para que um problema como a marginalização de pessoas trans seja resolvido, faz-se necessário debater sobre. No entanto, percebe-se uma lacuna no que se refere a essa questão, que ainda é muito silenciada. Assim, trazerà pauta esse tema e debatê-lo amplamente aumentaria a chance de atuação nele.', 'Torna-se evidente, portanto, que os caminhos para a luta contra a transfobia no Brasil apresentam entraves que necessitam ser revestidos. Para que isso ocorra, o MEC juntamente com o Ministério da Mulher, da Família e dos Direitos Humanos devem  desenvolver palestras em escolas, para alunos do ensino médio, por meio de entrevistas com as vítimas do problema, bem como especialistas no assunto. Tais palestras devem ser webconferenciadas nas redes sociais dos ministérios, com o objetivo de trazer mais lucidez sobre a transfobia e atingir um público maior. Talvez, assim, seja possível construir um país de que São Tomás de Aquino pudesse se orgulhar.']",200,200,160,200,160,920
83,Esporte em questão,"['Atualmente, o modo de vida de cada indivíduo espelha a forma como tal está inserido na sociedade. Há um grande número de pessoas se abstendo das práticas esportivas e se tornando sedentárias, o que interfere não somente na postura física, mas bem como nas relações sociais.', 'A atividade física beneficia de inúmeras e diferentes formas cada praticante. Aumento da autoestima, melhora da capacidade mental, redução de riscos de diabetes e doenças crônicas, diminuição do stress e da ansiedade, são alguns dos motivadores.', 'A prática esportiva necessita ser introduzida na rotina de cada pessoa como um hábito. Como concebemos criar hábitos diários requer prática e disciplina, deste modo, consequentemente geramos não somente a rotina da atividade física, mas pressuposto a isso uma alimentação saudável com uma melhora significativa na qualidade de vida.', 'Considera-se que o esporte é um meio de entretenimento acessível, cuja disponibilidade nas escolas insere uma gama de crianças e jovens. Em termos sociais, este é o primeiro passo para essas crianças que estão sendo incentivadas e estimuladas, a um meio esportivo, serem inclusas em uma sociedade muitas vezes distante para a maioria, devido ao fato dos altos níveis de carência em grandes comunidades.', 'De modo mais específico, podem -se mencionar como modelo de inclusão social os Jogos Olímpicos, que por sua vez conduzem em sua longínqua história incalculáveis marcas pessoais de superação, nas quais os atletas excedem seus próprios limites, verdadeiros merecedores de estima. Contudo, não se atribui a todos esse magnetismo. Para alguns atletas, são anos de muita dedicação, esforço e treinamento para atingirem seu objetivo e um tão sonhado título. Diante disso, eles não aceitam menos que a vitória, o que em certos casos os torna desprovidos de caráter.', 'Compreende-se que a prática esportiva gera grandes privilégios , seja para você que faz atividades regulares e vai à academia ou para os atletas de elite. E é importante ressaltar que o intuito do esporte é proporcionar as pessoas o aprendizado de cooperar uns com os outros, tal qual ser solidário, não unicamente com o colega de equipe, mas sim com os todos que convivem e fazem parte da nossa vida.']",120,160,160,200,200,840
9,Pública e gratuita,"['No Brasil, as melhores universidades sempre foram as públicas: USP e UNICAMP, por exemplo, figuram entre as 300 melhores do planeta, segundo o ranking inglês THE (Times Higher Education). Essa qualidade é proveniente de investimentos, principalmente em produção de conhecimento, além da oportunidade de ensino gratuito à população.', 'Quanto à produção de conhecimento, pesquisas de enorme relevância são desenvolvidas no país. Na UnB (Universidade Federal de Brasília de Brasília), por exemplo, há o desenvolvimento de um equipamento para facilitar a cicatrização de diabéticos. Tal iniciativa pode reduzir gastos do SUS (Sistema Único de Saúde) com esses pacientes e proporcionar maior qualidade de vida, evitando o sofrimento de amputações. Se a instituição fosse privada, o mais provável é que esse estudo não existiria, pois a prioridade seria o lucro, indício disso é a inexistência de pesquisas científicas em faculdades particulares no território nacional.', 'Em relação á à gratuidade, se hoje os mais pobres são minoria no Ensino Superior ensino superior público, a cobrança de mensalidade reduziria o percentual desses a próximo de quase zero. O número de estudantes oriundos de escolas públicas nas faculdades aumenta com programas sociais como cotas, subsídios e bolsas e não com mais um entrave financeiro.', 'Enfim, o aparente gasto com pesquisas pode reduzir custos para o Governo, como no caso de estudos relacionados à saúde, e a gratuidade é essencial à formação de muitos alunos. A educação, portanto, precisa ser prioridade e os investimentos em Universidades públicas mantido mantidos ou, se possível, ampliado ampliados.']",160,160,120,160,120,720
26,O Brasil não quer ou não consegue valorizar o professor,"['O Brasil anda na contramão, do mundo , no que tange a valorização do professor. Pelo menos é a conclusão que muitos chegam após intensas discurssões referente ao assunto.', 'O país vem aumentando gradativamente os recursos destinados à educação, e isso pode ser percebido, ao vermos políticas como a destinação de grande parte dos recursos obtidos com as reservas de pré-sal, bacias de petróleo abaixo das camadas de sal no litoral Brasileiro , à educação ou com estipulação de limites mínimos aos entes federativos de recursos destinados à educação', 'Além disso, outra discurssão que é muito presente entre os especialistas deste assunto, é o fato que em um país, cujo os políticos estão entre os mais corruptos do mundo, se realmente existe o interesse de valorizar o profissional de educação. porquanto poderia resultar em adolescentes saindo mais críticas das escolas, o que ocasionaria uma pressão maior sobre os governantes, por este motivo talvez eles prefeririam cidadãos alienados. Além disso em nosso país não há políticas à longo prazo, pois o real interesse destes é somente a reeleição passados quatro anos, e uma política valorizativa de professores assim como qualquer medida eficaz na educação geraria frutos em longo prazo, talvez trinta anos, o que para pessoas que só se preocupam consigo mesmas, é tempo demais.', 'Portanto é visívil que a valorização do professor, no Brasil, inexiste por incopetência do governo ou intencionalmente. Fato é que não teremos uma educação de qualidade, enquanto não tratar-los com dignidade e não fornecer recursos para que este desempenhe seu trabalho com qualidade, afinal não se faz omelete sem ovos.']",120,160,160,160,80,680
90,,"['Na Idade Média,a Igreja Católica condenava qualquer conduta que tivesse ligação com travestis e transexuais. Nos tempos hodiernos,esse dogma está muito presente no Brasil em que pessoas homossexuais e transgêneros sofrem discriminação e repulsa por parte da sociedade,esse problema é fortalecido por um país católico e a forte religiosidade da população aliada falta de informação,com pouco debate nas mídias contribuem para a persistência da transfobia no Brasil.', 'Em primeiro plano,o Brasil é um país com formação machista,patriarcal e cristã,a forte religiosidade da população muitas vezes é um dos fatores para a transfobia,visto que o livro cristão retrata a criação do homem e da mulher e entre eles houve a união,portanto quem tenta subverter o gênero sexual e uni com outra pessoa do mesmo sexo está contra as leis de um ser supremo. Nessa problemática,as igrejas cristãs não realizão união entre pessoas do mesmo sexo. Consoante o filósofo Voltaire,""o preconceito é opinião sem conhecimento"",ou seja,todas as pessoas que discriminam o próximo por sua condição,não conhecem realmente o motivo e o sofrimento que eles passam.', 'Outrossim,as mídias brasileiras retratam pouco a luta dos transgenêros e homossexuais por direitos,a falta de debates e discussões não esclarecem a necessidade do reconhecimento dessas minorias e contribui para a não aceitação por parte da sociedade. As leis no país também são brandas quando o assunto é a punição para esses tipos de crimes,em que os LGBT\'s são assassinados e humilhados e a justiça permanesse ociosa. Segundo Aristóteles,""a paz social só será alcançada pela prática da justiça,isto é,enquanto houver injustiças sociais haverá a transfobia.', 'Em virtude do exposto,cabe ao governo federal,instância máxima de poder responsável por tomar decisões públicas,em parceria com as diversas mídias como a Tv, o rádio e as redes sociais, implantar com maior frequência debates e propagandas incisivas retratando o cotidiano dessa população,com o fito de diminuir a transfobia na sociedade. Ademais,as igrejas cristãs devem instaurar o ensinamento mais acolhedor para essas minorias,buscando mudar o pensamento preconceituoso dos fiéis,e por fim,a justiça deixar de ser omissa e julgar os casos sem olhar a quem,só assim essa conduta herdada do período da Idade Média será minimizada na sociedade brasileira.']",160,160,160,200,160,840
90,,"['A diversidade cultural ,social, e sexual no Brasil é muito ampla, entretanto, o seu preconceito também é. Atingindo principalmente as esferas mais vulneráveis da sociedade, como por exemplo , os grupos de LGBT e negros ,que sofrem homofobia e racismo respectivamente. Sendo esses preconceitos , responsáveis em acarretar o aumento de desemprego entre homens e mulheres trans, exclusivamente afrodescendentes no Brasil .Tornando com isso,  a prostituição o único meio viável de sobrevivência entre eles.', 'Nesse contexto o aumento da taxa de transgêneros desempregados no território nacional ,deriva da ausência de políticas governamentais ,que assegurem a inserção deste grupo ,no mercado de trabalho, juntamente com a proteção de sua integridade física ,psicológica e moral . As quais, sendo garantida por lei , não são efetuadas com a devida eficiência, sendo uma das evidências disso, o fato de haver um aumento significativo nas mortes de tras ,e registros de violência ano após ano, seja pela cor, sexualidade, outrora pelos dois.', 'Ademais ,o submercado da prostituição tem crescido ,com o decréscimo das ofertas de emprego ,pela preeminência da cultura sexista nacional . Na qual, tem como papel, forjar uma maior estratificação cultural , sendo ela não apenas limitada à classe social, mas, principalmente através da sinalização de identidade de um indivíduo transgênero. Contudo, assim como na Idade Média, onde o conhecimento ficava limitado ao clero, e apenas devido as Cruzadas, ele foi expandido, libertando as pessoas de seus cativeiros mentais, fazse necessário uma maior propagação sobre este contexto na sociedade atual ,para uma melhor consciência sobre a gravidade desse assunto.', 'Portanto , para haver um aumento da empregabilidade para o publico LGBT no Brasil, e consequentemente uma redução do mercado informal ,e os riscos por ele suscetíveis ,é preciso com urgência, do auxilio do Ministério da cidadania e o Ministério da justiça ,através de parceiras público privadas ,que forneçam não apenas vagas de emprego para estes indivíduos , mas, a conscientização e aplicação de políticas à seus funcionários , com o viés de implantar a necessidade do respeito ao próximo . Possibilitando assim ,a inserção não apenas no mercado ,mas , o resgate da identidade de cidadão brasileiro , tendo seus direitos e deveres assegurados , e cumpridos pela constituição.']",160,160,120,200,160,800
50,Revolta da Ciência,"['No contexto atual, em que se tem divulgado intensamente os cuidados em saúde  por conta do surgimento do ovo coronavírus, em dezembro de 2019, é importante destacar o saber da academia . Nesse contexto, ressaltar a produção científica para conflitar com as patologias emergentes é essencial.', 'A princípio, é incontestável a eficiência da prevenção de doenças por medidas vacinais, advindas da ciência. A exemplo disso está a erradicação da varíola em 1980, amplamente anunciada pela Organização Mundial da Saúde . A despeito do ocorrido no início do século XX, no Rio de Janeiro, com a Revolta da Vacina, em que a população se rebelou com a medida, hoje ela está a par de suas vantagens.', 'Além disso, os conhecimentos já obtidos por estudos acadêmicos são benéficos no surgimento de epidemias. Sabe-se hoje muito a cerca do comportamento viral e sua forma de transmissão, bem como de estratégias derivadas deste conhecimento, como o isolamento social e a higienização pessoal, intensificamente abordada por Luiz Henrique Mandetta, presidente do Ministério da Saúde.', 'Sob tal ótica, é vital priorizar os dados acadêmicos nesse cenário de pandemia. Convém que os Ministérios da Saúde e da Economia evitem, por meio de um projeto de lei enviado à Câmara dos Deputados, o contingenciamento de recursos voltados à produção científica no país . Assim, pretende-se não interromper a elaboração de subsídios para a saúde. Dessa forma, busca-se dar voz à Revolta da Ciência .']",160,160,120,160,40,640
95,Debate sobre o marco temporal.,"['Em análise ao tema abordado, a um certo ponto crítico relacionado aos direitos indígenos, sobre restrições de suas posses terrenas. A saber que, antes mesmo da colonização do Brasil no século XVI, os índios já habitavam nessas terras. Visto que até em outrora tais terras já lhes eram tomadas.', 'A socialização está se inovando, onde hábitos, valores e crenças se acham em igualação entre a sociedade. Desde 1973, sistemas buscavam integração entre a sociedade indígena à sociedade socialista. Mas, o modo em que os indígenas opitaram, era viver seus primórdios, preservando sua cultura.', 'Contabilizando a população indígena, estima-se menos de (0,5%), cerca de quase 900 mil de pessoas, relacionando ao restante da população brasileira notar-se um índice baixo. Vendo que as áreas habitadas por esses povos, não condiz a devida ocupação, por isso impõe-se este processo de restrição.', 'Contudo, o STF debate sobre esta ação de delimitação (arco temporal), estabelecendo assim seus direitos de reivindicação nas terras que eles realmente habitassem.', 'Mas, aos sistemas STF e INCRA visem em proporcionar um projeto agrário próprio para esses povos, buscando também fortalecer os direitos que lhes convém, ao seu modo de vida e cultura.']",120,120,80,120,40,480
77,A Homofobia no Brasil e no mundo,"['Podemos observar que a homofobia é um termo que expressa aversão ao homossexualismo, gerando comportamentos críticos, violentos e preconceituosos, onde certos indivíduos não conseguem admitir tal comportamento dentro dos conceitos tradicionais da sociedade. Mas atualmente, vemos que existem campanhas e grupos sociais mostrando que a homofobia pode causar desprezo e sofrimento a aquela pessoa. Segundo os direitos humanos, a homofobia é crime e com base nisso, tentam mostrar que todos nós somos iguais, independentemente de sua ideologia de gênero.', 'No Brasil, temos como exemplo o GGB (Grupo Gay da Bahia), onde oferece assistência as pessoas que fazem parte do movimento LGBT. De acordo com a pesquisa  do GGB, nosso país possui a maior quantidade de registros homofóbicos no mundo. Infelizmente, a homofobia ainda é muito presente em nosso cotidiano, pois em alguns casos, devido a sua escolha sexual, acabam tendo problemas na hora de conseguir emprego ou ingressar em uma faculdade. Podemos considerar também as mortes que correm todo tempo no país e no mundo, devido a sua intolerância. Além disso, vemos que em outras partes do mundo, países orientais como Afeganistão e Arábia Saúdita, ainda não toleram o homossexualismo por questões religiosas. Já na Europa, países como Inglaterra e Espanha, algumas igrejas já realizam até o casamento gay.', 'Em virtude dos fatos mencionados, afirmamos que a homofobia é encontrada em todos os lugares, seja na escola, no trabalho ou na rua. Entretanto, nosso papel é tentar converter e mostrar que existem outras formas de encontrar felicidade sem precisar escandalizar a sociedade com essa forma de atitude.']",120,80,120,120,120,560
102,(Sem título 071),"['Sabe-         se, que         a água é de fundamental         importancia         para a manutenção da vida. No         entanto este         recurso hídrico está cada vez mais escasso no planeta Terra.', 'Estima-se que há menos de                 três         porcento          de água doce no mundo, sendo que maior parte encontra-se nos          pólos  em estado sólido. Contudo, noventa e sete porcento é inapropriado          para o consumo, já que          apresenta          elevado teor de Cloreto de Sódio.', 'Atualmente, o Brasil,         pais         de ampla diversidade         climáticas         tem enfrentado complicaçõe pela escassez hídrica. A estiagem que inicialmente era característica de regiões como o         nordeste         ,                 apresenta em situação semelhante no          centro-oeste          .                  O estado de São Paulo reflete bem os problemas enfrentadas pelas regiões metropolitanas          q          se deparam com dificuldades          em se          adquirir água potável.                  Contudo, os longos período de racionamento de água, para amenizar a situação fez                  com que a população em geral repensasse suas ações para com o meio ambiente. Campanhas conscientizadoras          é          de fundamental importância de maneira que possa proporcionar condições favoráveis á                  manutenção da vida.']",80,80,0,0,0,160
56,A atual crise penitenciária brasileira,"['Superlotações, convívio entre facções rivais, falta de água e de recursos necessários para o dia-a -dia. Esses são só alguns dos problemas ocorridos em diversos presídios brasileiros, que desencadeiam em conflitos internos e rebeliões, gerando por consequência a morte de muitos detentos. Esse problema cresceu muito na última década e parece estar longe de ser solucionado.', 'De acordo com estudos recentes, o Brasil é o terceiro país com a maior população carcerária do Mundo, atrás apenas dos Estados Unidos e China. Esse número é alarmante, visto que o país não tem estrutura para manter todo esse sistema em ordem. A alta concentração de detentos favorece dessa falta de controle, o que facilita o início de rebeliões.', 'Outro fator influenciador em rebeliões presidiárias são os confrontos entre facções rivais, que disputam dominâncias de locais e regiões. A falta de análise jurídica, para conferir melhor a situação de cada indivíduo preso, acaba encarcerando integrantes de facções inimigas na mesma penitenciária. Gerando uma maior chance de conflito.', 'Portanto, para solucionar problemas relacionados situação carcerária brasileira, que piorou recentemente, culminando numa crise de lotação. É necessário o apoio das autoridades, com criações de políticas públicas que visam diminuir a quantidade de presidiários. Isso por meio da ressocialização do indivíduo e pela diminuição da burocracia levada para julgar o acusado.']",120,120,80,120,80,520
2,"Ministros, não heróis","['Nos últimos anos, a Operação Lava-Jato, responsável por desmantelar grandes esquemas de corrupção, deu grande crédito ao Poder Judiciário, sobretudo por causa da atuação do ex-juiz Sérgio Moro, o qual foi visto como um herói nacional. Em oposição a isso, o Supremo Tribunal Federal sofreu diversos ataques, em virtude de suas decisões poucos populares. Tal percepção negativa, no entanto, não deve ser vista como algo necessariamente ruim, pois nem sempre a defesa dos valores constitucionais agrada à maioria.', 'Nesse sentido, é preciso dizer que a função principal da Suprema Corte é de guardar guardar a Constituição Federal de 1988. Esta Essa, por sua vez, possui um mecanismo de defesa inclusive contra a vontade do povo: as cláusulas pétreas. Estes Esses dispositivos, por guardarem valores essenciais à democracia, não podem ser alterados em nenhuma circunstância, seja por proposta de emenda ou plebiscito. Eles foram criados para resistir a ondas totalitárias e até mesmo a vontades populares eventualmente imbuídas de desejos de discriminação e de violência. Em certa medida, portanto, a Carta Magna pode ser antipopular e, da mesma maneira, será o STF, cujo papel é o de velar pela sua validade.', 'Na verdade, a insatisfação gerada ocorre, em grande parte, por um motivo: a população brasileira não conhece quase nada sobre a legislação pátria. As escolas regulares do país preocupam-se mais em ensinar ensinar, por exemplo, a diferença entre mitose e meiose nas aulas de Biologia. O que é ensinado sobre Direito Constitucional? Nada! O resultado disso é desastroso: pouquíssimas pessoas sabem qual é o papel do STF e quais são seus deveres ou limitações. Assim, quando tal órgão não atende ao cego clamor popular, surge uma reivindicação em massa que pede o seu fechamento.', 'Por fim, depreende-se que boa parte das reclamações quanto à atuação do STF surgem porque a população é ignorante. Para que isso seja mudado, é imprescindível que o Poder Legislativo crie uma lei que insira a disciplina de Direito Constitucional no Ensino Básico. Tal medida, provavelmente, poderá disseminar o caro conhecimento de que a função da Suprema Corte não está relacionada a heroísmos, mas a à defesa da Constituição Cidadã.']",200,200,200,200,200,1000
64,"Educação sexual, o tabu!","['O tabu das aulas de educação sexual nas escolas é muito visto ainda por pais e professores, que não veem necessidade nela e acham que pode causar uma vida sexual precoce no jovem', 'Ter essa aula não irá conduzir o jovem a ter uma vida sexual , por muitas vezes é considerada chata  essa aula, por pensarem que irá ter algum conteúdo erótico, onde na verdade não existe. Nessa aula o aluno aprende sobre seu corpo e como defende-lo de doenças, sobre métodos contraceptivos entre outras coisas.', 'Mas infelizmente é visível como a vida sexual dos jovens atualmente é ""ativada"" precocemente por decisão deles mesmos, tendo isso em vista é necessári essa aula, pois embora ativa sua vida sexual, pouco se sabe sobre o assunto sexo, não sabem se quer qual a necessidade do uso da camisinha ou oque é, e porque usa os anticoncepcionais, ou se conhecem pensam que só exite a camisinha e o anticoncepcional oque não é verdade . É necessário ter uma educação sexual, e que os pais façam parte também desse ensinamento, que aja intimidade entre pais e filhos para que caso ocorra algo no futuro os filhos falem com seus pais sem medo.', 'Por fim essa aula não ir prejudicar nem adiantar o jovem sexualmente, somente ajuda-lo tenha ele sua vida já ativada ou não.']",120,120,120,120,80,560
58,Floresta amazônica,"['Segundo Hannah Arendt, uma das filósofas mais influentes do século XX, a Terra é a própria quintessência da condição humana, logo, isso não é diferente quando se diz respeito a floresta amazônica, na qual se caracteriza pela biodiversidade variada e imprescindível para todos os seres.', 'Dessa forma, a heterogênea biodiversidade presente na maior floresta tropical é cogitada de forma desenfreada para uso dos seus recursos naturais pelas atividades agrícolas e extrativismo ilegal, oriundos e incentivados desde o período de Ditatura Militar por convicção de colonizar a região Norte, pelo emblema “Integrar para não entregar”.', 'Por conseguinte, há a queima e o desmatamento nas áreas de floresta por interesse econômico dos detentores dos meios de produção, perpassando até mesmo unidades de conservação e terras indígenas, protegidas pela Constituição Brasileira de 1988 e que de acordo com o levantamento do Instituto Socioambiental, entre os meses de julho e agosto, se apresentou 3.553 focos de calor em terras indígenas e 7.368 focos em unidades de conservação, com várias destas áreas aparecendo entre as mais desmatadas, conforme o Inpe, e portanto havendo uma correlação com o interesse privado.', 'Em vista dos fatos apresentados, é indispensável que o Estado tome providências para amenizar a situação atual. O Ministério do Meio Ambiente deve dar um apoio financeiro e tecnológico, por meio de verbas governamentais, de maior relevância para o Ibama, para se aumentar sua presença em áreas remotas, onde não há fiscalização e em inovações de táticas e operações, ocorrendo paralelamente, campanhas de conscientização voltadas para a população pelos órgãos institucionais sobre as causas e consequências do desmatamento, de um consumo sustentável, pois uma população, detentora de conhecimento, trabalha de forma conjunta para o fim do óbice.']",120,120,120,120,120,600
88,,"['“No meio do caminho tinha uma pedra”. O famoso verso do poeta brasileiro Carlos Drummond de Andrade trata-se de uma metáfora para desafios. Análogo ao poema é evidente que há uma pedra no caminho do Brasil: o estigma associado às doenças mentais na sociedade brasileira, fazendo-se necessário discutir sobre essa problemática.', 'A desinformação por meio das mídias é um fator que favorece o estigma relacionado às doenças mentais. Segundo Émile Durkheim, a base do indivíduo é formada pela família, mídia e escola, sendo assim, os meios jornalísticos e as redes sociais estão presentes na formação das pessoas e contribuem para que as doenças mentais sejam vistas como “frescura” ou “falta de Deus” e indubitavelmente venham a ser tratadas com descaso e negligência.', 'Por conseguinte, um outro estigma também está presente na sociedade brasileira, o preconceito. A série – disponível na Netflix – Atypical aborda a vida de um garoto com autismo que em seu dia-dia enfrenta problemas com preconceito e mostra toda a sua convivência na sociedade tendo uma doença mental, ele tem o apoio de sua família e de sua psicóloga que o ajuda com o tratamento . Fora das telas, muitas pessoas convivem diariamente com a discriminação relacionada as suas doenças mentais e sem o apoio necessário  e não tendo tratamento, as doenças mentais acabam se tornando um grande empecilho na vida de muitos brasileiros e atrapalham o convívio social.', 'Portanto, faz-se necessário a ação do estado para amenizar o quadro atual. O governo federal deve fazer planos de saúde voltados a saúde mental e campanhas midiáticas, por meio do Sistema Único de Saúde (SUS) e por redes de mídia com a finalidade de informar a população que doenças mentais existem e devem ser tratadas como qualquer outra, para que assim os estigmas existentes na sociedade brasileira não sejam mais uma pedra no caminho.']",160,160,120,160,160,760
56,Situação da população carcerária no Brasil,"['O massacre ocorrido nos presídios no Norte e Nordeste é um exemplo recente da atual crise no sistema penitenciário brasileiro. Em 2019, membros da facção Família do Norte mataram aproximadamente 55 presos em Manaus. Em represália, o PCC  encomendou a morte de detentos em Natal.', 'A violência existente nas penitenciárias é um reflexo dos crimes ocorridos fora dos presídios, sendo geralmente encomendados pelos próprios detentos. Estes problemas ainda são agravados pela falta de investimento do poder público em segurança. Nesse caso, celulares transportados por drones foram interceptados no interior do pátio das cadeias.', 'Entre 2006 e 2016,  ocorreu um crescimento aproximado de 196% na população privada de liberdade no Brasil, no entanto o número de vagas nas penitenciárias permaneceu estagnado. Segundo os Sociólogos, presídios superlotados são uma das causas do aumento dos conflitos internos e de denúncia de violação dos direitos humanos e insalubridade.', 'A população carcerária é formada por mais 50% de jovens, sendo que 90% são homens, negros, provenientes das regiões norte e nordeste do país  e com baixa escolaridade. Enquanto que 62% dos crimes cometidos por mulheres estão relacionados com o tráfico de drogas, sendo que 90% são mães e principais responsáveis pelo sustento e cuidado com os filhos.', 'Uma das medidas para melhorar a situação carcerária no Brasil é o investimento na educação de jovens e adultos, resultando em menor participação em crimes. O aumento da fiscalização dos presídios por meio da intensificação das revistas íntimas, instalação de bloqueadores de celulares e monitoramento no entorno das prisões com drones. Pessoas privativas de liberdade deveriam estudar enquanto estão presas para serem inseridos no mercado de trabalho e a obrigatoriedade de trabalhar para custear seus defensores públicos, estadia e para sustentar seus filhos.']",120,160,120,160,80,640
139,O medo do fim do mundo,"['As previsões sobre o fim do mundo em 2012 foram de encontro com os dizeres de diversos cientistas.         Este         assunto é polêmico, atraente e assustador. Porém, como lidar com a temática sem afetar as emoções humanas?', 'Diversos estudiosos do calendário maia divergiram em suas opiniões sobre a data de 21/12/2012. Alguns disseram que                 seria um fim                apocalíptico com grandes catástrofes, outros, que seria apenas o fim de um ciclo e o início de uma nova era. Por outro lado, os cientistas e agentes da Agência         Aero-Espacial         Estadunidense (NASA) procuraram acalmar a população, principalmente para evitar algum tipo de suicídio individual ou coletivo, como os que já ocorreram em face de previsões como         esta         .         Estes,         disseram que não havia nenhuma evidência sobre tal data,         tão pouco         alguma ameaça contra o         Planeta.         .', 'O assunto é simultaneamente atraente e assustador. É atraente porque a vida é cercada de mistérios, curiosidades, crenças e teorias. E isso, de certa forma, aguça o imaginário das pessoas. É também assustador, aliás, mais assustador que atraente, principalmente devido         as         grandes catástrofes naturais que têm ocorrido, haja vista o descongelamento das calotas polares, o aquecimento global, o aumento do nível do mar,         regiões com chuvas em excesso e outras com eminente seca.          Como se não bastasse, ainda surgem as grandes produções cinematográficas com filmes assustadores, demonstrando que haverá uma grande perturbação na Terra.', 'Apesar de o         Planeta          apresentar-se frágil, aparentemente ele terá muito tempo pela          frente  e para tanto         é necessário que as pessoas prossigam         nesta         caminhada de modo racional, não deixando sentimentos e emoções se sobreporem         a         razão. Cada ser tem uma tendência         em          acreditar nisso ou naquilo, porém é bom que junto com          esta          crença seja um pouco cético em relação ao fim do mundo, pois afinal nada é concreto sobre o assunto.', 'Diante disso, conclui-se que a temática, além de atraente e assustadora,         ela não         é limitada. Ela abre diversos leques para discussões e debates que         possa  corroborar em         como prosseguir         nesta caminhada         até que o fim do mundo ocorra, seja         este         fim individual         para cada ser ou         para a Terra como um todo.']",160,200,160,160,120,800
75,,"['livre porte de armas no rasil pode trazer vários pontos negativos para a sociedade, tanto futura quanto presente.', 'legalização do porte de armas pode fazer com que a sociedade se torne mais agressiva, e irresponsável, pois procurariam descontar suas raivas por meios de crimes desumanos . e acordo com os dados do IBGE relatados nos últimos meses, a taxa de criminalidade vem crescendo gradativamente efetuando vários reflexos negativos na sociedade.', 'portanto o porte de armas não deve ser legalização pois os brasileiros com seu baixo conhecimento sobre as étnicas não saberiam usufruir desse bem como um ponto positivo para a sociedade em vez de trazer benefícios só traria malefícios para a sociedade.']",80,40,40,40,40,240
8,A verdade absoluta através dos anos,"['Durante toda a evolução do planeta em que habitamos, várias teorias que eram tomadas como verdade absoluta por muito tempo, foram tempo foram derrubadas por outras teorias obtidas a partir de observações, que também não são extremamente confiáveis, e doutras e, outras vezes, são mais consistentes, obtidas através de fatos. O aprendizado que a humanidade tomou para si a partir disso, é disso é o fato de que nem sempre o aquilo em que se acredita por uma duração de certo tempo é válido.', 'Pensando nisso, e nisso e aplicando essa variabilidade de informações constantes constante na sociedade atual, nota-se que nada é recebido pela massa como verdade absoluta, o absoluta. O tempo de em que as autoridades impunham o que devia-se acreditar aquilo em que se devia acreditar, ou fazer, está ultrapassado e cada cidadão, conforme o andamento de sua formação, elege o no que deve acreditar ou fazer, de acordo com seus princípios. Esse fato deve-se também aos órgãos de autoridade, como o governo, que que, ao mascarar e corromper verdades ao povo, perde sua credibilidade.', 'Além do mais, o avanço da tecnologia traz uma desvantagem muito perigosa, aonde pois qualquer pessoa, independe independente de sua qualificação, pode criar uma teoria a partir de fatos inconsistentes, e lançá-la nas redes sociais, aonde onde todos terão acesso a mesma poderão acessá-la. Esses fatores, acoplados às fake news, e ainda mais reflexivo, aliado a à dificuldade que a sociedade tem em acreditar em coisas que os olhos não veem, fazem com que, teorias que teorias irrefutáveis, como a importância da vacina e a curvatura da terra Terra, tornem-se duvidosas. O problema de toda essa movimentação, é movimentação é que as pessoas acabam ficando à mercê em torno de tantas informações recebidas e nem sempre tem têm sabedoria suficiente para acreditar no que é cientificamente e sociologicamente comprovado.', 'Tendo todos esses fatores em vista, cabe a à população procurar a confiabilidade da fonte em que obteve alguma informação antes de propaga-la. À NASA, ao Ministério da Saúde e a tantos outros órgãos que tem têm seu andamento comprometido por diversas teorias malucas, cabe malucas cabe o esclarecimento dos fatos obtidos a partir de pesquisas sérias e assim e, assim, juntamente com as escolas, devem tornar claro a à população o coerente, como a importância das vacinas e o formato da terra.']",80,120,120,120,80,520
71,,"['A temática do ato de causar a própria morte sempre esteve em ascensão na sociedade, suas causas variam de acordo com o passar do tempo. Durante o século XVIII  por exemplo, na época do romantismo, quando Goethe publica ""Os sofrimentos do jovem Werther"", no qual o personagem principal se mata por um amor platônico. E é nessa época também, que os jovens começam a encontrar na morte uma solução para os seus problemas.', 'O suicídio fica em 2° lugar,  como principal causador de mortes entre os jovens. Segundo o Departamento de Saúde Mental e Medicina da UFG, a família representa a condição necessária para o crescimento e desenvolvimento de vínculos que garantam a sobrevivência física, social e afetiva das pessoas. Contudo, o contexto familiar é considerado fator causador para tentativa de homicídio. Perdas de relações afetivas, violência doméstica, doenças mentais ou físicas, ou ao se deparar com novas visões da família e sociedade colocam o adolescente em situação de vulnerabilidade.', 'Além disso, a escola pode se tornar um cenário favorável no que se refere ao fortalecimento do comportamento suicída. O bullying, um problema enfrentado mundialmente em qualquer escoa, está por trás de muitas tentativas de suicídio. O livro ""Por lugares incríveis"" de Jennifer Niver, narra a história de dois jovens prestes a escolher a morte. Um deles, Theodore, sofre bullying na sua escola . Ele é conhecido como ""o esquisito do colégio"". Uma história bem parecida com a vida real. O jovem é influenciado facilmente pelas opiniões alheias e, nesta tentativa de se encaixar, passa a agir de forma inconstante.']",120,160,120,120,0,520
83,"Mais que uma atitude, uma escolha.*","['A prática esportiva não é algo que surgiu no mundo contemporâneo, é um feito que data de muitos anos atrás,  (.) convém-se citar o seu berço, “A Grécia Antiga” ,que com seus jogos incentivava homens a permanecerem fortes e ativos para guerra, através da prática esportiva, e mais tarde viria a originar uma olimpíada que, por conseguinte, ultrapassaria os anos se aperfeiçoando até chegar a esta proporção da qual temos ciência atualmente.', 'Atualmente o esporte vai muito além dos olhos de uma torcida pelo seu time ou jogador favorito, a prática deste proporciona às pessoas melhor qualidade de vida em vários aspectos, como: Redução do estresse, elevação da autoestima, regularização do sono, melhores taxas do bom colesterol (HDL), redução de peso e ganho de massa corpórea, até pessoas que têm depressão melhoram seus humores após a prática esportiva. A sedentarização é algo comum na nossa sociedade moderna, na qual muitas pessoas vivem com pressa e seguindo uma rotina de trabalho ou estudos intensa,   (.) é importante definir prioridades, e não há prioridade melhor que a saúde e o bem estar do indivíduo.', 'Podem-se adquirir ensinamentos valiosos no meio esportivo, tais como a cooperação que faz pessoas sem vínculo algum produzirem laços e virarem uma família, capazes de defenderem uns aos outros em prol do mesmo ideal. Não se deve pôr a rivalidade acima de uma competição saudável, a integração humana é essencial para uma boa convivência, seja qual for o meio de atuação. As competições internacionais despertam o nacionalismo na melhor forma de amor ao seu país e a sua cultura, e também dão a possibilidade de ver toda a diversidade dos outros países, como se pôde ver nas olimpíadas 2016. Segundo dados  da UNESCO, a Constituição Federal do Brasil (1988) e o Estatuto da Criança e do Adolescente, expõem que a prática esportiva deve ser assegurada a todos os jovens e crianças, pois além de ajudá-los na coordenação motora, os trazem benefícios físicos e melhoram suas relações sociais com outros jovens.', 'Portanto, deve-se incentivar o esporte em suas múltiplas faces, promovendo projetos de inclusão de jovens carentes a tais práticas, incentivando o esporte na educação pública e privada do Brasil e promovendo a igualdade de gênero neste meio, pois não se deve haver desigualdade entre pessoas que se esforçam e dão tudo de si por igual, com a ajuda de todos, pode-se construir campeões e, acima de tudo, pessoas melhores e perseverantes que lutem não só pelo seu time ou país, mas acima de tudo pelos seus sonhos.']",160,160,200,200,200,920
4,Tardia e eficaz,"['Múltiplos fatores são considerados na condenação de um réu e isso pode trazer à tona algumas polêmicas. Atualmente, está em voga o questionamento quanto a à legalidade da pena após a decisão do juiz ter ocorrido em segunda instância.', 'Alguns países servem de exemplo para melhor esclarecimento entre as ideias opostas, e alguns casos específicos trazem a noção de que o cumprimento da pena é algo orgânico, por assim dizer, pode ser eliminado, diminuído ou ampliado, mediante apuração de novas provas, ou comportamento do réu após a batida do martelo.', 'Assim, sabendo que a punição ou absolvição, deve absolvição deve ocorrer em face do ato praticado, relacionando as consequências desse ato e principalmente a preservação do bem estar bem-estar social, há a certeza de que o refinamento de antigos processos são positivos ao sentido da justiça. Então, a despeito da última palavra decisória ter sido declarada em qualquer instância possível, é preciso reforçar a ideia de que o objetivo da libertação de um preso deve acontecer, exclusivamente, caso seja benéfico ao Brasil.']",0,0,0,0,0,0
51,analfabetismo por conta do governo,"['Mesmo que, o analfabetismo esteja diminuindo a cada dia que passa, muitas pessoas ainda sofrem com este problema, principalmente pessoas de áreas de extrema carência com pouquíssimos acessos educação básica. Será que são essas pessoas que não querem o acesso a educação ou o governo que não disponibiliza a devida educação a eles ?', 'De acordo com o portal de informações G1.com, em 2017, apenas o estado do ceará tem 15,2% da população analfabeta, que são 1,34 milhão de de pessoas; a maior parte dessas pessoas tem um curto acesso ao ensino básico escolar. Mesmo essas pessoas expressando o desejo de ser alfabetizados, não podem . Por que não há unidades escolares perto de suas casas; o governo acaba se preocupando mais com a crise econômica, política, etc, ao invés de se preocupar com o número de pessoas que não tem alcance a educação básica. Por isso é o governo que não disponibiliza a devida educação à povos de áreas carentes . as mesmo assim, ongs, muitas das vezes sem o mínimo apoio do governo vai a esses lugares e leva o ensino/alfabetização a essas pessoas. em cobrança sem nada em troca, apenas por amor e vontade de ajudar ao próximo.', 'endo em vista os aspectos observados, percebesse que: mesmo o governo não enviando unidades escolares a locais carentes, com níveis altos de pessoas analfabetas, ongs se disponibilizam/responsabilizam a levar á alfabetização essas pessoas, as incentivando a ter um conhecimento cada vez melhor, e através disto muitas pessoas acabam não só concluindo o ensino médio mas também concluindo o ensino superior e tendo uma forma de vida melhor.']",120,120,80,120,0,440
45,BLM,"['Em maio deste ano, a morte do jogador de futebol americano, George Floyd, desencadeou uma série de protestos contra o racismo no mundo inteiro. Além de pedirem por respeito, os manifestantes queriam, principalmente, o fim da violência policial contra a população negra. Nesse contexto, é notório observar que o abuso de autoridade tem ganhado cada vez mais força, inclusive no Brasil. Diante disso, cabe avaliar os fatores que corroboram para a problemática em questão.', 'Precipuamente, é importante destacar que no mundo inteiro os casos de abuso de autoridade vem aumentando e se tornando cada vez mais comuns na sociedade contemporânea, principalmente com a facilidade de registro desses atos . Por conseguinte, as imagens e vídeos rapidamente circulam nas redes sociais provocando ondas de indignação na sociedade. Prova disso, são as hastags criadas, principalmente no Twitter, para chamar a atenção das autoridades para o que está acontecendo.', 'Outrossim, é imperioso ressaltar que no Brasil o abuso de autoridade não é novidade. Isso, porque durante a ditadura militar, iniciada em 1964, explanou a face mais tirana dos governantes quando o então presidente, Cost e Silva, instaurou o ato constitucional 5 . Diante disso, fica claro que na mais recente democracia do mundo o abuso de autoridade é uma consequência passada que vem se intensificando nos dias atuais.', 'Ao observar os fatores abordados em discursão é evidente a necessidade de politicas publicas que possam mitigar atos como esses. Para isso, urge que o governo federal- responsável pelos interesses nacionais- adote medidas básicas constitucionais, por meio da elaboração de leis e uma fiscalização séria, capazes de atenuar e garantir o direito civil de cada um como cidadão, independente de cargo politico.']",160,160,120,160,160,760
83,Por um mundo mais consciente e saudável,"['Na Antiguidade, as práticas esportivas não se pareciam com as que conhecemos hoje. Em razão disso, eram conceituadas como práticas pré-esportivas. Algumas eram úteis para a sobrevivência do homem, como a corrida e a caça. Outras eram mais uma preparação para guerras, como a esgrima e as lutas. Em um mundo de evoluções, criações, revoluções industriais e guerras mundiais, hoje o planeta Terra e dominado pela tecnologia, dessa forma, o homem moderno vem deixando de lado as atividades esportivas, o que acarreta sérios problemas de saúde. Mas o que podemos aprender com a prática esportiva?', 'Este ano o Brasil recebeu o maior evento esportivo do mundo, os Jogos Olímpicos 2016, este evento tem como objetivo aproximar nações, deixando de lado as diferenças, seja elas culturais ou religiosas. Durante os dezessete dias de competições, o mundo celebra com os competidores suas  vitórias ou derrotas. Mas além das competições, as modalidades deixam um legado para os jovens  e adultos, são elas respectivamente,  as motivações e exemplos de superações através do esporte e uma melhor qualidade de vida.', 'O filósofo Sócrates, na Grécia antiga, já afirmava: “As duas grandes habilidades necessárias ao desenvolvimento e à formação do ser humano são a arte e o esporte”. O bem-estar físico era um dos caminhos para que o intelecto pudesse fluir livremente, ultrapassando fronteiras limitantes para qualquer aprendizado. Dessa forma, fica claro que o esporte é de extrema importância para uma melhor qualidade e expectativa de vida, pois reduz o risco em relação a doenças do coração, diabetes e alguns tipos específicos de cânceres. Entretanto, boa parte da população mundial enfrenta a obesidade, em consequência do vício tecnológico e a má alimentação.', 'Contudo, é importante conscientizar a população através dos meios de comunicação da importância da atividade esportiva e o quanto está prática é fundamental para uma vida melhor e saudável. É necessário também deste de cedo direcionar nossas crianças à brincar com os amigos ao invés de entreter com jogos online, porque assim o esporte contribui para a melhora das relações sociais uma vez que pode unir, de uma maneira espontânea e criativa, as pessoas na comunidade. Além disso, pode ser uma excelente forma de inclusão social, ao permitir oportunidades iguais de participação independente de gênero, raça ou habilidade.']",120,160,200,200,200,880
74,Mal de todos os séculos,"['É inegável que, para alguns, o simples fato de uma pessoa ser mulher a faz condenadora de sua própria morte. Isso se chama feminicídio, que em 2017 matou 946 mulheres apenas por ódio de sua condição de gênero. Não é de agora que pertencer ao gênero feminino venha ser um empecilho para estar em sociedade', 'Em primeira análise, vemos que desde os primórdios as mulheres são tratadas apenas como objetos. Isso se evidencia até mesmo na bíblia, onde no livro de Lucas diz que “Os que comeram foram cerca de cinco mil homens, sem contar as mulheres e crianças.” Elas não tinham voz e nem presença, eram apenas reprodutoras.', 'Em segundo plano, vemos uma grande busca de equidade por meio das mulheres e melhorias significativas. Em contrapartida vê-se uma luta para essa aceitação. Isso se deve ao fato do medo de que muitos, maioria homens, tem de sentirem inferiores ao tal “sexo frágil”. Um exemplo que temos em nosso Brasil é a Dilma Rousseff que deixou bem claro em uma de suas falas “Em condições de poder, a mulher deixa de ser vista como objeto frágil e isso é imperdoável. Aí começa a história da mulher dura. É verdade: eu sou uma mulher dura cercada de homens meigos.”', 'Levando-se em conta os fatos mencionados, observa-se que fica fora de cogitação para a ocorrência de um feminicídio . Para sua redução, ou melhor, abolição, as penas deveriam ser mais longas para aqueles que cometessem tal crime. Deveria ter, também, palestras incentivadoras a equidade de homens e mulheres, principalmente nas escolas.']",120,120,80,120,120,560
60,"Reforma da Previdência, uma discussão social","['Nas sociedades contemporâneas a expectativa de vida vem aumentando significativamente, dessa forma, reformas orçamentárias para arcar com pirâmides estarias cada vez mais envelhecidas denotam importância social, econômica e política. No brasil, especificamente, já apresenta um público idoso considerável e previsões de orgãos específicos, tais como: IPEA e IBGE mostram atenção para futuras aposentadorias. Logo, a reforma da previdência é crucial para atender uma lógica geográfica e econômica e, além disso, busca reformular o antigo sistema para adequar o pais à nova realidade global de economia emergente, no que tange trabalho e desenvolvimento social.', 'Nesse contexto, percebe-se quão importante é essa reforma, porque não é apenas mais um discurso político, mas equaciona uma relação demográfica enfrentada, por exemplo, em países desenvolvidos, como: Noruega, Suíça, Suécia e outros, cujas populações já são envelhecidas e gastos com aposentadorias saldam valores exorbitantes todos os anos. Então, é crucial estabelecer uma reforma a qual venha prevenir problemas sociais - falta de aposentadoria e pagamentos aos já aposentados.', 'Por conseguinte, a reforma da previdência aumenta o tempo para se aposentar, entretanto, o Brasil encontra-se em um mundo Globalizado cujo trabalho e consumo são essenciais para formalizar competividade frente ao capital internacional. Portanto, o aumento do tempo enfatizado é justificado pela necessidade em corresponder uma demanda econômica e política forte e consolidada de outros países – Estados Unidos, China e alguns países da Europa. E, embora argumentos contrários criticam esse tempo , faz-se necessário entender as diferenças salarias, em alguns países o tempo para aposentaria e contribuição é menor, por outro lado, possuem salários dignos e maiores em comparação ao brasil.', 'Com base nessas considerações, soluções são imprescindíveis para resolver o impasse. Diante da reforma da previdência ainda em discussão, o Estado deve, por meio de ações administrativas e educacionais, levar às comunidades menos informatizadas conhecimento sobre a reforma. Nesse viés de informação, especialistas em direito tributário e professores de geografia vão compor sistemas de palestras e mini cursos em escolas, comunidades carentes e interiores. Contudo, realizando uma proposta desta categoria, um futuro melhor e instruído existirá em solo brasileiro.']",120,160,160,160,120,720
88,yas,"['Nos dias atuais há um grande barbilho em relação as doenças mentais, principalmente, as cicatrizes deixadas pelas mesmas e a dificuldade de retornar a uma vida saudável. Convém lembrar que, antigamente, os assuntos relacionados a mente eram tabus, porém Van Gogh consegui transmitir seus profundos sentimentos em suas obras.', 'Em primeiro lugar, é crescente a taxa de homens e mulheres com algum tipo de transtorno mental como, por exemplo, ansiedade e depressão. A origem, muita vezes, é incerta e/ou adquirida por algum evento traumático. Salientando que depressão é tudo aquilo que o indivíduo vivenciou, já ansiedade é um "" excesso de futuro\'\'. Grande parte da população doente fecham os olhos para o problema por receio de julgamentos de outros indivíduos.', 'Segundamente, este contratempo afeta a vida pessoal e profissional, além de regredir o seu estado físico. É notório que para manter algo estável é necessário estar bem psicologicamente para bom desenvolvimento de suas atividades. Segundo dados da Organização Mundial da Saúde (OMS), a economia é afetada, diariamente, por consequências dos transtornos mentais. De modo, que a sensação de impotência aumente, levando as extremidades do barbilho, o suicídio.', 'Portanto, o papel da dos familiares, amigos e colegas é fundamental para a resolução, visando o bem-estar do próximo, as grandes mídias e meios de comunicação poderiam e deveriam criar campanhas para alertar a sociedade, enfatizando também campanhas já existentes como, Setembro Amarelo. As instituições de educação e trabalho, em junta com o Estado, influenciariam no aumento de psicólogos nos estabelecimentos. A população, por sua vez, compartilharia a empatia ao próximo, visando que doença mental não é frescura.']",160,120,120,200,160,760
49,A geração da tecnologia,"['Em sua canção ""Admirável chip novo"" a cantora brasileira Pitty faz uma crítica ao efeito manada causado pela mídia, no qual as pessoas realizam uma ação principalmente porque outras estão fazendo , independente da sua vontade individual. Tal comportamento vem sendo utilizado como estratégia para a manipulação do comportamento público, uma vez que empresas, através do marketing digital, contratam influenciadores digitais a fim de expandir o alcance de seu produto. Desse modo, torna-se necessário analisar os impactos das redes sociais no cotidiano: a expansão da desinformação e a interferência na autonomia do pensamento.', 'Primeiramente, é lícito postular que a influência digital corrobora com o crescimento da desinformação, posto que muitos influencers são incapazes de discernir as informações falsas das verdadeiras . A revista americana Entrepeneur apontou que 80% do tráfego online estão ligados a algum tipo de influenciador e que 92% dos consumidores acreditam mais nas recomendações deles do que de instituições . Sob essa perspectiva, fica evidente que o mundo virtual está mais sujeito a espalhar conteúdos enganosos, o que consequentemente coloca em risco a credibilidade de marcas que contratam tais serviços, já que as mesmas contratam a imagem do indivíduo para transmitir a figura de seu produto.', 'Em segundo lugar, é relevante examinar como o marketing digital interfere na autonomia do pensamento da população. Em face disso, o professor Fabrício Benevenuto concluiu que ""se muitas pessoas compartilham uma ideia, outras tendem a segui-la"". Benevenuto comparou sua tese à escolha de um restaurante, onde , entre um vazio e outro cheio, o indivíduo escolhe o cheio pois acredita que, se os outros já escolheram, deve ter algum fundamento nisso. Segundo essa linha de pensamento, as pessoas se apropriam da opinião de influenciadores e acabam, na maioria das vezes, por autossilenciar-se.', 'Entende-se, portanto, a importância da era digital na formação dos indivíduos. Desse modo, cabe aos influencers o dever de certificar a veracidade das informações, através de fontes confiáveis na internet, antes de compartilha-las em suas redes sociais, de modo a evitar a desinformação gerada pela mídia. Ademais, é necessário que a escola incentive o pensamento crítico dos alunos por meio das aulas de filosofia e sociologia e por meio de palestras, a fim de formar jovens independentes de opiniões alheias. Dessa forma, o Brasil será capaz de mitigar o efeito manada criticado por Pitty.']",160,160,160,160,160,800
60,Aposentar? Talvez,"['Um dos assuntos que mais geram discussões atualmente é, sem dúvidas, a reforma da previdência. Esta proposta do governo visa aumentar a idade mínima para se aposentar, ou seja, a idade mínima para um homem se aposentar será de 65 anos e 62 para as mulheres, porem a mudança só será aplicada aos novos trabalhadores.', 'Para as pessoas que já estão contribuindo por anos a mudança não tem tanto peso, o que gera tanta discussão sobre o assunto é que os novos trabalhadores irão demorar muito para se aposentar, isso se aposentarem.', 'Por outro lado, um ponto positivo desta proposta são as alíquotas , que serão maiores para os que recebem mais, e menores para os que recebem menos, diminuindo assim os impostos pagos.', 'A reforma da previdência tem seus pontos positivos e negativos, por isso, deve ser trabalhada e pensada de um modo que não prejudique demais os novos e os atuais contribuintes. Se vai ser algo positivo para o pas? Isso só o tempo pode nos dizer.']",120,120,80,120,40,480
73,Segregação,"['Apesar de já haverem 130 anos desde a abolição da escravatura, o Brasil ainda é um país retrógrado em questões de direitos civis, sociais e legais para com os negros. No seu último álbum, Beyoncé abordou a questão racial sofrida por pessoas de cor, pondo em pauta todas as discriminações, desde os dias passados até os dias atuais, sendo esta uma realidade vívida por eles não só no Brasil, mas também no mundo.', 'Desde sua abolição , é inegável a restrição de direitos para com negros, visto que eles foram libertados sem ao menos uma lei que os amparasse, garantindo seus direitos como cidadãos  Mesmo sendo o país mais miscigenado do mundo, o Brasil não arca com seus deveres diante do racismo no país . Por serem marginalizadas, pessoas pardas e pretas são privadas até hoje de terem acesso à educação, sendo este um dos problemas mais graves, pois quando somados, são maioria.', 'Segundo dados levantados, 66 vidas são tiradas diariamente justamente por terem a cor da pele mais escura, sendo 4.290 óbitos anuais e essa estatística difere o gênero, sendo mulheres negras as maiores vítimas desse problema . Quando é posto em discussão o mercado de trabalho, 6 em cada 10 negros perdem suas vagas para brancos e 60% deles já foram vítimas de racismo em seu ambiente de trabalho.', 'Portanto, medidas cabíveis devem ser adotadas para a resolução do impasse. O legislativo deverá elaborar uma emenda na lei que diferencie o racismo de injúria racial, pois esta última é uma punição rasa para racistas, dando brechas para o pagamento de apenas uma multa ou fiança. Os empregadores deverão agir com responsabilidade e poderão oferecer oportunidades para tais etnias menos privilegiadas. No aspecto novelístico, deverá haver oportunidades para atores negros interpretarem papéis que não reforcem o estereótipo da figura negra, assim conscientizando a sociedade de que pessoas negras também podem ser bem-sucedidas em suas vidas.']",120,120,120,120,120,600
82,A automedicação deve ser combatida,"['Cogita-se, com muita frequência, sobre o mau hábito da população de se automedicar sem que saibam  dos altos riscos que poderão ser ocasionados mediante à  isso. Observa-se que, atualmente, muitas pessoas fazem uso de medicamentos que, não necessariamente, tenham  sido prescritos por profissionais de saúde, mas sim por recomendações de outras pessoas que já tenham ou não feito uso destes .', 'O que grande parte da população não sabe é que o uso incorreto de medicações podem  causar graves problemas que se agravam com o tempo, podendo levar até mesmo à morte. A falta de conhecimento sobre um determinado remédio pode causar reações contrárias em seus efeitos.', 'Ainda convém lembrar que o ato de se automedicar sem que haja um conhecimento sobre os efeitos de um medicamento para com a doença que deverá ser tratada,  pode causar uma intoxicação. Além disso, a automedicação pode ocasionar em reações alérgicas à  uma determinada substância que contenha na composição do remédio.', 'Deve-se tratar os problemas de saúde com prévias recomendações feitas por um profissional que tenha o determinado conhecimento para prescrever o uso dessas drogas medicinais. As farmácias deveriam cobrar prescrições médicas para que não haja risco das pessoas comprarem remédios e se automedicarem. Deve-se reconhecer que cada caso é um caso e que, nem sempre, os efeitos causados em uma pessoa poderão ser os mesmos causados em outra.']",120,120,120,120,120,600
94,Autismo,"['A constituição federal de 1988, documento jurídico mais importante do país, prevê em seu artigo 5º, o direito à igualdade como inerente a todo cidadão brasileiro. Conquanto, tal prerrogativa não tem se reverberado com ênfase na prática quando se observa a inclusão dos portadores de autismo,dificultando,dese modo,a universalização desse direito social tão importante. Diante dessa perspectiva, faz-se imperiosa a análise dos fatores que favorecem seu quadro.', 'Em uma primeira análise, deve-se ressaltar a ausência de medidas governamentais para combater os desafios da inclusão dos portadores da síndrome. Nesse sentido,o campo social ainda aufere poucos investimentos para uma inclusão sólida. Essa conjuntura, segundo as ideias do filósofo contratualista John Locke, configura-se como uma violação do “contrato social”, já que o Estado não cumpre sua função de garantir que os cidadãos desfrutem de direitos indispensáveis, como a igualdade, o que infelizmente evidente no país.', 'Ademais,é fundamental apontar o preconceito da sociedade como impulsionador da dificuldade da inclusão de autistas no Brasil. Segundo Mantoan (2003),“Inclusão é o privilégio de conviver com as diferenças”. Diante de tal exposto,nota-se que a inclusão também deve acontecer através da mudança de mentalidade dos indivíduos. Logo, é inadmissível que esse cenário continue a perdurar.', 'Depreende-se, portanto, a necessidade de se combater esses obstáculos. Para isso, é imprescindível que os órgãos públicos, por intermédio de leis e campanhas publicitárias, atuem na quebra de barreiras que dificultam a inclusão – como a discriminação,preconceito e a ausência na variedade de leis inclusivas – a fim de promover a dissolução da problemática. Assim, tornar-se-á possível a construção de uma sociedade permeada pela efetivação dos elementos elencados na Magna Carta.']",160,200,120,200,200,880
84,Estrupo coletivo,"['Nesses últimos meses o Brasil tem se revoltado cada vez mais com os ocorridos, um caso que ocorreu há pouco tempo e gerou polemica foi de uma adolescente que afirmou que foi estuprada por trinta e dois homens e a situação foi gravada e postada nas redes sociais.', 'Esse caso teve muita repercussão por que surgiram fotos da garota com armas, roupas curtas e com homens, pessoas afirmaram que a mesma freqüentava o local e que pedia para ter relações com vários homens, e sendo assim a população se dividiu um lado apóia a vitima com o argumento que estupro é estupro, e o outro lado julga a vitima pelos seus atos, e diz que se ela não desse a liberdade ela não teria passado por isso.', 'O ocorrido resultou em marchas e campanhas nas ruas e internet, comentários de feministas e machistas tomam conta, é necessário ressaltar que o estupro se inicia quando a relação sexual é forçada, ou seja, quando o parceiro não deseja, no caso da garota ela estava embriagada e mesmo que ela tinha como costume ter relações com mais de uma pessoa isso não dava ao direito de outra pessoa sem permissão praticar o ato com a mesma. Já o histórico da vida da garota não deveria interferir no caso, pois, utilizando isso o foco que é o estupro acaba se perdendo.', 'Sendo assim, tanto o caso que foi relatado e tantos outros que ocorre não pode ficar impune, a atenção e os cuidados infelizmente tem que serem redobrados, o estupro é um crime e para quem o comete tem que ter uma condenação justa.']",0,0,0,0,0,0
84,Livre porte de armas,"['Atualmente, estamos cercados pela violência de várias formas, e é claro que algumas pessoas desejariam se sentir mais seguras, a maioria provavelmente gostaria de ter uma boa arma em casa guardada na gaveta, e outras prefeririam confiar em nosso conjunto de oficiais. Mas, qual seria a melhor opção?', 'Na maior parte das matérias jornalísticas, encontramos muitos relatos de tiroteios em vários lugares, envolvendo quase sempre bandidos e policiais, é claro que a população civil em si fica muito amedrontada pois, naturalmente se sentem ameaçadas . E se o governo e as forças militares resolvessem liberar o uso livre de armas por todo o nosso Brasil? Obviamente, o perigo aumentaria, porque se hoje em dia o porte sendo ilegal já faz muitos estragos em nossa segurança, se for liberado a situação só vai piorar.', 'O nosso desejo é que não houvesse pessoas ruins para que o porte pudesse ser aprovado legalmente, mas infelizmente, há cidadãos de má índole em qualquer lugar, então seria um ato muito insano prosseguir com a ideia da liberação.', 'Concluímos que, a melhor opção é deixarmos que os próprios militares cuidem das armas e seu manuseio, assim, trabalhando para evitar o porte ilegal de armas e aumentando a nossa segurança.']",160,160,120,160,200,800
78,REFORMA OU PROGRESSO?,"['Imannuel Kant uma vez citou:´´O ser humano é aquilo que a educação faz dele``, esta frase simples tem um forte siginificado na atual situação que a educação no Brasil está passando. A medida provisória da reforma do ensino médio põe em cheque o desespero do governo brasileiro em tentar transformar a educação no país, vista mundo a fora como precária e de baixa qualidade.', 'A reforma no ensino médio brasileiro é extremamente necessária para que aconteçam mudanças, porém  para que isto ocorra é preciso muito estudo e avaliação por parte da sociedade, porém como sendo uma medida provisória isto é deixado de lado. Mudanças sugeridas como aumentar a carga horária para um ensino integral é propícia até certo ponto, pois para que o aluno esteja na escola em período matutino e vespertino é preciso que aja dinamização e interatividade do ensino tanto em sala de aula com aulas teóricas quanto em laboratórios e aulas de campo o que não costuma ocorrer.  Para isto, as escolas públicas, estaduais e municipais necessitam de um grande investimento para atender esta demanda, caso não, o ensino se tornará tedioso e exaustivo .', 'Além disso, é necessário repensar a grade curricular das matérias estudadas no ensino médio, pois todas as matérias tem um peso singular no nosso conhecimento e formação pessoal, porém nem todos os estudantes têm afinidade com determinadas matérias, portanto, é necessário dividi-lás, mas não como áreas de conhecimento, pois o ser humano é multifacetado e pode seguir uma carreira que necessite de vários entendimentos , o ideal seria  além de ter aquelas matérias obrigatórias, o aluno poder optar e escolher propriamente quais matérias seguir . Deve-se pensar também no aluno, um pré-adolescente, que não formou uma opinião sobre sua carreira e no estudante que decide mudar de área visto que aquelas inicialmente escolhidas não lhe agradaram . Além do professor que será desvalorizado, visto que valerá o notrio saber e não um profissional qualificado .', 'Pode-se concluir, portanto que o governo brasileiro, especificamento o MEC,  precisa rever estas medidas e analisar todos os aspectos negativos e positivos que estas acarretar na vida escolar, profissional e pessoal do indivíduo. Existem sempre dois lados de uma decisão e esta reforma do ensino médio, infelizmente, está pesando mais para o lado negativo, visto que além dos temas abordados acima, há diversas outras divergências que atigem diretamente os estudantes e professores que não podem ser usados como fantoches . Para que cesse a calamidade na educação do Brasil é necessario muito mais envolvimento, discussão, e reformas democráticas que promovam o conhecimento de forma adequada.']",120,120,120,120,120,600
21,Ao se pensar a respeito da greve dos caminhoneiros,"['Ao se pensar a respeito da greve dos caminhoneiros é possível afirmar que ela é legítima sendo um importante instrumento popular para a luta por conquistas sociais e econômicas.', 'O primeiro fator a ser analisado é que sem manifestações e paralizações , o governo não cederia nenhuma reivindicação . Entende-se com isso que sem pressão não haveria nenhuma forma de pressionar pela queda do preço do óleo diesel, do frete, etc.', 'O segundo fator a ser considerado é que a paralização , por quase uma semana, afetou toda a cadeia produtiva; como exemplo, postos ficaram sem combustível, mercados sem produtos e assim por diante.', 'Assim, a necessidade de lutar por conquistas como a redução do valor do óleo diesel só foi possível com o governo se sentindo pressionado pela paralização , mesmo que isso tenha trazido efeitos colaterais sentidos pela população, como o desabastecimento sentido por todos.', '']",80,120,120,80,0,400
8,A ciência na era da pós-verdade,"['Atualmente a ciência já desmitificou vários fatos importante importantes de grande relevância com relevância, como também contribui para contribuiu com a sociedade em diverso acontecimento histórico diversos acontecimentos históricos, porém gerou-se geraram-se outros mitos sobre a terra Terra plana ou redonda.', 'segundo Segundo os relatos dos livros de historias História, no período do século xiv e xv dos séculos XV e XVI, nas grandes navegações expansão marítima nas Grandes Navegações, durante a expansão marítima, tinha havia diversos mitos sobre a terra Terra que era comentado uns do grande mito o qual desse era sobre de que o planeta era plano e também poderia cair um grande abismo com diversos monstros, entretanto era no período que existia tantos recursos tecnológico com hoje de equipamento de precisão, diversas pesquisas fundamentada, publicação em revista cientifica científica conceituada a qual demonstra uma veracidade para comprovar para a população porem dúvida deixou uma lacuna em aberto para outra parte da sociedade mais em intelectual que desacorda em alguns itens ou duvida sobre a existência. São acontecimento acontecimentos de relevância que trouxe beneficio trouxeram benefícios um exemplo Albert Einstein com uma formula fórmula de energia massa velocidade luz onde contribuiu para desvenda à desvendar a energia atômica é como isso acrescentou para desenvolvimento militar como a bomba atômica mas também com usina nuclear para gerar eletricidade.', 'por tanto Portanto, fica claro que a ciência buscar desenvolver é contribui e demonstra para a sociedade de que realmente pode acreditar nela até porque especulação não tem fundamento cientifico científico é abstrato.']",0,0,0,0,0,0
56,,"['Segundo anlise realizada pela ONG Human Rights Watch estimou-se que, no final de 2018, o número de presos no Brasil já passava de 840 mil. É a terceira maior população carcerária do mundo, atrás apenas daqueles dos Estados Unidos e da China . Logo, rebeliões em prisões brasileiras vêm se tornando cada vez mais frequentes desde o ano de 2017 no Brasil, visto que o sistema carcerário nacional só tem capacidade para abrigar a metade dos atuais detentos.', 'Exemplo dessas rebeliões aconteceu recentemente no mês de maio de 2019 na cidade de Manaus onde ocorreu a morte de 15 detentos resultado de motim, em seguida outros 40 detentos foram encontrados mortos em outras três unidades prisionais da capital amazonense . Resultado disso é a falta da má Administração Pública sobre os presídios onde as grandes facções controlam a criminalidade.', 'Outra consequência da superlotação dos presídios é a situação insalubre e até desumanas, diante disso, muitos presos recorrem ao udiciário e são postos em liberdade sob o argumento de que as prisões violam direitos humanos básicos. Além da situação precária das penitenciarias, o direito à educação, ao trabalho e à saúde é ignorado, a falta de empatia e preconceito da sociedade se tornam um conjunto de negligências que contribui para o alto índice de reincidência no crime.', 'Visto isso, torna-se evidente, a necessidade de se discutir a questão da situação carcerário do rasil. Cabe ao Ministério da Educação (MEC) junto ao Ministério da Saúde (MS) e ao Ministério do Trabalho, promover ações efetivas advindas do uso de verbas publicas a fim de integrar nos presídios brasileiros programas de educação básica que ajudara o detento a se reintegrar na sociedade após sua pena ser cumprida, já que o governo oferece subvenção econômica trimestral de dois salários mínimos a cada ex-presidiário admitido. Além disso, dar auxlio medico e kits de higienização pessoal o que evitara contrabando vindo de fora. Como também melhor fiscalização das prisões por parte dos agentes penitenciários. Tudo isso somado trará melhor condição de vida aos detentos e a sociedade como um todo.']",120,160,120,160,80,640
145,(Sem título 056),"['O Brasil foi escolhido como sede para a Copa de 2014 e desde então vemos discussões a respeito dos benefícios e malefícios que         este         evento trará ao país.                 Com todos os investimentos, acredita-se que tais mudanças ficarão como legado para o país, visto que tais investimentos são melhorias em vários setores.', 'Há         4         anos, o Brasil vem sem preparando e passando                 por reformas                nos campos de transporte, estádios, hotelaria e segurança. Com a construção dos         12         estádios onde ocorrerão os jogos, percebemos que muito dinheiro está sendo gasto de maneira exagerada, porém será um investimento que ficará para a população brasileira desfrutar posteriormente.', ""O Brasil tem como missão mostrar se é realmente o ''País do Futebol''.                Vemos a falta de         infra-estrutura         em hospitais, um baixo investimento na educação e a baixa qualidade de vida da população. Será que com tantos problemas o Brasil está realmente capacitado para sediar a Copa do mundo neste ano? A saúde brasileira se encontra precária, vemos principalmente pessoas morrendo nas filas de hospitais esperando por um bom atendimento e por um vaga."", 'A preparação para a Copa já está          em          reta final e a população deve se conscientizar do quanto o Brasil precisa melhorar.                Ao governo cabe a meta de fiscalizar os gastos e preservar todos os patrimônios que foram construídos e visar não somente a Copa do mundo, mas principalmente focar nas melhorias em outros         ramos na         realidade                que o país se encontra, buscando assegurar a saúde, segurança e educação que são direitos da sociedade brasileira.']",120,120,80,80,120,520
59,A fome e a desigualdade social no Brasil.,"['A fome no Brasil atinge o povo de forma cada vez maior, s populações que mais sofrem com isso', 'são os mais pobres.', 'O problema da falta de alimentos está ligada diretamente a falta de oportunidades, sejam elas', 'sociais ou não . Uma das primeiras questões a serem discutidas nesse assunto é o desemprego, o', 'desempregado não tem condições e nem possibilidades, consequentemente o pobre ficará sem dinheiro', 'para comprar comida. Por meio dessa desigualdade financeira muitos enfrentam a fome, a miséria, a', 'pobreza, etc.', 'Outro fator muito importante que conta para a desigualdade, é o sistema educacional falido, onde muitas', 'crianças têm pouco ou nenhum acesso à iscola. quantas e quantas crianças vão ""\'studar""\' somente', 'para comer o lanche, afinal, em suas casas não há o que comer, tragicamente os estudos ficam em', 'segundo plano impossibilitando que os pupilos se transformem em adolescentes estudiosos e adultos', 'com bom cargos e bom salários.', 'Uma educação de qualidade geraria ótimos profissionais, cabe ao governo proporcionar essa', 'opção aos pequenos e alavancar o mercado de trabalho, é sem sombras de dúvidas são os principais preceitos para diminuir essa escassez de alimentos, exterminando assim, a desigualdade.']",120,120,80,120,80,520
95,Debate sobre o marco temporal,"['Na obra ""Brasil: uma biografia"", as historiadoras Lilia Schwarcz e Heloisa Starling apontam ao leitor as idiossincrasias na sociedade brasileira. Dentre elas, destaca-se ""a difícil e tortuosa construção da cidadania"". Embora o país possua uma das legislações mais avançadas do mundo, muito do que nela se prevê não se concretiza. Tal fato é evidenciado no âmbito do debate sobre o marco temporal, tendo em vista que, apesar dos indígenas possuírem um direito constitucional, a omissão do Estado associada ao silenciamento, faz com que a cidadania não seja gozada por todos de maneira plena.', 'Dessa forma, em primeira análise, a ineficiência governamental intensifica a gravidade do problema. Para Thomas Hobbes, o Estado é responsável por garantir o bem - estar dos cidadãos. Porém, tal responsabilidade não está sendo honrada quanto aos indígenas, visto que o governo não está tomando atitudes para beneficiar essa população em relação sobre o marco temporal . Assim, para que tal bem - estar seja usufruído, o Estado precisa sair da inércia em que se encontra.', 'Além disso, outra dificuldade enfrentada é a questão do silenciamento. De acordo com o filósofo Foucault, na sociedade pós-moderna, alguns temas são silenciados para que estruturas de poder sejam mantidas. Nesse sentido, percebe-se uma lacuna no que se refere ao debate em torno do marco temporal, que tem sido silenciado . Assim, sem diálogo sério e massivo sobre esse problema, sua resolução é impedida.', 'Logo, medidas estratégicas são necessárias para alterar esse cenário. Como solução, é preciso que as escolas em parceria com a prefeitura, promovam um espaço para rodas de conversa e debates sobre o marco temporal. Tais eventos podem ocorrer no período extraclasse, contando com presença dos professores e convidados especialista no assunto. Além disso, tais eventos não devem se limitar aos alunos, mas ser aberto à comunidade, a fim de que mais pessoas compreendam questões relativas ao tema e se tornem cidadãos mais atuantes na busca de resoluções.']",160,200,120,200,120,800
147,A alternativa necessária,"['A política brasileira sempre foi          contestada  . Seja         pela falta de preparo dos políticos, seja pelas inúmeras denúncias de corrupção. O modelo eleitoral atual                 é o voto proporcional misto                , que demonstra muitas falhas e ineficiência                 até hoje. Sendo necessário a adoção de um novo modelo eleitoral, o voto distrital.', 'O voto distrital consiste em dividir o país em pequenas áreas,                 por isso distrital                , a fim de restringir o candidato         para         sua respectiva área. Esse modo de escolha trará consequências positivas para a política brasileira. Irá aproximar o cidadão do                 político eleito                , consequentemente o eleitor terá maior facilidade para acompanhar e cobrar as ações do                 político votado                .', 'Além de diminuir o distância existente entre políticos e         população         irá reduzir os custos das campanhas políticas, haja         visto          sua restrição na área de ação. Fortaleceria também o significado da eleição                , pois no modelo vigente, leis e normas são usadas a favor de candidatos que apenas atingem o cargo devido aos votos a outro político.', 'Sendo         assim é clara as falhas         do sistema atual haja         visto         a corrupção e o abismo entre candidato e cidadão. Como alternativa para solucionar esses         problemas         o voto distrital trará a valorização do voto do eleitor.']",120,120,80,120,120,560
83,,"['O Brasil é conhecido mundialmente como o país do futebol, e em competições mundiais sempre ocupamos lugar de destaque, mas além do privilégio de estar entre os melhores, a prática esportiva traz inúmeros benefícios físicos, mentais e sociais, visto que o esporte é uma forte ferramenta para manter o corpo em movimento, livrando-se assim do sedentarismo, e é também uma forma  de socialização , pois é praticada em grupo.', 'Sabe-se que a prática esportiva constante proporciona, além de um condicionamento físico e manutenção da saúde, valores importantes para a formação da cidadania como o autoconhecimento, respeito às regras e companheirismo, valores que fazem do esporte uma forte arma social, principalmente para jovens em formação. Porém, a falta de investimento em dependências esportivas, sobretudo nas escolas, inviabiliza a sua prática e prejudicam a formação de milhares de jovens brasileiros. Além disso, a supervalorização do futebol prejudica a popularização de outros esportes e acaba afastando aqueles que não se adaptam a prática futebolística.', 'Sendo assim, é indispensável usar o esporte como arma social, pois ele ensina valores fundamentais para o convívio social. Contudo, é necessário que o governo invista em aparatos poliesportivos, para a prática e divulgação de vários esportes, tanto nas escolas quanto em bairros carentes(.) associado a isso, é importante investir na formação profissional do educador físico, para que esse ensine as diferentes modalidades e os verdadeiros valores contidos no esporte, usando dessa arma para a formação do caráter e promoção da cidadania.']",120,160,200,200,200,880
69,Intoxicação agrotóxica,"['Promulgada pela ONU em 1948, a Declaração dos Direitos Humanos garante a todos os indivíduos o direito à saúde e ao bem-estar social. Conquanto, o principal problema dos agrotóxicos é a intoxicação , tanto do homem quanto dos animais e do meio ambiente impossibilitada que essa parcela da população desfrute desse direito universal na prática . Nesse sentido, convém analisarmos as principais consequências de tal postura negligente do uso de agrotóxicos para nossa  sociedade, assim é necessário que subterfúgios controlados a fim de resolver essa inercial problemática , diante desse contexto, não há dúvidas de que o uso de agrotóxicos no Brasil é um desafio aís; mas também em casos de intoxicação de trabalhadores durante o processo de produção até a intoxicação de cidades próximas e a intoxicação nos alimentos.', 'A educação é o fator principal no desenvolvimento de um aís. Hodiernamente , ocupando a nona posição na economia mundial, seria racional acreditar que o Brasil possui um sistema público de ensino eficiente. Contudo, a realidade é justamente o oposto e o resultado desse contraste é claramente refletido no uso de agrotóxicos no Brasil. Uns dos problemas mais comuns é a contaminação do solo, lençóis freáticos, contaminação de rios e lagos e a saúde humana. De acordo com o Greenpeace, o Congresso Nacional já tem em mãos um projeto para uma agricultura melhor para quem planta e para quem come: a Política Nacional de Redução de Agrotóxicos (PNaRA).', 'Faz -se mister, ainda, salientar as negligências de nossas  atitudes como impulsionador do uso de agrotóxicos. De acordo com Zygmunt Bauman, sociólogo polonês, a falta de solidez nas relações sociais, políticas e econômicas é a característica da ""modernidade líquida"" vivida no século XXI. Diante de tal contexto é possível obter benefícios sem o uso de agrotóxicos ?.', 'Infere -se, portanto, que ainda há entraves para garantir a solidificação de políticas que visem à construção de um mundo melhor. Dessa maneira, urge que uma possível alternativa para a substituição de agrotóxicos são os biopesticidas, ou seja, substâncias naturais ou derivados de plantas geneticamente modificadas que façam controle de pestes, dessa forma, o Brasil podeira  superar o uso de agrotóxicos nas lavouras.']",120,120,120,120,120,600
84,Segurança para quem?,"['O porte de arma pela população civil tem sido um assunto evidentemente comentado nesses últimos dias, devido aos ataques terroristas acontecendo ao redor do mundo. O que muitos alegam é que essa seria uma solução para nossa própria segurança, porém esquecem que cidadãos armados sem um devido treinamento geram cada vez mais violência.', 'Se as maiorias das pessoas são contra a morte, consequentemente será contra o porte de armas, pois segundo os dados da ONU mostram que mais armas acarreta em mais mortes, porque com a autorização dessas armas, maior número de pessoas sem um preparatório antes irá portá-las, assim em qualquer momento que achar (que) está em “perigo” irá disparar contra a vida de outra pessoa. Ninguém precisa de armas para viver, se as têm é porque em algum momento da vida tem a intenção de utilizá-las. Liberar essas armas só dificultaria o trabalho policial, aumentando o número de pessoas criminosas andando com elas. Os ataques terroristas nos mostram isso, eles têm uma ideologia e o acesso a armas, espalham suas ideias causando medo ao redor do mundo,atacando as pessoas inocentes. Colocar armas de fogo nas mãos de quem não sabe lidar com elas só ocasionará mais mortes.', 'Portanto, diante desses fatos o governo deveria proibir as vendas de armas, terem leis rigorosas com as pessoas que forem pegas portando-as elas , também ter maior monitoramente contra o tráfico de armas, (.) para que isso veja feito a polícia tem que está extremamente treinada e preparada para enfrentar a violência em todas as suas formas. Pois menos armas significam menos mortes.']",120,160,160,160,200,800
91,...,"['No final da Segunda Guerra Mundial surgiu  movimento negando a existência do Holocausto -massacre do povo judeu- esse acontecimento não se limitou apenas isso e foi para o campo científico contradizendo a ida do homem a Lua, a vacina, o aquecimento global e o formato da Terra estes movimentos são chamados de negacionismo científico . Devido a isso, alguns efeitos surgiram como teorias pseudocintficas e volta de doenças já erradicadas.', 'Nesse contexto, vale ressaltar que a ciência teve avanços nas últimas décadas, entretanto algumas pessoas tendem a negar esta verdade. Como o advento das redes sociais os negacionistas ganharam força levantando questionamentos como o terra planismo refutado por Galileu Galilei na idade média para tanto surgem respostas para entender o porquê dessas teorias pseudociêntificas como a de Freud que diz que existe um mecanismo psicológico que tende a negar a verdade. Então para tais teorias não ganharem mais força é necessário levar informação para todas as pessoas.', 'Ademais como consequência surgiram os movimentos anti-vacinas. Depois do surgimento da vacina doenças que antes eram motivo de grande preocupação chegaram a ser erradicadas, porém, com o crescimento do negacionismo científico alguns pais não querem vacinar seus filhos e consequentemente tais doenças voltaram a aparecer como exemplo o sarampo. A volta dessas doenças pode ser explicada pela pesquisa feita pelo Pew Research Center, que indica que mais de 36% da população brasileira não acredita na ciência  algo preocupante que infelizmente está acontecendo.', 'Portanto, uma intervenção deve ser feita, pois, a ciência é necessária para todos. Por isso o Ministério da ciência e tecnologia responsável pela organização dessas áreas  deve criar para propagandas pregando a valorização da ciência de modo que essa programa sejam divulgadas da grande mídia- com a ajuda de empresas privadas- . Somente assim, será possível mostrar população com a ciência importante para tudo é essas teorias pseudocientíficas como as citadas no início cairão por Terra.']",160,160,160,160,160,800
101,(Sem título 030),"['É notável que o Brasil, infelizmente, possui         o         sistema de segurança pública         é precário         e,         por outro lado,         as pessoas criam métodos para escapar da violência. Contudo, os brasileiros estão com                 os valores          invertidos, onde          a sociedade está submersa num mar de sangue.', 'Uma ONG – Organização Não Governamental –         Mexicana         levantou uma pesquisa com as 50 cidades mais perigosas do         mundo, onde         14 delas são brasileiras; essa informação ratifica o histórico da insegurança, mas não é novidade para ninguém.                 Dessa forma                , qual seria a melhor maneira de minimizar a criminalidade no Brasil?', 'No Rio de Janeiro, por exemplo, a medida tomada pelo governo foi ocupar as comunidades com policiais para tirar o poder do tráfico e, consequentemente, a                 criminalidade desapareceria. Porém, esses profissionais têm outro problema para enfrentar: os baixos salários; e, muitos deles, recorrem à corrupção que acarreta em mais problemas para sociedade.', 'Por fim, uma forma imediatista de diminuir a criminalidade no Brasil é ter mais rigor nas leis como:                 diminuição da          maior idade          penal, prisão perpétua e, em alguns casos, a pena de morte.                Entretanto, por mais utópico que pareça, a melhoria da educação seria a                 única capaz de implantar o amor no coração das pessoas                , afinal, “Gentileza Gera Gentileza” como dizia o nosso sábio profeta.']",120,120,120,80,120,560
129,A ética familiar,"['Relativo         à formação da família e suas         transmutações         é possível afirmar que os acontecimentos influenciam         direto         ou indiretamente na educação dos jovens. A                 facilidade                dos meios de         comunicação aliado         à presença da         mídia         revela um novo modelo familiar,                 no qual as pessoas são alienadas de forma ostensiva e acabam seguindo um padrão oferecido erroneamente.', 'É perceptível que o fácil acesso         as         mais novas formas de tecnologia expõe                 olhares                ofensivos para a sociedade, fazendo-a refém                 das imagens criadas sinuosamente. Um grande exemplo é a novela “Babilônia” que expressa sentimentos e ideais distintos aos das famílias, alterando a educação base e intervindo, sobretudo, na formação dos jovens que evoluem com o pensamento confuso e imaturo.', 'Somado a isso, é nítido o poder controlador que a mídia está exercendo sob o espaço familiar,                 transmitindo papéis incentivadores com a finalidade de estimular desordenadamente as pessoas a acompanhar cada cena a ser transposta.                O problema surge quando a ficção passa a ser realidade,                 tornando a tradição e a cultura de cada família aquém de uma situação favorável                ,         no qual         as funções que eram para ser dos pais passam                 a ser redigidas para manejo dos meios de vinculação.', 'A estrutura familiar, portanto, está sendo conturbada                 pela imagem que as pessoas passam a divulgar juntamente com os meios de comunicação. É oportuno desenvolver adaptações, cuja possam interferir nas simulações que a mídia procura exaltar, junto á                  trabalhos socioeducativos que busquem conscientizar a sociedade que enxergam nesses papéis a sua realidade.']",80,120,80,80,0,360
118,"Beagles, as únicas vítimas?","['Os testes de produtos em animais         é         uma necessidade do avanço         cientifico         . Eles são importantes, pois podem evidenciar possíveis riscos que         estes         produtos podem oferecer         com         sua         utilização         .', 'A         utilização         de ratos de laboratório é tradicional no meio         cientifico         ,                 por ser de fácil reprodução, possuir                bom tempo de vida entre gerações, e                 possuir                algumas semelhanças                 morfológicas à morfologia                humana,         fazendo-os viáveis         para a experimentação.         Porem         a sua utilização causa questionamento sobre a natureza e os objetivos do experimento, devido aos sentimentos e medos que                 eles                apresentam,         caracterizando         o experimento como antiético.', 'Recentemente         houve a constatação do         uso de cães da raça beagle como cobaias de testes de produtos cosméticos. Tal descoberta causou revolta na                 população                e desencadeou protestos                 contra a utilização desses cães nesses testes                , no entanto soa injusta a proteção de apenas um pequeno grupo de animais por meio         destes         protestos, sendo que no meio cientifico é muito comum a utilização de ratos e chipanzés em experimentos como cobaias, isso ocorre por seu sistema morfológico ser similar ao humano.', 'Os protestos que ocorreram tinham como propósito conscientizar a população sobre os possíveis maus-tratos aos animais que serviram como cobaia,         porem          tais movimentos tinham membros de grupos          mau-intencionados          , como o          do          black blocs, infiltrados que utilizaram          dos movimentos          para dificultar a identificação de seus integrantes durante o ato de vandalismo que praticaram, fazendo ainda que o movimento perdesse sua credibilidade.', 'Assim, portanto         é importante conciliar o avanço         cientifico, condições         éticas que envolvem animais e humanos como cobaia. Isso pode ser feito banindo a utilização de seres que possuam capacidade de sentir dor ou sentimento e utilizando seres vivos que                 possuam seu sistema nervoso ausente ou pouco desenvolvido que possuem pouca capacidade para sentir dor ou sentimentos                , amenizando assim                 problemas com questões éticas                no desenvolvimento         cientifico         .']",120,120,80,80,80,480
95,o Marco temporal,"['Marco temporal segundo os indígenas defendem o direito originário á terra por estarem aqui antes da criação do estado brasileiro. O marco temporal também ignoraria os povos que foram expulsos de suas terras sob violência ou devido à expansão rural e urbana dos brancos, pelo desmatamento ou mortos por proliferação de doenças quando a Constituição federal foi promulgada.', 'Em 2009 o STF  teve que resolver os conflitos dos indígenas com produtores de arroz que disputavam pela terra indígena Raposa Serra do Sal. No artigo 231 da Constituição diz que são reconhecidos pelos índios sua organização social pelos seus costumes, línguas, tradições, crenças, direitos originários sobre a terra e proteger e fazer respeitar todos os seus bens.', 'Levando em conta o marco temporal defende apenas as terras que fossem julgadas da mesma maneira.']",120,80,80,120,0,400
60,,"['Um tema mais do que controverso vem sendo alvo de várias discusses inclusive em papos informais entre a família: a reforma da previdência . As dúvidas são será que a reforma é de fato necessária e de que forma ela deve ser feita . Afinal, a reforma é problema ou solução?', 'É um fato que o país está envelhecendo e que o déficit orçamentário vem aumento devido aos gastos com a previdência social . Por isso uma atitude deve ser tomada;  não dá pra continuar como está pois segundo alguns estudos, a previdência pode tomar até 100% do orçamento daqui a alguns anos.', 'Por outro lado a reforma que vem sendo apresentada possui alguns pontos críticos que podem ser revistos . Não é necessário que aumente tanto os anos de contribuição. Deve-se achar um meio termo para se adequar ao que o trabalhador deseja e também ser benéfico para o país.', 'Portanto pode-se entender que a reforma é sim uma solução  pois a previdência precisa ser atualizada. No entanto, é preciso encontrar a melhor maneira de reforma-la para que tanto o governo quanto o trabalhador fiquem satisfeitos. Dessa forma ambos podem sair ganhando e o país pode resolver um enorme problema que vinha corroendo o orçamento federal.']",120,120,80,120,120,560
61,Deu-nos a pátria querida,"['De acordo com a lei 13.819, sancionada com o intuito de prevenir o suicídio, é de extrema importância atentar-se a problemas de saúde pública que são passíveis de prevenção. Todavia, na nação tupiniquim, a aplicabilidade da lei é falha ao que tange o suicídio entre os policiais. Uma vez que ora a falta de medidas de segurança pública eficazes, ora o desamparo aos agentes gera o número crescente de mortes, s quais ultrapassam os ocorridos no horário de serviço. Logo, é mister que medidas sejam tomadas para solucionar essa celeuma .', 'A priori, é lícito postular o caráter negligente do Governo com a coletividade. Segundo o filósofo Thomas Hobbes o Estado é responsável por garantir o bem-estar da população. Entretanto, a hodierna pátria verde-amarela, não possui essa proteção. Infelizmente, os policiais são diretamente afetados pela falta de segurança pública. Isso porque além da profissão estressante, também são obrigados a temer por suas vidas fora do combate armado. Por consequência, em detrimento de tamanha pressão, muitos colocam fim a suas vidas. Por isso, é inadiável a melhoria da segurança pública e das condições de trabalho dos agentes.', 'Ademais, é substancial destacar a falta de empatia sofrida pelos oficiais. Consoante a filósofa Hannah Arendt a Banalização do Mal é seriamente prejudicial a população. Uma vez que não só naturaliza o assassinato de jovens negros por policiais –agravante do racismo e da violência-, como também a morte de agentes devido a vingança. Sendo assim, os policiais diariamente necessitam tomar difíceis decisões e todo cansaço psicológico em simbiose a falta de apoio gera suicídios em massa.', 'Depreende-se, portanto, que o suicídio entre os policiais é um problema de saúde e de segurança pública e necessita ser findo . Para tanto, o Governo Federal- órgão de maior representatividade no Estado- deve implementar medidas de segurança eficazes. Por meio de mais agentes, e melhor tratamento ao psicológico de todos, além disso é necessário acabar com o errônea visão de conectar a negritude ao crime, afim de diminuir a violência. Quiçá  assim, os governantes compactuem com Hobbes e a população seja bem gerida.']",120,120,80,120,120,560
68,RECONHECIMENTO DE HISTÓRIAS DE UM LOCAL,"['Ao longo dos anos a cultura ganha mais espaço entre meios sociais e ao decorrer do período  a sociedade se esquece ou não vive algo que foi um simbolo, uma marca e um registro importante para aqueles que presenciaram aquele momento.', 'O patrimônio histórico se caracteriza pelo encontro e pelo fato da recordação daquilo que não foi presenciado ou esquecido, em apenas um ou vários ambientes onde se encontra bases desses importantes monumentos históricos, sendo eles casas , objetos ,ambientes , entre outros.', 'A tombação dos ambientes ganham valor cultural e um valor histórico para o país, para o município, para o estado e para cada um que valorizam a lembrança. Ganhando o valor maior na cultura e no enriquecimento do saber.', 'Sem esses patrimônios não se lembrariam e nem poderiam visitar o local que teve por traz uma história importante .', 'Portanto, o patrimônio histórico precisa sim ser tombado e preservado para a conservação de lembranças de um determinado local. As pessoas precisam desfrutar e conhecer tudo aquilo que foi importante!']",120,80,80,80,80,440
72,Fake news uma problemática social,"['É notório que o saber sempre esteve atrelado às inúmeras realizações humanas, sejam elas de cunho científico, religioso, antropológico e político-econômico. Haja vista que o conhecimento possibilitou a humanidade conhecer os complexos da vida, também permitiu a difusão de informações pelo mundo, pois a imprensa de Gutenberg no século XV revolucionou seu tempo. Configurando, dessa forma, diretrizes para desenvolver criticidade e, assim, incutir direitos sociais obrigatórios. Mas, a problemática atual dos fake news trazem uma distorção da realidade e prejudicam o indivíduo leitor; além disso, em época de eleições vem ocasionando discussões e injustiças por polarizar ideologias intolerantes.', 'Primeiro, discutir acerca desse cenário é formalizar uma reflexão às negativas pelas quais o cidadão enfrentará , porque estarão sujeitos ao obscuro da internet em um espaço no qual todos podem compartilhar ideias e conteúdos, por outro lado, muitos não apresentam qualidade, autenticidade e base legal para noticiar um fato . Então, percebe-se quão difícil é a situação daqueles que buscam por informações verdadeiras, e como bem diz o escritor italiano Umberto Eco, “a internet deu voz aos ignorantes”. Logo, é preciso entender que estar sujeito aos fake news na contemporaneidade é valer-se da atenção em ler algum artigo, bem como investigar suas fontes remetidas.', 'Segundo, o combate s notícias falsas começa a partir do momento em que o caráter e a sensibilidade ao próximo estejam acima da simples conscientização , dado que o respeito é uma ação ética proliferado através da construção social, porém, o hábitos em fortalecer tal cidadania é quantificar e qualificar as instituições sociais defendidas pelo sociólogo francês Émile Durkheim, tais como escola, sistema judiciário, poder policial e outros. Portanto, essa é uma questão conjuntural, efetiva e injusta, principalmente em tempos de eleições presidenciais, cujas propagandas, como exemplo das eleições nos Estados Unidos em 2016, utilizaram de informações hipócritas para difamar o oponente. Construindo, dessa maneira, um ambiente antiético, conflituoso, cheio de discussões e xingamentos desnecessários .', 'Por último, constata-se a influência da era digital no mundo moderno e o uso para fins maliciosos dentro dessas plataformas para gerar informações dúbias e sem contexto. Contudo, resoluções são precisas para resolver o impasse. Nesse contexto, seria pertinente o corpo escolar desenvolver projetos junto à comunidade para que venham discutir a importância em buscar conhecer as fontes dos noticiários e propagandas.']",120,160,160,160,120,720
52,Liberdade irracional,"['Seres vivos, podemos citar inúmeros, podendo ter diferenças físicas, mentais, mas algo que todos possuem em comum: ciclo vital.', 'Todos tem esse mesmo objetivo, nascer, crescer, se reproduzir e morrer. Dentre todos essas etapas do ciclo vital, a mais importante e responsável pelo crescimento dos seres vivos é a reprodução.', 'Tendo em vista esse conceito, a reprodução assemelha-se como algo positivo, entretanto, pelo fato de que, segundo Aristóteles, o ser humano é um animal racional, ele tem a capacidade de escolher entre se reproduzir ou não; cuidar de um bebê ou não. E esse é o principal problema da gravidez precoce, pois um jovem tem sonhos, objetivos que ainda não foram alcançados e se deparando com uma situação de gravidez, se vê como seu futuro estivesse acabado, muitas vezes recorrem a orfanatos, parentes ou abandono.', 'Essa liberdade que provém da racionalidade faz pessoas cometerem atitudes horrendas, como diz George Shaw, ""Liberdade significa responsabilidade. É por isso que tanta gente tem medo dela."" Essa é a visão que os jovens precisam ter antes de tomarem atitudes irresponsáveis que podem prejudicar tanto eles como a criança que irá vir ao mundo.', 'Logo, a divulgação dos métodos contraceptivos para jovens é essencial, pois é necessário para nossa nação fazer, por meio da educação, uma sociedade futura responsável.']",120,80,40,120,40,400
103,Automedicação,"['Comumente                 se vê pessoas                praticando a automedicação, muitas vezes porque                 viu                a         propagando         do medicamento na televisão, outras vezes por conselho de um conhecido. A automedicação, por um lado, é         boa         para não sobrecarregar os hospitais,         mas por outra         coloca em risco a vida de quem a pratica.', 'A questão “saúde” no Brasil ainda é algo que merece mais atenção e investimentos. Os hospitais, sejam eles públicos ou privados, e postos de saúde, estão com superlotação, o que causa demora no atendimento e uma má prestação de serviço. A fim de evitar a         espera         muitas pessoas fazem a automedicação. Os jovens, os mais adeptos da prática, são                 muitas vezes                influencias pelas propagandas,                 muitas vezes                ilusórias, vinculadas         aos         meios de comunicação,                 uma vez que eles assistem a tevê e ouvem ao rádio mais do que uma pessoa adulta.', 'Não é raro ouvir casos de pessoas que morreram por se automedicar, muitas vezes devido a uma superdose do medicamento. A prática é algo que pode ser fatal. Segundos a Fundação Oswaldo Cruz (FIOCRUZ), em 2007 quase que 35 mil pessoas sofreram intoxicação por se automedicarem, sendo que 90 morreram.', 'As pessoas, e principalmente os jovens, devem ter consciência que                 remédio é uma droga                , e que deve ser ministrado somente por                 pessoas eruditas no assunto                , que estudaram e que sabem a melhor forma de tratar o problema. Devem saber que automedicação é prejudicial à saúde, podendo levar         a         morte ou causar sérios riscos ao corpo.', 'Os usuários de redes sociais,         na maioria os jovens         , devem criar grupos e divulgar o problema para o maior número de pessoas possíveis, informando o risco que elas correm com a automedicação. Os maiores laboratórios, para evitar que a população sofra problemas sérios com a prática, devem vincular junto         a         mídia comerciais informando os graves danos que podem acontecer aos adeptos da prática.                 Nas propagandas dos medicamentos todos os laboratórios devem informar as reações adversas mais comum, juntamente com interações medicamentos.']",120,120,80,80,120,520
76,Direitos e lutas,"['Ao longo dos anos, a mulher vem deixando de ser submissa ao homem e tornando-se independente. Como já visto em muitos livros de história ou até mesmo em literaturas de estilos antigos, como ""O Guarani"", a mulher deixou da dependência do pai ou do marido para afazeres, não só domésticos, como também, dentro de empresas . Conquistaram direito ao voto, empregos que antes eram somente destinados a homens, como até mesmo, a presidência de uma república, como nunca visto antes.', 'Já descrito visivelmente na sociedade, ela tem se igualado em cargos que somente dedicados a homens eram; mas há, nesse caso, uma grande controvérsia: enquanto o homem, nesse mesmo cargo, ganha um alto valor salarial, a mulher, por sua vez, não ganha, muitas vezes, dois terços do mesmo valor. Isso, além de mostrar uma grande arrogância com a mulher que,  expõe-a somente de fachada, é uma volta às décadas passadas.', 'Nas casas, em muitas podemos dizer, a mulher ainda cuida somente dos afazeres domésticos e de seus filhos, vezes por obrigação, vezes por escolha. O grande erro que vemos é que a sociedade ainda não aceita isso como um trabalho; para muitos homens, isso é somente um passatempo, sem saber o quão árduo, podemos dizer, é esse trabalho. Já, parte de pessoas do gênero masculino ajudam nos afazeres na casa.', 'Muitos grupos lutam por direitos das mulheres, mas acabam exaltando-se no jeito em que pedem isso; e, acaba assim, passando uma mensagem de estupidez à sociedade. Hoje, há a escandalização dessa luta. Lutar por seus direitos não é atacar símbolos e causar destruição, muito menos, andar nu. Lutar por seus direitos é usar de inteligência e estratégia para ganhar. Um grande desafio, ainda que, não deveria ser.']",120,120,120,120,80,560
90,como combater a transfobia no Brasil,"['A novela ""A força do querer”, produzida pela rede Globo, traz a história, baseada em fatos reais, de Ivan, que é transexual e sofre vários ataques psicológicos e físicos, inclusive da família, por conta da sua identidade de gênero. Com isso, a emissora denunciou a realidade brasileira dessa comunidade e quebrou estereótipos, que influenciam a transfobia, além da falta de conhecimento.', 'Em primeira análise, o preconceito patriarcal existente no sodalício brasileiro é um fator que contribui, fortemente, para a ocorrência de ações transfóbicas. Isso ocorre porque, o estereótipo enraizado, de que só deve haver duas identidades de gênero - feminino e masculino - faz com que as pessoas, diante dos transexuais, realizem injúrias, que podem ser até mortais. Logo, a desconstrução desse pensamento é fundamental e a mídia é o melhor caminho, pois leva maior representatividade a esse grupo, como no seriado “ a vida de Jazz”, que mostra todo o processo de mudança de gênero da protagonista.', 'Outrossim, a educação, assim como afirmava Nelson Mandela, é a base de uma sociedade e o caminho para mudanças. Por conseguinte, a educação sexual e sociológica devem ser muito aliadas para a banalização de casos transfóbicos. Portanto, é de suma urgência que se reformule a matriz escolar, já que os números de ataques estão crescendo em 39%, segundo a Associação Nacional de Travestis e Transexuais (Antra).', 'Contudo, medidas devem ser realizadas para que os casos de transfobia no Brasil sejam erradicados. Assim, o governo, em conjunto com as associações midiáticas e a comunidade travesti e transexual, devem criar, em rádios e canais televisionáreis, propagandas representativas, que acabem com os estereótipos. Também, o Ministério da Educação, deve reformular a matriz curricular, inserindo matérias como sociologia e educação sexual, para então, conectar-se à ideia de Mandela, que coloca o conhecimento como o principal fator para transformações.']",160,160,160,200,160,840
74,"feminicidio , violencia contra mulher","['O feminicidio está cada vez mais frequente no nosso cotidiano , pois vemos todos os dias em jornais e em sites mulheres sendo brutalmente assassinadas,  feminicdio pode ser considerado uma forma extrema de ódio e repulsa ás mulheres ou contra tudo que está ligado ao sexo feminino. No entanto, ele pode se classificar em feminicdio intimo, não intimo e feminicdio de conexão.', 'De acordo com alguns dados de pesquisa , nos últimos anos pelo menos 50 mil mulheres são mortas no Brasil. O estudo ainda aponta que 15 mulheres são assassinadas por dia no país devido a violência. Nota-se que 40% dos assassinatos contra o gênero feminino foram executados dentro da própria casa por companheiros e por ex- companheiros, trata-se d e um problema lobal, que se apresenta com poucas variações em diferentes sociedades e culturas e se caracteriza como crime,  ao carregar traços como o ódio que exige a destruição da vitima.', 'O silêncio de algumas mulheres não faz com que o feminicidio não seja crime, pois o silêncio delas mostra o medo de acontecer algo pior, por isso não podemos ficar calados temos que reagir coma s leis feitas em defesa da mulher como a Maria da Penha e a lei do feminicidio,   Brasil que queremos é um Brasil com igualdade independentemente do sexo,ou seja , um Brasil justo.']",120,120,80,120,80,520
24,As Consequências da Lei,"['Todos os dias se vê nos noticiários casos ultrajantes de violência ligada ao tráfico de drogas e as pessoas se sentem inclinadas a apontar culpados. Pela lei da oferta e demanda, a resposta é óbvia: a culpa é dos usuários! Embora essa afirmação faça sentido, ela não explica todo o contexto do tráfico e de sua proibição, como quem realmente lucra com a ilegalidade desse comércio e como a desigualdade influencia para que este fenômeno tome proporções tão grandes como tomou no Brasil.', 'Com certeza o usuário tem sua parcela de culpa pela violência. Afinal, é ele quem financia. Mas não se deve ignorar os principais culpados: a proibição, a desigualdade, a falta de oportunidades, os governantes incompetentes e quem acha que o problema está só na favela e fecha os olhos para helicópteros cheios de cocaína.', 'Dito isso, a proibição das drogas não beneficia ninguém além de quem lucra com isso. Em 1920, foi aprovado o Ato Volstead nos EUA, que proibia o consumo e comércio de bebidas alcoólicas. O resultado foi um grande aumento do contrabando e de violência por parte de gângsteres. Então, em 1933, a lei se tornou a única a ser revogada da Constituição americana. A regulamentação da maconha e de outras substâncias ilícitas evitaria mais cenários como esse, como ocorreu no Uruguai, em que as mortes decorrentes do tráfico foram reduzidas a zero. Além disso, a legalização da cannabis traria consequências positivas à economia brasileira. Segundo profissionais da Consultoria Legislativa da Câmara dos Deputados, o Brasil teria mais 5,7 bilhões de reais em circulação e mais 5 bilhões em impostos, além de menos 997,3 bilhões gastos no sistema prisional.', 'Dessarte o Estado não pode impor restrições à liberdade individual de sua população com a desculpa de estar prezando pela saúde dos cidadãos, pois as consequências são muito piores. O consumo e comércio de drogas deve ser regulamentado e junto a isso deve haver uma forte campanha alertando sobre os riscos do consumo dessas substâncias, como vem ocorrendo com o tabaco a muitos anos e mostrando resultados.']",160,200,160,200,200,920
82,Os malefícios da automedicação,"['A automedicação pode gerar sérios problemas se realizada sem acompanhamento médico ou sem o conhecimento necessário para a efetivação de tal prática. Esta, muito comum nos dias de hoje, deve ganhar  foco principalmente acerca de suas consequências para a vida daqueles que a praticam.', 'Comumente, grande parte da população percebe a automedicação como sendo uma solução para o alívio imediato, seja de dores no corpo, mal estar  , ou até mesmo sintomas de febre. Porém, é válido lembrar que determinados remédios, se aplicados ou ingeridos de forma inadequada, podem levar a consequências que agravam ainda mais determinado problema. Dentre  elas  pode-se citar o aparecimento de reações alérgicas, intoxicação e a resistência de microorganismos  decorrentes  do uso de antibióticos  por exemplo. Além disso, é importante ressaltar que a utilização de medicamentos sem a avaliação p?evia de um médico também pode acarretar em dependência ou ineficácia de determinada substância. Tal fato corrobora a ideia de que  no intuito de aliviar alguma dor, bem como amenizar determinado sintoma, se for utilizado de forma indevida (ao que se refere à quantidades ou frequência de seu uso), os remédios podem piorar a qualidade de vida de um indivíduo, podendo levar até a mesmo à morte.', 'Em relação a isso, pode-se levar em consideração também o fato de que muitas pessoas procuram meios “online ” para a realização de receitas caseiras que prometem aliviar ou até mesmo curar alguma doença. Porém, tal aspecto também pode acarretar em graves problemas se não tiver acompanhamento médico e  por falta de conhecimento daquele que divulgou tal medida.', 'Portanto, é de suma importância citar algumas medidas para amenizar tais problemas decorrentes da automedicação. Dentre  elas  pode-se levar em consideração a priorização pela procura de profissionais da área de saúde. Além disso, é necessário que haja programas de orientação à população em geral, assim como o estímulo à fiscalização apropriada, ao uso de campanhas, discussôes e propagandas que visem diminuir o uso indevido dessa prática.']",160,120,160,160,120,720
145,Jogando bola dentro da favela.,"['Num país cujos ídolos internacionais são         “reis” do futebol         e as desigualdades sociais assolam grande parte de sua         população         é natural que as crianças de                 lá                sonhem com um futuro jogando bola. O governo sabe disso, investe nisso. Trouxe até a Copa do Mundo para                 cá                ! E em ano de         eleição.', 'Nesse         2014, além de parar para ir         as         urnas, o Brasil         ir         ter uma pausa para ver futebol. Mesmo com atrasos em obras e irregularidades descobertas, dentre elas o superfaturamento de obras e                 esquemas de lavagem de dinheiro                , os governantes         transparecem         otimismo. É o país da alegria que sediará o Mundial.', 'Não vemos essa alegria e otimismo         estampada         na face do povo brasileiro.                 Eles                estão sufocados com                transporte público lotado e         suas constantes falhas         , com                péssimo atendimento em hospitais e                altos preços de produtos básicos. Foram poucos os investimentos em transportes, por exemplo, e os turistas         usufruirão         de ônibus, metrô e afins para chegar aos estádios. Não faz muito sentido atrair olhares mundiais para cá, mas quando os estrangeiros aqui chegarem sofrerem como brasileiros.', 'De sofrimento brasileiro entende. Os moradores de comunidades na periferia, acostumados com o abandono do governo, têm visto suas moradias na mídia quase que diariamente, e não é só notícia sobre violência, pelo contrário, a mídia até exalta favelas, tudo para que o estrangeiro não tenha medo dela. Essa mesma mídia exibe um comercial de tv de uma marca de cerveja que exalta as festas brasileiras, só não discorre sobre como essas festas têm sido quase que exclusivas para os que         tem maiores         condições financeiras de pagar caro e ver uma partida de futebol.', 'Lima Barreto disse: O Brasil não tem povo, tem público. E esse público assiste         as         manobras do governo para trazer um grande evento que deixará apenas belas estruturas futebolísticas montadas dentro de uma enorme         favela         com condições precárias de saúde, educação e transportes. Essa favela chamada Brasil.']",160,200,200,160,0,720
77,Homofobia,"['Homofobia nada mais é que a repulsa ou preconceito contra homossexualidade, ou seja, com o homossexual. É notório por quase toda a população que, no Brasil, o número de homofobicos só aumenta diariamente e em ritmo acelerado. Todos os dias são relatados casos, m 2016, foram mortas 343 pessoas lésbica, gays, transexuais, bissexuais e travestis em nosso país – Dados levantados pelo Grupo Gay da Bahia (GGB). É muito preocupante, pois muitos desses crimes não têm a punição que se deveria ter.', ""Em uma de suas citações, o arcebispo da igreja angelicana, Desmond Tutu, frisa: “A orientação é dada, não é uma questão de escolha. Seria louco alguém escolher ser gay com a homofobia que temos hoje.” Contudo, em nossa contemporaneidade as atrocidades cometidas contra LGBT'S, é incessante e com resultados nada bons. Essa situação já perdura desde muito tempo, em 2012, o maior número de vítimas foram jovens entre 19 e 25 anos, eles são o público alvo desses ataques de acordo com a secretaria de Direitos Humanos (SDH)."", 'No ano de 2016, foram relatados vários caos, merece destaque o do jovem Diego Vieira Machado, um paraense gay, negro e aluno da UFRJ, que foi encontrado morto às margens da ilha do fundão na Bahia de Guanabara. O mesmo estava sem roupas, sem documentos e apresentava marcas de espancamento, possivelmente ele foi morto por pauladas . O ocorrido, como de se esperar, choca o país e principalmente a família das vítimas , que, quase sempre não são atendidos pela justiça.', 'Em suma, é notável que, a homofobia é muito presente no Brasil e precisa ser debatida com mais frequência com a população, isso se quiser melhorar. Requer do Ministério da Educação promover campanhas esclarecedoras sobre o assunto, uma das formas de conscientização é levar esse assunto para ser debatido nas escolas, para que desde cedo as pessoas tenham a consciência de que isso é errado. É de extrema importância também da Justiça Brasileira, criar uma lei que aumente a pena dos agressores, pois assim, talvez, eles sintam um pouco de medo ao quererem praticar os delitos novamente.']",160,120,120,160,120,680
88,,"['No filme 300, a antiga sociedade espartana é representada pela normatividade de seus cidadãos, assim, aqueles que possuíssem qualquer aspecto desviante eram reprimidos ou mortos. Sob esse viés, essa é a cruel realidade de muitos brasileiros, que sofrem com o impasse dos estigmas relacionados às doenças mentais. Dessa forma, essa problemática perdura devido, não só, à influência familiar nos processos excludentes, mas também ao conceito de boa vida imposto pela mídia.', 'A princípio, é válido expor o peso da família na formação de valores individuais. Nesse contexto, de acordo com o geógrafo Friedrich Ratzel, o indivíduo é suscetível ao meio e é, portanto, fruto dele. Partindo dessa ótica, com a constante inferiorização dos portadores de doenças psicológicas, os responsáveis pelos jovens os induzem à repetição dessa discriminação. Assim, o impasse torna-se um inadmissível ciclo entre gerações, de modo que, além do agravamento do entrave, esse ato se aproxima da doutrina fascista.', 'Ademais, é necessário expor a superficialidade nas redes sociais como ferramenta de padronização. Partindo de tal premissa, na série ""Black Mirror"" o episódio ""Queda livre"" retrata uma sociedade que é ditada por avaliações digitais, e aqueles que não possuem uma boa nota, são excluídos e inferiorizados, ficando propensos a depressão e ansiedade. Nesse sentido, a concepção de perfeição imposta pela mídia é um entrave à individualidade, principalmente no contexto de saúde mental. Dessa forma, enquanto medidas não forem tomadas em prol da dissolução dos estigmas sobre as doenças mentais, a tecnologia continuará se enriquecendo com o preconceito.', 'Portanto, infere-se que o ciclo do preconceito e a superficialidade digital são fatores que contribuem para os estigmas sobre as doenças mentais. Assim, é necessário que o Ministério da Educação, por meio da matriz curricular, elabore atividades lúdicas destinadas aos alunos, como gincanas e passeios, a fim de instigar a inserção dos doentes mentais. Cabe, também, ao Ministério da Cidadania, por intermédio das redes sociais, como Instagram e Facebook, criar propagandas que incentivem a pluralidade mental, com o propósito de dissolver padrões e incentivar as diferenças. Somente assim, será possível erradicar a problemática e contrariar preceitos espartanos.']",200,200,160,200,200,960
31,A terciarização é uma forma de organização,"['A terciarização é uma forma de organização das empresas, em que ela não precisam contratar trabalhadores para atividades não relacionadas àquilo que produzem. O resultado é prejudicial a todos, pois os trabalhadores perdem o direito conquistado com anos de luta.', 'De acordo com pesquisas realizadas pelo G1, o Brasil possui 12 milhões de terceirizados, ou seja, 25% da população têm seus direitos burlados, sendo explorados por intermediários que visam apenas o lucro de si próprio . Resultando no aumento das taxas de desempregados e a divisão das classes trabalhadoras.', 'Outro fator existente para a aprovação da Assembléia Legislativa é o projeto de Lei 4330, que prevê a contratação de serviços terceirizados para qualquer atividade de determinada empresa, sem estabelecer limites ao tipo de serviço, ou seja, tanta atividade-meio quanto atividade-fim.', 'Em virtude dos fatos mencionados, podemos considerar a terceirização como um retrocesso das leis trabalhistas, visto que mesma funciona em países altamente desenvolvidos devido a priorização da educação, saúde e da segurança.']",80,0,0,0,0,80
50,A Salvadora,"['Atualmente no Brasil já houve mais de 5.000 casos e mais de 200 mortes provido  da nova pandemia também conhecida com Covid-19, um vírus que saiu de uma cidade chinesa, pode causar uma gripe aguda, trazendo  aqueles com a imunidade baixa á perda da vida.', 'Até onde o mundo sabe estão procura de uma vacina, para a prevenção contra o vírus, os responsáveis pela proteção mundial são os cientistas, muito  das vezes esnobados e chamados de inúteis pela sociedade que em várias situações fora salva pelos mesmos , com a evolução da Ciência há também a evolução da sociedade como podemos ver desde o passado, a vacina contra o sarampo, contra o h1n1, contra até a gripe mais comum , que traz mais mortes do que o próprio coronavírus , foram trazidos a ida por cientistas que além de querer contribuir com o mundo também querem o reconhecimento de que eles muitas vezes salvaram o mundo', 'Portanto é necessário que as crianças, os jovens e até os idosos saibam que há pessoas que os protegem diariamente colocando uma barreira contra os vírus passados, os novos e os futuros. É necessário que as mídias coloquem em destaque o trabalho de todos os cientistas e médicos em volta do mundo e não apenas dos governantes no país.  Porque a Ciência é a Salvadora de todos e todas;']",120,160,80,120,80,560
46,A universalização do saneamento básico,"['Na fundação da cidade de São Paulo, os portugueses foram se alocando nas partes mais altas do território, pois observavam os indígenas que faziam a transição entre as áreas menos elevadas para as mais elevadas, por conta das chuvas que alagavam as partes mais baixas e criavam grandes lagoas. Com o fim do colonialismo no país, o desenvolvimento ocorreu, entretanto, apenas para as classes com maior poder aquisitivo, que continuavam nas partes elevadas de São Paulo, enquanto a classe mais pobre sofria todos os anos com o alagamento das chuvas e o esgoto dos ricos, nas áreas mais planas da cidade e com isso,  centenas de pessoas morriam todos os anos, porque as doenças se proliferaram pela falta do saneamento básico na cidade. Essa realidade até hoje se arrasta em todo o Brasil, portanto, conclui-se que o desinteresse do Estado em criar políticas públicas de tratamento de dejetos é histórico, causando assim a saturação do SUS (Sistema Único de Saúde) por doenças que poderiam ser evitadas com projetos de saneamento para o Brasil.', 'A priori, a Constituição Federal (1988) obriga todos os estados e municípios a criarem projetos para tratarem de forma ecológica os desejos causados pela população, contudo, mais de 50% da sociedade não contempla atividades voltadas para o saneamento básico. A classe que ainda mais sofre com a falta de interesse dos dirigentes públicos é a com menor poder aquisitivo, por serem obras que não arrecadam tantos votos e que iriam demorar mais do que um mandato , a falta de conscientização mútua para cobrança desse direito constitucional também é um agravante, haja vista que os municípios ultrapassaram a data que já havia sido prorrogada, em 2014, para o fechamento de todos os lixões do país.', 'Em segunda análise, a falta de estrutura do Estado em proporcionar um convívio digno e harmonioso para a maioria da população ocasiona um risco à vida e o desperdício de recursos públicos e privados, tendo em vista a correlação da saúde pública com o saneamento básico. A diarreia, por exemplo, mata por desidratação dezenas de pessoas (maioria crianças) por ano, no Brasil, sendo 80% desses casos óbitos por água contaminada, afirma o G1.', 'Em virtude dos fatos apresentados, observa-se a importância do saneamento básico universal para o país se desenvolver, sabendo que a privatização vai aumentar as desigualdades que se perpetuam até os dias de atuais e o risco que a displicência dos governantes em não cumprirem leis federais. Conclui-se, portanto, a necessidade inata de se ocorrer campanhas de conscientização da população em cobrar os representantes políticos, por meio de veículos de comunicação, assim a problemática social irá virar tema de relevância nos ambientes políticos. Deve-se criar, também, uma comissão federal para acompanhar e auxiliar, individualmente, os estados e municípios na construção de aterros sanitários, de sistemas de coleta de lixo, tratamento de esgoto e etc. com a finalidade de orientar os prefeitos e governadores, por vias licitatórias.']",160,160,120,160,160,760
44,Deixe Ela Ser,"['O quão difícil pode ser o caminho para chegar nos altos pódios, a indústria do esporte desde o início dos grandes eventos como os jogos olímpicos  enfrenta a dificuldade de garantir competições justas, no universo esportivo feminino que teve seu início mediado pelos próprios homens, o que gerou testes comprobatórios absurdos como a necessidade de ficar nua na frente de médicos que iriam julgar se ela era realmente uma mulher . Mas o mundo avançou e as mulheres vem quebrando com esse pensamento patriarcal, mas ainda enfrentam a necessidade de provar quem realmente são.', 'Com o advento da tecnológia atualmente os meios de se comprovar que uma atleta está apta a competir não passa mais pela situação citada a cima, mas o simples fato de ter que se comprovar a feminilidade demonstra que apenas os métodos foram alterados mas o principal que é o pensamento ultrapassado e preconceituoso continua se proliferando entre as gerações. Uma mulher dotada fisicamente perde sua característica de mulher, enquanto homens superdotados fisicamente não perdem suas características de homem, pelo contrário são exaltados como deuses.', 'Com o intuito de garantir uma participação justa atualmente temse praticado o doping pois para que as pessoas com algum tipo de alteração natural biológica participem de competições e necessário fazer um tratamento com medicamentos que reduza o nível de moléculas que exercem efeitos fisiológicos, ou seja, alteram sua composição biologia natural, o que segundo o próprio Comitê Olímpico Internacional (COI) é caracterizado como doping.', 'Por fim a discriminação sexual deve ser combatida com veemência, deve ser criado uma assembleia onde todas as partes envolvidas possam ser ouvidas, não pode-se permitir que os homens continuem dando as diretrizes de como as mulheres precisam ser, mulheres não precisam dar arguição de si, não se pode prejudicar alguém por suas características naturais.']",160,160,120,120,120,680
49,A influência depende da benevolência.,"['É inegável que a sociedade contemporânea se transformou com o advento da internet, impulsionado pelas redes sociais. Consequentemente, a liberdade de expressão se expandiu nos ambientes virtuais e possibilitou que pessoas comuns com acesso à internet expressem suas opiniões. Esse fato contribuiu para o surgimento dos influenciadores digitais, que utilizam a fama e o grande alcance de seus conteúdos para moldar o comportamento do seu público. Contudo, comportamentos incentivados por alguns “influencers”, como o descumprimento de normas sociais  podem afetar penosamente a coletividade.', 'De acordo com o site Correio Braziliense, em 2020, a influenciadora digital Gabriela Pugliesi desrespeitou a quarentena decretada devido ao coronavírus e organizou uma festa. Essa postura foi contra as recomendações da Organização Mundial da Saúde e ocasionou muitas reações negativas do público que não apoiou a atitude da famosa. Posto isso, torna-se evidente que a participação ativa da maioria dos internautas é colaborativa para o bem da saúde pública e auxilia o processo de construção de indivíduos críticos, capazes de sustentar e defender pontos de vista que coadunem para o bemestar social.', 'Segundo dados do site UOL, do ano de 2020, em uma reunião online os senadores aprovaram o projeto de lei para o adiamento do Exame Nacional do Ensino Médio, por conta do coronavírus. Esse acontecimento foi resultado de uma mobilização de jovens e influenciadores digitais como Lucas Felpi e Débora Aladim que visavam a prorrogação da prova, visto que, as escolas foram fechadas e um em cada quatro brasileiros não possuem acesso à internet para estudar, conforme a pesquisa do Instituto Brasileiro de Geografia e Estatística, em 2018 . Dessa forma, é notório que a participação dos influenciadores nas redes sociais assume um papel essencial na ampliação da divulgação de problemáticas que necessitam ser analisadas pelo poder público e contribui para que mais pessoas se engajem em prol da defesa de pautas importantes para a sociedade.', 'Em suma, a potencialidade que os conteúdos dos influenciadores digitais têm de modificar ideias, mobilizar pessoas e criar novos padrões de comportamento de forma positiva é grandiosa. Sendo assim, é de fundamental importância que os seguidores possuam autonomia e senso crítico de discernir atitudes prejudiciais que possam impactar negativamente a vida das pessoas, exemplificado pelo o descaso com a saúde pública de Pugliesi em meio a uma pandemia , a fim de que possa prevalecer somente nos meios digitais e na realidade as contribuições benéficas e relevantes dos influenciadores digitais.']",160,200,160,160,160,840
7,Problemáticas para utilização das criptomoedas,"['As reflexões acerca de como o uso das criptomoedas pode representar uma revolução econômica mundial atestam a relevância do assunto na atualidade. Entretanto, embora essa tecnologia de criptografia possa exprimir uma política monetária dos novos tempos e proporcionar grande autonomia para seus usuários, há uma série de problemas que podem impedir uma revolução dessa proporção. Entre esses problemas estão: a resistência dos governos diante da perda de controle econômico em seus países e os riscos que apresentam para seus investidores.', 'A criação das criptomoedas foi possibilitada pela tecnologia blockchain (cadeia em blocos), composta por uma base de dados que armazena o histórico de transações e possui uma forte criptografia nesse processo. Assim, diferentemente das moedas tradicionais, as moedas virtuais não são controladas pelo Banco Central, ou seja, o seu uso é livre de instâncias burocráticas. Dessa forma, como a maior fonte de poder para os governos são os seus bancos centrais e o monopólio de dinheiro, a possível mudança de um controle monetário centralizado para um descentralizado apresenta sofre de forte resistência dos governos, pois acabaria com tal poder. Um exemplo dessa perda de controle é que o governo ficaria impedido de emitir e valorizar a moeda e ainda de bloquear o dinheiro das pessoas, como historicamente já aconteceu em políticas econômicas de alguns países.', 'É inegável a relevante transformação econômica, política e social que o uso das criptomoedas pode proporcionar para a sociedade atual vez atual, uma vez que elas desburocratizam os processos, eliminam intermediários e permitem a descentralização da moeda. Todavia, existem riscos para os investidores nessas moedas em razão da abertura que elas oferecem para operações ilícitas. Nesse sentido, a moeda virtual é baseada em um software de código aberto que permite o anonimato das pessoas e, devido à dificuldade de rastrear os usuários, o mercado das moedas virtuais estimula a prática de crimes como a corrupção e a lavagem de dinheiro. Os bitcoins (primeira moeda virtual do mundo) utilizados pelos investidores no intuito de movimentar grandes quantias não declaradas são um exemplo dessa prática ilícita.', 'Portanto, verifica-se que vários são os fatores que impedem uma revolução econômica mundial proveniente das criptomoedas. Diante disso, para se esperar um crescimento considerável desse novo tipo de dinheiro são necessárias relevantes medidas, entre as quais estão a regulamentação específica da moeda virtual no que concerne a sua utilização e comercialização e o atendimento a critérios amplamente divergentes como a descentralização com proteção ao consumidor e a preservação do anonimato dos usuários sem ser um canal de evasões fiscais e outras ilicitudes.']",200,200,200,200,200,1000
95,É preciso fazer a lei valer,"['Refletir sobre a política através de aspectos prioritariamente pragmáticos. É realmente difícil, em nossos dias, compartilhar o progresso tecnológico, da simples tradição indígena é inaceitável para a ganância do agronegócio, das mineradoras, dos grileiros. O sentido efetivo embutido na forma de evolução tecnológica que vem imperando desde pelo menos a Segunda Guerra Mundial conduz, e interliga-se, indissociavelmente, ao dinheiro e ao aperfeiçoamento constante dos meios de prosperar passe por cima de quem for. Se possível inventam teses. Porque se a União concedeu aos povos indígenas os direitos originários sobre as terras, no artigo 231 da Constituição do Brasil no ano de 1988 .Logo, não cabe mais argumentos nem teses. E sim demarcar e fazer valer a lei.  E não fazer outro projeto de lei para retirar dos índios seus direitos legalmente constituídos.', 'As terras indígenas são sagradas para eles. Eles protegem a natureza e amam. A terra é a mãe deles. É diferente o significado para o homem do agronegócio, eles tiram dela toda riqueza que puder e depois largam lá os rios secos ou poluídos e a terra infértil ou desertificada. Sem a menor compaixão, com dinheiro no bolso logo procuram outro logar. Os índios não querem outro lugar, querem o seu lugar, aquele que vive com toda memória de seus ancestrais. Esse marco temporal deve ser destruído, queimado e enterrado suas cinzas em um caixão de chumbo para não contaminar a terra.', 'O arco emporal é injusto, toxico e explosivo. Não deve de maneira alguma passar. Tem que ser inconstitucional. Porque é. O artigo 231 da constituição nacional diz isso. Que tipo de constituição é essa? Pelo bem do país, os direitos indígenas devem ser respeitados. Que são: demarcação, proteção, costumes, língua e tradições. A lei não retroage! O STF deve fazer toda a demarcação e pedir desculpas. Que a força da lei vença a lei da força.']",120,80,80,120,0,400
89,,"['O debate sobre a importância do isolamento social tornou-se uma polêmica no Brasil, especialistas como o infectologista Rodrigo Contrera, em resposta à revista CNN afirma que essa medida é a mais eficaz contra a propagação da covid-19 no país. No entanto, o residente Jair Bolsonaro discorda, afirmando que ficar em casa é para os ""fracos"" e ""a economia não pode parar de girar"" durante uma afirmação em Mato Grosso. Dessa forma, milhares de brasileiros se aglomeram diariamente devido a falta de informação, negando, assim, a gravidade da pandemia.', '""É fato social toda maneira de agir,fixa ou não, suscetível de exercer sobre o individuo uma coerção exterior"" partir da frase do sociólogo Émily Durkeim, podemos fazer algumas análises da sociedade atual, uma delas é a falta de entendimento da população brasileira sobre o novo coronavírus, devido a propagação de informações falsas. Diante desse cenário, a população age de maneira irresponsável contrariando opiniões científicas. Não só é culpa dos brasileiros que agem de tal maneira, mas também de toda uma estrutura governamental que não informa melhor a população sobre a gravidade do problema.', 'Ademais, é inadmissível que autoridades políticas insistam que a economia é mais importante que a vida humana. De acordo com dados do Ministério da Saúde, desde o começo da pandemia, o país já registrou 262.770 mil mortes. No dia 04 de março de 2021, o país registrou 1.910 mortes evidenciando que, de fato, as autoridades governamentais não conseguiram controlar a pandemia e que após um ano, precisamos urgentemente adotar medidas rigídas, como o isolamento social tão negado pelo governo.', 'Logo, medidas públicas são necessárias para alterar esse cenário. Para que isso ocorra, o Ministério da Sáude e Ministério da Economia  em parceria com as secretarias estaduais de educação, deverão criar um plano nacional que esteja incluso o repasse de verbas para contratação de agentes fiscais que informem a população sobre a importância do isolamento social em todo território nacional, e que uma parte da verba seja destinada para fiscalização de aglomerações em bares, restaurantes, boates e etc. A partir dessas parcerias, espera-se que ocorra uma mudança significativa na curva epidemiológica do país.']",160,160,160,200,160,840
82,Dose certa,"['Durante o início do século XX, a Revolta da Vacina foi um dos acontecimentos históricos responsáveis por sensibilizar a população e provocar grande comoção. Paradoxalmente, a ação que visava ao combate à  varíola teve um resultado oposto e acarretou inúmeros problemas decorrentes. De forma análoga, resquícios do século passado ainda estão presentes na sociedade brasileira contemporânea, seja pela postura passiva dos indivíduos, seja pela falta de acesso à informação, evidenciando a necessidade de asseguramento de direitos e conscientização coletiva.', 'Indubitavelmente, os avanços tecnológicos e científicos exercem grande influência sob  o comportamento humano atual. Segundo Heráclito, ""Tudo está em constante e profunda transformação."" As descobertas mais recentes, associadas ao ritmo da informação nos meios digitais, são capazes de gerar uma mentalidade social baseada na ausência de um diagnóstico elaborado, bem como da verificação do conteúdo exposto. Assim, a automedicação é sustentada pelos pilares da ciência e da tecnologia, haja vista que,  a praticidade e rapidez poderão sanar dúvidas e resolver o problema, através dessa lógica, da forma mais eficaz possível.', 'Outrossim, a falta de consciência da sociedade em relação aos seus direitos e a precarização do serviço público contribuem para a cultura da automedicação. De acordo com Nietzsche, ""A desigualdade de direitos é a primeira condição para que haja direitos."" Segundo essa linha de pensamento, é possível explicar a frequência desse hábito, pois  além do indivíduo estar submetido a um sistema de saúde aquém de suas necessidades, a ausência de uma noção básica do que lhe é garantido na Constituição contribui para o uso de métodos inerentes e propícios à sua realidade.', 'Fica claro, portanto, que a automedicação possui razões históricas intrinsecamente ligadas à falta de consciência jurídica da população, bem como dos malefícios que poderão ser causados, constituindo um mal que deve ser combatido. Dessa forma, o Ministério da Justiça, junto ao  Ministério da Saúde, deve elaborar um plano de governo contendo os direitos do cidadão e as consequências do uso inapropriado e arbítrio de medicamentos. Ademais, a Mídia, em especial TVs, rádios e jornais impressos, deve mostrar os efeitos colaterais causados pela automedicação e a proximidade de hospitais e postos de saúde. Sendo assim, a população irá se prevenir das doenças e infortúnios causados, alcançando o bem-estar por meio da dose certa.']",160,200,160,200,200,920
58,,"['O lema do regime militar sobre a amazônia era"" ocupar para não entregar"", e foi o que aconteceu no período ditatorial do Brasil, não respeitando a flora e a fauna da região. Embora,  muitos governos vieram depois  pouco ou quase nada foi feito pela preservação da floresta. ma vez que, o desmatamento só aumenta. No entanto, os governandos ignoram a importância dela.', 'Em primeiro lugar, em 2019 no mês de agosto teve o maior número de queimadas e desmatamento dos últimos 9 anos, segundo o portal BBC Brasil, gerando uma grande comoção mundial. Já que a amazônia pode não ser o pulmão do mundo, mas ajuda a manter a temperatura equilibrada.', 'Contudo, se isso preocupa o mundo os brasileiros ficam mais temerosos ainda. Visto que, no período do segundo reinado a floresta da Tijuca teve que ser reflorestada pois não chovia no Rio de janeiro. E um dos fatores mas importante da floresta para o Brasil é a chuva que vai para o pas todo.', 'Percebe- se, portanto, que cabe a união do governo federal e ONGS ambientais, fizerem campanhas e estudos o que vai tornar mais fácil a fiscalização, e a conscientização da população através de comeciais documentários educativos nas mídias sociais sobre a importância da floresta.']",120,120,80,80,80,480
55,,"['Desde o Iluminismo, entende-se que uma sociedade só progride quando um se mobiliza com o problema do outro. No entanto, quando se observa a importância de valorizar os povos indígenas no Brasil,  hodiernamente , verifica-se que esse ideal iluminista é constatado na teoria e não desejavelmente na prática  e a problemática persiste intrinsecamente ligada à realidade no país. Nesse contexto, torna-se claro  a insuficiência de estruturas especializadas no acompanhamento desse público,  bem como o entendimento acerca do papel social desse arranjo.', 'É indubitável que a questão constitucional e a sua aplicação estejam entre as causas do problema . Tal fato e reflete nos escassos investimentos governamentais em qualificações profissionais e em melhor suporte físico,  medidas que tornariam o ambiente mais inclusivo para a população indígena e devido à  falta de administração e fiscalização pública por parte de algumas gestões.', 'Outro aspecto a ser considerado é a desvalorização como um dos principais motivos , visto que, tais costumes e cultura  são discriminados no país . De acordo com Hans- Georg Gadamer , a história não nos pertence : nós  pertencemos a ela . Seguindo essa linha de pensamento, é alarmante a exclusão dessa nação,  pois são mal vistos pela sociedade e muitos não são aceitos. Assim, medidas são necessárias para mudar esse quadro.', 'Portanto,  são necessárias medidas capazes de mitigar essa problemática.  Destarte, o Ministério da Educação e Cultura  (MEC) , deve incluir programas capazes de relatar a importância dos povos nativos no Brasil, inserindo suas culturas e hábito.  Ademais,  o Governo em parceiria com a FUNAI , devem proteger suas terras e seus direitos garantindo à igualdade social . Desse modo, suas histórias e culturas serão dada à devida relevância no Brasil .']",120,120,80,120,120,560
73,,"['O Brasil é um Estado Democrático de Direito muito recente em relação a outras Nações-Estados, e, por isso, possui demandas de determinados grupos sociais não resolvidas e não satisfeitas, como é o caso dos desafios encontrados pelos negros atualmente, que se pode traduzir em uma demanda  por reconhecimento deles enquanto cidadãos de direitos individuais e sociais. Entretanto, não é apenas o carácter de o Brasil possuir uma democracia muito nova que faz com que persista essa demanda, mas o facto de ele possuir determinados conjuntos de práticas, hábitos e valores cultivados pelos cidadãos brasileiros, que faz com que esas demandas  por reconhecimento e respeito dos negros, atualmente, persistam e mantenham-se geração após geração.', 'Deve-se destacar a dimensão cultural do ser humano para tentar-se resolver estes desafios, uma vez que a cultura - enquanto conjunto de valores, hábitos, ideologias, conceitos e visão de mundo que compõe o ser humano, e é passada de geração em geração através da oralidade, da escrita, e da reprodução de hábitos - em alguma medida, determina se se deve ter preconceito, ou se se deve respeitar, ou se se deve reconhecer os negros como cidadãos ou não. Isto é, é a cultura que determina se se concebe o negro como igual a todo e qualquer ser humano, ou se se deve concebê-lo como um ser inferior diferente dos outros seres humanos.', 'Se uma criança é orientada pela sociedade a reproduzir atitudes que menosprezem o negro, é bem provável que esta criança cresça com esa concepção em seu  espírito. Se alguns membros do grupo social desta criança possuem atitudes que apequenam a figura do negro na sociedade, é bem provável que esta criança comece a reproduzir esas atitudes, já que para se sentir como um membro participante, e portanto, para incluir-se no grupo social ela vai desejar o fazer. Deste modo, percebe-se que são os valores da sociedade que determinam a forma de se conceber o negro na dimensão social.', 'Todavia, o que fez com que essa concepção sobre o negro surgisse na sociedade brasileira? Ela não surgiu, ela coincide com o próprio surgimento da cultura brasileira. Ou seja, ela faz parte da constituição da cultura brasileira. E, por isso, é tão difícil erradicá-la do ideário dos cidadãos. Parece que se é natural conceber os negros como incapazes, incompetentes e inúteis quanto a status e papel sociais de destaque. Entretanto, tudo isso não passa de valores cultivados, e portanto, já que são aspectos da dimensão cultural do ser humano, não podem ser tomados como aspectos da dimensão natural dele.', 'O que se propõe para tentar diminuir os desafios enfrentados pelos negros no Brasil são mudanças de atitudes, de hábitos e de concepção por parte dos cidadãos. Para que iso ocorra, é necessário que a educação televisiva pare de reproduzir valores falsos em relação ao negro no conteúdo dos programas. É necessário que haja uma atitude crítica em relação à moral e aos costumes que são cultivados na sociedade brasileira, para isso é imprescindível que debates sobre esse tema sejam trazidos pelas universidades por meio de projetos de extensão à comunidade. E, além diso, é necessário valorizar a figura do negro no campo do trabalho através de salários justos e de promoção e abertura a eles  para que possam ocupar funções de destaque na sociedade.']",120,120,120,120,120,600
36,Trabalho escravo contemporâneo,"['Levando em consideração que a questão do trabalho forçado no mundo contemporâneo está em voga em nossa sociedade, é necessário destacar que essa escravidão existente na modernidade é diferente daquela que existia até no final do século XIX, quando era considerada uma atividade legal. Um fator relevante que leva a essa forma de trabalho ilegal principalmente em regiões agrícolas, é o desemprego, fazendo com que as pessoas trabalhem por jornadas exaustivas vivendo em condições sub-humanas de trabalho . Dessa maneira, ao encontro do que foi exposto questiona-se: é correto explorar e privar o ser humano do exercício de sua liberdade?', 'Em primeiro lugar, o índice de desemprego no país sempre foi considerável, ocasionado mão-de-obra abundante. Dessa forma, os trabalhadores saem do seu Estado de origem em que muitas vezes a situação de pobreza é terrível, na busca por melhores condições de vida deslocando-se para outros Estados. Isso faz com que o trabalhador se sujeite a condições degradantes de trabalho em que é explorado, contraindo dívidas enormes com o empregador sem possibilidade de deixar o local sendo ameaçado com violência física e psicológica.', 'Em segundo lugar, os grandes proprietários de terras agrícolas submetem os trabalhadores à jornadas de trabalho exaustivas sem alimentação adequada e água potável. Ademais, com expediente desgastante colocando em risco a integridade física do trabalhador em que na maioria das vezes o intervalo entre as jornadas é insuficiente para repor suas energias. Nesse sentido, um homem que permanece nessas condições durante um período de 20 à 25 anos dificilmente vai conseguir se librar desse ciclo de trabalho escravo pois após todo esse tempo ele estará tão debilitado que não terá mais possibilidade de deixar o local.', 'Em vista dos argumentos supracitados, compreendemos que há a necessidade de é necessário resolver o problema da escravidão moderna. Para tanto, é imprescindível a elaboração de um Estatuto com o objetivo de acabar ou minimizar com essa situação que ocorre com pessoas que tem pouca ou nenhuma escolaridade. Esse Estatuto, instituído pelo governo Federal em parceria com a sociedade privada preconizaria, então a fiscalização permanente das áreas que usam o trabalho escravo em seus serviços. Nesses locais em que foi identificado esse tipo de trabalho, as terras devem ser desapropriadas, os proprietários devem responder a processos judiciais e as terras devem ser distribuídas entre os trabalhadores escravos. Viabilizando a priorização da educação de qualidade para sociedade para que as pessoas tenham conhecimento sobre seus direitos e não aceitem serem submetidos à condições degradantes de trabalho.']",120,80,80,80,80,440
45,A cultura da violação.,"['No que se refere a violação de conduta observados por pessoas com cargos importantes no âmbito social, é notório a opressão desenvolvida, questionando-se suas atuações em vista de diversos relatos de diferentes situações, de maneira intransigente e antidemocrática. No qual, são frutos de circunstâncias de desvio ou excesso do poder aquisitivo, para prejudicar desse modo os menos favorecidos.', 'Em primeiro plano, vale ressaltar, que a falta de averiguação é um dos principais fatores que contribuem constantemente para prática desse delito . Bom exemplo, ocorreu na onda de protestos no mês de maio de 2020, onde, protestantes vieram as ruas após um policial imobilizar e asfixiar George Floyd, um homem negro que não o resisti ao abuso da abordagem policial. Além disso, o uso da força bruta evidencia questões éticas e culturas em relação aos atos que manifestam discriminação, e que por muitas vezes saem impunes ou não tem a penalidade devida.', 'Portanto, em virtude de defender todas as pessoas, São Tomas de Aquino relata que o tratamento respeitoso entre todos é de grande importância. Porém, a questão do excesso de poder, contraria o ponto de vista filosófico, uma vez que no Brasil muitos grupos podem alvos por defender crenças contrarias. Dado que o papel da segurança pública é assegurado por mesmo da constituição no artigo 144 por meio da manutenção da ordem.', 'Desse modo, fica claro que a postura incompatível utilizada possui o intuito de satisfazer as vontades particulares, feitas de maneira omissiva ou comissiva. Para esse fim, é necessário que o Estado  aplique corretamente o projeto de Lei 85/2017 que visa classificar como crime o abuso de autoridade cometido por agentes públicos e servidores no exercício de suas funções, valendo também para os três âmbitos, executivo, legislativo e judiciário. Dessa forma é viável reformular o modo como são treinados para o cumprimento de ordens, observando suas falhas e aprendendo com erros, como Mahatma Gandhi diz. Temos que nos tornar a mudança que queremos ver.']",160,160,120,160,160,760
58,Desmatamento e queimadas,"['A floresta amazônica é uma das maiores áreas de vegetação do Brasil e vem sofrendo com as queimadas e os desmatamentos.', 'Nossa  floresta tem uma importância enorme em nossas vidas e na vida dos animais que nela vivem. Plantas e árvores purificam nosso ar, proteja os animais e lhes dão abrigo sempre que é preciso. Mas, de uns tempos para cá vem sofrendo bastante com a ação dos homens.', 'O desmatamentos e as queimadas estão bem visíveis ultimamente. Pessoas querendo terras para plantações, para fazer futuras moradias, mas,  esquecem que a natureza e a água são nossos bens mais preciosos e por isso devemos  preseva-los sempre.', 'Com tudo isso, pensemos  então, em ajudar a floresta amazônica a crescer cada dia mais e não desmata-la como está acontecendo. Natureza é vida, então por favor não acabe com essa linda vida.']",120,80,80,120,40,440
73,,"['Já se foram mais de quinhentos anos após o fim da escravidão, mas os brasileiros negros ainda presenciam a enorme disparidade entre eles e os brancos. O preconceito, faz com que essa grande parcela da população sofra enormes desafios tais como falta de educação e desigualdade social.', 'A população preta e parda é, a que em maior número residem nos subúrbios e também são os mais marginalizados . Essas são algumas das consequências da ampla desigualdade social no país, além disso o mesmo problema traz o aumento da violência e insegurança encontrados na sociedade atual.', 'A educação, que deveria ser um direito de todos, é falha. Quando não falta escolas perto  há escassez de professores, bem como diversas vezes os alunos têm que trabalhar cedo para ajudar a família eles nunca sentem-se incentivados para os estudos, onde faz que entrem para o mundo das drogas logo.', 'Percebe-se então, que, é lamentável a realidade dos negros no Brasil, s pessoas precisam se conscientizar e entender que jamais necessitam passar pelo oque  essa parcela da sociedade vivenciou durante toda a história para saber que a cor da pele nunca irá predestiná-la a ser um humano bom ou má . Assim, diminuiria os crismes racistas e indiferença entre povos.', 'Do mesmo modo, o Ministério da Educação  poderia investir no incentivo  desses jovens a irem as à instituiçao educativa, abrir novas vagas de cursos profissionalizantes gratuitos e também em faculdade. Dessa maneira haveria uma capacitação e maior oportunidades de ingressos no mercado de trabalho e diminuiria os abismos entre a sociedade.']",120,120,120,120,120,600
83,"Se você não cuidar bem do seu corpo, vai viver dentro do que?","['A prática esportiva proporciona inúmeros benefícios físicos e mentais, além de ser um momento prazeroso, tem grande poder de inclusão e convívio social, faz-se necessário o acompanhamento de um profissional competente, principalmente na infância por ser um período de descobertas e insegurança, onde muitas vezes os pais querem realizar-se através dos filhos. O Brasil sediou recentemente o maior evento esportivo mundial no Rio de Janeiro, as Olimpíadas e Paralimpíadas, com mais de quarenta modalidades, envolveu países de todos os continentes, (.) esses jogos tiveram origem na Grécia Antiga no século VIII a.C, no decorrer de vários séculos os jogos foram inovando nas modalidades e tornando-se verdeiramente pluralistas.', 'As paralimpíadas são um exemplo de superação dos limites, tiveram sua origem em Roma em 1960, nas mesmas instalações onde foram realizadas as olimpíadas, iniciou-se com 400 atletas e 23 delegações. O esporte adaptado, teve início após a segunda guerra mundial, quando muitos soldados mutilados retornaram para casa', 'Os jogos promovem a paz entre os povos, a integração, o respeito às culturas, é uma mistura de cores, representadas pelos anéis olímpicos, essas cores formam todas as cores das nações. A UNESCO tem grande empenho ao incentivo e a prática esportiva, atua contra o doping no esporte, problema esse que afeta muitos esportistas, além de ter suas políticas centradas nos jovens, tem como objetivo globalizar a educação, fomentar a paz e promover a livre circulação de informação entre os países.', 'Saúde é estado completo de bem estar, no entanto , é de suma importância motivar as pessoas a um estilo de vida saudável, rever os hábitos familiares em parceria com as escolas, que deveriam trabalhar os alunos em período integral, incentivar e envolver nas atividades esportivas, anda na primeira infância os pais deveriam iniciar com tapetes musicais, ou brinquedos que incentivam, quanto aos espaços públicos, devem ser convidativos, e as empresas deveriam implementar a ginástica laboral, como é o caso do estado da Paraíba.']",120,160,160,200,200,840
58,Novo aroma para um Brasil sem fogo,"['Os setores da economia são primário, secundário e terciário, sendo o Brasil ainda dependente do primeiro, o qual engloba atividades que demandam uso de terras para cultivo e extração. Nesse cenário, um dos principais alvos para tal é a Floresta Amazônia, cuja porcentagem que se refere à administração brasileira protagoniza nos últimos meses índícies de desmatamento e queimadas alarmantes, incentivados pelo mercado global e mau aproveitamento de sua extensão pelo governo brasileiro.', 'Primeiramente, uma dos fatores que impedem a preservação da floresta é a demanda externa por produtos. Por exemplo, segundo uma especialista em meio ambiente alemã , Carina Zell-Ziegler, a demanda exacerbada, feita pela União Europeia de carne brasileira, impulsiona o destamamento à medida que grandes pedidos exigem grandes áreas de produção. Dessa forma, preso ao setor primário, o Governo do Brasil sobrepõe os lucros à conservação da natureza e deixa de explorar outras alternativas favoráveis a ambos como o turismo ecológico, por exemplo.', 'Outra maneira de reconstruir o cenário econômico para alinhar a floresta com a economia nacional seria o investimento nos campos de pesquisa. Deste modo, a principal fator de importância da Amazônia, a biodiversidade, seria explorada em diversas áreas como medicinais e cosméticas com perfumes, o que atrairia mercado estrangeiro e transmitiria prestígio para a população tendo Floresta Amazônica como símbolo de desenvolvimento do país, assim como foi o petróleo na Era Vargas, e no Gorverno JK, possibilitando sua preservação para gerações futuras.', 'Urge, portanto, que a estrutura economica do Brasil se ajuste à preservação da Floresta Amazônica por meio do acordo entre os ministérios do Meio Ambiente e Turismo, investindo verbas na atração autossustentável de capital atráves do ecoturismo, movendo o Brasil para o teceiro setor. Ademais, para amenizar a dependência do setor primário de exportação e reduzir queimadas e desmatamento, o Governo Federal deve restringi-lo e redirecionar tais verbas para infraestrutura em centros de pesquisa destinados ao conhecimento da biodiversidade da floresta. Assim, ocorrerá a preservação da Amazônia e desenvolvimento do país.']",120,160,80,120,80,560
90,.....,"['Segundo a Constituição federal brasileira, todos os cidadãos são iguais perante lei, independente da religião, etnia, condição social ou orientação sexual. Mas todos que têm acesso ao mínimo de informação sabe muito bem que não é assim que funciona no Brasil. Muitos ainda tentam se encaixar na sociedade e lutam para viver o seu dia a dia sem preconceito, por exemplos, as pessoas transsexuais. Para que todos possam viver uma vida livre e sem medo do que possa acontecer apenas por serem elas mesmas, é necessário medidas urgentes contra os casos de transfobia.', 'O preconceito com pessoas transgêneros está presente no nosso cotidiano e isso faz com que muitos sejam expulsos do próprio lar, local onde deveriam ter mais apoio, abandonem seus estudos e acabam encontrando dificuldades no mercado de trabalho, tendo ensino superior ou não. Podemos considerar o governo federal responsável por maior parte dos problemas vividos por pessoas desse grupo, pois ele não está cumprindo com seu dever de isonomia social. Os governantes deveriam se impor, mostrar apoio a todos e não permanecerem inertes sobre tais situações.', 'Portanto, fica claro que o Brasil deve começar a tomar as devidas precauções para que não só as pessoas transsexuais, mas como todos do público LGBT , se sintam mais seguros. A criação de cotas para que eles possam ter mais chances de ingressar nos locais de ensino e de trabalho, tendo assim mais representatividade e voz ativa na sociedade. Palestras em escolas para que aprendam sobre a importância de combater qualquer tipo de preconceito. Caso haja tais atitudes, o Brasil estará mais perto de ser um lugar onde as pessoas desfrutam de seus direitos e se sentirão um pouco mais livres para serem elas mesmas.']",160,160,120,160,160,760
94,Dificuldades em incluir autistas no ensino regular,"['A Constituição federal de 1988, documento supremo de nosso país, perdiz em seu artigo 3° inciso IV que a República Federativa do Brasil deverá promover o bem de todos livre de qualquer tipo de preconceito ou discriminação. Contudo, ao observarmos as dificuldades enfrentadas na inclusão de pessoas autistas, fica claro que a realidade é bem distante do previsto na Constituição.', 'Em primeiro lugar, é importante ressaltamos a falta de conhecimento sobre o autismo. Grande parte da população entende esse transtorno baseado em estereótipos e achismos, o que infelizmente gera o preconceito que impede muitas crianças autistas de serem matriculadas no ensino regular e devidamente socializadas. A exemplo disso tomamos a fala preconceituosa do Ministro da Educação, Milton Ribeiro, que há alguns disse que a inclusão de alunos com necessidades especiais atrapalha o aprendizado dos demais alunos.', 'Além disso, depois de incluídas no ensino regular, esses alunos se deparam com outras dificuldades; a falta de recursos, de professores capacitados e, como previsto na Lei de Diretrizes e Bases para a Educação (LDB), nem todas as escolas possuem Salas de Recursos Multifuncionais que servem para amparar esses indivíduos.', 'Portanto, visando a plena inclusão dos autistas na escola regular, urge que o Ministério da Educação (MEC) e as Secretarias da Educação através de campanhas e cursos, invistam na formação continuada dos professores e em educar a sociedade para a inclusão e o respeito à diversidade.']",120,120,120,160,120,640
48,Impasses do SUS,"['Hospitais superlotados. Estrutura deficitária. Insuficiente aparato profissional. Segundo a Constituição Federal Brasileira, a saúde é dever do Estado e direito de todos, garantido mediante políticas sociais e econômicas direcionadas ao seu acesso universal e igualitário. Entretanto, a persistência da precariedade do sistema único de saúde reflete não só o desinteresse histórico do Estado, mas também a inação social. Nesse contexto, tal situação representa um preocupante atraso nacional e precisa ser revertida, em prol do bem-estar coletivo proposto por Rousseau .', 'Em primeiro plano, o pleno acesso ao SUS é dificultado pela secundarização da pasta saúde coletiva no Brasil. Esse paradigma decorre da danificação moral do Poder Público em favorecimento de interesses de ordem subjetiva, responsável por impossibilitar a competência da gestão política. Com efeito, conforme dados do IPEA , apenas 3,6% do PIB brasileiro são destinados à saúde, contrariando a recomendação de 12 % da OMS . Nessa perspectiva, não são disponibilizados ao SUS suportes infraestruturais e profissionais eficientes para atender as demandas da população . Desse modo, a revitalização dos serviços de saúde demanda a exata compreensão da prioridade absoluta estabelecida pela lei.', 'Além disso, sob a ótica sociológica, a inação do corpo social contribui para a perpetuação da conjuntura deficitária do SUS no Brasil. Esse cenário decorre da histórica passividade da sociedade brasileira mediante os problemas de ordem coletiva. Tal fato possui estreita relação com o conceito de individualismo metodológico da epistemologia weberiana, no qual o autocentrismo é postulado como inerente à condição humana . Nesse sentido, a mobilização social em prol da saúde pública é negligenciada. Dessa forma, a desconstrução do individualismo faz-se imprescindível para a luta sociopolítica pela qualidade do SUS.', 'Portanto, medidas são necessárias para resolver o impasse. Em razão disso, o Poder Executivo Federal , sob a ação do Ministério da Saúde, deve providenciar o aumento do contingente de profissionais da área da saúde por meio do aperfeiçoamento de programas como o ""Médicos pelo Brasil"", que incluam melhorias infraestruturais nas unidades de atenção básica e hospitalar, a fim de promover o acesso universal e igualitário da população à saúde pública .Em paralelo, é necessário o engajamento social em função de reivindicar das autoridades a competente oferta destes serviços. Assim, é possível suspender o descaso.']",160,200,160,200,200,920
71,Suicídio,"['O seriado “s 13 porquês” relata motivos que fez a jovem Hannah Baker tirar a própria vida. Fora das telas, o suicídio tem se tornado cada vez mais comum, portanto, é um problema que precisa ser solucionado.', 'A falta de apoio da família, seja na parte profissional ou na sexualidade dos filhos, a pressão que é imposta psicologicamente em época de vestibulares e,  até mesmo, dentro da faculdade por professores, a homofobia e abusos sexuais, são pontos que implicam no suicídio de muitos jovens e adultos, sendo estes abalados de tal maneira que não acham mais sentido em viver, assim,  tomando medidas irreversíveis.', 'Na série citada, é explicito o jeito como a jovem se suicida, embora apareçam telefones e avisos de prevenção, jovens que pensam a respeito e assistem a série, acabam sendo induzidos . O suicídio causa um transtorno coletivo em famílias e amigos, como a depressão, o divórcio, o isolamento, e  inclusive, mais suicídios. É um impacto psicológico muito forte e poucas pessoas conseguem lidar com isso.', 'Dessa forma, devem ser tomadas medidas para resolver o assunto em questão. Seria interessante que o MEC juntamente ao Ministério da Saúde  promovesse palestras de conscientização nas escolas, demonstrando como ajudar uma pessoa nessa situação, além de falar da importância da terapia e da conversação, onde nesses casos são de suma importância, podendo ser uma palestra aberta ao público da região do colégio, além divulgar os números d CVV, Centro de Valorização da Vida, que é um atendimento voluntario para o apoio emocional.']",120,120,120,120,120,600
82,Remédios,"['A automedicação, muitas vezes vista como uma solução para o alívio imediato de alguns sintomas indesejados, mas isso pode trazer consequências mais graves do que se imagina, muitas vezes orientada por alguém que não é um profissional capacitado.', 'O uso de uma forma incorreta sem uma orientação medica pode agravar uma doença ou esconder sintomas do mesmo. Segundo dados do Sistema Nacional de Informação Tóxico-Farmacológicas (SINTOX)   em 2003   os medicamentos foram responsáveis por 28% de todas as notificações de intoxicação, e isso pode acarretar vícios.', ' As estatísticas da Organização Nacional da Saúde (OMS)   em todo mundo  50% dos pacientes tomam medicamentos de forma incorreta, muitas vezes ocorre por sentirem uma dor e já ter o remédio para determinado sintoma em casa. A venda de medicamentos sem receita médica em farmácias deverá ser combatida e todos os remédios tarjados deveria  ser vendido  somente com receita médica  caso  essa prática for violada   ocorrerá uma multa para a farmácia.', 'Portanto   para evitar mais vícios e entre outros problemas que a automedicação pode ocasionar, sempre que estiver com dor   deve-se procurar um profissional. Assim como as famosas propagandas de remédios dizem: e  persistirem os sintomas, um médico deverá ser consultado.']",120,80,80,80,120,480
70,Malefício Periódico Social (MPS),"['O Movimento Harmônico Simples (MHS) estudado pelas leis newtonianas consiste na ação de um corpo em sair e voltar para um lugar em certo período, de maneira comparativa, tens que alguns problemas sociais podem sumir e reaparecer assustadoramente . Em exemplo, o retorno do crescimento das DST´s (Doenças sexualmente transmissíveis), o que entre os jovens é bastante evidente na atualidade, algo que era controlado, preocupa a sociedade, a qual permitiu tal situação por meio de um conjunto de ações negligentes.', 'Nesse raciocínio há uma evidente contestação ao pensamento do filósofo alemão Frederich Hegel, o qual defendia uma evolução perptua do homem e da sociedade, percebe-se nesse fator um claro regresso, pois por irresponsabilidade acomodação a maioria dos jovens permitiu se o uso de objetos contaminados, sexo sem camisinha ou ao contato com sangue infectado, tais ações são as principais medidas que possibilitam a adesão de doenças venéreas, estas enfermidades que já haviam sido quase erradicadas por campanhas governamentais, agora retornaram.', 'Seguidamente, temos  que na base desse processo, muitos adolescentes acreditam que tais malefícios saúde que eclodiram na segunda metade do século XX já não representavam um risco na contemporaneidade, estando eles completamente enganados, unido a essa causa estão as poucas campanhas midiáticas e a apresentação da sexualidade de maneira indevida, pois a grande maioria das famílias cultuam DST´s como um verdadeiro tabu e boa parte das escolas não possuem projetos voltados para a educação sexual.', 'Assim sendo, é perceptível que tal realidade advém de uma neutralidade de instituições sociais quanto à prevenção dessas doenças e o tratamento quanto a sexualidade . Diante disso, é necessário que o Poder Legislativo crie uma lei que inclua aulas de Educação Sexual mensalmente na grade curricular de todas as escolas de Fundamental II e Ensino Médio, de maneira que essas tratem de quebrar o tabu da sexualidade ,  através da apresentação de informações aos jovens quanto a métodos preservativos e a garantia que eles conheçam os malefícios e indícios das doenças venéreas, atingindo em alguns anos a eliminação dessas do âmbito social para que assim não retornem.']",120,160,120,160,120,680
27,O diferente que faz parte da gente,"['Brasileiros podem ser considerados por estrangeiros e até por nós, um povo leigo, algo que já está sendo considerado da nossa cultura, pois comumente é visto notícias, em que pessoas entram em brigas, que podem evoluir para casos gravíssimos, por motivos que poderiam ser resolvidos de modo diplomático com uma simples conversa.', 'Os nossos representantes na política brasileira, são exemplos simples de casos em que a argumentação deveria estar acima de tudo, contudo quando têm votações, reuniões e assembleias facilmente é mostrado que essas pessoas que comandam nosso pais não sabem nem resolver de modo argumentativo , muito menos respeitam as opiniões que divergem as suas.', 'Têm casos que podem ser vivenciados diariamente por qualquer pessoa que frequenta as redes sociais, pois sempre há manifestações de opiniões, que se polarizam, e ao invés de ser discutidas expondo seus pontos de vista e respeitando aos outros, estes são xingados e ofendidos sem mesmo ter a chance de expor seus pensamentos.', 'Mas acima de tudo esse povo acolhedor tem que aprender a respeitar o que é diferente para ele, assim irá entender o outro lado, e consequentemente poderá mostrar o que na sua opinião não está correto, um gesto simples que começa nas escolas e evolui para a vida.']",80,80,120,80,80,440
93,A industrialização do parto,"['Foi instituído pelo Ministério da Saúde o Programa de Humanização no Pré-natal e Nascimento (PHPN) , cujo intuito fundamenta-se na humanização da assistência obstétrica às gestantes. No entanto , o modelo de parto no Brasil torna-se cada vez mais um mero ato cirúrgico , uma vez que a falta de ética médica concatenada à carência informacional tem obstruído a autonomia da mulher acerca do nascimento de seu próprio filho . Dessa maneira , é um problema a ser sanado , a fim de que a chegada de uma criança seja algo o mais natural e saudável possível.', 'Nessa perspectiva , faz-se necessário mencionar a pesquisa , coordenada pela Fundação Oswaldo Cruz (Fiocruz) , onde é apontado que cerca de 70% das brasileiras deseja um parto humanizado no início da gravidez , porém , a minoria obtém êxito. Primordialmente , destaca-se a antiética de alguns profissionais da saúde ao exercerem influência na escolha da gestante visando apenas facilitar seu trabalho , consequente , a falta de orientação relacionada aos tipos de parto ,  podem causar sérios problemas , por exemplo , a infundada ideia de que cesárea é o parto mais seguro. Destarte , a má conduta médica contribui para a estruturação desta problemática.', 'Ademais , a desinformação tem naturalizado a industrialização do nascimento juntamente à violência obstétrica. Nesse sentido , o documentário da plataforma de streaming Netflix , O Renascimento do Parto , expõe através de relatos o quão comum é a falta de acolhimento dos médicos durante o trabalho de parto , outrossim , na filmagem é frisada também a importância na humanização do atendimento , para que seja uma experiência satisfatória mãe , bem como , saudável ao bebê e sua progenitora.', 'Portanto , cabe ao Ministério da Saúde investir na humanização de todo processo da gravidez . Por meio de recursos autorizados pelo Tribunal de Contas da União (TCU) juntamente recursos digitais , promover a criação de uma plataforma contendo informações a respeito da importância do protagonismo feminino em sua gestação. Além de que , debates devem ser promovidos entre médicos e gestantes a fim de que haja maior interação entre eles , tornando toda  gestação um acontecimento totalmente harmônico e natural , assim devolvendo ao parto toda sua essencialidade.']",160,200,120,160,160,800
72,Uma mentira dita mil vezes torna-se verdade.,"['""Uma mentira dita mil vezes torna-se verdade"".Essa célebre frase de Joseph Goebbels, ministro da propaganda na Alemanha Nazista, permite refletir acerca do papel das ""fakes News""ou ""hoax"" (termos ingleses para notícias falsas) na sociedade. Estas acabam por exercer controle sobre o indivduo e, por fim, nas decisões importantes, por exemplo, as eleições.', 'Em primeira análise, cabe pontuar que as noticias falsas exercem controle sobre o individuo. Isso porque, essas noticiam acontecimentos extraordinários e alarmantes, logo o internauta sente grande vontade de compartilhá-las, uma vez que as ver como algo importantíssimo e não tem o cuidado de pesquisar a fonte, já no outro geram o mesmo sentimento  e, por fim, cria-se um rede de espalhamento de \'hoax"" . Isso, é o observado em pesquisas divulgadas pela Universidade de São Paulo (USP), as quais noticiam que 12 milhões de pessoas já compartilharam notícias falsas em alguma rede social.', 'Outrossim, as ""fakes news"" influenciam negativamente as decisões tomada na sociedade, por exemplo, as eleições. Essa divulgam acontecimentos, falas, opiniões, gestos sobre determinada pessoa ou partido, s quais não são verdades, marcando negativamente sua imagem , logo quem é vítima das mesmas acaba sendo prejudicado e tem suas chances de vitória reduzidas para cargos públicos. A título de exemplo, é destacável as ""hoax"", divulgadas por blogs, sites e redes sociais sobre o candidato a presidência do Brasil, José Serra, as quais impactaram negativamente sua imagem e diminuíram sua popularidade frente ao povo.', 'É evidente, portanto, que medidas devem ser tomadas para diminuir o poder das ""fakes news"" na sociedade. Diante disso, a Agência Brasileira de Inteligência deve, em conjunto com o Facebook, Instagram e Whatsaap, identificar e remover as noticias falsas, a fim de diminuir sua disseminação e seu controle sobre a população.']",120,120,80,120,80,520
78,Construção,"['É notório perceber que o ensino médio está fortemente condicionado ao ENEM (Exame Nacional do Ensino Médio) ou a  vestibulares . Com a recente aprovação da reforma pelo Senado Federal, algumas medidas mostraram-se incertas quando a sua eficácia, como é o caso exclusão de História, essencial na formação do indivíduo, dentre as disciplinas obrigatórias, e falta de qualificação para professores e espaço físico adequado aos alunos no período integral das escolas.', 'Se por uma lado o estudante dispõe da opção de escolher uma das disciplinas integradas relacionado a área de seu interesse, por outro, a exclusão de História como matéria obrigatória pela Base Nacional Comum Curricular (BNCC), torna o estudante distante do conhecimento das memórias de seu país, assim como a ausência de Artes que impede a capacidade de interpretação ideias de diferentes maneiras . A entrada do período integral, visando o aumento de 800 para 1400 horas, implicará em mudanças na estrutura das escolas para os alunos que passarão mais tempo nesse ambiente , e para os professores e técnicos que necessitarão realizar novos métodos de ensino, em suma, o governo terá maiores despesas com essa nova adaptação e tecnologia. Além disso, a falta de tais profissionais no ensino é um grande problema para a educação, visto a carga horária inchada destas pessoas para suprir os salários que muitas vezes são insuficientes .', 'Anterior a uma reforma, deve-se existir a construção , ou seja, a solidificação de bases no ensino fundamental, pois os professores do ensino médio não serão capazes de suprir as carências oriundas de outra etapa escolar . Ademais, a deficiência de pessoas  nesta área poderia ser suprida com a capacitação de disciplinas pedagógicas para que outros profissionais possam se adentrar a educação básica, mesmo que estas entidades educacionais não participem efetivamente nas decisões da reforma, enquanto deveriam estar essencialmente presentes .']",120,120,120,120,120,600
44,DISCRIMINAÇÃO FEMININA,"['A prova de feminicidade tem tido muitas discussões desde 1930, e continua causando danos psicológicos irreversíveis a vários jovens até hoje. O movimento Let Her Run, tem como perspectiva eliminar esse paradigma, que é motivado pelo marxismo persistente na sociedade, atrelado ao mal cumprimento dos direitos humanos.', 'Em primeiro plano, é notório o favorecimento do homem na sociedade. De acordo com a filósofa francesa Simone de Beauvoir; “Homem é a definição de ser humano e mulher é a definição de fêmea – quando ela se comporta como ser humano, ela diz que imita o homem”. Por conseguinte, desde de o passado elas lutam por espaço no esporte, o qual ainda permanecem barreiras, exemplo da discriminação que muitas atletas de níveis de testosterona acima da média sofrem.', 'Em segundo plano, de acordo com o filósofo alemão Immanuel Kant; “todos somos iguais perante o dever moral”, o qual é garantido pela declaração universal dos direitos humanos. Entretanto, isso não ocorre na prática, pois o gênero feminino ainda é desfavorecido , como ocorreu com a atlética sul africana Caster Semenya nos 100 metros rasos. Assim o movimento Let Her Run, abre caminho para eliminar as barreiras no esporte feminino.', 'Portanto, torna-se necessário medidas que minimize esse problema. Para isso é preciso que words athletics , por meio da reunião dos dirigentes, retire regras que segregam o esporte feminino, uma vez que no masculino não sofrem com os mesmos atos. Desse modo, não seria necessário a prova da feminicidade, ademais, minimizaria a ilusória superioridade do homem nos esportes.']",160,160,160,200,160,840
65,Educação,"['Muitos estudos no campo da criminologia e das ciências sociais têm demonstrado que não há uma relação direta de causalidade entre a adoção de soluções punitivas e repressivas e a diminuição dos índices de violência. No sentido contrário, no entanto, se observa que são as políticas e ações de natureza social que desempenham um papel importante na redução das taxas de criminalidade, afirma o UNICEF, órgão das Nações Unidas para a infância.', 'Esse debate também é alimentado por uma falsa percepção da amplitude da criminalidade juvenil . Dados oficiais mostram que, dos 21 milhões de adolescentes que vivem no Brasil, apenas 0,013% cometeu atos contra a vida, afirma a ONU.  (Organização das Nações Unidas)Estatísticas mostram que os adolescentes são responsáveis por menos de 1% dos crimes violentos. Mais do que autores, eles costumam ser vítimas da violência.', 'É consenso entre psicólogos e educadores que o ambiente familiar influencia a formação de crianças e adolescentes. O Estado brasileiro já tem políticas de apoio à família, aplicadas pelos centros de referência de assistência social. Só que eles atendem a uma vasta gama de situações, desde a violência contra a mulher até o atendimento aos idosos. Uma ideia seria a criação de centros de atendimento às famílias especializados em problemas relacionados a crianças e adolescentes.', 'Para resolver essa situação é preciso investir na educação infantil, é na criança, que está o homem de amanhã. O governo tem que garantir a educação desde a creche, com atividade extraclasse, com um esporte, ou musica, ou só brincadeiras para aprender algo bom brincando. E cobrar dos pais resultados, o governo não deve permitir jamais que menores morem nas ruas. Lá não é lugar de crianças, E toda sociedade deve ter mais compaixão  com o jovem delinquente, eles são vitimas do sistema de exclusão brasileiro. É preciso saber escutar esses jovens e ajudar com profissionais competentes para redirecionar seus destinos. A vida não ensina nada, ela só cobra . Quem ensina é o professor na escola. Ou a educação é um direito e um dever de todos! Ou o governo pagará bem caro o preço de sua negligencia.']",120,160,120,120,120,640
82,,"['No que se refere á  automedicação no Brasil, pode-se perceber que parte da população utiliza a internet como mecanismo para análise de dores e sintomas freqüentes. Tendo  em vista não só como um meio de tratamento mais rápido, mas também mais econômico e prático.', 'Podemos perceber que a ingestão de medicamentos em casos triviais não apresenta em primeira instancia  risco algum. O jornal Folha de S.Paulo aborda o assunto afirmando que a maioria das dores que afetam a população é auto limitada . Nesse sentido, fica notável a poupança de tempo ao se tratar em casa doenças corriqueiras.', 'Convém lembrar ainda que, cuidar  de pequenas enfermidades no recinto domiciliar evita filas e a superlotação nos hospitais. Segundo o jornal Folha de S.Paulo  ir ao médico para se ter acesso a um simples analgésico levaria a  saturação dos sistemas públicos e privados de atendimento.   Haja vista,  que   se por ventura  os sintomas persistirem   a consulta com um médico é indispensável.', 'Sendo assim, medidas são necessárias para resolver o impasse. A fim de atenuar a questão, a sociedade deve, portanto, manter-se informada sobre os riscos em se automedicar, procurando conhecer mais sobre os remédios ingeridos e jamais deixar de realizar consultas com o agravamento dos sintomas. Os meios de comunicação, por sua vez   precisam através  das mídias sociais alertar os usuários dos riscos dessa prática, promovendo campanhas de conscientização sobre o uso controlado de remédios sem receita. Como já disse o filósofo Immanuel Kant, “O ser humano é aquilo que a educação faz dele”. Seguindo essa linha de raciocínio   é preciso refletir que   se utilizadas de forma consciente   a ciência em conjunto da  tecnologia muito tem a contribuir para a humanidade.']",120,160,160,160,120,720
41,Educação libertária,"['Colégios militares têm ganhado muitos destaques por seu bom desempenho no Enem e na disciplina dos seus alunos, porém existem muitos questionamentos sobre a rigidez impostas e quais são os impactos no aprendizado,  na construção da identidade e dos valores de cada educando. A imposição no aprendizado através do autoritarismo foge dos padrões pedagógicos, os alunos aprendem pelo método da rigidez e do medo, parecem verdadeiros “robôs” que executam as tarefas pré-estabelecidas pela instituição, onde o senso crítico e o incentivo a criatividade praticamente não têm espaço. Assim como argumenta a professora Pilar Lacerda na frase ""A escola de educação básica é o lugar da formação de valores, de conhecer e respeitar o outro. Do diálogo e da construção de normas comuns. Que cidadão está sendo formado neste modelo militar? A não ser que o jovem queira seguir carreira militar"".A escola não pode ser um lugar burocrático é local para discussões e aprendizado, os alunos precisam se expressar e saber respeitar uns aos outros, é possível disciplinar os alunos de várias maneiras, apresentando desafios, despertando interesse pelas atividades pedagógicas e muitas vezes ouvi-lo para a partir de um interesse ou dificuldade dele desenvolver um trabalho, e assim ver seus avanços. Justificar que as escolas militares tem um bom desempenho no Enem não é um bom argumento, pois muitas escolas que não utilizam o método militar conseguem alcançar bons resultados como exemplo é o Colégio Objetivo que são destaques nas provas, olimpíadas e na melhores universidade do país. O que podemos concluir é que o modelo militar é mais fácil para ter controle sobre os alunos, pois se for indisciplinado as consequências realmente surgiram .']",160,200,120,120,0,600
62,Reumanize-se,"['Que incrível! Vocês só sabem odiar? Ou odiar é tudo o que vocês sabem fazer? O dia todo. Introdução desta redação foi copiada de uma rede social, onde uma pessoa fez essa pergunta para um grupo de pessoas que propagam a discórdia nas redes sociais. Com o avanço da tecnologia, as redes sociais estão cada vez mais presentes na vida das pessoas. Hoje, uma parte da sociedade vem perdendo a noção do que é público e do que é privado, confundindo liberdade de expressão com intolerância. Como consequência, os discursos de ódio nas redes sociais, são mais frequentes a cada dia.', 'A internet trouxe inúmeros benefícios, como unir o mundo através de redes de computadores, Essa nova era é incrível e veio para ficar . E facilitar a vida de quem usa essa maravilha com respeito, responsabilidade e criatividade . Entretanto, a finalidade que lhe será dada depende de cada cidadão. Par a par com a liberdade anda a responsabilidade, dizia Santo Agostinho. Em redes sociais é preciso ter responsabilidade ao usar tais ferramentas, pois, sendo de uso coletivo, não é coerente agir apenas de maneira individual.', 'Além disso, a liberdade de expressão não é um direito fundamental absoluto. A partir do momento que se ultrapassa o limite dessa liberdade, ofendendo alguém, espalhando ódio ou incitando a violência, põe-se em risco a convivência pacifica nas redes. Logo, será inevitável que respingue na vida real querendo ou não, atos como estes devem ser punidos pelas devidas autoridades. A facilidade e o alcance das atrocidades cometida na vida virtual são mais devastadoras. Porque, em segundos o mundo inteiro pode saber da covardia sofrida ou provocada, como na vida real, compartilhar ou fazer ação de ódio, racismo, machismo, fascismo e preconceito com raça, religião e condição sociocultural também é crime.', 'Portanto, faz-se necessário que o governo potencialize a fiscalização dos crimes que ocorrem na internet, além de criar leis específicas para o mundo virtual. As escolas e as famílias também têm um papel importante formando cidadãos conscientes da diversidade cultural e de opiniões que há no mundo e instruídos para um uso responsável da internet e das redes sociais. Mais debates, mais propagandas em todos os canais de mídias, reparação de uma sociedade mais critica e mais consciente. Criticar não é ofender! Se a sociedade não mudar o problema se repete. Que todos juntos de harmonia encham o mundo virtual e real.']",120,120,80,120,80,520
83,Nos superando,"['É inquestionável, a forma de como a prática esportiva pode modificar vidas, fazendo com que cada indivíduo se supere, aprende e inspire a outros. Mas, quais são as razões para isso acontecer?                                                                                                                       São diversas as abordagens que o esporte pode causar em determinada pessoa. Muitos veem como um hobby, intercalando para um melhor condicionamento físico, ajudando também na saúde. Mas, existem aqueles que levam mais a sério, transformando em profissão, sendo o caso dos atletas, que servem como espelho, para aqueles que se inspiram e sonham em ser e chegar ao mesmo lugar, superando suas próprias barreiras.', 'Projetos são desenvolvidos, atingindo principalmente os menos favorecidos, que buscam através do esporte um novo caminho, vendo como saída para a realidade em que se encontram.                                                                                                                       Portanto, a  prática esportiva afeta de forma direta ou indireta, em  todas as classes sociais, gêneros e etinias, possibilitando uma interação entre os quais estão ligados. Sabemos que o nosso país não investi no esporte, mas temos em mente como é transformador e o quanto podemos aprender, e que somos realmente capazes de nos superar e servir de inspiração.']",120,120,160,120,200,720
50,COVID-19,"['O surgimento de um novo vírus chamado de Covid-19 assustou ao mundo, fazendo o pânico se instalar e alertando  a todos para os cuidados de higiene. Sua primeira aparição foi na China, fazendo  a mesma registrar 7.902 mortes.', 'O Covid-19 teve uma rápida propagação e por isso foi denominado como uma pandemia, logo nas primeiras semanas os cientistas não sabiam como o mesmo atacava e nem como o organismo humano se defendia . Com bastante empenho dos nossos cientistas como: patologistas, infectologistas, médicos, enfermeiros, dentre outros profissionais, foi descoberta a forma como o vírus atacava e de imediato os especialistas criaram meios de prevenções, como exemplo, distância de 1 metro, uso de álcool em gel, lavar as mãos constantemente com água e sabão e, principalmente  evitar aglomerações.', 'Esta última medida fez com que os prefeitos, governadores e presidentes de suas cidades, municípios e países ordenassem a paralisação das mesmas com o intuito de atrasar a circulação do vírus, pois o mesmo  tem a facilidade de se propagar num raio de 2 metros.', 'Com tudo isso, diversos artistas e pessoas comuns saíram nas janelas de suas casas para aplaudirem aos cientistas da área de saúde, reconhecendo  o grande papel dos mesmos , onde conseguiram definir o genoma do vírus em poucos dias . Podemos observar a necessidade de investimento na saúde, do restruturamento nos hospitais e postos para que em momentos de crises como esta não venhamos ter a necessidade de nos preocuparmos com a superlotação  e nem ter que escolher qual classe ou faixa etária deve viver.', 'Além do investimento na saúde, deve existir o investimento para a educação, pois é por ela que se dá o nascimento dos cientistas, dos pesquisadores e tantos outros profissionais importantes para combater as endemias, pandemias e surtos do mundo . Com esta medida, estaríamos melhorando os equipamentos de laboratórios para meios mais avançados de pesquisar e aumentando a velocidade de respostas em todos casos, sendo de emergência ou não.']",120,160,80,120,80,560
42,(Sem título 084),"['Hoje dependemos igualmente da qualidade de ensino e do esforço individual do aluno, pois o sucesso só é conquistado deste modo. Nos dias de hoje com inúmeros casos de alunos de baixa renda, ou alunos sem apoio familiar conseguirem o tão sonhado emprego, fica claramente explícito que com determinação e esforço o sucesso é possível. Entretanto, para o sucesso ser mais facilmente alcançado a escola tem um importante papel, a escola tem como prioridade aperfeiçoar a capacidade do aluno. Logo, com boa qualidade de ensino e grande desempenho do aluno o sucesso é facilmente alcançado.']",0,0,0,0,0,0
90,Transfobia no Brasil,"['Na novela “A força do querer” levanta a tese de um dos protagonistas (Ivan) um menino trans, acaba não sendo aceito por sua própria mãe e alguns de seus familiares por um longo tempo, ele sofria muito preconceito devido a sua identidade de gênero . Mas mesmo assim ele não deixou de lutar para que fosse aceito por eles, e independente de tudo, nunca deixou que isso afetasse como ele era de verdade, assim como muitos fazem na “vida real”. E por que isso acontece?', 'É importante ressaltar que o Brasil é o país que lidera o ranking mundial de assassinatos contra os transexuais. De acordo com o Ministério da Saúde, 11 pessoas trans são agredidas diariamente. Cabe analisar com tudo isso o preconceito e a falta de oportunidades para eles , como por exemplo o mercado de trabalho que é algo difícil para eles, e por isso, a prostituição e a moradia nas ruas tornam-se mais propícios. E isso acontece por existir a cultura da “heterocisnormatividade” que para eles o certo é a relação heteroafetivas entre pessoas cis, excluindo totalmente desse meio pessoas LGBTQIA+ . Podemos analisar também a falta de inclusão de pessoas trans nas escolas, e isso contribui para que esse problema persista cada vez mais.', 'Em virtude dos fatos mencionados, os caminhos para o combate da transfobia no Brasil devem ser tomadas de formas específicas. Os governos estaduais poderiam  fazer uma parceria com a mídia, para assim criarem projetos na escola, para educar novos alunos e fazer com que eles tenham respeito sobre a população, também para não praticarem nenhum tipo de racismo, preconceito ou homofobia com os demais problemas que aparecem na sociedade. E além de tudo garantirem a segurança de todos os alunos no ambiente escolar e em outros lugares. A mídia necessita também  por meio de comunicações, seja por sites, televisão, rádio, entre outros, ressaltar a importância dos direitos para todos e de forma ampla, e caso não aconteça nada disso, ocorrerá denúncias. Sendo assim, será possível uma vida segura para todos, próspera e cheia de oportunidades.']",160,120,120,160,160,720
47,As dificuldades no encino a distância.,"['Atualmente, o mundo sofre vários problemas em decorrecia do distanciamento social, provocado pela COVID-19. Nessa perspectiva, um desses imbrógrios esta relacionado à educação, a qual segundo o Fundo das Nações Unidas para Infancia (UNICEF), cerca de 1,5 bilhões de crianças na América Latina e no Caribe se encotram fora do ambiente escolar. No Brasil, para diminuir essa situação, algumas escolas presenciais resolveram opitar pela educação a distância, da qual tiveram que enfrentar grandes desafios como a falta de equipamentos basicos e a falta de convívio social .', 'A prióri, em consoante com o filósofo prussiano Immanuel kant, ""o homem não é nada além daquilo que a educação faz dele"", a educação é primordial para a formação do indivíduo. Logo, é dever do governo garantir lá de acordo com a Declaração Univesal dos Direitos Humanos (DUDH). Sendo assim, o estudo a distância se tornou uma boa alternativa, porém, a falta de equipamentos básicos é um grande obstáculo que deve ser superado, por exemplo: livros digitais, vídeo aulas e internet principalmente, que é a principal fonte de comunicação entre os professores e seus alunos.', 'Ademais, a falta de convívio social é outra dificuldade da educação a distância, sobretudo para as crianças que não sabem lidar direito com o distanciamento, e acabam ficando suscetíveis a transtornos, como ansiedade e depressão. Assim, é importante que os pais fiquem atentos. Dessa maneira, é alertado por especialistas a presença de cronograma com tarefas e diversões que estimulem a interação com as outras crianças.', 'Portanto, os desafios da educação a distância no Brasil precisam ser superados. Sendo assim, para garantir o direito ao conhecimento assegurado pela DUDH, se faz necessário que o governo , por meio do Ministério da educação, invista na compra de materiais eletrônicos que seriam distribuídos aos alunos que não os tiverem, podendo ser compartinhados aos estudantes da mesma casa. Só assim, esses alunos poderiam estudar durante esse distanciamento obrigatório.']",160,160,120,160,120,720
6,Pulmões limpos e estômagos vazios.,"['A floresta amazônica sempre despertou e ainda desperta vários interesses nacionais e internacionais. Ela é explorada nacionalmente por extratores de madeira, garimpos, agricultores, etc., já etc. Já os outros países, demonstram países demonstram preocupação ambiental, porém, em grande parte parte, com um falso discurso.', 'É através de uma queimada que acontece naturalmente uma vez por ano, somada a fotos antigas divulgadas como se fosse a tempo real e em redes sociais por celebridades, por celebridades em redes sociais como se fossem atuais, que são disseminadas informação informações de que a Amazônia está em chamas. Esta intenção é a demonstração de um sentido político contrário ao atual governo brasileiro que comprova claramente sua propriedade nacional que é essa região.', 'Moradores deste desse local informam que essas queimadas acontecem anualmente devido ao clima seco da época do ano.', 'O lençol freático da região é motivo de cobiça internacional e o presidente francês Macron, devido a à perda de força política e credibilidade em seu governo, utiliza-se atualmente de discurso ambiental, se intitulando intitulando-se um salvador preocupado com o planeta.', 'Todos devemos preservar o planeta e a Amazônia também é composta por regiões de outros países, sendo no Peru, altamente contaminada por mercúrio da extração de ouro, todavia somente o Brasil é lembrado.', 'A Amazônia pertence ao Brasil e não é território internacional, sendo assim, benéfica ao mundo a partir do momento em que é preservada, sem deixar também de ser corretamente explorada para benefício econômico somente para o Brasil, da mesma forma que seria feito, talvez até de forma indiscriminada por nações hipócritas.']",120,120,80,80,120,520
33,"Educação Física obrigatória; Artes, não.","['Artes e educação física são duas disciplinas que podem se tornar opcionais pela nova reforma do ensino médio. Há de se ponderar; porém, que são áreas com necessidades e finalidades diferentes.', 'Em se tratando da disciplina de educação física, ela é de suma importância para os estudantes e deve ser mantida obrigatória, pois o exercício físico previne problemas cardiovasculares, obesidade e outras enfermidades, e ajuda até mesmo no desempenho dos alunos em matérias teóricas, porque já é conhecido pela ciência que essa prática melhora a memória e a cognição. Além disso, principalmente nas populações mais pobres, a escola pode se tornar o único lugar a se praticar exercícios, e com o advento do horário integral como norma geral às escolas, o sedentarismo tende a crescer significativamente.', 'Já em relação à disciplina de Artes, o quadro é distinto: trata-se de algo ligado à abstração. Necessário sim para a expansão do conhecimento e criatividade; porém, por ser algo mais subjetivo, pode ser substituído por outras atividades culturais sem a necessidade de obrigatoriedade como feiras e oficinas culturais integrando todos os alunos.', 'Portanto, são necessárias ações que resolvam tais impasses. A Educação Física não deve ser retirada das disciplinas obrigatórias, sob risco de até mesmo onerar o sistema de saúde com mais estudantes vítimas do sedentarismo e suas consequências. A disciplina de Artes; porém deve ser de rotina daqueles que realmente se identificam com o assunto e desejam aprender mais. Assim, um ensino médio mais coerente com as necessidades dos estudantes, terá mais qualidade.']",120,120,80,120,120,560
121,Reforma Eleitoral,"['Propaganda eleitoral, show de hipocrisia, gatunos, palavras essas que viraram         sinônimos entre         a população,         fazendo a ela         perder a esperança         sobre a         política. Como consequência disso, em ano de eleição, muito se discute a respeito do horário eleitoral em redes de televisão aberta, pois ele é uma forma         da         população conhecer as propostas de seu candidato.                 Todavia, deveria criar um canal aberto destinado a esse assunto e a população a ter esperança em questões políticas.', 'O horário político atualmente desagrada milhares de brasileiros, pois ele atinge todos os canais de televisão aberta, sem         ter         chance         do individuo         escolher         o         que assistir. Além disso, o dinheiro destinado à propaganda política vem dos cofres públicos, tendo como objetivo beneficiar todos os candidatos na questão do tempo, no entanto, ocorre o oposto,         partidos         ‘’pequenos’’, como o antigo PRONA (Partido de Reedificação da Ordem Nacional), presidido pelo deputado federal Enéas Ferreira Carneiro, possuía um tempo menor de propaganda eleitoral.         Em contrapartida         ,                 não tinha chance de vencer os seus adversários. A questão do dinheiro sempre esteve presente na política brasileira, na época da República Velha, os coronéis eram praticamente candidatos vitalícios, burlavam os resultados políticos, fazendo ganhar a eleição quem eles queriam.', 'Atualmente, a população brasileira vê os políticos como uma quadrilha de negligentes que surrupia o dinheiro destinado à saúde e educação,                 fato esse que perdura na história do Brasil desde o período da República.                Este fator aniquila a política brasileira,         onde         os brasileiros         votam,         só por         votar. Não levando ela         a sério,         fato esse,         ocorreu na última eleição,         onde         o palhaço Tiririca foi eleito o deputado federal mais votado de todos os tempos.', 'Em virtude dos aspectos observados,         devia-se criar          um canal aberto                destinado a questões políticas, com debates entre os políticos que, em época de eleição, apresentassem propagandas         eleitorais, onde os políticos         eleitos, discutissem com a população as melhorias que deveriam ser feitas em sua         cidade, sobre o que precisa ser melhorado, entre outros.         Consequentemente, o indivíduo decidirá se quer ou não assistir à propaganda eleitoral, pois, afinal de conta, estamos em um país democrático. A população deveria levar mais a sério a política, pois todos dependem dela, e votar consciente.']",160,120,120,80,120,600
1,O progresso da tecnologia,"['No decorrer dos séculos XVIII e XX, o mundo passou por três revoluções industriais, e industriais e, atualmente, no século XXI, a quarta revolução industrial já acontece. As inovações tecnológicas proporcionadas por esse fenômeno impactam diversos setores como, saúde como saúde e agricultura, e a tendência é o mercado de trabalho aderir cada vez mais às novas tecnologias que estão sendo desenvolvidas. Entretanto, se os trabalhadores não acompanharem as modernizações, as oportunidades de emprego poderão se tornar escassas.', 'Segundo dados do Instituto Brasileiro de Geografia e Estatística (IBGE), é importante destacar que o Brasil possuía uma taxa de desemprego de 11,2% no final de 2019, aproximadamente 12 milhões de pessoas. Contudo, existem setores com muita disponibilidade de vagas, como os de tecnologia, os quais exigem uma qualificação do candidato, sendo esse requisito, um requisito um fator desclassificatório para muitas pessoas que não possuem uma formação superior.', 'Com o desenvolvimento da Inteligência Artificial (IA), muitas tarefas padronizadas que eram realizadas por serem humanos foram e estão sendo substituídas feitas pelas máquinas inteligentes. Em oposição a isso, vários empregos surgiram, como e-commerce, marketing online e e-business, porém esses serviços não conseguem abranger a demanda de indivíduos descapacitados, pois as premissas principais desses ramos são a criatividade e capacitação para o uso da tecnologia. Sendo assim, as pessoas excluídas acabam recorrendo aos subempregos ou não conseguem trabalhar.', 'Portanto, é primordial que o Estado faça adesão de tome medidas para amenizar a realidade atual. A fim de que os jovens possam ter conhecimento das transformações tecnológicas, é necessário que as escolas realizem trabalhos, palestras e projetos de vida relacionados às profissões atuais. Em adição Adicionalmente, a presença do Ministério da Educação e Cultura (MEC) é importante, para importante para a implantação de disciplinas obrigatórias no componente curricular das escolas, como informática ou robótica, para que a juventude possa se integrar mais facilmente no mercado tecnológico. Já para a população adulta, o Governo deve garantir a existência de cursos gratuitos para a sociedade. Com essas ações, os trabalhadores poderão acompanhar as inovações da era e conquistar uma vaga de emprego.']",160,160,160,160,120,760
71,Suicídio,"['A palavra suicídio vem do latim:  ‘sui caedere’  e significa ‘matar-se’ . Prática realizada desde a Grécia antiga como método de libertar-se do sofrimento. Sendo a quarta causa de morte de jovens no Brasil. Os motivos para o suicídio são variados, desde a adolescência ao encontrar dificuldade como as mudanças naturais da idade, buillyng na escola e tende continuar na idade adulta com os problemas pessoais ou financeiros, abuso de álcool ou drogas, medicamentos, fim de relacionamento, doenças terminais e até mesmo excesso a tecnologia que restringe o contato humano causando a sensação de solidão.', 'Constantemente somos  bombardeados com campanhas em prol da prevenção do suicídio. Na mídia nas campanhas do governo, na TV como a famosa série Os 13 Porquês  explicando possíveis causas da morte de personagem. Na literatura como o livro Suicídio de Durkheim focado nas características individuais e suas conexões . Ao mesmo tempo nos deparamos com um certo despreparo de profissionais que trabalham com jovens ou da própria família e amigos do suicida. Até mesmo romance da morte a Goethe fez em Sofrimentos do jovem Wherter, que se suicidou por uma rejeição amorosa. Na música os músicos Chris Cornel e Chester Benington que suicidaram, os casos serviram de inspiração para fãs e simpatizantes finalizarem a própria vida, mal interpretados, afundados em niilismo, ansiedade e depressão.', 'A luta contra este mal que assombra em pleno século XXI precisa começar pela conscientização da sociedade, falar abertamente sobre saúde mental, buscar compreensão da família e amigos, encontrar e elucidar causas . Restringir acesso a meios letais, retirar do alcance objetos cortantes e perfurantes, medicamentos. Já disse Augusto Cury: ‘’ Quando uma pessoa pensa em suicídio, ela quer matar a dor, mas nunca a vida.’’']",120,160,120,120,120,640
20,#Partiu Estados Unidos,"['Ao longo do processo de formação do Estado brasileiro , muitos imigrantes adentraram as fronteiras verde-amarelas e ajudaram a formar a nação que se vê hoje. A principal característica do Brasil, no que diz respeito aos aspectos do seu povo, é a miscigenação. Mas ao longo das últimas décadas o que se pôde observar é justamente o contrário: o brasileiro quer ir embora . Pesquisa realizada pelo Datafolha revela que 43% da população brasileira deixaria o país e 63% dos jovens que vivem no país fariam o mesmo. Tanta desilusão com o país pode ser explicada pela desestabilidade econômica e a alta carga tributária que se paga hoje . Sem deixar de fora também o vasto número de problemas sociais que o país enfrenta e a crise política que assola o país.', 'O brasileiro trabalha em média um terço do ano apenas para pagar impostos, segundo reportagem apresentada pela revista Exame em março de 2018. Apesar de pagar tributos altíssimos em produtos básicos, como serviços, combustível e gás de cozinha, o Brasil tem uma alíquota sobre o imposto de renda baixa, se comparado a países desenvolvidos. Mesmo assim, ainda paga-se muito caro pelos bens de consumo, o que leva a um alto índice de sonegação de impostos. Mesmo não sendo a cobrança do imposto de renda seu maior vilão, o dinheiro obtido com a arrecadação de impostos, que deveria ser empregado para o bem do povo, muitas vezes é desviado por corruptos, levando o país a cobrar cada vez mais impostos sem conseguir melhorias sociais.', 'Observa-se que um problema leva a outro: a cobrança elevada de impostos leva à sonegação; desvio do dinheiro público leva ao não investimento nas políticas públicas , que leva a um serviço público ruim, que leva a falta de segurança, a falta de saúde, a falta de educação . Se um país não conseguir administrar o dinheiro arrecadado com os impostos, acaba falhando no básico, acarretando em problemas sociais difíceis de se resolver. Apesar das adversidades o brasileiro é um povo que não desiste e quer melhorar, mas nem sempre sua pátria lhe permite, o que o faz ir em busca de outra.', 'Como se não bastasse todos os problemas sociais enfrentados pelo brasileiro, ainda lhe sobra as consequências de uma crise política que não dá indícios de que acabará tão cedo. O país conta em seu currículo político com a cassação de uma presidente, a prisão de um ex-presidente, prisão do ex-presidente da Câmara dos Deputados, prisão do ex-governador do estado do Rio de Janeiro e presidente atual sob ameaça de ser investigado, dentre tantos outros casos de corrupção e crimes cometidos no ambiente político. Diante desse cenário de instabilidade, compra de votos, caixa dois para financiamento de campanhas, o brasileiro fica desmotivado, não conseguindo enxergar a luz no fim do túnel.', 'Portanto, pode-se atribuir a evasão do jovem brasileiro, principalmente pela falta de esperança. O jovem pouco viveu, e para ele dez anos é muito tempo, não para esperar até que o país melhore. Ele quer ascender profissionalmente, ele quer ser o melhor, ele busca o melhor. Os Estados Unidos se torna o principal objetivo do jovem, por ser um país de oportunidades, um país livre, onde as leis são cumpridas, ou seja, o jovem vai em busca de seus sonhos, e que pode ser bem representado pelo “sonho americano”.']",200,200,160,160,80,800
146,Racismo,"['O ponto de partida e o principal motivo do racismo se         deve         à educação de cada         individuo         . Desde o nascimento, somos influenciados a criar um ""pré-conceito"" sobre algo ou alguém e a partir         disto         criamos                próprias opiniões sobre o assunto. Alguns possuem forte crença naquilo que lhes é ensinado, portanto recusam-se a ter uma visão diferente. Até então, tudo bem, pois liberdade de expressão é um direito que todos possuímos. O problema se inicia quando o racismo                 torna-se moral ou, em casos extremos, físico.', 'Apesar de o racismo                ser                 menos decorrente                em comparação ao passado, ainda há um grande número de casos no         dia-a-dia         . E, por exemplo, quando ocorre com pessoas influentes na         mídia. Isso         choca a maior parte da população e gera indignação coletiva como ocorreu com                 os jogadores insultados durante um jogo de futebol                .', 'Se temos a consciência de que o racismo é algo ruim,         porque         alguns ainda insistem em praticá-lo? O problema então se encontra nas leis que não são tão         vigorosas         ou na educação de cada         individuo         ? Se uma criança crescer no meio de uma família racista, logo ela fará parte da população preconceituosa e caberá a                 ela saber como lidar com o seu racismo: ofender moral e fisicamente um negro ou respeitá-lo.', 'Problemas como esse incluem se aprofundar muito no assunto, pois cada         individuo          praticante de racismo                tem um motivo                que julga certo fazer aquilo. A lei deve ser mais rígida em casos não só de racismo como todos                os tipos de discriminação. Cada criança, desde o seu primeiro dia de aula, deve aprender que independentemente da cor da pele de cada um, somos todos seres humanos e a cor da pele não torna alguém superior ou inferior em relação ao outro.']",120,120,120,120,120,600
84,Esta não é a solução,"['No Brasil, desde do ano de 2003 está em vigor o Estatuto de Controle de Armas, campanha criada pelo Governo Federal a favor do desarmamento, com o intuito de diminuir a violência, e os homicídios causadas por armas de fogo.', 'Contudo, no Congresso há um projeto de lei que tem por objetivo acabar com a controle de porte e registros de armas no país. Entre suas ideias de mudanças, está a diminuição de idade permitida para a compra de armas, de 25 anos para 21 anos de idade, e garante o seu uso à deputados e senadores.', 'Mas isso traria benefícios para a sociedade? Estudos feitos pela Agência do Brasil, mostram que em treze anos de campanha, cento e sessenta mil mortes foram evitadas pela sua restrição. E que no ano de 2004, ano posterior a implantação do Estatuto, registra-se uma queda no número de homicídios por disparos, após dez anos de crescimento constante.', 'Exemplos fora do país podem intensificar a percepção de que a utilização de armas pela população civil não é uma solução para a diminuição da violência, e que ao contrário, muitas vezes é ele o progenitor para tais atos.', 'Uma confirmação disto foi o atentado a boate gay, Pulse na cidade de Orlando na Flórida; onde Omar Mateen, de origem islâmica, facilmente conseguiu comprar uma arma para espalhar o caos, e assassinar e ferir inocentes que frequentavam o lugar. Os Estados Unidos provam assim, que a falta de regras mais rígidas do controle do armamento causa-se severas consequências; tais como massacres e criminosos ainda mais armados.', 'Conclui-se no fim, que no Brasil a preocupação deve-se ser n a fiscalização de entrada de armamentos pelas fronteiras, e não em “acabar” com um projeto que só auxiliou a segurança no país.']",120,160,200,160,200,840
102,Pseudo Cidadão ,"['Várias regiões do Brasil estão sofrendo a escassez de água,         atingindo         hoje, quase 46 milhões de brasileiros. A estiagem chegou de uma                 forma abrupta                , castigando o país e assolando a esperança         dos mesmos         . Sabe-se hoje que o mais importante reservatório de água que abastece grande parte das regiões afetadas pela estiagem,         Cantareira         , sofre um                 desnível com cerca de 11,6 por cento                , já utilizando o         Volume Morto         que trabalha com 400 milhões de metros cúbicos de água         situado         abaixo das comportas das         represas do Sistema Cantareira         .', 'A falta         deste         recurso natural insubstituível leva-nos a ter consciência de que pouco temos e muito devemos fazer.                 Tal          fato, deve-se a          falta de chuva nas regiões afetadas e em todo o Brasil, mas principalmente nas regiões Sudoeste e Centro-Oeste, devido aos bloqueios atmosféricos, que são por sua vez comuns nesta época do ano, causando a estiagem.', 'Podemos         citar         com toda a clareza dos fatos, que o brasileiro tem uma certa confiança exagerada de que a água não irá acabar e por conta disso há um desperdício desenfreado por parte da população. Com a estiagem e os alarmantes níveis dos reservatórios, deu-se um movimento de conscientização por parte dos que estão e dos que não estão sendo afetados, ainda, pela falta de água. Mas ainda não foi o suficiente.', 'A         gerencia         hídrica de todas as regiões                 que sofreram          assolação  , usaram de inicio o Volume Morto         , que “aliviou” um pouco a tensão dos atingidos pela seca, mas também não foi o suficiente.                 Obtiveram então por racionar o recurso no estado de São Paulo,                  que gerou polêmica e revolta          pelos que usam do mesmo         .', 'A revolta por parte daqueles mesmos que fazem o         mal  uso         da         água, deveria         ser medida de acordo com         seus fatos         .                 Deveriam          usar          do tempo que ocupam para criticar os métodos que a          gerencia          hídrica          usa          para pouparmos-nos de um futuro          inserto          e trágico que          ira          abranger horizontes          à fora          com a falta de água e          usar          do bom senso para se policiar e ter mais responsabilidade ao          usar          o meio          em          que mais dependemos para sobrevivermos.']",120,120,80,80,0,400
70,Ideologia e DSTs,"['""O meu prazer agora é risco de vida/ meu sex and drugs não tem nenhum Rock \'n Roll"". Nesse trecho da canção "" Ideologia"", composta e interpretada por Cazuza, faz um jogo de palavras com o ""slogan"" da juventude dos anos 80 - sexo, drogas e rock \'n roll - para retratar, dentre outros aspectos sociais, a problemática da AIDS, doença, até então, pouco conhecida. Hodiernamente, no Brasil, o aumento do número de adolescentes infectados com DSTs (Doenças Sexualmente Transmissíveis) levanta discussões sobre maneiras eficazes de prevenção, tratamento e informação para a juventude do século XXI - totalmente distinta dos jovens dos anos 80.', 'Segunda a Biblioteca Virtual em Saúde, as DSTs são transmitidas, principalmente, por contato sexual sem o uso de preservativo com uma pessoa infectada e, geralmente, se manifestam por meio de bolhas, feridas ou corrimentos. O cancro mole, HPV e a Gonorréia são alguns exemplos dessas enfermidades. Dentre estas, a Síndrome da Imunodeficiência Adquirida (AIDS) é a mais destrutiva, pois, mesmo diante dos avanços na medicina, ainda não possui cura.', 'Diante disso, percebe-se a problemática que é o aumento desse tipo de doença entre os jovens brasileiros. De acordo com o Departamento de DST, AIDS e Hepatites Virais do Ministério da Saúde  houve um aumento expressivo de brasileiros, entre 15 e 19 anos, infectados - uma variação de 187,5% com a transição da estimativa de 2,4 para 6,9 em cada 100 mil habitantes. A elevação dessa taxa pode ser explicada pela ausência de medidas eficazes  que acompanhem as mudanças comportamentais dos jovens do século XXI, imersos em uma sociedade bem mais dinâmica, cosmopolita e marcada pela instantaneidade das redes sociais.', 'As campanhas e outras formas de prevenção de todas as DSTs, portanto, devem ser reformuladas e integradas ainda mais nos âmbitos virtuais. O Ministério da Saúde, por exemplo, pode investir mais na criação de posts educativos, através de perfis em Facebook, Instagram e Twitter,  demonstrando relatos - com todo o resguardo de imagem - de jovens infectados e as mudanças que esse fator trouxe em suas vidas socio-emocionalmente. Além disso, mitigar a falsa ideia que alguns jovens ainda possuem de que o coquetel AZT é a cura para a AIDS  e, portanto, o uso da camisinha e da adoção de práticas e comportamentos sexuais mais seguros serem imperativos. Assim, o Brasil ajudará a manter seus jovens mais saudáveis.']",160,200,160,160,120,800
43,O Hábito do Cancelamento,"['Para o cientista Albert Einstein ""Se tornou aparentemente óbvio que nossa tecnologia excedeu nossa humanidade"".Logo que essa citação se encaixa no momento atual,como a cultura do cancelamneto,de modo que as pessoas são odiadas através das redes sociais,por pensarem diferente,ou por terem cometido algo de errado. Nesse contexto,deparamos com a má influência midiática e os transtornos psicológicos.', 'A princípio,a internet está cada vez mais devastadora,onde as pessoas usam a ferramenta como um meio de julgar a outra nas redes sociais .De modo que a influência midiática, impõem nas pessoas um determinado padrão,como na forma de pensar e agir,um padrão onde tudo deve estar de acordo com as regras estabelecidas pela mídia.', 'Ademais,o cancelamento pode ter como consequência transtornos psicológicos,uma vez que a pessoa cancelada foi julgada e linchada virtualmente,causando depressão e até mesmo o distanciamento social . De certo que cancelar não é o melhor caminho para corrigir erros,pois pode criar questões maiores,temos que nos colocar no lugar do outro praticando assim a empatia,como na frase do pensador Mahatma Ghandi ""Temos de nos tornar a mudança que queremos ver"".', 'Torna-se,evidente,portanto,para que a cultura do cancelamento seja anulada o Ministério da Tecnologia (MCTIC) ,junto com as redes sociais, Twitter e Instagram, deve por meio de discussões, campanhas e relatos,criar vídeos e anúncios para a conscientização de usuários da internet,com a finalidade de que o cancelamento não é o melhor formato de repreender alguém. Como também,para solucionar a outra problemática deve-se usar dos mesmos recursos,com a finalidade das pessoas poderem usufruírem as redes sociais sem que sofram transtornos psicológicos']",160,160,120,200,160,800
87,Crianças,"['A erotização infantil não é um problema atual, pois essa cultura vem sendo cultivada gradativamente desde muito tempo. A sexualização das crianças está presente em', 'diversos ambientes culturais e sociais, inclusive na mídia, que tem parte da culpa nessa questão, pois procura chamar a atenção do público expondo da pior maneira', 'os jovens e crianças, visto que a polêmica é o que gera audiência. Ademais, devido a essa “adultização” precoce que é imposta pelos meios de comunicação  e até mesmo pela sociedade, há um grande aumento nos índices de crimes relacionados a pedofilia, e a situação segue se agravando.', 'Primeiramente, é importante ressaltar a influência gerada pela tecnologia (como internet e a televisão) e o papel que adquirem na erotização de menores, dado que a sociedade está cada vez mais ligada no mundo das redes sociais e nos sistemas de informações, assuntos polêmicos e maldosos relacionados a categoria infantil ganham muito espaço para comentários e dão brechas para a imaginação perversa das pessoas.', 'Sob esse viés, é clara uma preocupação com a exposição infantil, de tal forma que os crimes e violações feitos a jovens tem estado presentes em todos os cenários - até mesmo os familiares - com assédios recorrentes. De acordo com o relatório da Polícia Federal, houve um aumento das denúncias de pedofilia na internet de 190%, totalizando 5.866 casos, no período de um ano. Além de não somados a essas denúncias, todos os casos que não vão a público, por medo da vítima.', 'Portando, a erotização infantil é um grande problema no Brasil e desencadeia diversas ações negativas. Dessa forma, são necessárias medidas do Ministério da Educação juntamente com o corpo docente das instituições de ensino, para pôr fim a essa cultura de sexualização de crianças, por intermédio da introdução de educação sexual nas escolas,  organizando palestras e debates com professores e especialistas, a fim de que os menores aprendam desde cedo a como lidar com esse problema, e fazer com que a sociedade trate as crianças somente como tais.']",160,160,160,200,160,840
23,Informação no rótulo de produtos transgênicos,"['Transgênicos são organismos geneticamente modificados em laboratório, onde é alterado seu DNA com o objetivo de potencializar ou criar características que não se obtém originalmente na natureza. A questão é: deve haver informação nos rótulos de produtos transgênicos ou trata-se apenas de uma formalidade dispensável?', 'Segundo o Código de Defesa do Consumidor, é obrigatória a rotulagem de produtos que contenha mais de 1% desses organismos, o que assegura o direito e liberdade de escolha do consumidor, além de garantir que o mesmo saiba quais produtos está consumindo, seus ingredientes e composição.', 'Há também a duvidas e receio no que diz respeito à eficácia e saúde fornecida por esses organismos, que ainda estão sendo alvo de muitos estudos e testes, onde um dos pontos debatidos é o desencadeamento de alergias ao longo do tempo, como também doenças mais severas, entre elas o câncer, que se da principalmente ao aumento da utilização de agrotóxicos nesses produtos.', 'Dessa forma, a defesa dos Direitos do Consumidor deve ser prioridade, visando à informação do produto para o comprador ; outrossim, estudos mais intensos sobre possíveis efeitos desses organismos nos alimentos, no ambiente e na saúde das pessoas devem ser feitos rigorosamente; além do investimento governamental em propagandas com a intenção de promover informações sobre tais alimentos, são algumas cabíveis soluções sobre o tema descrito.']",120,0,80,120,80,400
114,É necessário remir a ética da coexistência social,"['Propõem         -se reflexão:                 promover a hostilidade no âmbito escolar é ampliar aquele vácuo que se encontra no imaginário brasileiro de não ater-se à ética da coexistência                . Nota-se: não é difícil encontrá-la, contudo, uma quantidade ínfima de ignorância na sua essência é capaz de produzir                 os falsetes do não se pode posterior ao se cogitar o realizável.                Nem tudo está perdido.', 'Com a problemática do bullying prático e virtual, entra-se em uma discussão precisa: o que posso fazer enquanto responsável por meu filho, para que ele não se metamorfoseie em condutor do terror ou seja vítima desse                 longínquo desprazer inerente à sociedade? Sob qualquer aspecto, não se pode preconizar distorções éticas seja nas mais cognoscíveis ou nas mais herméticas facetas                . O próprio         professor, é         capaz de contribuir com a violência direcionada ao aluno, através de anulações de                 sua                capacidade intelectual                 cuja razão é uma funesta inaptidão didática                . E é claro que o aluno pode ter participações aceitáveis na aula. Tal realidade só piora quando o estudante que já é vítima da         violência, depara-se         com dissimulação                 no valor da retidão, que tem suas origens na família e que está apta a produzir não essências dramáticas                . Nesse período conflituoso da vida do pré-adolescente e do adolescente, o que é o desprezível,                 enquadra-se em propagandear a harmonia social como a artificialidade da mesma.                Com isso, perde-se de vez a noção de respeito coletivo e acentua-se a intimidação social.', 'O massacre em Realengo, a tragédia em Saana, o assassinato em         Springfiel         em território ianque, o morticínio na         Columbie         High School, em Littleton e as repetições em outras         nações, são         evidências explícitas de                 uma conjuntura com âmago social.                Atribuir essas causas                 existenciais à indole religiosa do ""tudo"" como se          vê  , significa         negar as                 soluções para essa vivaz ""predileção nauseante""                . Nota-se que a hodierna inclinação para matar é sustentada por quatro certezas: a crença na superioridade do próprio grupo étnico(etnocentrismo), o orgulho exasperado, a tirania como veículo da opressão aos ""fracos"" e a mediocridade vivencial.         Hitler, adoraria         constatar que essa propensão à carnificina é oriunda de sua                 idealização e consolidação de sua obstinação                ao horrível, visto que conseguiu lançar seus pilares. Matar para a insensatez é                 fomentar o desejo aos mil êxtases.', 'Não se sabe sobre os autênticos agentes tentadores desses lastimáveis momentos vivenciados                 por cada                aluno vitimado, seja pelo bullying ou por seu resultado e                 por cada                pai atormentado pelo receio da matança. Todavia se sabe que a estupidez humana presente em todos os         casos, relata         que as convicção de sua sedução é a própria aptidão do homem em mastigá-las. Não é para                 cingir-se a um pessimismo existencial, mas para empenhar-se na regurgitação da verdade ingênua da estupidez. Confissão da existência: Isso não é um bicho de sete cabeças!']",80,120,120,80,80,480
55,,"['No filme norte-americano “Moana” os costumes da Polinésia são representados de maneira sutil, dando ênfase à diversidade cultura. Entretanto, fora da ficção, nem sempre as diferentes culturas possuem tal visibilidade, sendo alvo de preconceitos e possuindo dificuldades para garantir seus direitos. Esses imbróglios socioculturais são a realidade em que os povos indígenas vivem no Brasil, fazendo-se necessári a discussão acerca da importância da valorização e da garantia dos direitos desses povoados.', 'É necessário, primeiramente, entender que a presença dos indígenas no território brasileiro é antecedente ao processo de ocupação estabelecido pelos exploradores europeus. Porém, o desapossamento das terras desses povos tornou evidente o processo de urbanização e a dizimação dessa minoria, n qual grande quantidade foi morta em lutas e, principalmente, pela contração de enfermidades a partir do contato com as culturas brancas. No cenário hodierno , o processo de regularização da demarcação de terras é conflituoso, devido à resistência dos proprietários rurais, impossibilitando que o direito originário à terra seja garantido. Tal fato pode ser observado nos dados divulgados pela FUNAI (Fundação Nacional do Índio), os quais revelam que esses grupos representam 0,4% da população brasileira.', 'Percebe-se, ainda, a forma que os povos indígenas vêm sendo alvo de pensamentos errôneos e preconceituosos, enraizados desde o período colonial. Tomando como base o pensamento do filósofo Immanuel Kant, a partir do qual “o homem não é nada além daquilo que a educação faz dele”, nota-se que a visão do índio atípico e folclórico foi construída pela sociedade e passada pelas gerações, fazendo com que essa população seja alvo de preconceitos, influenciando também na desigualdade social, visto a sua exclusão e ao fato de não possuírem oportunidades igualitárias. Prova disso, pode ser analisado,  a partir dos dados do Banco Mundial, no qual 1 a cada 4 indígenas latino-americanos vive na pobreza.', 'Portanto, é necessário que a FUNAI desenvolva uma maior revisão das demarcações dos territórios indígenas, previsto pela Constituição. Ademais, a parceria entre essa fundação com o Ministério da Educação  seria de extrema importância para que houvesse a transmissão da cultura indígena, com o intuito de propiciar a inclusão dos mesmos  no setor educacional. Isso poderia ser feito a partir da incrementação do estudo dos hábitos e das línguas indígenas nas escolas.']",120,160,120,160,120,680
48,sus,"['O Sistema Único de Saúde (SUS), criado em 1988 a partir da Constituição Federal tem o intuito de garantir que todos tenham acesso saúde. Entretanto, o não cumprimento desse direito é evidente,visto que o gerenciamento do SUS não ocorre de forma adequada e o orçamento planejado pelo Governo Federal é pouco para suprir as necessidades em hospitais .Pensando por esse viés, é imprescindível debater e buscar minimizar os efeitos desses problemas.', 'Em primeira analise, podemos observar a dificuldade de pacientes em conseguir agendar consultas ou exames e a demora no atendimento. O motivo disso acontecer é que segundo dados do tribunal de Justiça de Contas (TCU),64% dos hospitais estão em superlotação. Dessa maneira, fica claro que o sistema de saúde faz o papel inverso do que está escrito na constituição e resulta na piora da qualidade de vida dos cidadãos.', 'Em segunda analise,um dos impasses que contribuem para que os brasileiros não desfrutem de inúmeros recursos relacionados a saúde é o fato das verbas que são destinadas para essa área serem poucas. De acordo com os dados da Organização Mundial de Saúde , o governo Federal destinou apenas 3,6% do orçamento em 2018.Logo, é evidente que com esse orçamento não é possível reestruturar e criar ambientes hospitalares, comprar materiais cirúrgicos e financiar pesquisas. E isso afeta ,especialmente, os mais pobres, já que não possuem condições para o pagamento de saúde particular e dependem do SUS.', 'Depreende- se portanto  que medidas sejam tomadas parta solucionar o impasse. E imprescindível que o Governo Federal aumente o valor dos orçamentos planejados para a saúde com a finalidade de melhorar todos os aspectos dessa área. Ademais, em parceria com o Ministério da Saúde, reestruture e crie hospitais afim de que as pessoas tenham acesso  saúde de qualidade com maior rapidez .Essas medidas são para garantir o bemestar populacional e que o direito por um SUS de qualidade seja cumprido como consta na constituição federal.']",120,160,120,200,160,760
51,Analfabetismo funcional,"['Existem pelo menos dois tipos de analfabetos: os analfabetos que não conseguem ler de fato e os analfabetos funcionais, que são aqueles que sabem ler, porém de maneira insuficiente, pois não conseguem entender bem o que leem.', 'No Brasil, foi-se o tempo em que o analfabetismo era um problema que atingia grande parte da população . Embora ainda seja um problema a ser enfrentado, o país está caminhando na direção de países desenvolvidos, que tem baixas taxas de analfabetismo, graças aos, entre outros motivos, programas de enfrentamento do analfabetismo do governo federal.', 'Hoje em dia, um grande problema a ser enfrentado no Brasil é o do analfabetismo funcional, que atinge grande parte dos alfabetizados do país. Trata-se da dificuldade em compreender textos dos mais diversos tipos, graças à falta de entendimento pleno, à interpretação pobre e insuficiente dos textos. Ler sem conseguir entender bem, é como se não houvesse lido.', 'É necessária a implantação de cursos, não só de alfabetização básica, como também ""intermediária"", esta para aqueles que já sabem ler, mas ainda têm dificuldades de, por exemplo, entender ou interpretar o papel da vírgula numa oração . Dificuldades estas que podem atrapalhar, e muito, na compreensão da leitura e também da escrita.']",160,160,120,160,120,720
63,,"['Segundo Charles Darwin, na teoria da Seleção Natural, o indivíduo se adapta ao ambiente e sua circunstância sobreviverá, além disso, as características são transmitidas aos seus descendentes. No entanto, a ganância dos homens por ascensão social e por acumulação de capitais tem levado à destruição da natureza. Dessa forma, a falta de políticas públicas eficientes, como também a cultura popular do “jeitinho brasileiro” alinhada à escassez de diálogos acerca dos recursos naturais finitos são problemas que devem ser enfrentados pela população e o Estado, visto que não só reforça a exploração, como também,  a ocorrência de tragédias ambientais.', 'Os autores pré-modernistas fizeram uma literatura engajada de denúncias dos problemas sociais, políticos e econômicos do Brasil. Entretanto, na sociedade contemporânea não só a falta de leis, como também as negligências do Estado por meio de fiscalizações omissas corroboram para o acontecimento de tragédias no cenário brasileiro, pois em uma sociedade de classes há buscas pelos interesses. Nesse sentido, a classe burguesa luta por acumulação de capitais, além disso, a classe dos trabalhadores luta por direitos, esse fato alinhado à educação defasada na Lei de Bases de Diretrizes da Educação, outrossim, o não cumprimento das punições estabelecidas às empresas, a sociedade, muitas das vezes, age de forma corrupta.', 'É incontrovertível que, desde o Iluminismo e, posteriormente, a Revolução Francesa, o caráter participativo acentuou-se expressivamente nas sociedades atuais. Todavia, com a cultura do “jeitinho brasileiro”, como também a não instrução sobre os mecanismos de preservação são consequências históricas. Desde o início do século XVI, com a chegada oficial da colonização portuguesa no Brasil, cultiva-se a ideia de que os recursos naturais são infinitos, ou seja, há uma cultura de massa imposta por uma elite, onde os interesses privados são valorizados em detrimento da preservação, como por exemplo, no rompimento da barragem de Mariana que destruiu o distrito de Bento Rodrigues.', 'Em face do exposto, para que as características desfavoráveis não se tornem hereditárias, é necessário, portanto, que o Congresso Nacional fiscalize, de maneira objetiva, os meios de prevenção que devem ser utilizados pelas empresas, por meio de agentes do setor de segurança do trabalho, que deverão aprimorar as formas de concessão de alvarás. Ademais, cabe ao Ministério da Educação , com medidas midiáticas, criar cartilhas informativas sobre as tragédias ambientais brasileiras, como também, promover debates nas escolas, que impulsionará uma maior difusão da percepção crítica acerca dos recursos naturais. Dessa forma, segundo o imperativo categórico do filosofo Emmanuel Kant,  “Age de tal modo que a máxima de tua ação possa sempre valer como principio universal da conduta”.']",160,200,160,200,160,880
68,,"['É correto afirmar que os patrimônios históricos do Brasil possuem sublime importância tanto para as gerações passadas quanto para criações futuras, haja vista que o conhecimento que essas propriedades transmitem é de exacerbada relevância e segundo a perspectiva de Edmundo Burke, político e filósofo  ""Um povo que não conhece sua história está condenado a repeti-la.""', 'Deve-se pontuar, de início, que é essencial o interesse da população tratando-se da bagagem histórica do Estado , pois só dessa maneira é possível compreender os equívocos do passado para conseguir evoluir o pensamento e romper com os antigos padrões criados pela sociedade.', 'Recentemente foi dada a notícia de que o Museu Nacional, o mais antigo do país, situado no Rio de Janeiro, foi incendiado conforme fontes do Portal do Estado de São Paulo. Foram perdidas inúmeras obras e documentos que  com certeza  acrescentariam relevante sabedoria na cultura brasileira, portanto, é de extrema indignação o fato de que o prédio não possuía um sistema adequado de proteção contra incêndios.', 'Diante do exposto, com o fito de que os patrimônios históricos são imprescindíveis, compete ao Governo,  propiciar melhores alternativas de segurança aos mesmos , por meio de verba para o investimento dessa área. Sendo assim, esses legados estariam à salvo para propiciar o saber à nação.']",120,160,120,160,120,680
86,P,"['Na obra ""O Alienista""  do grande escritor brasileiro Machado de Assis, conta a história do Dr. Simão que julgara quase todos de uma cidade como loucos por não agirem dentro de um padrão normal. Analogamente, na atualidade o uso das redes sociais trás grande impacto na vida das pessoas, devido, o modismo imposto pelos influenciadores digitais e as severas críticas de anônimos. Dessa maneira, isso causa vários problemas para as pessoas, dentre eles a baixa autoestima e a depressão.', 'Primeiramente, a baixa autoestima é uma típica inaceitação pessoal que está cada vez mais presente entre os indivíduos. Sob esse viés, essa falta de amor próprio pode ser vista no filme ""O corriga"" de 2019,onde o protagonista Arthur é muito criticado pela sociedade, se tornando um vilão  .Fora da ficção, muitos internaltas usam perfis falsos apenas para descriminar os terceiros, o que faz um vasto número de pessoas não se aceitarem e até tomarem medidas extremas como o suícidio. Dessa forma, deve-se evitar acontecimentos parecidos.', 'Ademais, a falta de adequação á moda dita pelos influenciadores digitais deixam muitos seguidores depressivos. Oposto a isso, na frase de Anne Frank escrita em seu diário ,diz: "" Deixe-me ser eu mesma, e então estarei satisfeita"". Logo, os indivíduos precisam aceitar-se como são, e não de acordo com ""padrões"" igualmente Arthur que acabou em um hospício por distúrbios mentais . Nesse sentido, caso a população estiver disposta a se enquadrar a esse modismo, deverá estar ciente do grande risco posta á sua saúde tanto física quando mental.', 'Portanto, urge que o governo federal (como orgão mais adequado) arja contra os agressores por meio da punição severa, para impedir que as discriminações feitas por indivíduos anônimo se perpetue. Além disso, o Ministério da Saúde deve criar uma ""#seja você mesmo"", por meio das redes sociais, afim de insentivar a população a se aceitar e questionar sobre a existência de alguém complemente normal como fez Machado de Assis em sua obra.']",160,160,160,200,160,840
59,Fome resultado da desigualdade,"['A fome no Brasil está direcionada não apena com a falta de alimentos , como também ausência de oportunidades no mercado de trabalho devido a má distribuição de recursos oferecidos como : o Programa de Cadastro Único e o acesso a educação.', 'A fim de identificar e caracterizar a população de baixa renda para inserção nos programas sociais, o cadastro único não é eficiente pois não abrange todas as famílias necessitadas e oferece uma renda mensal de apenas R$89,00 por pessoa o que dificulta ao acesso de alimentos em quantidade e qualidade.', 'Ademais a dificuldade ao acesso s escolas e as diciplinas dada por elas , vêm acarretando grandes evacoes escolares, gerando alto nível de desemprego e fome uma vez que o mercado de trabalho busca pessoas qualificadas e com bom aproveitamento escolar , excluindo de forma implícita a população de baixa renda  j que não é oferecido a estes recursos para alfabetização de qualidade.', 'O alto custo de vida brasileira tem como cenário a permanência da fome. Portanto cabe ao governo um reajuste na renda mensal oferecida pelo cadastro único de acordo com os preços dos alimentos, fiscalizar e rever as políticas públicas para acabar coma  fome de  forma eficiente . Assim como o ministério da educação oferecer , não apenas ter programa de educação para todos como fazer campanhas e palestras educativas melhorando a qualidade e a forma como aplica as diciplinas .']",120,120,80,120,80,520
83,,"['A prática esportiva sempre esteve presente na história da humanidade, seja ela com a “seriedade” e tecnologia que adotamos hoje, seja como uma brincadeira despretensiosa de crianças(.) e isso é uma coisa atemporal;  já que na Grécia Antiga, berço da arte e das olimpíadas, os esportes já eram moldados de forma a se perpetuarem até hoje. Por outro lado, a ciência também ratifica a importância dos esportes tanto para a saúde física quanto para a saúde mental e social. Entretanto, além dessas beneficies , a prática esportiva deixa desafios.', 'Os esportes sempre tiveram espaços nas sociedades como um todo, contudo, isso não significa apoio estatal ou investimentos.  Simplesmente por ser algo quase inerente ao homem e, consequentemente,  às crianças. Brincadeiras, os famosos “babas” e dentre outras práticas ganham nível mundial e tornam - se alvos de medalhas, troféus e sonhos. No entanto, a inocência das práticas esportivas acaba por ser influenciada pelos preconceitos e dogmas ultrapassados, mas que existem até hoje: “ futebol não é para meninas”, tais expressões manchão os esportes e em eventos mundiais são notados, tanto pela falta de visibilidade quanto pela falta de apoio.', 'Ademais, conforme o avanço das ciências, mais atestamos a importância da prática esportiva e os seus reflexos nas sociedades , contribuindo para o desenvolvimento físico, psicológico e sociocultural de crianças, jovens e adultos. Como exemplo, nos temos a Rafaela Silva, medalhista de ouro na Rio 2016; a judoca superou a hipossuficiência da comunidade onde vivia, além do racismo na última olimpíada, tal história emocionou o Brasil e reafirmou a importância dos esportes,o qual contribui para a superação e crescimento pessoal e profissional das pessoas.', 'Por fim, é incontestável que a prática esportiva é essencial, e ela contribui para a sociedade em diversos aspectos, como na formação de cidadãos, na ideia de grupo, na formação de um lado social e humano das pessoas. Porém, isso tudo pode ser catalisado se determinados erros fossem corrigidos, a exemplo, a falta de investimento e incentivo por parte dos Estados; o preconceito quanto ao sexo feminino em determinados esportes, além da falta de apoio por parte da mídia e dos órgãos públicos; a necessidade do amplo acesso e da fomentação da prática esportiva nos setores de riscos da sociedade. Portanto, retificando isso e outras adversidades, poderemos ter uma ampla prática esportiva, com ainda mais reflexos positivos.']",120,120,160,160,200,760
144,Mulher,"['As mulheres iniciaram uma verdadeira revolução nas formas de relações entre elas e os homens.                No Brasil, uma conquista que demonstra tal alcance foi a eleição da primeira presidenta. A população a         veem         com capacidade plena para exercer o posto mais importante da nação.', 'Em certos casos, houve até inversões de papéis em que                 o marido é “a dona-do-lar” e a esposa, o provedor da família. Tal situação, encarada por alguns de forma receosa                , é um dos reflexos de conquistas femininas, em que não há rotulação de função por sexo.', 'Contudo, existem lares em que                 essa divisão de tarefas por afinidades e interesses mútuos                inexiste, pois não há a figura do pai. Nessas condições, a mãe precisa trabalhar, cuidar dos filhos e do lar. Cenário comum para muitas famílias, em que a responsabilidade da estrutura familiar recai sobre os ombros da mulher, da mãe.', 'Apesar de tantos avanços                , ainda há, em algumas organizações, uma diferença de tratamento entre homens e mulheres.         Principais          cargos de chefia          serem          destinados a homens e, caso elas ocupem tais postos,          com          salário inferior ao deles                . Essa situação revela que a luta precisa continuar; novas vitórias precisam ser alcançadas.', 'Por isso                a mulher transformou a sociedade, mostrando sua importância e competência nos mais diversos ramos de atividade. Conquistas que precisam ser permanentemente fortalecidas para que seus sonhos possam ser alcançados em sua plenitude.']",120,120,120,120,120,600
78,Ela não pode ser aprovada,"['Com certeza que a reforma do ensino médio será um problema para a questão da educação desse país , principalmente se duas das medidas dessa reforma entrar em vigor, que por sinal serão elas: o poder  dado ao aluno de só querer cursar uma determinada área e a opção também dada de fazer aulas técnicas. Essa reforma do ensino médio deve ser embargada para que não piorem o que já se encontra ruim .', 'Se a media que está sendo apresentada como reforma do ensino médio, no qual dar aos alunos o poder  de optar só por cursar:  Matemática, Linguagens, Ciências humanas e da Natureza,  for atendida, todos os alunos terão um conhecimento incompleto e o pior disso tudo é que, (2) o Mistério da Educação, será cúmplice disso, pois segundo ele, todos irão cursar até a metade do segundo ano um ensino normal, depois daí, eles optariam por fazer uma dessas quatros áreas. Como que querem melhorar a educação se vão reduzir pela metade o conhecimento como o todo desses alunos  ? A resposta será indivíduos que se bobear  nem conhecerão partes significativas da história do próprio país . Fora isso, essa medida contribuirá para mais um problema no futuro, na qual será uma horda de pessoas que só saberá se expressar através de conhecimentos específicos.', 'Outra medida oferecida como proposta de reforma do ensino médio, é a opção do alunos de fazerem aulas técnicas. Tudo bem que nos primeiros anos essa proposta poderá dar certo, porém, só estão esquecendo de algo . Como irão pagar todos esses profissionais capacitados para dar essas aulas, se alegam que o país se encontra recessão  ? A resposta para essa pergunta será a desculpa do governo em dizer que nem todos esses profissionais serão pagos na data prevista e que muitos terão que amargar esse prejuízo, isso se não tomarem um calote . Isso de fato causaria muita revolta para esses profissionais, sem contar que esse também seria o cenário perfeito para fomentar inúmeras greves por parte deles, e quem se sairia mais uma vez prejudicado e com cara de bobo, seria o ferrado do aluno.', 'E é por essas causas citadas acima que essa reforma do ensino médio deve ser embargada para que não piore o que já se encontra ruim. Pois do contrário, esta  reforma formará futuras pessoas que irão ostentar um baixo conhecimento de mundo ou específico demais, ou ainda, desencadear uma série de revoltas por parte dos professores e alunos que se sentirão todos lesados pelo governo, que por sua vez, pode alegar que não poderá pagar pelas aulas técnicas , porque o país passa por sérios problemas na economia.']",40,80,40,40,40,240
58,,"['Conforme dados do INPE - Instituto Nacional de Pesquisas Espaciais, no segundo semestre de 2019 verificou-se um aumento de mais de 200% nas áreas desmatadas e queimadas na região da Amazônia Legal em relação à 2018. Essa situação alarmante fomentou a discussão, em diversas mídias, sobre a importância de se preservar a biodiversidade da fauna e flora da região amazônica. Preservar a floresta é importante e necessário sob vários aspectos, principalmente sob os aspectos ecológico e socioeconômico.', 'Sob o ponto de vista ecológico, a floresta é indispensável para manter a dinâmica climática mundial e por fornecer água potável para milhões de pessoas, além de ser o berço da biodiversidade planetária, contando com milhares de espécies vegetais e animais encontradas exclusivamente nesse bioma.', 'Sob outro viés, deve-se atentar para a importância socioeconômica da floresta, visto que ela é fonte de renda e alimento para populações indígenas e ribeirinhas que habitam a região. Esses grupos tem sido severamente afetados pelas queimadas e pela perda da biodiversidade na região, o que pode levar a quadros graves de doenças respiratórias, bem como, a longo prazo, a um processo de pobreza extrema e, como consequência, a morte ou o êxodo dessas populações.', 'Nesses sentido, considerando o aspecto ecológico, para preservação da floresta amazônica, é indispensável que a União e os estados fortaleçam a fiscalização dos crimes ambientais cometidos na área, com o objetivo de estagnar esse processo e punir os responsáveis por esses crimes. Em relação ao viés socioeconômico, faz-se necessário que a União e os estados, em parceria com ONGs - Organizações não governamentais e escolas locais, implementem projetos de educação ambiental e manejo sustentável da floresta, objetivando fixar e proporcionar qualidade de vida para as populações que habitam a floresta e dela tiram o seu sustento.']",120,160,120,160,120,680
83,,"['A muito as práticas esportivas fazem parte das relações sociais, unindo pessoas em um misto inexplicável de emoções que só pode ser compreendido por quem o vivência , o que parece se enquadrar na célebre frase de Nietzsche: "" E aqueles que foram vistos dançando foram julgados insanos por aqueles que não podiam escutar a música"". Entretanto, o esporte cumpre, também, um papel que vai além do emocional e da competição, englobando a função social, política e individual,', 'Não raras vezes, eventos esportivos foram utilizados como instrumento de disputas ideológicas. Na África do Sul, Nelson Mandela usou o esporte para unir brancos e negros. Nessa perspectiva, o esporte possui caráter unificador, uma vez que pode promover a interação harmônica entre diferentes grupos sociais.', 'No quesito político, a falta de incentivo por parte do governo a tal modalidade é um dos problemas mais discutidos, principalmente no Brasil, que sediará as Olimpíadas neste ano. Desde cedo, o atleta brasileiro aprende a ter disciplina e perseverança para conseguir atingir as suas metas ao mesmo tempo em que luta pela própria sobrevivência.', 'Além disso, a prática de atividades físicas interfere diretamente sobre a saúde da população, visto que ela auxilia no combate combate à obesidade e promove um melhor desenvolvimento do corpo. Pesquisas realizada por vários órgãos, dentre eles o IBGE (Instituto Brasileiro de Geografia e Estatística), revelam que pessoas que possuem o hábito de se exercitar apresentam menores chances de desenvolver doenças cardíacas, osteoporose, entre outras. Outro benefício e faz no desenvolvimento neuromotor em crianças.', 'Devido ao caráter amplo dos benefícios advindos da prática esportiva, ela deve ser incentivada no âmbito familiar e educacional, por meio das aulas de educação física, por exemplo, como forma de desenvolvimento da criança e como parte da formação de um cidadão. Deve haver também, por parte do governo, um maior investimentos para estimular o atletismo. Assim, além das vantagens sociais, o país terá mais atletas para representá-lo nos diferentes eventos esportivos.']",160,160,200,160,200,880
115,A literatura no mundo atual,"['Atualmente, os jovens não são de ler         muito, num Mundo         de tanta tecnologia acabam se deixando levar por         ela, e com isso         acabam se esquecendo dos livros, os tão maravilhosos livros.', ""Concordo em fazer uma nova liguagem de obras          literarias,  pois como disse         muitos jovens não leem mais,                 quando leem é pouco, e por isso deve modificar a obra e deixá-la na linguagem mais 'jovem'                , assim será mais produtivo e mais prático para nós, jovens, do que aquele livro         que não sabemos o sigfinicado das palavras         ."", 'Portanto,                 deve sim ser modificado                , porque creio que muitos jovens irão                 voltar aos hábitos de leitura                .']",80,80,80,80,0,320
90,-como combater a transfobia no Brasil--,"['No Brasil existe o maior índice de transfobia, preconceitos e homicídios s pessoas trans. Como já dizia Voltaire, preconceito é opinião sem conhecimento. Torna-se evidente que os maiores causadores desse cenário é a alta vulnerabilidade de transexuais nas prostituições e a falha do estado em prevenir e investigar esses crimes.', 'As maiorias das pessoas trans, largam a escola no ensino médio devido aos preconceitos e bullyings constantes. A falta de vagas em empresas para as pessoas transexuais ocasionam a vulnerabilidade dos tais, quando não sofrem preconceito no próprio local de trabalho, sendo preciso lidar com questões relacionadas à homofobia, vindo de colegas de trabalho ou dos próprios superiores, incluindo abusos psicológicos e violências sexuais.', 'Neste ano, 89 pessoas transgêneros foram mortas no Brasil, quantidade que supera em 39% registradas no ano de 2019, muito provável que os números verdadeiros sejam maiores e é bastante notória a falha do estado em prevenir e investigar esses crimes.', 'Diante dessa problematização, as empresas devem disponibilizar vagas de empregos as pessoas trans, o estado deve criar cursinhos pré-vestibulares e exames nacionais de ensino médio especifico para esse publico. O estado deve aumentar os monitoramentos dos guardas nas ruas. Assim prevenindo a transfobia no Brasil.']",160,120,120,160,160,720
48,Os Problemas do SUS na Prática,"['O sistema de saúde pública do Brasil é o maior do mundo, são 162 milhões de pessoas que dependem dos atendimentos do SUS . Porém, com a grande demanda surgem as grandes dificuldades, principalmente no momento da pandemia no Brasil.', 'Na teoria, o SUS deveria disponibilizar milhares de remédios e vacinas , além de fazer consultas e cirurgias gratuitamente. Entretanto, na prática  não é bem assim: faltam medicamentos, sem falar na fila de espera que a população enfrenta por atendimento.', 'Durante a pandemia de coronavírus, esses problemas estão mais visíveis. A falta de leitos de UTI , respiradores e equipamentos é um problema que os brasileiros sofrem diariamente, além da falta de testes para o coronavírus que é preocupante, pois resulta na subnotificação no número de casos.', 'Em suma, é dever do Ministério da Saúde  junto com governadores e prefeitos investir em tudo que for necessário para o combate ao coronavírus , além de projetos que foquem na redução das longas filas de espera do SUS.']",160,120,120,120,120,640
55,Enquanto os homens exercem seus podres poderes os indios vão sendo extintos,"['Valorizar e garantir os direitos dos povos indígenas no Brasil é tão importante quanto garantir a saúde do planeta Terra. O povo da floresta são os verdadeiros guardiões  da natureza, sem os indígenas,  a grandiosa e imponente Floresta Amazônica já teria virado pó . A população brasileira aumentou muito ao longo das décadas, mesmo com números menores de membros por famílias, já somos mais de 200 milhões de habitantes. E, no entanto, a população de índios brasileiros diminuiu. Estranho hein? Como pode? Dizem as pesquisas dos historiadores, que havia no Brasil cerca de cinco milhões de índios em 1500, e hoje, 2019, quinhentos e dezenove anos depois há cerca de 800 mil. E o governo e as autoridades competentes acham isso normal? Três milhões e duzentos mil índios a menos?', 'Segundo os mais atualizados dados do IBGE (Instituto Brasileiro de Geografia e Estatística), o Brasil tem 208,2 milhões de pessoas espalhadas em todos os estados, em áreas rurais e urbanas. Mas o número de bovinos é ainda mais impressionante, chegando a 218,2 milhões de indivíduos. Desde 1974, quando começaram as contagens, o Brasil nunca tinha chegado nem perto de ter um rebanho tão grande. Há ainda dentro do Brasil 37,9 milhões de porcos (mais do que toda a população do Canadá) e 1,3 bilhão de frangos e galinhas explorados por sua carne e para ovos (o equivalente a toda a população da China). Todos esses animais comem rações feitas com grãos como milho, soja, sorgo e outros. E todos eles demandam muita água também, tanto para beber, quanto no manejo enquanto eles estão vivos e também nos matadouros para limpeza dos locais de abate.', 'Agora, adivinhem onde está o maior rebanho de gado do Brasil? Em São Felix do Xingu no estado do Pará.  Lá existem, 2.222.949 de cabeças de gado segundo dados do IBGE. Anteriormente colonização o território do município de São Félix do Xingu era habitado por diversos povos indígenas, dentre os quais se destacam: Caiapós, Araras, Arauetés, Paracanãs e Assurinis. Segundo o Museu Goeldi, sua presença, e de diversos outros povos tradicionais nestas terras, data de muito tempo, ao menos 9.500 ano. Estes povos, muito embora ainda possuam grandes áreas sob seus domínios, foram pilhados, mortos e forçados ao trabalho pelo elemento colonizador que atravessou pela área do município ao longo do tempo. Isso é um crime hediondo trocaram índios pelo gado.', 'Diante do exposto, fica evidente que os povos indígenas precisam ser valorizados e protegidos muito mais que os rebanhos de gados. A ganância não pode mais exterminar vidas nativas em troca de dólares. A LEI Nº 6.001, DE 19 DE DEZEMBRO DE 1973 , deve ser respeitada e cumprida integralmente. Existe um caminho para todos, e é simples, o governo deve investir no turismo sustentável, a cultura indígena deve ser conhecida por todos, ela é rica na agricultura, nas plantas medicinais e na politica de subsistência. Um projeto de intercambio cultural, Florestas X Metrópoles poderia gerar muito mais renda que gado, além de um enorme ganho de consciência ecológica que mudaria a vida de todos para sempre. Os índios precisam urgente de todos, e a natureza precisa dos guerreiros das florestas, governo brasileiro deve pedir perdão a esses brasileiros nativos. E jamais tomar seus direitos. O despotismo jamais poderá reger essa nação. Com tiranos não combinam brasileiro corações.']",120,120,80,80,80,480
84,Educação a arma certa.*,"['Para que serve uma arma? Se não, para matar, mutilar e ferir gravemente um ser vivo. Antes do Governo tentar cogitar, se deve ou não liberar o livre comércio de armas de fogo. É dever dele, consultar a nação. Vivemos em uma democracia inderita . , E o povo é soberano. Um assunto dessa magnitude é de interesse de todos, e não só (do) governo.', 'Depois de doze anos em vigor, a lei brasileira que restringiu a posse e o porte de armas de fogo no país está prestes a ser alterada pelo Congresso Nacional. Desde 2003, o Estatuto do Desarmamento (Lei 10.826) vem sendo ameaçado por tentativas de revogação que agora podem ser concretizadas com a aprovação do Projeto de Lei 3.722/2012, que está pronto para votação no plenário da Câmara dos Deputados.', 'O governo brasileiro não deveria se preocupar com a fabricação e a legalização das armas de fogo. Ele deveria se preocupar com os inocentes que perdem as vidas ou ficam sequelados por resto da vida por causa delas. Deveria se preocupar com a educação. Em pagar um salário digno aos professores para eles assim, formarem melhores cidadãos para o mundo.', 'Tudo o que acontece no mundo é uma questão de educação. Um país que não educa seu povo. Deve se preparar para as consequências. É constitucional que todos os brasileiros tenham, educação, saúde, moradia, trabalho e segurança. E não, uma arma. Já temos problemas de mais , precisamos de soluções. É na escola que se encontra a solução para um mundo melhor, o Brasil precisa de investimento nas escolas, nas pesquisas, o governo bom é aquele que acredita no seu povo. O diálogo ainda é o maior e o melhor caminho para desenvolver a humanidade. Enfrente e em frente. Armas não. Mais homens armados de amor.']",120,160,160,200,200,840
53,O mundo com outros olhos,"['Na nossa sociedade vigente , é consenso que a informação vem cada vez mais ficando difundida e de fácil acesso graças inclusão digital e o advento do Smartphone, sendo que hoje o número de Smartphone ultrapassa o número de brasileiros.', 'Com essa grande disseminação de notícias é inevitável o nascimento das notícias falsas ou como são chamadas ""fake news"", que por meio de veículos de imprensa menores e de pouca credibilidade espalham tais notícias distorcendo ou até mesmo inventando-as. Com isso vem a criação de ""bolhas"" digitais e sociais, onde a pessoa em questão se isola de outros meios de comunicação e convive apenas com aquele grupo que lhe convém , já que essas pessoas pensam e concordam com seus ideais, o que influencia o mesmo não procurar fontes confiáveis e acaba disseminando tais notícias.', 'Entretanto com tais facilidades de expor eventos cotidianos, até mesmos pessoas com um simples celular podem expor acontecimentos até mesmo de outros países, proporcionando uma visão diferente daquela mostrada na televisão e outros meios tradicionais.', 'Dado o contexto, a medida viável e que vem sendo posta em prática pela mídia  é o combate a ""fake news"" e seus disseminadores, outra medida, essa sendo de cunho individual, é a pessoa sair de sua zona de conforto e procurar outros pontos de vista, tendo como exemplo a alegoria da caverna de platão, quando o indivíduo sai de ""caverna"" ele observa o mundo com outros olhos e outro ponto de vista.']",120,120,80,120,0,440
47,Cegueira Humanitária,"['Por analogia à dura mensagem transmitida por José Saramago  na obra""Ensaio Sobre a Cegueira"", em que é retratada a negligência da população diante da realidade desigual que os cerca, assim como a negação em enxergar os valores que se perderam em meio à prepotência humana, dessa forma fazendo-se necessária uma cegueira física para a percepção dessas injúrias, pode-se observar como a pandemia vigente acentuou e evidenciou a desigualdade social no Brasil, e uma das áreas mais afetadas foi a educação. De fato, foram adotadas inúmera estratégias tecnológicas para a continuidade do ensino, no entanto, é fato também, que milhões de domicílios brasileiros não tem acesso à internet, outros não possuem computador e há ainda aquele sem eletricidade nas moradas. Além disso, as habilidades digitais e os processos pedagógicos para o mundo digital são limitados. Dessa maneira, explicita-se a intensificação da precariedade do sistema educacional brasileiro diante das diferentes classes sociais e a urgência por mudanças.', 'Inegavelmente, a crise sanitária contemporânea, vista sob o prisma da educação e da discrepância do acesso à plataformas virtuais pelos milhões de estudantes brasileiros, potencializou as mazelas sociais já existentes. Como constata, Luís Vaz de Camões, no soneto ""Mudam-se os tempos, mudam-se as vontades"", as mudanças ocorrem de modo inesperado e não seguem uma lógica e, diante disso, o eu líico mostra-se perplexo, porém compreende que as mesmas  são inevitáveis e necessárias. Da mesma forma, inesperadas mudanças se sucederam com a vigência da pandemia e é imprescindível que inovações continuem a se desenvolver para que adversidades como o déficit de aprendizagem, evasão escolar e desigualdade de oportunidades, a princípio evidenciadas, sejam enfim, amainadas.', 'Evidentemente, o mundo não estava preparado para lidar com o sistema educacional via internet, de forma tão ampla e cotidiana. Assim como o acesso às plataformas educacionais por estudantes e professores é precário, também o é, consequentemente, o conhecimento de uso destas e o desenvolvimento de didáticas educativas e passíveis de assimilação por parte dos alunos . Embora o desafio hodierno para a deliberação de estruturas pedagógicas virtuais acessíveis,  seja latente e preocupante, os conhecimentos aprimorados poderão revolucionar o universo educacional pós-pandemia.', 'Diante disso, é indispensável que se tomem providências para a organização dos métodos de ensino mediante tão trágicas circunstâncias. Para isso,é necessário que o Ministério da Educação(MEC) , estabeleça parceiras com ONGs  nacionais como a Fundação Estudar(FE) e a Ação Social para a Igualdade das Diferenças(ASID Brasil), para potencializar estratégias como o Centro de Mídias Educacionais no Amazonas, o qual levava educação através de meios digitais aos habitantes de zonas rurais mais afastadas mesmo antes da pandemia. Para tal, as entidades devem instituir um centro espaçoso onde estarão dispostos instrumentos educacionais digitais e disponibilizadas gravações de aula, estipular um rodízio, com horários definidos para que não haja aglomerações, e assim, proporcionar melhores oportunidades aos grupos fragilizados. Desse modo, a cegueira humanitária criticada por Saramago será esclarecida e os agravos urgentes, sanados.']",160,160,160,200,160,840
76,Lugar de mulher é onde ela quiser!,"['Nos dias atuais ouvimos muito falar sobre como as mulheres vem batalhando para ter uma posição melhor não só no mercado de trabalho, como também na sociedade em que vivemos. Discriminação não é somente pela cor de sua pele, ou por sua classe social, hoje em dia também se é discriminada por simplesmente ser mulher, como se isso fosse algum tipo de ""privilégio"" ou ""defeito"" aos olhos de alguns membros da sociedade .', 'Somente por ser mulher, corre-se o risco de ser abusada sexualmente, verbalmente e porque não socialmente, já que as mulheres em pleno século XXI ganham 30% menos que os homens, algumas pessoas ainda definem certos trabalhos como ""trabalho masculino"" e ""trabalho feminino"", afinal de contas, emprego tem gênero?', 'Mulheres tm direito de lutar pelo que querem, pelo que acham justo, por um salário melhor, por um emprego melhor, por respeito dentro e fora de seu local de trabalho. Por ser mulher não deve se sentir intimidada, nem obrigada a andar de cabeça baixa na rua para não chamar a atenção de um estranho .', 'Há muita coisa para ser feita para que o mundo se torne um lugar melhor para se viver, não só para mulheres, como também para homens, crianças, idosos, independente de sua classe social ou sua escolha sexual. Só queremos um lugar onde a desigualdade seja somente mais uma palavra no dicionário e seu significado não seja sentido por tantos pelo mundo.']",120,120,120,120,120,600
45,Abuso de autoridade no Brasil!!,"['O sucesso do filme nacional “Tropa de Elite” é atribuído pelo motivo da obra ficcional apresentar um enredo com severas críticas ao abuso de autoridade da polícia brasileira. Por isso, essa problemática de cunho social se estabelece no mundo real de forma violenta e dominante. Assim, o abuso de autoridade caracteriza-se pelos indivíduos que visam obter benefícios baseando-se em seus cargos públicos. Logo, sob esse viés, é justo avaliar o problema na falta de uma punição mais severa para esses infratores relacionado a obrigação do Estado que é cuidar do bem-estar da nação.', 'A princípio, há uma urgência em uma punição mais assertiva, digna de exemplo para a sociedade, quando se trata de abuso de poder. Consoante a um fato noticiado pela mídia, recentemente, prova que a punição sobre atos de abuso de poder falha, explicitamente, no Brasil . A exemplo disso, o desembargador Eduardo Almeida Prado Rocha de Siqueira que rasgou uma multa referente ao descumprimento de normas de saúde sobre a atual pandemia do coronavírus, fora afastado do cargo, porém, continua a receber seu salário normalmente. Ademais, esse fato contraditório, mitiga a autoridade do Poder Judiciário brasileiro e deturpa a visão do sociólogo Hobbes que o Estado tem a obrigação de cuidar do bem-estar da população.', 'Outrossim, vale ressaltar que o abuso de poder corrobora com a falta de administração estatal perante ao interesse público. Segundo o sociólogo Max Weber, o Estado possui o uso legítimo da força para remediar problemas sociais. Entretanto, esse prestígio estatal, às vezes, pode confrontar com problemas na própria conjuntura que o Estado possui para combater esses crimes cometidos por civis. Desse modo, quando um policial militar agride uma senhora negra de meia idade, covardemente, torna-se evidente que o abuso de autoridade suprime o dever estatal de velar pela segurança e comodidade social. Por isso, é imperativo que exista uma medida interventiva para combater esses impasses sociais.', 'Verifica-se, portanto, que a falta de uma punição severa influi, negativamente, na obrigação estatal em cuidar da nação que governa. Dessarte, é preciso que o Ministério da Justiça e Segurança Pública elabore o projeto “Mais Punição, Mais Justiça” com o intuito de tornar mais severa as punições aos indivíduos que possuem cargos públicos e, porventura, ousarem cometer abuso de poder, explicitamente. Para isso, é necessário que esse projeto parte do pressuposto que esses infratores serão afastados de seus cargos, perderão os seus salários e, ainda, terão que pagar multas referentes a indenizações para as suas vítimas; enquanto estiverem sob investigação e apuração dos seus crimes. Assim, com essa medida, o Brasil tornar-se-ia um país referência no combate ao abuso de poder.']",160,160,160,200,160,840
92,Conspiração Chinesa - VI,"['Na produção global ""Malhação: Viva a Diferença"", a personagem asiática, Tina, trata dos estigmas relacionados a sua cultura, enfatizando chacotas e convicções presentes na sociedade a respeito de sua nação. Em consonância com a realidade essas concepções estão vigentes no convívio de orientais, relacionando-se com suas capacidades intelectuais, estereótipos físicos e língua. Com o início do vírus covid-19 em território Chines, a perseguição ganhou uma maior violência, sendo a pandemia o ápice da disseminação desta segregação. Mostrando-se necessário pensar em como combater o preconceito amarelo, colocando fim às piadas, visões e chagas sociais.', 'Após declarações polêmicas do ex-presidente dos Estados Unidos, Donald Trump, atribuindo a responsabilidade da pandemia aos chineses, uma onda de ataques direcionados a população surgiu ferozmente. Desta forma, a acusação de crime biológico contra a humanidade, mesmo sem provas de sua veracidade, acionou uma polêmica conspiratória - “doença chinesa” -, tendo como estopim para a desconfiança, questões políticas de rivalidade entre as duas potências. Segundo o filósofo,  Rene Descartes, deve ser evitada toda precipitação e preconceito ao ser analisado um assunto e apenas ter por verdadeiro o que for distinto. Assim, deixando claro que tais acusações somente devem ser aceitas e disseminadas a partir de provas concretas de sua veracidade.', 'Paralelamente, outro presidente incentivador de tal acusação é Jair Bolsonaro, que além de seguir com afinco as ideias de seu ídolo Trump, também proporcionou uma cena vexatória com um estrangeiro, utilizando uma piada pejorativa com conotação lasciva a respeito do físico do viajante. Expressões racistas a respeito de orientais - ""xing ling"" e ""asiático é tudo igual"" - são comuns e vistas como inofensivas para maioria da população, não percebendo o real ataque que elas promovem sendo crimes de xenofobia e preconceito. Outro estigma relacionado população é em relação a sua capacidade intelectual, onde paradigmas enraizados na sociedade enaltecem a inteligência do oriente, relacionando-os a pessoas extremamente inteligentes. A personagem supracitada, Tina, deixa claro a cobrança imposta por sua cuna, onde diz que todo asiático é considerado ""nerd"". Desta forma, menosprezando seus esforços pessoais e gerando a ideia de que sua nacionalidade é sinônimo de sucesso. O preconceito linguístico e culinário também são marcas presentes quando o intuito é menosprezar tal cultura, ofendendo os costumes tradicionais de uma nação.', 'Destarte, é imprescindível que sejam adotadas medidas a fim de cessar o preconceito amarelo. Para isso seria necessária a criação de leis eficazes, por parte do Legislativo - órgão responsável pela criação das leis -  com objetivo de punir veementemente praticantes de tal ato preconceituoso, bem como ataques virtuais, contando com ajuda da polícia federal com investigações do crime no âmbito tecnológico das redes sociais. Instituições psicológicas devem oferecer apoio s vítimas da violência; escolas devem conscientizar a respeito de tais condutas, evidenciando o quão prejudiciais elas são. A educação familiar também é de suma importância, ajudando a desconstruir preceitos da sociedade e abrindo a mente das crianças para um senso mais crítico. Somente assim, a população oriental teria seu respeito merecido perante a sociedade, acabando com a pressão e a ofensa social e psicológica.']",160,160,120,200,160,800
87,Inocência perdida,"['Em 2007, a Associação Norte-americana de Psicologia(APA na língua inglesa) denunciou conteúdos ilícitos para crianças que estimulavam o erotismo. Atualmente, as mídias comunicativas e as redes sociais influenciam os jovens a realizarem comportamentos sexuais, antecipando um período imprescindível: a infância.', 'Em primeiro plano, os programas publicitados exibem uma temática mais relacionada aos adultos como as cenas das telenovelas, propagandas comerciais e as revistas, ""despertando"" o interesse dos menores que estão assistindo e introduzindo-os para atitudes inadequadas às suas idades, mesmo indiretamente.', 'Ademais, o espaço cibernético revela uma esfera desigual que determina a beleza, incentivando crianças e adolescentes representarem padrões físicos considerados sensuais e atrativos. Como ocorreu com Gabriela Abreu Severino, a conhecida cantora Melody, ela se apresenta em suas publicações virtuais e videoclipes de forma atraente com a pouca idade.', 'Portanto, o conteúdo divulgado pela mídia interfere o desenvolvimento natural de uma criança. Nesse contexto, o Ministério da saúde deve iniciar uma campanha de conscientização denominada  ""Limites e cuidados"" para jovens entre dez e quatorze anos adquirirem o conhecimento sobre educação sexual, por meio de palestras gratuitas em unidades básicas de saúde durante um ano após o confinamento. Assim, esse problema será moderado e possibilitará um futuro melhor para a sociedade infanto- juvenil.']",200,160,120,160,160,800
86,Saúde ou Internet?,"['O planeta está em constante movimento, e não apenas no que se refere à rotação e translação. A Terra está em constante mudança no que se refere a espécie humana e a fatos sociais.', 'Desde o início da história da humanidade, o homem está em constante busca por invenções que o tragam melhorias, desde o arado da Pré-História até o requintado maquinário da Segunda Revolução Industrial.', 'Assim sendo, a sociedade foi se moldando de acordo as novas necessidades']",200,40,0,80,0,320
62,Discurso de odio nas redes sociais.,"['Na serie da Netflix, “13 Reasons Why”  retrata a historia da protagonista Hanna Baker que se suicida, e deixa fitas cacetes contando os motivos da sua morte, na sétima fita deixada, a personagem aponta que foi alvo de discursos de ódio nas plataformas digitais, os quais,  continha comentários ofensivos e invasivos que denegriam e violavam a imagem da garota . Fora das telas esse problema ainda persiste no Brasil. Nesse sentido, convem analisarmos as principais causas, consequências e possíveis soluções para esse impasse.', 'Inicialmente podemos  entender a falta de empatia e respeito como uma das principais causas e motivadores das recorrentes agressões na Web. Assim como,  o Filósofo Hebert Spencer afirma, que a liberdade de cada um termina onde começa a liberdade do outro. Podemos atribuir que a necessidade igualitária de cada ser humano finalmente se tornar totalmente responsável por seus atos.', 'O ministério da saúde,  liberou em pesquisa que o suicídio é a quarta causa de morte entre jovens de 15 a 29 anos no Brasil, sendo 20% deles causados por ofensas e comentários maldosos transmitidos por quaisquer canais de comunicação. Apesar da criação de Leis que definam o cidadão totalmente responsável por seus atos e consequências, a indecência que induz a violência nas plataformas ainda é totalmente notória. Sendo assim é inaceitável que esses padrões persistam.', 'Fica evidente, portanto, que os discursos de ódios pregados nas redes sociais, precisam ser combatidos. Paulo Freire afirma, que se a educação sozinha não transforma a sociedade, sem ela tampouco a sociedade muda , sendo assim, urge, que o MEC (Ministério da educação e Cultura) crie, por meio de verbas governamentais, campanhas plubicitarias que conscientizem gerações atuais e futuras nas redes sociais, tais que incentivem a pratica da liberdade de expressão de um modo que não desrespeite os direitos humanos. Sugerindo ao usuário criar um habito de navegar na Web com respeito e empatia.', 'Somente assim, será possível combater a agressividade de muitos dos que utilizam a internet no país.']",120,120,120,120,120,600
81,A Intolerância Religiosa,"['O Brasil ? apesar de ser considerado um país laico, apresenta muitos preconceitos devido às diferenças de práticas religiosas. É comum ver pessoas falando de determinada religião em detrimento de outra, no entanto, não há problema em ter opiniões e gostos diferentes ? o problema é quando o direito de determinada pessoa praticar sua religião fere o direito do outro. Alguns meios de comunicação, ? já foi noticiaram caso  de pessoas agredidas fisicamente  e verbalmente por seguir diferentes religiões. Como solucionar esse problema?', 'A lei já existe e visa punir quem praticar algum autor de preconceito contra outras religiões, mas isso não inibe o preconceito, só mascara. É necessário educar as pessoas para aceitar e conviver com diferentes crenças, etnias, orientação sexual, etc. Também, ? é necessário impor limites para que as religiões sejam praticadas somente em templos religiosos e residências como cada família preferir, ? a partir do momento que se pratica a religião em locais públicos  ofende  o direito do outro que não tem ou possui religião diferente  um exemplo são as orações em transportes públicos, pois, atualmente ? estão proibidas.', 'Observa-se o governo criando mecanismo para inibir religiosos que não respeitam as outras pessoas e com o passar do tempo, quem sabe, poderá ser um assunto não mais discutido. Respeitar é simples, ? e é a base de toda a convivência.']",120,80,80,120,120,520
73,Problemas Raciais No Século XXI,"['Não é de hoje que negros têm enfrentado problemas devido à sua cor . Tais preconceitos advêm do apogeu da escravidão no mundo, na qual a cor da pele definia as relações de hierarquia e poder. Mesmo com a abolição da escravatura, um pouco dessa política racial persistiu em todo o continente americano, sendo muito mais grave e frequente na América do Norte, o que pode ser observado em filmes como “As Branquelas”, que no áudio original possui dezenas de piadas racistas, as quais não foram traduzidas por justamente não serem engraçadas para os amantes de comédia do Brasil, o que já coloca o país na frente de uma potência como os EUA no processo de igualdade entre raças.', 'O Brasil, dentre todos os países colonizados por Europeus, se destacou recentemente por adotar políticas que tendem a não só a reduzir o racismo, como também inserir os negros no mercado de trabalho, universidades e serviço público, facilitandolhes a vida . As respectivas leis de cotas, ratificadas pelo Supremo Tribunal Federal recentemente como constitucionais, têm ajudado negros,que histórica e logicamente tiveram menos oportunidades que brancos, devido condições financeiras principalmente, a alcançarem cursos de graduação em renomadas universidades federais e empregos em órgãos públicos. São políticas importantíssimas para um país que tem a maioria da população, inclusive prisional, negra, mas que, por outro lado, tem brancos como maioria no âmbito de universidades e empregos públicos, pois evitam a marginalização dessa raça, ajudando a diminuir parte da população carcerária, que encontra-se descontrolada.', 'Outra medida antiga, porém essencial no combate ao racismo, adotada no Brasil,  foi a elevação desta conduta ao patamar de crime inafiançável e imprescritível pela Constituição Federal de 1988, o que traz segurança jurídica para o combate desta prática, reduzindo drasticamente brechas nas normas, instrumentos que advogados usam para defender seus clientes. Este tipo de ação mostra que após o Regime Militar, houve e ainda há uma série de Legisladores comprometidos com o país, que veem e se preocupam com seus problemas, não apenas velhos burocratas que estão lá para servir a interesses próprios.', 'Há ainda de se mencionar o desgaste que a comunidade negra sofre. Recentemente, houve o assassinato de Marielle Franco, parlamentar do Rio de Janeiro, a única vereadora negra carioca. Sua morte foi uma tragédia em dobro, porque uma voz que já sentiu na pele o racismo foi calada, tirando a pouca representatividade que a etnia possuía na Câmara e, consequentemente, prejudicando o andamento de futuras ações que tinham por objetivo reduzir a desigualdade.', 'Nota-se que o Brasil, embora esteja no caminho certo para combater a desigualdade entre raças, poderia estar mais avançado. As políticas de cotas têm mostrado um resultado nas universidades federais, mas que ainda é tímido e insuficiente, já que a maioria da população é negra. O que deve ser feito é uma revisão do sistema de cotas, deixando o proporcional à população negra do respectivo estado, bem como estendido às universidades estaduais também, que, à exceção da Universidade de São Paulo, USP, que adotou recentemente um sistema cotista, não possuem nenhum.']",120,120,120,120,120,600
149,(Sem título 043),"['Recentemente, a empresa holandesa Mars One divulgou um projeto de colonização a [de] Marte prevista para 2023 e já reuniu mais de 100 mil candidatos à viagem sem volta. Apesar do significativo número de interessados, esse projeto parece mais um sonho.', 'Com gasto de 15 milhões de reais, a empresa pretende tornar o Planeta Vermelho (que tem seu teor de oxigênio praticamente nulo e média térmica de -65oC ) habitável para a espécie humana com o uso de uma tecnologia que a NASA não terá conseguido reunir nem em 2050. Não é preciso dizer o quão arriscada será a viagem para os quatro candidatos que forem selecionados. Além da óbvia periculosidade inerente à parte física da jornada, como falhas tecnológicas e eventuais desvios do plano original, os ""astronautas"" jamais voltarão à Terra, tendo que abrir mão de suas famílias e amigos, e ainda se sujeitarão à convivência com três pessoas sobre cujo comportamento e temperamento nada sabem.', 'Tirando os intermináveis problemas técnicos do projeto, há [também] a falta de propósito da colonização marciana. Não há motivos reais para se ir a Marte [àquele planeta] e, mesmo que a Terra esteja sendo degradada por ações humanas, existem várias maneiras viáveis de se conter [conterem] os estragos feitos ao nosso planeta [a ela], de tal forma que a ida para marte [Marte] é absurda.', 'A conclusão é simples: o projeto de colonização de Marte [Mars One] é perigoso, improvável [de realização improvável] e desnecessário. O dinheiro que será empregado nele seria melhor aproveitado se aplicado em áreas de investimento prioritárias.']",200,200,200,200,200,1000
36,Aquele velho crime,"['A escravidão, escravismo ou escravatura é a prática de usar, vender ou adquirir seres humanos de forma forçada e obrigando-os a trabalhos forçados, deste modo foi criado o termo ""raça"" para diferenciar um ser humano com a pele mais clara de outro ser humano de pele mais escura – o qual se escravizaria. Essa prática é utilizada desde os tempos mais remotos da história. No Brasil teve seu inicio no século XVI, com a produção do açúcar no nordeste brasileiro. Mas foi abolida com Lei Áurea de 1888. Mesmo clandestinamente, hoje, o ser humano explora seus semelhantes, tanto negro como branco, amarelo, pardo entre outros. Mas enfim, escravizar é humano?', 'Primeiramente, não existe o termo ""raça"" para distinguir um e outro ser humano por cor de pele ou por condição financeira, pois todo ser humano é de uma única raça, à diferença esta na genética, cultura, país onde nasceu, etc. A maioria dos ""escravos modernos"", são submetidos a condições de higiene precárias e submetidos a trabalhar por horas e horas com baixos salários ou até com nenhum. Vários deles (se não dizer grande maioria deles) recorrem a este meio em busca de melhor condição de vida, ou para ajudar a família, por não conseguirem outro tipo de trabalho ou por serem enganados com falsas promessas, mas logo se deparam com um regime fechado, com ordens a serem cumpridas e sem caminho de volta.', 'Além disso existem vários outros tipos de escravismo modernos na sociedade. Homens e mulheres que deploram a liberdade de uma determinada pessoa (esposo (a), namorado(a), familiar ou ate desconhecidos), os proibindo de sua liberdade para saciar seus próprios desejos. Crianças que não estudam ou param de estudar submetendo-se a trabalhos pesados e desumanos em troca de alimento e moradia, ou uma determinada quantia em dinheiro, muito baixa para determinados serviços, esperando assim ajudar familiares.', 'Entretanto, a Declaração Universal dos Direitos do Homem assegura direitos igualitários para todo ser humano, podendo este gozar da sua vida, liberdade e segurança pessoal. O Art. IV assegura que nenhum homem pode ser mantido em escravidão ou servidão, e que todo tipo de tráfego de escravos é proibido. Esta mesma Declaração afirma que nenhum ser humano pode ser submetido a tortura ou a castigos cruéis, degradantes e desumanos.', 'Contudo, a escravidão é real em nosso planeta, e não basta apenas criar, e julgar leis, tem que as cumprir, determinando assim que haja uma maior fiscalização por meio dos governos, principalmente em locais em que a população se encontra em condições de pobreza e desigualdade social elevada, conscientizando-as também a denunciar os abusos cometidos em sua sociedade.']",80,80,80,80,80,400
85,A Decorrência do Estupro,"['Frequentemente ouve-se falar de estupro, crime hediondo, que tem como maior parte das suas vítimas mulheres, e crianças. Tal crime, tem o número de denúncias reduzidas , e causa trauma nas vítimas.', 'A quantidade de denúncias, embora crescente, (ainda) é um número pequeno , equivalente à frequência em que este crime ocorre. É muito provável que estas denúncias sejam poucas por medo, e/ou receio por parte da vítima, que na grande maioria é ameaçada. Conviver com insegurança, e (a) dúvida de denunciar ou não, torna a vítima mais fraca fisicamente, e principalmente psicologicamente.', 'Algumas vítimas conseguem superar os traumas advindos do estupro, porém outras tentam lidar com isto para sempre. A propósito, as consequências são muitas, como por exemplo, o desencadeamento de doenças graves, como a depressão, e outros transtornos mentais que afetam o bem estar físico e psicológico.', 'Embora o número de denúncias ainda seja pequeno em relação a frequência (com) que o crime acontece, este número cresce. Para combater ou minimizar o estupro, e as consequências geradas por ele, é preciso que as vítimas denunciem. As penas devem se tornar mais rígidas, e realmente serem cumpridas. Aconselha-se que as vítimas busquem ajuda psicológica. E que as famílias apoiem a mesma. Espera-se que a população também faça a sua parte, auxiliando pessoas que foram vítimas do estupro. O governo deve auxiliar as vítimas disponibilizando programas que tenham atendimento psicológico acessível a todos, e também com campanhas que alertem a todos (sobre) a importância da denúncia.']",0,0,0,0,0,0
84,Porte de armas pela população civil,"['A insensibilidade das pessoas no mundo hoje pode gerar uma guerra civil incontrolada , as pessoas estão em constantes conflitos entre eles os políticos; sociais e culturais(.) a incapacidade dos ser humano em conviver com opiniões alheias gera discussão e violência gratuita por toda parte. A falta de segurança da sociedade gerou o desejo de fazer a sua própria segurança, em alguns países a legislação permite o uso da arma de fogo para todos sem descriminação, mas essa permissão não gerou bons resultados, pois a falta de capacitação e ignorância do ser humano levou a muitas tragédias.', 'A mais recente tragédia aconteceu em Orlando nos Estados Unidos, onde um atirador de origem Islâmica abriu fogo dentro da boate Gay, deixando 49 mortos e mais de 50 feridos, segundo alguns jornais o crime aconteceu por homofobia e ódio, depois dessa tragédia nos EUA, as opiniões ficaram divididas em torno da legislação que permite o porte de arma de fogo, alguns querem que o país revogue totalmente essa lei, criando então o estatuto do desarmamento, e outros defendem regras mais rígidas para ter acesso a armas.', 'No Brasil, entrou em vigor em 2003 a estatuto do desarmamento, que tem como objetivo dificultar o porte de arma no Brasil , mas desde a sua criação ele vem sofrendo vários embates com o objetivo de derrubar essa lei. No Congresso está tramitando um projeto de lei que cria o estatuto de controle das armas, dando a população o direito para obter armas com um único requisito mínimo, ser maior de 21 anos, o discurso em torno dessa proposta é que os brasileiros não estão seguros, e que o acesso à arma é para o cidadão de bem se defender dos criminosos, mas os defensores do armamento não pararam para analisar as consequências dessa proposta, pois uma sociedade armada vai gerar várias mortes gratuitas no trânsito, nos estádios de futebol, nas manifestações etc. Os que cometerem crime vão alegar legítima defesa.', 'É notório observar a falta de segurança da sociedade, a violência é uma cultura do dia a dia, mas não é necessário colar as pessoas para fazer justiça com as próprias mãos. Contudo é necessária a intervenção do Estado, para criar mecanismos de segurança, é dever de o estado investir e garantir a segurança de todos.']",120,160,200,160,200,840
68,Um povo sem cultura é o mesmo que um povo sem memórias,"['A cultura e a arte é o patrimônio histórico da humanidade. Assim tendo o dever de não deixar morrer.', 'Com a falta de aplicação de capital em museus faz com que ocorra percas históricas incalculaveis para a humanidade . Um exemplo é o Museu Nacional do Rio de Janeiro que ocorreu um incêndio.', 'Não podemos permitir a ideia do futurismo, pois esse movimento artistico abrange a destruição do antigo para a construção do novo.', 'Para que não ocorra a destruição do patrimônio histórico da humanidade é preciso cobrar do poder público e federal mais recursos, realizar manifestações pacificas. ois já perdemos  anos de história, o que precisamos  perder mais para que haja atitude de nossos representantes.']",120,120,80,120,80,520
95,∆,"['A chegada dos portugueses ao Brasil, em 1500, foi um dos primeiros fatos que restringiram o direito dos indígenas às terras ocupadas por eles. De maneira análoga àquela época, quando se observa a realidade hodierna, nota-se que ainda existem desafios relacionados a essa questão, o que evidencia a necessidade do debate sobre o marco temporal, medida que garante aos índios apenas a posse de terras ocupadas por eles em 5 de outubro de 1988. Logo, essa conjuntura adversa possui como causas não só a negligência governamental, como também a pouca representatividade política deles.', 'Primeiramente, é oportuno afirmar que o problema é motivado pelo exíguo apoio do governo. Acerca disso, de acordo com o artigo 231 da Constituição federal, os índios possuem os direitos originários sobre as terras que tradicionalmente ocupam. Entretanto, com a nova medida do STF (Supremo Tribunal Federal), uma data pré-determinada passará a definir essa ocupação, o que reduzirá o espaço habitado por eles, uma vez que nesse dia muitos grupos já haviam perdido seu direito à posse e não moravam mais em seus territórios. Nesse sentido, isso torna-se um avanço do capitalismo sobre os espaços indígenas, já que o único favorecido será o setor ruralista, que poderá anexar mais territórios para a agropecuária. Dessa forma, a pouca ajuda da máquina pública está relacionada ambições econômicas.', 'Outrossim, é imprescindível destacar que o número de índios na política ainda é baixo. A esse respeito, segundo o ilustre filósofo grego Aristóteles, ""O homem é um animal político"". Sob essa ótica, existe uma necessidade humana em defender seus direitos por meio da política, fato que não ocorre com os aborígenes, uma vez que eles representam apenas 0,34% dos governamentais, o que fomenta impasses como apropriação de terras, segregação e exclusão social. Desse modo, é paradoxal que em um país democrático, a população aborígene seja privada dessa democracia.', 'Faz-se necessárias, portanto, medidas que realmente assegurem o direito à propriedade de terra dos indígenas. Para isso, urge que o STF garanta a legitimidade de posse a eles, por meio de uma revisão dos termos do marco temporal, para que ambições capitalistas sejam excluídas de tal medida. Além disso, a FUNAI  - principal órgão que defende os interesses dos aborígenes no país- deve dar oportunidade a esse grupo na luta por seus anseios, por meio de um projeto Índios na Política, com o propósito de evitar que eles sejam prejudicados por alguns grupos. Assim, um problema iniciado em 1500, solucionar-se-á no Brasil.']",160,200,160,200,200,920
92,....,"['Na Lei n°9459 de 1997 diz que serão punidos quem praticar, induzir ou incitar a discriminação ou preconceito a raça, cor, etnia, religião ou precedência nacional. Nesse sentido, tal premissa não se faz presente no contexto brasileiro vigente, uma vez que pessoas de ascendência asiática vem sendo alvo de racismo e chacota. Logo, faz-se necessário medidas a fim de amenizar esse impasse, que dentre as principais causas estão a falta de atitude governamental somada à omissão da sociedade.', 'Sob essa perspectiva, convém enfatizar que a falta de atitudes do governo está entre as principais causas do preconceito com pessoas amarelas. Nessa óptica, de acordo com o filantropo Chico Xavier, a omissão de quem pode e não auxilia o povo é comparado ao um crime que se pratica contra a comunidade inteira. De maneira análoga, é quase inexistente politicas públicas e privadas voltada para esclarecer e conscientizar a população acerca de assuntos que, ao longo do tempo, foram vistas de forma preconceituosa. A exemplo disso, pode-se destacar a força que esse racismo ganhou depois que Donald Trump,  usou um termo racista para se referir s pessoas amarelas e ao vírus C-19. Dessa forma é inaceitável que esse tipo de crime seja tolerado.', 'Ademais, a omissão da sociedade está ligada como mais um dos fatores que agravam o impasse. Nesse contexto, de acordo com o filosofo brasileiro Felipe Pondré, o qual afirma que a evasão ao estrangeirismo é ainda entendida, pela maioria do povo brasileiro, como uma pratica comum e que pode ser justificada pelo medo da crise econômica e da decadência da identidade nacional. Sob esse viés, é perceptível a perpetuação de um cenário brasileiro que, que ao invés de estender a mão contribui para a exclusão, chacota e preconceito pessoas asiáticas.', 'Fica evidente que a falta de atitude do governamental e a omissão da sociedade são prejudiciais ao preconceito amarelo e que, portanto  é necessário mudanças. Por isso o Ministério Da Educação, deve promover  debates midiáticos em parceria com as mídias que, sobretudo, abordem as consequências negativas da postura preconceituosa dos brasileiros quanto aos asiáticos. Nesse sentido, o intuito de tal medida é tornar possível pessoas amarelas e a punição a quem cometer esse crime. Feito isso, uma sociedade mais justa e consciente será formada, e a atitude de cooperação, defendida por Chico Xavier, finalmente estará em ação para benefício de todos.']",160,200,160,200,160,880
50,Corona vírus,"['A Covid-19 é uma doença infecciosa causada pelo corona vírus da síndrome respiratória aguda grave 2 . Os sintomas mais comuns são: febre, tosse e dificuldade em respirar. A transmissão é feita ao espirrar ou tossir, pois essas gotículas podem ser inaladas ou atingir a boca, nariz ou olhos de pessoas em contato próximo. O aparecimento dos sintomas ocorre de 2 a 14 dias após o contágio.', 'Todo o planeta tem  se mobilizado para conter a pandemia do corona vírus(covid-19). Uma pandemia é um termo utilizado para designar quando uma doença infecciosa se torna uma ameaça em uma grande região, seja ela um continente ou todo o planeta.', 'Em 2009 houve uma pandemia de gripe A(H1N1), de uma variante de gripe suína cujos primeiros casos ocorreram no México. Essa pandemia ocorreu em abril de 2009, tendo fim em 10 de agosto de 2009 deixando 18.036 mortos e 700 milhões-1,4 bilhões de casos.', 'Para conter a pandemia do Covid-19, a orientação do atual governo foi deixar toda a população em quarentena para evitar a propagação do vírus . Também foi dada a ordem de utilizar álcool em gel para desinfectar as mãos caso tenha contato com o mundo externo. Essa ordem foi dada porquê a maior fonte de contágio está sendo pelas mãos e espirros.', 'Ainda não há vacinas contra a Covid-19, porém está sendo desenvolvida pela ciência em várias partes do mundo. Para prevenir o contágio, foram distribuídas vacinas contra gripe para o grupo de risco que são idosos acima de 60 anos, portadores de doenças crônicas como diabetes, hipertensão e asma.']",160,80,80,120,0,440
72,A Geração tecnológica influenciando a humanidade,"['No que se refere geração tecnológica no quesito internet ela vem se destacando como sempre, onde as informações est presente ali a todo instante, cada segundo ao entrar em algum site já se recebe noticias do mundo inteiro, muitas das informações sem preceito algum, sem base de crédito se realmente são de fato verídico . Com toda a modernidade em visão, as pessoas leigas de diversas temáticas vão se levando e fantasiando que tudo atrás daquele grande progresso, está expressando somente a verdade.', 'Com essa evolução da internet as eleições presidenciais aproveitam para mostrar através dos meios mais acessados de comunicação o Facebook para propagar a sua campanha . As pessoas não devem deixar se influenciar por propagandas enganosas, em averiguar com fatos reais se realmente tudo que diz dessas pessoas vai ser cumprido , pesquisar em redes confiáveis, em dados estatísticos de como é a vivencia politica daquele cidadão, fazendo perguntas a si mesmo; Quais foram as maneiras e recursos que ele usou para chegar onde está? Quais foram os benéficos e os maléficos dele a frente de sua população? Será que ele é verdadeiro e sincero?', 'Antes de qualquer passo a ser feito é preciso muita cautela,  e discernimento em analise do que as noticias quer passar, não ter uma só opinião e sim de todos os que convivem e estão mais familiarizados do contexto, não se deixar envolver em uma estagnação, e se deixar levar pela realidade e os acontecimentos cotidianos e meditar, o que está por trás dessa grande máquina de acesso, ter a com ciência de como o mundo está hoje com tantos farsantes e golpistas existente, com históricos relatados nos jornais de pessoas já foram vitimas desses enganadores da internet.', 'Sendo assim;  ter mais percepção, compreensão e investigação é indispensável quando o assunto é internet, ser coerente e não eloquente, não entrar de cabeça com qualquer noticia e propagandas politicas, pensar mais no voto quando a proposta lançada for muito de brilho aos olhos, nada pode ser o que parece. Ficar em alerta e denunciar quando descobrir uma falsidade ideológica livrando assim também outras pessoas de não caírem nesse mundo da geração sombria que a internet vem trazendo para que assim possa se chegar a um fim.']",120,120,80,120,80,520
78,Reforma do ensino médio,"['O Brasil, em pleno século XIX, enfrenta sérios problemas no sistema educacional, principalmente no ensino médio . Diante disso, foi criada uma medida provisória que propõe a reforma do ensino médio. Relativo à essa reforma, é possível destacar tanto aspectos positivos quanto aspectos negativos. Se por um lado,  essa medida possibilita ao aluno optar por áreas de conhecimento de seu interesse; por outro, a falta de planejamento pode acarretar em problemas.', 'Os péssimos índices alcançados pelo ensino médio no Ideb 2015 e a elevada taxa de evasão escolar levaram a medidas urgentes para melhorar essa realidade . Os pontos positivos dessa reforma são que os alunos terão a oportunidade de escolher em qual área do conhecimento querem se aprofundar. Além disso, a opção do ensino técnico traz a oportunidade de inserção dos jovens no mercado de trabalho, principalmente daqueles que não querem ou não tem a chance de ingressar no ensino superior.', 'Entretanto, apesar dos aspectos positivos, a falta de discussão e planejamento podem trazer problemas. Não só a eliminação de algumas matérias como obrigatórias , mas também a ampliação da carga horária vêm causando revolta em estudantes e professores, uma vez que, se mal planejada pode aumentar ainda mais o desinteresse dos alunos e prejudicar os professores.', 'Sendo assim, é inegável que essa reforma apresenta muitos pontos positivos , porém ainda há muito o que ser discutido . Dessa forma, é necessário que o MEC apresente de forma mais detalhada a proposta de reforma e promova um debate maior em torno do assunto, utilizando-se das mídias , para abranger toda a população. Ademais, é preciso investimentos  do Governo na capacitação das escolas e de professores para a implantação da nova reforma.']",80,120,120,120,120,560
74,Feminicídio no Brasil,"['O Feminicídio é um problema muito corriqueiro em nosso país. Isso deve ser abolido de nossa cultura , em razão de estarmos em um século moderno, no qual o homem e a mulher devem possuir a igualdade de direitos.', 'Feminicídio é o ato de violência contra uma mulher, pelo simples fato de sua sexualidade . Por mais que vivemos num mundo desenvolvido e avançado, há diversas pessoas que ainda possuem pensamentos e atitudes ultrapassadas, como por exemplo, o fato da superioridade do homem sobre a mulher.', 'Com o decorrer dos anos,  esse conceito tem sido mais debatido e diminuído, fazendo com que mulheres sejam aceitas na sociedade, recebam um salário remunerado igual a de seus colegas homens e deixem de ser submissas para serem independentes de seus pensamentos.', 'As mulheres da atualidade buscam, através do feminismo e protestos, o seu lugar no corpo social. O feminismo, que luta para que todos os seres humanos tenham direitos iguais, não é só um movimento político para mulheres. Homens podem e devem ajudar nessa mobilização, pois só assim conseguiremos o respeito mútuo entre gêneros, colocando como prioridade o bem ao próximo e o pensamento igualitário.']",120,80,80,80,40,400
60,Objetivo constitucional prejudicado pela Reforma Previdenciária,"['Um dos objetivos fundamentais da República, conforme o artigo 3º da Constituição Federal de 1988, é a construção de uma sociedade livre, justa e solidária. No entanto, a proposta de emenda constitucional sobre a reforma da previdência vai de encontro à justiça almejada pelo texto constitucional ao prever regras mais duras para a obtenção do direito de aposentadoria pelos trabalhadores brasileiros. Diante dessa perspectiva, faz-se mister analisar os seus principais efeitos.', 'Em primeiro lugar, o fim da aposentadoria por tempo de contribuição, prevista na reforma, é um retrocesso na busca por igualdades sociais. Assim, ao estabelecer a idade mínima como requisito universal para a aposentadoria, a proposta de emenda desconsidera as diferentes médias de expectativas de vida presentes no país que possui dimensões continentais . Ademais, segundo o pensador inglês, Clement Attlee: “a democracia não é apenas a lei da maioria, mas a lei da maioria respeitando o direito das minorias”. Diante do exposto, é necessário considerar que, como consequência, em muitas regiões brasileiras, as pessoas não terão a oportunidade de se aposentarem antes de morrerem.', 'Além disso, a diminuição do valor da aposentadoria de 90% para 60% da média das contribuições para quem se aposentar com o tempo mínimo de contribuição previdenciária irá afetar milhões de brasileiros. Segundo a pesquisa realizada pela LCA Consultores, em 2018, cerca de 11 milhões de pessoas dependem da aposentadoria de idosos para sobreviver, além deles mesmos. Com essa diminuição, muitas famílias poderão ser levadas à pobreza. Desse modo, a reforma da previdência, cuja finalidade é o reequilíbrio das contas do sistema previdenciário para garantir o pagamento dos seus benefícios, poderá contribuir para o aumento da pobreza, gerando uma maior desigualdade social no país.', 'Infere-se, portanto, que a reforma da previdência pode se tornar um grande problema para o país se for aprovada com as mesmas medidas propostas. Destarte, o Congresso Nacional deve revogar essa proposta de emenda constitucional e buscar novos mecanismos para combater o déficit da previdência, como o término da política de desonerações fiscais e das desvinculações das receitas destinadas a programas sociais e previdenciários por meio de alterações legislativas. Em outras palavras, o governo deve passar a cobrar impostos de alguns órgãos e entidades que são isentos atualmente e utilizar toda a receita das contribuições para a previdência. A partir dessas ações, espera-se que haja um reequilíbrio das contas do sistema previdenciário, ao mesmo tempo em que os direitos dos aposentados permaneçam assegurados, tornando a sociedade brasileira mais justa e solidária conforme o objetivo fundamental previsto na Constituição Federal.']",160,160,120,160,120,720
84,Pólvora,"['O Mapa da Violência 2015, mostra que há aproximadamente 8 milhões de armas de fogo ilegais no Brasil. Além disso, segundo a ONU 71% dos homicídios na sociedade brasileira são causados por armas. O que colabora para esses números? O Estatuto do Desarmamento não está cumprindo o papel a que se propôs em 2003? O que deverá ser feito para que os dados se tornem positivos?', 'O projeto, Estatuto de Controle de Armas, que está tramitando no Congresso Nacional, pretende deixar a lei sobre porte de armas por civis mais branda. Segundo este, a idade mínima para aquisição de uma (arma) passará de 25 anos para 21 anos. E mesmo, quem estiver sendo julgado por homicídio ou tráfico de drogas terá o seu direito garantido. Um dos argumentos dos defensores da proposta é que assim o governo terá mais controle sobre armas circulando pelo território nacional.', 'Realmente o país necessita de um maior controle relacionado às armas. Mas também, deve haver um rígido controle sobre quem as possui. A sociedade precisa estar consciente de que portar armas não é sinal de ostentação. Nem de lucros. E sim, de segurança. Envolve vidas.', 'Em suma, o que garante a defesa da população são leis e órgãos de segurança pública. Desse modo, cabe ao Governo investir em segurança, criar leis e projetos, como o Estatuto de Controle de Armas. Porém, aplicá-los de forma correta e não com regras tão brandas. O Brasil não está preparado para uma lei armamentista.']",160,160,120,120,200,760
50,As novas descobertas na ciência,"['“A vida sem ciência é uma espécie de morte’’, essa frase dita pelo filósofo grego Sócrates nos reflete que, a falta de importância à ciência leva  morte de muitas pessoas, pois é com ela e com seus avanços que temos melhorias na astronomia, tecnologia, saneamento básico, química, educação em geral, nas informações que temos  no dia-a-dia , e principalmente na área da saúde.', 'A falta de recursos para essa cognição prejudica na construção de novas escolas sobre o assunto, na melhoria de termos educacionais já citados acima, na importância de ações políticas, na rede de pesquisa pública que todos os brasileiros têm o direito de ter, conforme está escrita na lei nº 12.527/2011 , e na região da saúde pública (como na produção de vacinas e no estabelecimento de hospitais).', 'Mas essa crise na ciência não se deve apenas pelo fato de corte de verbas, mas também de uma visão estratégica e de uma política de Estado  que compreenda a necessidade de aumentar os investimentos no setor para assegurar a competitividade e promover o desenvolvimento econômico e social do país.', '“Os investimentos federais em ciência no Brasil nos últimos anos vêm despencando em queda livre, independentemente do governo”, disse Helena Nader, professora da Universidade Federal de São Paulo (Unifesp) e presidente de honra da Sociedade Brasileira para o Progresso da Ciência (SBPC). Nessa categoria de despesas estão incluídos os setores de educação, saúde, defesa e ciência e tecnologia. “ representa uma opção do Estado brasileiro”, avaliou Nader.', 'Contudo, a ciência permite a humanidade compreender um pouco mais sobre a natureza, ela é importante na nossa  vida pois nos ajuda a ter uma qualidade de vida melhor, pois através dela muitas doenças foram eliminadas, (um exemplo disso foi a Influenza A subtipo H1N1), e é com novas descobertas e avanços na área que cientistas e a população podem erradicar pandemias.', 'O contributo desta compreensão para a sociedade é inquestionável, na medida em que possibilita avanços nos campos da saúde, da alimentação, do ambiente, da tecnologia, da energia e muitos outros, melhorando a qualidade de vida das populações e enriquecendo  as sociedades intelectual e culturalmente.', 'Uma forma de contribuir com este entendimento é o governo aumentar o dinheiro enviado para laboratórios, universidades e campus, para acelerar o processo de novas descobertas, de novos avanços para a erradicação de doenças, e produção de vacinas.']",160,120,120,160,40,600
51,Analfabetismo Funcional,"['O analfabetismo funcional diz respeito a um individuo que não possui capacidade de interpretar textos, um problema, que mereço espaço dentro de discussões políticas ligadas educação. Entretanto, é um problema com pouca visibilidade no Brasil, principalmente política, devido a ignorância e falta de incentivo do governo, em oferecer uma infraestrutura escolar de boa qualidade, na rede pública, que permita ao jovem desenvolver essa capacidade de interpretação e leitura . Assim, para que esse problema seja solucionado, muito ainda tem de ser feito.', 'O analfabetismo funcional pode estar ligado a uma série de motivos pontuais, onde podem ser destacadas: ensino de baixa qualidade, ausência de incentivo governamental e familiar, descaso do governo para com a educação pública e descaso do individuo para com os estudos. Por muitas vezes, aqueles que sofrem deste problema, acabam sentindo-se inferiores a aqueles, que já não passam por essa situação, além de causar certa insatisfação pessoal. Esse sentimento de inferioridade faz com que muitos alunos saiam das escolas, por desistirem de aprender, o que pode afetar a vida profissional futura do indivíduo.', 'Com base em tudo que foi dito, podemos concluir que este é um problema grave . Contudo, é algo que pode ser solucionado. As medidas para tal são  sutis e a evolução é gradual. Atualmente, existe um programa, idealizado pelo MEC (Ministério da Educação), que oferece o suporte necessário, para desenvolver conhecimentos ligados à leitura e alfabetização e é um suporte, que pode ser buscado, até mesmo para os indivíduos que são analfabetos e querem desenvolver suas capacidades. Mas o governo não deve parar em apenas um meio de solucionar esse problema. Mais medidas devem ser tomadas para o enfrentamento ao analfabetismo, em principal, algo que vem sido apelado por boa parte da população, que o investimento em melhores condições de estudo nas Instituições de ensino público.']",120,120,80,120,80,520
81,Redação (Sem titulo),"['Na sociedade atual, combater a intolerância religiosa é um problema no Brasil e isso se deve ao fato de que antigamente  desde o período colonial  muitos índios e pessoas eram proibidas de se manifestarem, coisa que vem ocorrendo nos dias atuais. O país está sendo afetado com essa intolerância que vem prejudicando a liberdade de expressão dos indivíduos, ] caso esse problema venha a persistir, vai prejudicar muito o cotidiano da sociedade brasileira.', 'Nesse sentido, percebe-se que não só precisa  de leis mais rígidas, como também de uma população mais unida. Em primeiro plano, nota-se que a sociedade brasileira vem sendo bastante crítica, na qual  é muito bom. No entanto, há aqueles que não apenas critica , mas também prejudica   a liberdade de expressão das pessoas que acaba se tornando um crime. Ademais, de acordo com a constituição federa  l é livre a liberdade de crença religiosa às pessoas, visto que elas podem se manifestar em diferentes correntes, como políticas, culturais, movimento sociais e entre outros.', 'Além disso, saber ter controle e consciência da lei é algo fundamental para o brasileiro. Soma-se, ainda, que tanto a pessoa ter crença quanto não ter, é um direito que o indivíduo, ou seja, a sociedade tem, pois é livre a escolha e isso é de dignidade humana. Dessa forma, a união e a vontade de escolher cabe a cada pessoa saber a melhor forma. Torna-se evidente, portanto, que essa intolerância religiosa é algo que precisa ter mais atenção e cuidado para combater. Desse modo, o papel do governo é fundamental, que se faz  necessário que ele invistar  criando ou tornando a lei mais rígida, a fim de ajuda  nos casos da privação da liberdade de expressão. Outrossim, as escolas em consonância com os pais dos alunos criar  palestras e debater para que comece a perceber desde criança que é crime a discriminação com o outro. Assim, vai diminuir consideravelmente os casos de crime.']",80,120,80,120,120,520
76,O desafio da equidade de gênero,"['Em 1988, quando a Constituição Federal do Brasil estabeleceu em seu 5º artigo a relação jurídica de igualdade de gênero, que tem como teoria a igualdade de homens e mulheres, afirmando que, todos tem tanto os mesmos direitos quanto as mesmas obrigações.', 'Entretanto, no ano de 2017, pesquisas feitas revelam que apesar de toda estrutura criada para quebrar o dogma da desigualdade, o Brasil caiu 11 posições no ranking de combate a desigualdade. Pelos cálculos realizados, seriam necessários cerca de 100 anos para a anulação total de tal controvérsia.', 'Sendo assim, é indispensável a adoção de medidas capazes de assegurar o respeito ao gênero, convém, portanto, que o Ministério da Justiça juntamente com o Ministério da Segurança pública,criem estratégias capazes de progressivamente anular tamanho desrespeito á população brasileira o mais rápido possível.']",120,80,80,120,80,480
49,Mundo Digital x Meio ambiente,"['No pandora atual, cogita-se com frequência sobre o papel dos influenciadores digitais, ou influencers como também são chamados . De certo, tendo em vista a maneira com que o mercado encontrou por meio deles de divulgar seus produtos e informações, sugerindo um ""padrão ideal"" de vida e consumo. Nesse contexto, analisar suas causas e efeitos para a sociedade é imprescindível a fim de minimizar a problemática.', 'Inicialmente, é relevante observar que em meio a força das redes sociais, muitas empresas utilizam o marketing digitaigital através dos influencers para divulgar seus produtos e marcas. Certamente, pelo grande poder de comunicação e influência que eles exercem na vida de seus seguidores. Dessa maneira, por meio desse protagonismo digital, acabam moldando os pensamentos e atitudes das pessoas, levando-as ao consumismo.', 'Outrossim, caracteriza-se o consumismo como uma compulsão que leva o indivíduo a comprar de forma ilimitada, e que na maioria dos casos é uma consequência das estratégias utilizadas pelos influenciadores digitais. De fato, segundo a Youpix 64% dos jovens de 18 a 34 anos já usaram os influencers como uma fonte de conhecer uma marca ou produto. Nessa perspectiva, vale ressaltar que tal exagero de compras acaba prejudicando o meio ambiente, em razão do descarte incorreto de embalagens ou de produtos já inutilizáveis.', 'Portanto, para as problemáticas supracitadas reduzam-se, é preciso intervir. Logo, cabe ao Ministério da Educação em parceria com as instituições de ensino, criarem um programa sobre consumo consciente e educação financeira nas escolas, por meio de palestras ministradas por profissionais dessa área, para que os jovens aprendam e cresçam como consumidores conscientes no ato da compra . Além disso, é de suma importância que também promovam projetos sobre a coleta seletiva e reciclagem do lixo, através da realização de feiras com enfoque ambientalista que proporcione aos alunos separar e reciclar os resíduos de sua própria residência, para que ajudem na conscientização e na redução dos impactos ambientais, confirmando assim o pensamento de Nelson Mandela ""A educação é a ferramenta mais poderosa que podemos usar para mudar o mundo "".']",160,160,120,160,0,600
3,Mundo moderno e suas tecnologias,"['Ao se falar em tecnologia, devemos observar alguns seguimentos segmentos que vem vêm se destacando e ganhando espaço no mundo contemporâneo. Nesse sentido, podemos destacar a revolução do transumanismo. Tecnologia transumanismo, tecnologia que poderá garantir aos seres humanos uma qualidade de vida melhor através de implantações de chip no corpo humano.', 'A priori, a implantação dessa tecnologia, que se concentra em um chip, irá garantir ao ser humano um aperfeiçoamento em diversas áreas da vida, como por exemplo, na capacidade física, intelectual, psicológica e emocional. Dessa forma, emocional, melhorando expressivamente sua qualidade e prolongando seus anos de vida. Tal feito iria gerar uma grande revolução na história da humanidade.', 'A posteriori, devemos nos atentar atentar ao público limitado que terá acesso a esse essa tecnologia. Certamente, o chip e sua implantação terá terão um valor elevado, fora do alcance da maioria da população, o que irá suscitar uma potencialização na desigualdade social aumentar a desigualdade que já assola nossa sociedade nos dias atuais, fazendo com que o público de maior poder aquisitivo tenha mais poder sobre as demais parcelas da população.', 'Com os Dos dados supramencionados, infere-se, portanto, que a tecnologia é imprescindível para o desenvolvimento e qualidade humana, entretanto, a maioria delas são de a maioria dela tem alto custo financeiro, fazendo com que a população de classe baixa e média não tenha acesso a determinado tipos de serviços. Sob essa ótica, cabe ao Poder Público garantir que esse grupo de pessoas, com menor poder aquisitivo, tenha acesso a tais tecnologias. Dessa forma, todos, sem distinção, poderão usufruir das inovações e benefícios que a tecnologia proporciona ao mundo contemporâneo.']",120,80,120,120,120,560
14,Braxit,"['No Brasil, grande parte da população emigra procurando melhorar de vida em países mais desenvolvidos. Dessa forma, sair do pacto para imigração e diminuir as relações com o Mercosul representa mais prejuízos do que vantagens. Uma vez que o Brasil não é o país que mais recebe imigrantes, essa política contra o pacto pode prejudicar a vida de brasileiros no exterior.', 'Primeiramente, com a atual crise política e econômica na Venezuela , muitos cidadãos desse país estão procurando refúgio em países vizinhos. Sendo a Bolívia a que mais recebe essas pessoas sendo seguida pelo Brasil. A entrada desses imigrantes para o no Brasil deveria ser incentivada uma vez que o Brasil tem a capacidade de recebê-los e de aproveitar essa mão de obra para o desenvolvimento econômico nacional.', 'Em contrapartida, a saída do pacto global para a imigração pode prejudicar a relação do Brasil com outros países que recebem emigrantes brasileiros. Pois não sendo uma nação signatária do pacto pode sofrer com políticas mais duras como afirma o sociólogo Thomas Marshall sobre a conquista de direitos dos cidadãos na atual fase da globalização.', 'Portanto, o Brasil só tem a perder dificultando a imigração e incentivando a xenofobia. Logo para reverter essa situação o país não deve sair do pacto, flexibilizar a entrada de imigrantes e não se comparar com países desenvolvidos como o Reino Unido e a política do Brexit. Só assim poderemos crescer como nação, compartilhando os direitos sociais para todos.']",160,200,160,200,160,880
82,Os riscos da correria,"['Na contemporaneidade, devido a  rapidez dos acontecimentos, é bastante comum que as pessoas queiram resolver os seus problemas de forma rápida e prática, inclusive quando os mesmos  envolvem saúde e bem-estar. Nesse contexto, estudos recentes indicam que a ingestão discriminada de medicamentos de diversos tipos é fenômeno crescente .', 'Seja na busca pela boa forma,  prevenção de gravidez ou até mesmo cura para dores de cabeça, a automedicação tem se tornado prática com cada vez mais adeptos no Brasil e em todo o globo. São inúmeros os malefícios que isso pode trazer ao indivíduo    como, por exemplo, piora no quadro clínico, surgimento de microorganismos  resistentes aos medicamentos, dependência química    entre outros. Nos últimos anos, uma grande parcela de pessoas ingerem remédios, como anabolizantes, sem prescrição médica,    em busca do corpo perfeito. A discussão sobre o assunto gera bastante polêmica. Já foi comprovado pela ciência,   que anabolizantes, em sua grande maioria, causam sérios anos á saúde dos usuários   podendo desencadear doenças como o câncer e até mesmo levar á morte. Além disso, é bastante comum,    acompanhar casos de pessoas que ingerem medicamentos de forma indiscriminada,    na intenção de curar dores no corpo, o que pode gerar uma grave dependência á  esses medicamentos,    e também pode levar ao óbito.', 'Assim, para erradicar esse problema, é necessário que sejam criadas leis mais severas para coibir a venda de medicamentos sem prescrição médica. Além disso, é imprescindível que campanhas publicitárias de conscientização e esclarecimento sobre o problema,   sejam criadas pelo governo ou por ONGs.']",120,160,120,160,160,720
120,Liberdade responsável,"['A intolerância religiosa é resultado de uma liberdade mal usada, em que os valores do próximo são desconsiderados, abrindo espaço para deboche social e a         centralização          de uma fé sobre as demais                . O respeito mútuo é essencial para a harmonia entre todos, pois a                 autonomia                de expressão não justifica a difamação alheia,                 já que o governo buscará o equilíbrio e ao mesmo tempo impedirá o discurso que incita o ódio ou a violência entre as crenças.', 'Um dos pilares da democracia é a                 aliança do          povo  , em          uma nação                tão distinta internamente, o respeito assume papel primordial para a aceitação do modo de agir dos outros,                 caso não opte                , torna-se uma questão individual ou de um grupo,                 que se          esforçarão          pelos seus preceitos dentro dos limites da cidadania                .', 'Este          vigor intenso pela sua própria          verdade  , não         será motivo para chacotas e depravação das demais, são ações ilícitas diante de uma sociedade baseada na         justiça, o         valor de                 dispersar uma doutrina                deve estar         firmada         no diálogo e no fato de ser flexível em agir\xa0 com a diversidade de pensamentos.', 'Soma-se o fato         que, a         evolução geral de um país só acontecerá se                possuir uma população unida em torno de um         objetivo ou seja         um território em que a paz         predomine, o  governo          na tentativa da estabilidade, eliminará ares de desordem pela prosperidade coletiva, exemplos dos causadores deste          desconcerto, são          : o ódio extremista de pequenos grupos e a violência terrorista.', 'Portanto, o uso da liberdade de         opinar, deve         estar         fixada  em uma base que assuma o         compromisso de agir com respeito diante da diferença,                 não          havendo assim,           a                 centralização de uma fé sobre as demais, já que cada uma possui seu conjunto de valores, eliminando de vez a desmoralização de doutrinas existentes e fomentando um governo venturoso que trabalhe em benefício da ordem pública.']",80,120,0,80,80,360
93,Parto humanizado,"['A humanização do parto é uma proposta que começou a ser difundida a partir do ano 2000 e até hoje impacta muitas vidas,  que aderem e lutam por este projeto. Porém, é um assunto não definido como questão de saúde pública, porque muitos hospitais e profissionais de saúde ainda carecem de conhecer e aplicar esta forma de tratar seus pacientes como são, seres humanos dignos de amor e respeito.', 'Muitas mulheres ao se informarem sobre o parto humanizado têm a concepção de que ele não deve ser realizado em um hospital, e isso é compreensível, porque, segundo pesquisas, o Brasil realiza o quádruplo de 15%, valor recomendado pela Organização Mundial da Saúde (OMS) para a prática de cesárea nos partos, intervenção, muita das vezes, desnecessária e desrespeitosa à gestante por não ser informada sobre o procedimento realizado.', 'Um parto humanizado significa tratar a mãe com respeito e dignidade de ser humana, filha de Deus, pois ela possui inteligência e vontade, precisa ser acolhida e compreendida pelos profissionais de saúde, principalmente, zelando pela vida do bebê. O tratamento pode e deve ser realizado em um hospital, porque “em 10% dos casos ocorrem complicações”, que “necessitam de atendimento médico imediato e local para tratamento apropriado da mãe e do bebê.”, como explica a Dra. Dani Werka.', 'Assim, é necessário que os hospitais públicos e privados se empenhem em realizar fóruns, palestras, workshops, entre outras ações, para acrescentar à formação de seus profissionais de saúde o conhecimento sobre a umanização do parto e como realizá-lo. Com esforços mútuos, o parto humanizado se tornará uma questão de saúde pública, para promover a vida da mãe e do bebê.']",160,120,120,120,80,600
91,Negar a ciência é trágico.,"['Acima de tudo  , o filósofo conceituado, Edmund Burke disse uma vez que toda lei tem apenas dois fundamentos: equidade e a utilidade. Após isso, fica evidente a necessidade de ambos princípios para que possamos viver em união em nossa sociedade, mas por conta da ação de negar a ciência, que não vemos isso no nosso cotidiano.', 'Na sequência existem inúmeros motivos que levaram a esse imbróglio, sendo incontestável uma intervenção. Ademais, durante a pandemia do Sars-Cov-2, o chefe de Estado e do governo do Brasil fez duros ataques à comunidade científica, menosprezando a sua função de proteger a saúde dos indivíduos, após várias e várias manifestações negando a sabedoria da ciência, o país chegou a marca de quatrocentos e trinta mil mortes por conta do novo coronavírus. Sem dúvida vemos que negar ciência e o seu poder só traz consequências gravíssimas.', 'Imediatamente lembramos da frase do filósofo alemão, Immanuel Kant que dizia: ""O ser humano é aquilo que a educação faz dele"". Realmente a educação é um poder gigantesco na vida de qualquer pessoa, com isso cabe ao Ministério da Educação em parceria com as Secretarias Estaduais e Municipais tomarem medidas para inserir no currículo escolar temas sobre a ciência na sociedade, mostrando os resultados trágicos do negacionismo científico. Como também isso é um direito assegurado na Constituição federal de 1988 no Artigo 196 que diz que saúde é um direito de todos e dever do Estado que deve garantir mediante políticas sociais e econômicas, não só como… como também é obrigação das autoridades desmentirem notícias falsas sobre a ciência.', 'Em conclusão convém lembrar que cabe ao Ministério da Educação e as Secretarias estaduais e municipais  juntamente com o governo promover medidas políticas sociais e econômicas para despromover o negacionismo científico tanto no meio escolar, sites, propagandas, revistas, panfletos para que assim possamos dar o real valor a ciência e salvar vidas juntamente com a nossa economia.']",160,120,120,160,120,680
90,Segurança e Inclusão de Trans no Mercado de Trabalho,"['A Constituição federal de 1988 artigo 5°  diz que todo cidadão tem direito educação, segurança, trabalho toda dignidade do ser humano. Embora a gente tem uma constituição que garante tudo isso mais na prática não é bem assim a realidade no Brasil.', 'Em primeira análise vale relatar o Big Brother Brasil 2021. questão da transfobia apareceu nesta edição do reality , após serem maquiados pelas mulheres , alguns dos participantes homens desfilaram e fizerma poses efeminadas. Dessa forma  Lumena então ,  criticou ""a brincadeira"" explicando que , para pessoas trans, poderia representar violência . Nas redes mulheres trans falaram sobre suas experiências e como a atitude do grupo acabou sendo ofensiva, como mostrou uma reportagem do site universa. Desse modo os trans sofrem com violência no dia a dia, não se sentem seguras com medo de sofrer agressoes verbal e fisica por pessoas preconceituosas.', 'Em segunda análise vale destacar a falta de oportunidade no mercado de trabalho e fato quando se trata de dados sobre a comunidade transgênero estas pessoas são invisìvel aos olhos dos principais instituto de estatistica desempregados se deparam com a taxa de desocupação de 12,4% do trimestre fechado em fevereiro divulgado pelo Instituto Brasileiro de Geografia e statistica (IBGE) essa é a veracidade brasileira.', 'Portanto medidas são necessárias pra resolver esse impasse Associação Nacional de Travesti e Transexuais (ANTRA) devem propor soluções aos problema de violência e desemprego .Por meio de um projeto de lei a ser entregue na Camara dos deputados . Neles deve constar um 0800 para denunciar agressões, campanha nas tv , rádios e redes sociais contra agressão , uma campanha em todas midias sociais para inclusão de pessoas trans no mercado de trabalho. Espera-se com essas medidas combater a transfobia em ascensão na sociedade brasileira.']",160,120,120,160,160,720
61,,"['Segundo Platão, “o importante não é viver, mas viver bem”, o qual representa a saúde mental dos policiais que sofrem agravos aos devidos conflitos podendo ser gerados tanto de forma familiar ou profissional, levando à um suposto suicídio.', 'A família deve dar um auxílio, mas vale ressaltar que os sofrimentos de origem familiar acabam sendo despercebidos pelos integrantes da mesma e então não buscam ajudar a intervir a questão do suicídio, o que arremata sendo levado ao ambiente de trabalho.', 'Assim que o indivíduo exerce sua vida profissional sem tratar sua própria saúde mental, acarreta um rendimento prejudicial e isso agrava ainda mais a questão dos sentimentos indesejáveis, podendo ocasionar depressões futuras e transtornos que segundo o sujeito portador dessas angústias, a morte é a solução para acabar com os problemas enfrentados.', 'Portanto, medidas são necessárias para atenuar o número de suicídios entre os policiais, os quais encaram problemas psicológicos decorrente de suas rotinas e distinguem como saída tirar a própria vida. Sendo assim, deve-se ter um bom relacionamento tanto no ambiente familiar como de trabalho, o qual deve sempre manter a saúde mental em dia e participar de eventos criados para conscientizar sobre o número de suicídio entre policiais que vem aumentando, pois conforme diz Platão, o importante é viver bem.']",120,120,80,80,40,440
44,??? •-•,"['De acordo com o Artigo 1 da Declaração Universal dos Direitos Humanos, “Todos os seres humanos nascem livres e iguais em dignidade e em direitos”. No entanto, em relação ao esporte feminino, observa-se justamente o contrário, visto que a participação das mulheres nessa modalidade esportiva depende de certos paradigmas, sendo muitas vezes necessário um melhor esclarecimento quanto ao gênero da mulher. Dessa forma, em razão da padronização social e da intolerância , emerge um problema complexo que precisa ser resolvido.', 'Em primeiro plano, é preciso salientar como os padrões estabelecidos pela sociedade são uma causa latente do problema. A respeito disso cabe citar a teoria do sociólogo Émile Durkheim de fato social que consiste em maneiras de agir, de pensar e de sentir que se impõem sobre o indivíduo, obrigando-o a se adaptar s regras da sociedade onde vive. Assim, infere-se que, uma mulher ao apresentar características que não são consideradas regulares , tende a sofrer uma força sobre si que a impõe de seguir os padrões do corpo social a qual ela participa. Pois, ao se definir como normal um aspecto dominante, muitas vezes aquilo que é diferente passa a ser automaticamente rejeitado.', 'Deve se abordar ainda que, outra causa para a configuração da problemática, é a discriminação contra esse tipo de disfunção endócrina em mulheres, haja vista que existe um tratamento desigual para com os homens, que não necessitam de supressores hormonais para participar de competições, sendo que estes também apresentam níveis variáveis de testosterona, e distinções físicas que lhes causam vantagens . Sob essa lógica, a exclusão de pessoas que não atendem aos critérios instituídos pela sociedade se perpetua de maneira opressora.', 'Portanto, a necessidade de comprovação de gênero de uma mulher é um desrespeito aos seus direitos básicos assegurados pela Declaração Universal. Nesse sentido, para melhorar essa problemática, é mister que os órgãos responsáveis pela administração esportiva  realizem uma reavaliação de suas leis de modo a promover uma melhora na democratização do esporte, para que haja uma maior valorização e aceitação das diferenças individuais de cada pessoa respeitando os direitos humanos e a diversidade']",160,200,160,200,160,880
88,,"['O bemestar mental é um dos trópicos mais discutidos nos dias de hoje o entanto, isso não anula todas as dificuldades que as pessoas passam por apenas tentar cuidar da própria saúde que é essencial para atingir qualidade de vida.', 'Existe certo preconceito ao se falar em cuidados mentais, as pessoas deixam de procurar ajuda muitas vezes pensando em que parentes e entes queridos vão dizer . Ansiedade e depressão, por exemplo, estão presentes há anos na sociedade mas poucos procuravam tratamento por achar que iriam presumir se tratar de ser apenas besteira ou uma forma de chamar atenção. Vicent Van Gogh pintor famoso do movimento pós-impressionista sofria de depressão, ficou conhecido como louco e foi rejeitado diversas vezes por tal motivo sendo que era somente uma pessoa que necessitava de cuidar da sua saúde mental.', 'Além do preconceito, essas pessoas ainda enfrentam mais um empecilho, infelizmente, nem todos podem arcar com o custo de pagar um tratamento ou até mesmo uma terapia, tendo que lidar com tudo sozinhas, sem assistência profissional especializada.', 'O estado deve tomar medidas para assegurar o bemestar de toda a população, seja com palestras, a criação de projetos de assistência para pessoas de baixa renda, grupos de apoio. Para talvez assim promover o mínimo de conforto e ajuda para esse grupo de pessoas cada vez maior.']",160,120,80,120,120,600
52,Mãe precocemente,"['Grávidez na adolescência hoje em dia já não é mais novidade, o que antes era pra ser algo que deveria acontecer no seu tempo é simplemente os jovens mostrando a nós que vivemos em outra geração  na qual não existe mais responsabilidade de ambas as partes dos adolescentes,as pessoas no mundo no qual vivemos dispensa todo e qualquer conselho dado dos mais sábios no caso nossos pais ou avós.', 'Dizer que uma gravidez aconteceu sem querer ou sem esperar já não cola mais pois existe diversos meios de preservativos como por exemplo: camisinha,pílula,injeções e etc, o que deve haver mesmo é o cuidado e o principal usar sempre camisinha mesmo sem gostar.', 'Enfim antes de tomar qualquer que seja a decisão tenha consciência de que tudo na vida tem um preço.']",80,40,40,80,0,240
44,Inclusão de LGBT no esporte feminino mundial,"['Atualmente, a mídia levantou a discussão sobre a possibilidade de mulheres trans ou que possuem níveis hormonais superiores aos estabelecidos pelas Instituições Esportivas Internacionais como a Tiffany para serem aptas a jogar em times femininos. Nesse cenário, percebe-se existência de exclusão desse público em competições esportivas, apesar da Constituição ederal preconizar o bem de todos, sem qualquer tipo de discriminação. Logo, fatores como preconceito e poucas pesquisas sobre o assunto contribuem para o agravamento da situação.', 'Primeiramente, as atletas são vítimas de preconceitos diariamente e também no esporte. Constata-se que esse problema é histórico por causa do patriarcalismo, no qual acreditava-se que a mulher tinha sexo era frágil e sua participação em atividades físicas prejudicaria a capacidade de ter filhos. Atualmente, essa situação persiste, já que os órgãos internacionais definiram um nível máximo de testosterona (5 nmol/l) para participação delas nos jogos (Jornal BBC), diferente do que acontece com os jogadores masculinos. Logo, devem ser desenvolvidas maneiras de incluir a diversidade nos eventos.', 'Em segundo lugar, muitas pessoas acreditam que o desempenho esportivo das mulheres trans é superior às que já nasceram femininas. Entretanto, isso não passa de uma crença, pois ainda não existem pesquisas científicas que provam esse argumento, em função da existência de poucas candidatas LGBT interessadas em seguir na carreira. Em geral, atletas são considerados de alta performance por outros fatores para ser classificado como tal (coordenação motora, conjunto de experiência e entre outros) e não apenas o biológico, de acordo com o endocrinologista Magnus.', 'Diante dos argumentos expostos, nota-se a deficiência na inclusão de LGBT no esporte. Nesse sentido, as Fundações de Amparo a Pesquisa dos Estados de São Paulo e de Mato Grosso, responsáveis pelo fomento, devem incentivar pesquisas sobre as habilidades esportivas das mulheres trans, bem como estabelecer exigências para participação de atletas masculinos, por meio da disponibilização de recursos financeiros para as Universidades em parcerias com os bancos mundiais iniciarem os estudos. Espera-se com isso, aumentar a diversidade nos jogos e desestimular o preconceito.']",160,80,80,200,40,560
88,,"['Sabe-se que desde os primórdios da sociedade brasileira pessoas acometidas por qualquer tipo de doenças mentais são vítimas de preconceito, exclusão e bullying por parte de indivíduos ditos normais. Vemos muito disso na série “Spin out”, produzida pela plataforma de streaming “Netflix”. Na série a protagonista, Kat Baker, é uma patinadora profissional portadora de Transtorno Bipolar, a série mostra bem como a doença a atrapalha tanto na sua profissão quanto nas situações diárias com amigos e família. Essas são apenas algumas das muitas situações vivenciadas por pessoas acometidas com doenças mentais no Brasil e no mundo.', 'Atualmente sabemos que os índices de suicídio e depressão cresceram de uma forma extraordinária, mas diferente do que muitos pensam todas as doenças mentais existentes nos dias de hoje também existam nos tempos antigos, a diferença era que tais enfermidades eram tratadas como algo surreal e todos aqueles que eram diferentes das pessoas “comuns” eram tratadas como loucos. Mesmo com tantas descobertas acerca do assunto e tanto conhecimento que possuímos atualmente, a sociedade continua sendo muito cruel com pessoas acometidos por tais doenças.', 'No Brasil mais de 11,5 milhões pessoas têm depressão, sendo assim considerado o país mais depressivo da América Latina. Através disso é possível notar a necessidade de tratarmos tais assuntos com seriedade. Essas são algumas das “enfermidades” mais cruéis que existem, pois muitas vezes você deixa de viver a sua própria vida . Os preconceitos existentes na sociedade só tendem a dificultar a experiência dos “enfermos”.', 'Por conseguinte, sabemos que vivemos em um ambiente totalmente desfavorável para pessoas acometidas por distúrbios mentais, o que podemos fazer é estudar sobre o assunto e aprender a como lidar com esses indivíduos. A palavra que define é empatia, o que muitas vezes é algo esquecido pela maioria das pessoas.']",200,160,120,160,80,720
131,Propaganda eleitoral,"['No Brasil o horário político surgiu no ano de 1965, em todas as emissoras de TV abertas do país. Mas dados recentes de pesquisas mostram que não é bem visto pelos telespectadores, onde grandes porcentagens dos cidadãos brasileiros acham dispensáveis.                  A propaganda eleitoral          sem dúvida tem sim          seus benefícios                , porque hoje a maioria dos brasileiros tem em seu ambiente domiciliar uma TV, um rádio e também a         internet, sendo dessa         forma, todos tem acesso         ás         informações divulgadas, podendo assim aprimorar seus conhecimentos sobre seu respectivo candidato e conhecer                 suas propostas de mandato                .', 'Mas convenhamos que as campanhas não estão tendo um diferencial, estão muito repetitivas, falta algo que prenda a atenção                 do ouvinte                , como por exemplo, o que ocorreu na campanha de São Paulo,                 em 1985,          onde          o PT, criou          um          personagem “Zé do muro”,          e conseguindo          assim chamar a atenção do público, e          teve          como resultado a vitória na eleição.                No         entanto         as campanhas estão se tornando muito sonolentas.', 'É preciso mudanças na campanha eleitoral, como, dividir o tempo por igual entre todos os candidatos, e seria mais favorável o debate público eleitoral, onde entram vários assuntos em pauta, e podendo assim, os candidatos exporem de maneira mais abrangente suas propostas de governo.', 'Portanto, esses poucos minutos         é          de certa forma uma importante ferramenta para a democracia          brasileira, é          preciso que os cidadãos brasileiros participem mais da politica do          país, obter          mais conhecimentos sobre os candidatos,          a final          são estes que constituem a sociedade em que vivemos, então é preciso votar com responsabilidade.']",120,120,80,80,80,480
51,O mau persistente,"['No que se refere ao analfabetismo funcional no Brasil, é importante afirmar que a falta de apoio escolar na formação adequada dessas pessoas acaba por agravar a situação em questão . Isso se evidencia não só pela ausência das instituições de ensino em dar uma importância maior na problemática vivenciada, mas também na precariedade que a política educacional brasileira enfrenta ao longo dos anos.', 'Primeiramente observa-se que devido à omissão das instituições de ensino sobre o assunto narrado favorece para o agravamento do analfabetismo funcional . Isso pode ser explicado pelo fato de as instituições não se preocuparem tanto se o aluno efetivamente aprender o conteúdo . Com isso as escolas, como as instituições privadas, acabam passando os alunos de ano . Como consequências, eles acabaram por encontrar dificuldades em interpretar textos considerados simples ou fazer cálculos básicos, como a soma ou a multiplicação, devido à ausência das instruções que teve aos anos anteriores.', 'Outro fato que contribui para a falta de apoio escolar para a formação desses indivíduos é a precariedade que a política educacional enfrenta ao longo dos anos . Com efeito, a metodologia de ensino empregada no Brasil precisa ser revisada com a finalidade de melhorar a compreensão dos alunos. Como por exemplo a realização de questionamentos em sala de aula e não apenas a aplicação de provas com o objetivo de medir o conhecimento do aluno, mas para que esse venha compreender o assunto tratado por tal consequência os alunos acabam por gerar dificuldades de aprendizado devido à metodologia de ensino utilizada.', 'Portanto, faz necessária a conscientização a respeito da problemática em questão. Sendo assim, o Ministério da Educação deve criar políticas públicas que incentivem a prática da leitura. Para isso o governo deve aumentar a frequência  da leitura no cotidiano das pessoas buscando melhorar os hábitos da leitura, passando a compreender melhor os textos lidos. Assim o contexto vivenciado será, aos poucos, minimizado.']",160,160,120,160,120,720
58,A importância da floresta amazônica,"['A floresta amazônica vem sofrendo há muito tempo com o desmatamento e as queimadas. Alguns enxergam essas práticas como uma ação necessária ao suprimento das necessidades do ser humano, outros vem como um dos maiores problemas ambientais da atualidade.', 'As principais consequências estão relacionadas ao meio ambiente. Ao desmatar, compromete toda a biodiversidade da área. Espécies de fauna perdem seu habitat e espécies da flora podem entrar para a lista de ameaças a extinção, causando assim um enorme desequilíbrio ambiental.', 'De acordo com o INPE (instituto nacional de pesquisas espaciais), dados apontam que no mês de julho de 2019 o desmatamento aumentou em 278% comparado a julho do ano anterior. E isso tem gerado preocupação, pois a amazônia é responsável pelo equilíbrio ambiental do mundo todo.', 'Portanto, medidas precisam ser impostas para minimizar esse problema. É essencial que o governo desenvolva campanhas de preservação ambiental, através dos meios de comunicação. Assim, podemos  preservar a floresta amazônica que há tempos vem sofrendo.']",120,80,80,120,80,480
46,"Privatização do saneamento básico, uma discussão social e política","['A privatização torna-se uma discussão inerente diante do descaso qual o fraco saneamento básico impera no Brasil. Haja vista que o governo e a gestão política não interferem conjecturas eficazes para melhorar um simples sistema de esgoto em um bairro periférico, medidas mercadológicas e capitalistas de intervenção privada proliferam em meio ao problema e, dessa forma, traduzem discussões a respeito da igualdade de acesso a um direito básico e denunciam ações governamentais ainda pacíficas diante de uma necessidade higiênica da população menos favorecida.', 'Então, a desestatização vem para minimizar os impactos negativos do problema atual e, embora argumentos contrários perpetuem aumento de impostos ou taxas a pagar por um saneamento básico digno, caberá ao estado regulamentá-las e definir integração e acessibilidade ao qualquer cidadão pagador de impostos. Por conseguinte, é definida na Constituição rasileira de 1988 o direito à saúde, por assim dizer, é fulcral garantir ações sanitárias qualitativas, mas isso não acontece como revelado pela pesquisa do Instituto Brasileiro de Geografia e Estatística – IBGE por meio do Pesquisa Nacional por Amostra de Domicílios – PNAD, em 2015.', 'Logo, às vezes não faltam pesquisas acadêmicas ou projetos sanitaristas de estudiosos para desenvolver um espaço organizado, saudável e notório para quaisquer populações, mas é perceptível quão fracas são as políticas públicas. Por isso, diante do desastre organizacional e político em manter uma normativa a qual venha beneficiar a saúde e a higiene da população, acham-se na solução de privatizar, medida essa positiva porque quando envolve mercado e capital, a tendência é entregar um ambiente melhor ao cliente ou pelo menos tentam.', 'Com base nessas considerações, a privatização é uma resposta ao despreparo governamental em lidar com questões básicas da sociedade. Isto posto, soluções precisam engendrar resultados. Cabe ao Ministério das Cidades , após a concretização da privatização do saneamento básico, regulamentar por intermédio de uma Medida Provisória – MP, uma lei pela qual venha integralizar e regulamentar qualquer forma de taxas altas ou medidas de custeios frente as novas empresas em prol do saneamento básico. Para tanto, além de democratizar qualidade, deve beneficia famílias carentes e, dessa forma, perpetuar uma sociedade mais limpa e organizada.']",160,160,160,160,160,800
48,saúde publica e seus desafios,"['O SUS  é um dos programas que apresenta um amplo serviço, como programa de promoção a saúde, vacina, consultas especializadas, entre outros, porém tem enfrentado muitos desafios , sendo que a maioria das vezes é pela mal organização e gestão dos procedimentos gerando impactos negativos.', 'Atualmente o SUS está em um batalha frente á frente contra a pandemia do Covid-19, com risco de sobrecarregar o sistema e de entrar em colapso até o meio do ano, o S conta com um planejamento de dar preferência as regiões mais afetadas pelo covid 19, sendo que o maior vilão é a falta de preparação de alguns profissionais, falta de leitos e demora no atendimento.', 'O jovem SUS oferece um serviço amplo e completo do que um plano de saúde, ajudando milhões de brasileiros com vacina, acompanhamento e orientação, além disso nas consultas especializadas o governo está investindo em tecnologia para melhor atender a população, como diz Jobs tecnologia move o mundo.', 'Portanto tornase evidente que o brasil é o único pas com mais de 200 milhões de habitantes, o qual oferece sistema de saúde publica, no entanto para combater aluns desafios deve haver uma reestruturação no sistema, o governador e prefeito em conjunto com o ministério da saúde, devem oferecer cursos de capacitação profissional, construção de mais hospitais para aumentar o numero de leitos, além de organizar melhor o atendimento separando os mais grave do menos grave atendendo por tempo determinado. Afinal o SUS é direito de todos.']",120,160,120,120,160,680
48,Saúde Pública,"['Conforme assegura a Constituição de 1988, todo cidadão deve ter acesso a serviços relacionados à saúde. Para que isso ocorresse na prática, o Sistema Único de Saúde foi criado. Ele é de extrema importância para aqueles que não possuem condições de ter acesso a planos particulares, visto que oferece um atendimento médico gratuito . Apesar disso, possui inúmeros problemas , os quais em detrimento do baixo investimento por parte do Poder Executivo.', 'Primeiramente, é importante destacar a abrangência do SUS. Segundo dados do Ministério da Saúde, 75% da população brasileira depende exclusivamente dele . Portanto, muitos só têm acesso aos tratamentos de doenças  graças ao plano gratuito. Para exemplificar, atualmente, a doença COVID-19 ressaltou isso, visto que maioria dos leitos de UTI ocupados pertencem ao serviço hospitalar público, conforme dados divulgados pelos governos estaduais.', 'Apesar de ser essencial para os brasileiros, a saúde pública não recebe os investimentos necessários. Em 2019, segundo o Conselho Nacional de Saúde, 20 bilhões de reais foram retirados desta área, sendo que o correto seria a ampliação dos gastos . Este problema ocasiona o agravamento outros já existentes, tais como nos quesitos de infraestrutura precária e atendimento inadequado, os quais não são concernentes com um bom serviço hospitalar, conforme é assegurado na Constituição.', 'Para solucionar os problemas que abrangem o SUS, é preciso que os indivíduos exijam mais investimentos do Governo Federal nesta área . Isso seria possível por meio de manifestações pacíficas, as quais ocorreriam até que o objetivo fosse atingido . Assim, a população brasileira usufruiria de um bom atendimento e de uma infraestrutura hospitalar melhor. Dessa forma, o Estado cumpriria o dever de garantir o direito da população de ter acesso a serviços de qualidade.']",160,120,120,160,120,680
71,,"['13 reasons why é uma série norte-americana que aborda problemas sociais por que passam os jovens e ganhou bastante notoriedade desse público. A partir de então, a questão de doenças como depressão ganhou maior visibilidade, principalmente depois que fenômenos extremos decorrentes dessa moléstia passou a se tornar frequente, como o suicídio. Nesse contexto, pode-se afirmar que numa época cada vez mais digital, o uso das redes sociais se torna mais corriqueiro e, consequentemente, põe em pauta o fenômeno da crise existencial.', 'Em primeira instância, cabe pontuar que em plena era digital, as pessoas costumam compartilhar seu dia a dia nos aplicativos sociais, muitas vezes com recorte diferente da realidade. Isso é evidente num dos maiores sites utilizados para tal, o Instagram, em que pessoas normalmente postam fotos no intuito de transparecer sua felicidade que é pautada, em geral, por viagens e popularidade. A partir disso, cria-se uma noção distorcida sobre o conceito de “felicidade” e aquele que compara sua vida real com o que se vê nessas redes percebe as diferenças e, com isso, gera um sentimento de tristeza por não viver essa outra realidade. Tal situação é um dos fatores que corrobora a depressão e, se não tratado, o suicídio, já que traz um sentimento no indivíduo de se sentir diferente diante do que é exposto como padrão de felicidade.', 'Ademais, vale ressaltar que esse recorte da realidade manifestado nas redes sociais traz consequências a sociedade, uma delas é a crise existencial. O grupo que mais sente esse fenômeno é o que sofre de transtorno de ansiedade, que corresponde a 33% da população mundial segundo a OMS- Organização Mundial da Saúde-, potencializado pelo estresse, fobias e pressão social. Uma vez diante dessa realidade, esse grupo sente-se mais pressionado e exigente consigo mesmo, tornando-se depressivos e aptos a tomar atitudes extremas como o suicídio.', 'Destarte, o físico Isaac Newton já dizia que um corpo tende a permanecer inerte até que uma força atue sobre ele. Sob essa ótica, faz-se necessário medidas enérgicas para tirar esse cenário da inércia. É imprescindível, portanto, que instituições da educação promova projetos de atividade educativos que permitam que os jovens fiquem menos tempo conectados nas redes sociais e sobre mais tempo para lazer. Além disso, profissionais da saúde- médicos e psicólogos- devem atuar de forma mais dinâmica, fomentando palestras em escolas acerca do problema da depressão, esclarecendo suas consequências para que os jovens estejam mais cientes de como evitar. Feito isso, o problema do suicídio poderá, ao longo do tempo, ficar restrito às ficções de séries e deixar de ser uma realidade.']",120,160,120,160,120,680
49,O papel dos influenciadores digitais,"['A internet, desde que surgiu no fim do século XX, ganhou grande força e é um dos maiores meios de comunicação que se pode ter atualmente. Contudo influenciadores digitais se tornaram fortemente recursos de venda e poder, e podem de certa forma influenciar algo bom ou ruim.', 'A priori devemos notar, que alguns influenciadores fizeram com que muitas pessoas saíssem da quarentena, o que atualmente é contra a lei, para a prevenção da Covid-19, se tornando um escândalo . Além disso, esses influenciadores que recebem para representar produtos e marcas, perderam contratos, o que não é o errado, mas poderia ser evitado, pois fazem com que o consumidor se interesse pelo que representam.', 'Eventualmente, não existem leis específicas que cuidem da influência digital, e muito menos indivíduos conscientes, tendo autonomia de seus atos. A própria mídia não a promove eficientemente . O que revela indivíduos fazendo o que influenciadores vendem, na forma digital.', 'Portanto medidas são necessárias para se resolver o impasse, o Governo Federal , junto com o Ministério das Comunicação, deve acompanhar esses influenciadores, criando leis,  para que posteriormente seja anunciada à mídia, para evitar novamente casos como ocorreram atualmente . Órgãos privados, representados por marcas que ganham com a influência, podem criar cursos, para o cuidado com a imagem, dessa forma como disse, Immanuel Kant “O homem é aquilo que a educação faz dele”, tudo se aprende, sendo assim, muitos desastres podem ser evitados, com o cuidado desses influenciadores.']",160,160,120,160,120,720
27,A limitada capacidade da maioria dos brasileiros,"['A limitada capacidade da maioria dos brasileiros na construção de seus argumentos ficou mais evidente com o avanço da crise política que se instaurou em nosso país nos últimos anos. Os debates tornaram-se polarizados e maniqueístas; ambos os lados acreditam que as suas ideologias e opiniões são verdades absolutas, que o seu lado é o lado do bem, da honestidade, e o único caminho para se alcançar o progresso. Já o lado oposto nada tem a acrescentar afinal é o lado da corrupção, da mentira, dos vilões que desejam tirar os direitos e tomar o país para si. Acusações feitas a partir de falas mal interpretadas e falta de averiguação de notícias que circulam em redes sociais fazem parte deste cenário onde não há espaço para discussões limpas e construtivas.', 'Para alcançar o domínio no desenvolvimento de nossos argumentos , é necessário acima de tudo o respeito pelos argumentos e opiniões contrárias. Devemos reconhecer os pontos fracos das ideias que defendemos e exaltar o que há de melhor no ponto de vista dos outros.', 'É de fundamental importância que nossos argumentos sejam apoiados por dados e informações verdadeiras, de fontes confiáveis; não podemos ter como base boatos e difamações espalhadas na internet.', 'Estimular a leitura crítica e organizar debates sobre diferentes temas em colégios e universidades são grandes ferramentas para o aprendizado da argumentação pelos estudantes.', 'O respeito às opiniões alheias, a aceitação das falhas em nossas convicções e a busca das soluções para os problemas comuns a todos devem reger o andamento de um debate.']",200,160,160,200,120,840
150,A Violência no Âmbito Escolar,"['Sabe se que a         Violência         no meio escolar é um tema muito         polêmico  , e         que está sendo debatido com mais transparência nos dias de hoje, principalmente nas redes de ensino público, onde a maioria dos alunos vive em comunidades violentas e desestruturadas, sem o auxílio governamental         necessário, destacam se         na atualidade o bullying, cometido frequentemente nas escolas e o cyberbullying, presente nas redes sociais e em blogs.', 'É notório que a prática da violência nas escolas brasileiras         têm         aumentado         desordenadamente  , muitos         alunos são julgados por serem diferentes ou por não aceitarem um                 estilo                proposto pelos demais colegas. Adolescentes são submetidos         as         mais diversas situações humilhantes, chegando a até sofrerem com problemas relacionados à depressão e, em alguns casos, ao suicídio, como é o caso de Roliver, um estudante de Vitória no         Espirito         Santo que não resistiu a pressão ao ser alvo de chacotas todos os dias.', 'Nos Estados Unidos, a prática do bullying se tornou comum entre os estudantes do ensino médio, casos como o de Roliver não são         raros, ocorrências         mais extremas estão sendo registradas com mais frequência, como a de jovens                 que almejam outros                e cometem suicídio. Outra prática que está sendo disseminada com mais rapidez é o cyberbullying , que consiste nos mesmo princípios do bullying         convencional         só que na realidade é cometido nas redes         sociais         onde o estrago emocional é mais violento. Quando         esta         prática é cometida, torna se quase impossível         de parar         , pois é lançada em um ambiente         onde         muitas pessoas poderão visualizar e compartilhar o acontecimento.', 'Portanto, o                 acompanhamento          dessa prática          deve ser acompanhado                com mais rigor, programas de auxílio e alerta devem ser criados para informar as pessoas         dessa terrível prática         , reuniões com os pais e familiares devem ser instigadas, para que eles saibam como lidar com         essa situação          . Diga não ao bullying, a tristeza de          um          pode ser evitada com uma simples ação.']",160,120,120,160,160,720
47,Eda,"['Educação a istância  é uma modalidade de estudo onde se faz necessário meio tecnológico, pois professores e alunos estão separados fisicamente. Diversas universidades pelo Brasil já oferecem esse tipo de estudo que é regulamentada por lei.', 'Diante da atual situação que o mundo está passando  com o novo coronavírus e a necessidade de isolamento essa modalidade está sendo bastante utilizada, no Brasil diante desse cenário, as dificuldades surgiram, desde a falta de recursos utilizados pelos professores quanto aos alunos que nem todos tem acesso internet.', 'A educação foi uma das áreas mais impactadas com a pandemia, onde  os mais carentes mais uma vez foram os mais afetados, alunos com baixa renda não estão conseguindo acompanhar as aulas e escolas públicas muitas não oferecem o estudo a distância por falta de recursos.', 'Com a pandemia a desigualdade foi ainda mais acentuada entre os alunos de escola pública e particular, onde será evidente os impactos no aprendizado e no ingresso a uma vaga no vestibular.']",120,120,120,120,40,520
114,A violência nas escolas,"['Uma situação que vem se         agravando, e         se multiplicando, cada vez mais, é a violência         ocorrente         nas escolas.         Isso         de fato, não pode ser dispensado ou deixado de         lado, devemos         fazer algo para mudar essa situação.', 'Membros do núcleo gestor das         escolas, tentam         fazer o possível para diminuir         o ocorrido         e acabam não obtendo         exito         nas sua         tentativas, isso         significa que não estão achando as soluções         certas, para         resolver esse problema.', 'Nos últimos anos,         nós é mostrado         muitas ocorrências envolvendo esse tema, muitos jovens sofrem agressões, tanto física como verbal. Pode servir como         exemplo, um         caso ocorrido no Rio de Janeiro, em que um ex-aluno, no dia 7 de abril de 2011, entrou numa         escola, e         praticou um         massacre         matando vários alunos de lá.', 'Fora isso, também, o enorme número de brigas          ocorrentes          nas escolas, que são gravadas por outro          alunos, e          postas nas redes sociais, como uma forma de expor algo          divertido, e          legal aos outros.', 'Algo que deve ser         ressaltado, é a, importância         da presença dos pais no processo         de mudanças nesses casos, sem         a cooperação dos pais, não é possível mudar essa realidade.                 Devemos         nós         aprofundar e estabelecer um compromisso                 de ambos os lados                , para a melhor comunicação com os alunos         e         assim, saber o que         esta         acontecendo em sua vida, os problemas, as dúvidas, achando assim uma forma de ajudar esse aluno.', 'Para que assim,         alunos, pais e membros da direção         possam         entrar num acordo entre si, levando aos alunos, não                precisarem praticar                 algo para se aliviar, e se sentir melhor, como a violência com os demais.']",120,120,80,80,80,480
76,Combatendo a desigualdade com exemplos,"['A ideia de igualdade de direitos dos gêneros surgiu séculos atrás e mesmo após tanto tempo é possível verificar discrepâncias em diversos setores da sociedade, d economia à política. A divisão de atividades, tendo o homem como centro da família e a mulher como cuidadora do lar, não demonstra mais a realidade. O avanço foi gradual e constante, porém ainda insuficiente.', 'A sociedade como um todo não sabia lidar com tal avanço e por isso as mulheres começaram a ser aceitas em profissões consideradas maternas ou mesmo detalhistas e delicadas como professora, pintora, enfermeira e secretária. Mesmo mostrando-se competente nessas áreas, a aceitação em cargos de comando, por exemplo, não era boa . E ainda, quando aceita, o reconhecimento não existia, independente do esforço.', 'Empresas que buscam o melhor profissional, independente do gênero, com igualdade salarial, bônus por metas e uma carreira a ser trilhada, tornam-se mais atrativas e acabam por incentivar outros estabelecimentos a seguir o mesmo caminho para não perder bons empregados . Isto mostra como o exemplo de uma empresa afeta positivamente o mercado ao seu redor.', 'Os resquícios da sociedade patriarcal impedem a equidade salarial, por exemplo, pois muitos homens sentem-se intimidados com algo que deveria ser natural. Isso mostra o quanto o governo é importante para fortalecer a igualdade de gênero, estabelecendo normas e leis que possam coibir empresas que oferecem oportunidades iguais com vencimentos diferentes aos gêneros ou impedem o crescimento profissional de qualquer funcionário.']",160,120,120,120,120,640
59,A fome no contexto social brasileiro,"['""É preferível morrer pelo fogo, em combate, a morrer em casa, pela fome"", disse Fidel Castro, revolucionário que liderou a Revolução Cubana, movimento anticapitalista ocorrido em Cuba, que passava por uma crise na qual um dos seus grandes efeitos foi a atenuação da desigualdade social e da consequente falta de alimentos para a alimentação dos indivíduos das classes sociais mais baixas, as quais foram uns dos motivos para a revolução em questão.', 'A desigualdade social e carência das classes baixas faz parte do contexto social não só de Cuba, mas de toda a América Latina desde a chegada e ocupação dos colonizadores em sua terra. No Brasil é característico a fome como grande mazela social e a inércia do Estado em relação ao combate a fome, que é notável desde o fracasso do Fome Zero, programa federal criado em 2003 para o enfrentamento da fome e miséria no país.', 'Outrossim, 2,5% dos brasileiros ou 5,2 milhões pessoas passaram fome no ano de 2017 . O país corre risco de ser reinserido no Mapa da Fome da ONU , do qual saiu em 2014.', 'Portanto, a fome traz à tona a desigualdade na qual a sociedade brasileira está inserida, o que torna urgente, por parte do Governo Federal, a implementação e aprimoramento de políticas públicas que combatem  fome e a organização de campanhas que visam a conscientização da sociedade em relação a esse problema, para garantir que seja cumprido o que está escrito no artigo 6° da Constituição Federal: o direito que o cidadão tem à alimentação.']",160,120,80,120,80,560
33,Educação,"['Absurdamente nossos governantes vem cometendo mais erros na área educacional, os quais poderão levar mais ao fundo do poço os índices de evasão escolar de nossos estudantes. Para melhorar esses índices são necessárias muitas outras ações a nível social e educacional que acrescentem e não retirem nada do que já conquistamos.', 'Neste tempo em que os estudantes ficam a maior parte de seu tempo conectados aos meios tecnológicos e sendo assim não praticam exercícios físicos, é imprescindível ofertar a eles a prática esportiva e a oportunidade para desenvolver habilidades artísticas.', 'Outros dois equívocos são: acreditar que temos estrutura física disponível para trabalhar em tempo integral em todos os estabelecimentos educacionais do país e não observar que nossa clientela vem de famílias carentes, que vislumbram a entrada no Ensino Médio e a possibilidade de trabalhar meio período para colaborar com a renda familiar.', 'Enquanto os que tem o poder de melhorar os aspectos educacionais estiverem se pronunciando com “notório saber”, sem conhecer nossas realidades e reais necessidades, estaremos, infelizmente, a um passo de piorar ainda mais a educação de nosso país.']",80,0,0,0,0,80
48,Saúde Brasil,"['No quadro ""Criança Morta"" do artista plástico Cândito Portinaria, retrata uma família de baixa renda sem condições de tratamento hospitalar para o filho, onde a criança vem a falecer nos braços do pai e visto por também por parentes a sua volta. Nessa conjuntura, o Brasil tem um sistema de hospitais públicos comprometido a décadas e que não apresenta atendimento adequado a sua nação, o que eleva as morte da população, refletida na obra de Cândito. Nesse sentido, o agravamento na rede de saúde pela mortalidade no país tem relação direta com a corrupção e tambem a falta de higiene na sociedade o que acaba por aumentar a problemática.', 'Em primeiro lugar, as verbas direcionada saúde do cidadão deve ter destino correto e não ser capitalizado com interesses pessoais . Segundo o pensamento marxista usar da da autoridade para sobrepor-se ao direito do outro, causa um desequilíbrio social . Com esse raciocinio , os desvios finaceiros ocorrido por gestões públicas de saúde aumenta a ineficiência do Sistema Unico de Saúde (SUS) nos cuidados básicos da nação, o que reforça a ideia marxista. Então é importante criar medidas governamentais rigorosas para combater tal pratica de corrupção na rede hospitalar brasileira.', 'Em segundo lugar, a ausência de cuidados simples com a higiene pessoal aumenta as dificuldadde do SUS. A população não tem uma orientação educacional positiva nessa questão  isso influncia na doença por verme, como exemplo .Conforme Immanuel Kant, a educação transforma o ser humano, dessa maneira, uma população com uma conciência educacional na higiene individual contribui na proteção contra infeções e diminui o risco apresentado na pintura ""Criança Morta"". Desse modo, a contribuição da comunidade ao cuidar da higiene pessoal e do próximo ao levar informação salva vidas.', 'Portanto, o Ministério da Saúde e o Sistema nico de Saúde, por meio das mídias socias, televisão aberta e rádio à exemplo, desenvolva boletim constante sobre orientação para cuidar da saúde por intermedio da higienização do corpo, apontar os problemas causados pela negligência nessa situação isso tudo sendo orientado pelo SUS .Desse modo, a nação brasileira conseguir melhorar as epectativas de vida.']",120,160,120,160,120,680
110,Vitima  e não criminosa,"['""Volência""          ato de agredir          fisicamente ou psicologicamente          um          indivìduo          . Em casos de estupros qual o papel dos envolvidos?', 'Muito vem se comentando sobre a pesquisa do IPEA         (INSTITUTO DE PESQUISAS ECONÔMICAS APLICADAS),         e a visão das pessoas sobre a violência sofrida pelas mulheres.', 'Infelizmente o estupro          è          uma realidade na vida de muitas mulheres em nosso          paìs          . Que          alèm          de terem sofrido um          abuso          são sujeitadas às          humilhaçoes          ao irem dar queixa do crime ocorrido. Chegando ao          cùmulo          de serem olhadas como culpadas por serem bonitas ou estarem com roupas ""curtas"".', 'Devido a         isto         muitas mulheres         atè         evitam dar         queixas         por vergonha e receio de serem taxadas como culpadas. Como se         ela mulher         fosse a criminosa e não o canalha que a         estuprou.', 'Em fim         por tudo isso         jà dito è         preciso uma                 humanização          pùblica         para que a         mulher         quando         abusada         possa se sentir segura em denunciar         e que tambèm         tenha um apoio         psicològico         para que tal violência deixe o         mìnimo         de sequelas         possìveis         .']",80,80,80,80,80,400
46,04 - FBS,"['Segundo a Constituição Federal de 1988, no seu artigo 196, é dever do Estado garantir o acesso à saúde, bem como é responsável pelas medidas públicas para zelar pelo bem-estar físico de todos os cidadãos brasileiros. Assim, faz-se necessário que o Poder Público atente-se para a privatização do saneamento básico enquanto situação que põe em risco a saúde de milhares de cidadãos do país. Esse cenário antagônico é fruto tanto da desigualdade social, quanto do racionamento de água. Diante disso, torna-se necessário a discussão desses aspectos, a fim do pleno funcionamento da sociedade.', 'Mormente, é fulcral pontuar que a privatização do saneamento básico deriva da baixa atuação dos setores governamentais no que concerne a criação de mecanismos que coíbam tais recorrências. Segundo o pensador Thomas Hobbes, o Estado é responder por garantir o bem está da população, entretanto, isso não ocorre no Brasil. Devido à falta de atuação das autoridades governamentais, a desigualdade social vai excluir muitas famílias de usufruírem do saneamento básico que, por sua vez, pode ser tornar muito caro. Desse modo, faz-se mister a reformulação dessa postura estatal de forma urgente.', 'Ademais, é imperativo ressaltar que a privatização do saneamento básico pode ocasionar, assim como aconteceu na cidade de Itu, município de São Paulo, o racionamento da água afetando diretamente as vidas dos habitantes que ali vivem. No livro “Vidas Secas” de Graciliano Ramos o  protagonista Fabiano, desprovido do acesso ao conhecimento, acabava sendo explorado e humilhado por aqueles que detinham o poder. Nesse viés, sendo o saneamento básico de extrema importância a vida humana, hoje são milhares de fabianos no Brasil. Dessa forma, a restrição do saneamento básico por meio da privatização é imperativo alertar aos brasileiros sobre sua importância para que assim esteja cada vez mais inserido na sociedade brasileira.', 'Portanto, pode-se inferir que o debate sobre a privatização do saneamento no Brasil é imprescindível para a construção de uma sociedade mais igualitária. Nessa lógica, é imperativo que o Governo Federal busque alternativas para criação de projetos, através das verbas públicas, para a melhoria do saneamento básico, com efeito de que a sociedade brasileira não enfrente tanto a escassez, quanto o racionamento. Assim, a construção da cidadania será facilitada e os fabianos se tornarão, de fato, cidadãos plenos.']",160,160,120,160,120,720
83,Além do óbvio - O esporte como formador social,"['Que a prática esportiva traz uma série de benefícios para a saúde física e psicológica do ser humano, todos já sabem. O que muitos esquecem é que além de desenvolver hábitos saudáveis, prevenir doenças e estimular hormônios que proporcionam sensação de prazer, a prática esportiva contribui para a formação dos valores de um indivíduo.', 'Por meio do esporte, podem-se desenvolver princípios como o espírito esportivo, companheirismo e disciplina, por meio das vitórias e derrotas pelas quais os atletas passam.  Bem como, a inclusão social, principalmente relacionada à igualdade de gênero e à diversidade cultural étnico-racial. Visto que a socialização proveniente dessa prática permite o contato entre os mais variados povos, sujeitos às mesmas atividades, o que revela a capacidade igualitária que os permeia.  De modo a garantir ao esporte a difusão da cultura da paz e do respeito ao próximo.', 'Ainda que digam que as competições podem ser disseminadoras de danos à índole dos participantes, devido ao desejo de ganhar a qualquer custo, deve-se salientar que não é uma regra que cabe a todos os envolvidos. Muito além disso, a prática esportiva é responsável por permitir a mudança de vida de uma série de pessoas, principalmente oriundas de comunidades carentes. Hoje o esporte é um caminho alternativo para aqueles que estão sujeitos a vida da criminalidade.', 'Enfim, a prática esportiva não se limita ao superficial, ela atua como um caminho alternativo em meio ao que vivemos. Contudo, é preciso desenvolver novos meios para colocá-la em prática, com o intuito de acabar com a difusão de aptidões negativas. Como um festival de esportes em que o foco não seja a competição, mas sim o trabalho em equipe, a luta por uma causa humanitária de alcance global que culmine em benefícios reais para a comunidade humana.']",160,200,160,160,200,880
82,Consequências ocultas da automedicação,"['A automedicação ameaça a qualidade de vida dos brasileiros, isso se deve ao fato de que grande parte da população não tem conhecimento sobre os fármacos que utiliza, assim doenças graves podem ser ocultadas e causar problemas mais graves no futuro.', 'A atual facilidade em adquirir remédios tem provocado um consumo desenfreado destes  produtos, porque já está subentendido pela população que se um remédio é liberado pela Agência Nacional de Vigilância Sanitária pode ser usado sem lhe causar problemas. Contudo, sem a orientação de um profissional  o remédio poderá ser uma solução momentânea para os sintomas,  então  por combater as causas  o mau uso de medicamentos pode esconder a real gravidade de certa doença, dificultando o tratamento correto.', 'As propagandas da mídia, infelizmente, estimulam bastante a automedicação, principalmente as que utilizam ícones populares, como o apresentador Luciano Huck  que foi utilizado em um recente comercial de um suplemento vitamínico,  a fim de influenciar aqueles que confiam em sua imagem e que, lamentavelmente, não são informados de que algumas vitaminas em excesso prejudicam o equilíbrio do organismo e, consequentemente, a boa saúde.', 'Conclui-se que  por falta de instruções à população  a automedicação de ser combatida,  para isso  deveria haver uma maior restrição às propagandas da indústria farmacêutica e as instituições públicas poderiam fazer campanhas apresentando os riscos dessa prática a qualidade de vida dos indivíduos.']",120,120,120,120,120,600
34,Geração da auto estima inflamda ,"['A partir do fim do século XX, o otimismo e a auto estima vem crescendo na população mundial. Jovens com sentimento de extrema segurança e afirmação das próprias capacidades adensado pelos pais, vindo de um geração totalmente diferente. Essa auto afirmação mudou profundamente o caráter e personalidade dos jovens, levando os a se excluir de certos meios sociais por causa da sensação de superioridade dada pelos pais.', 'Mais se engana quem pensa que isso afeta apenas os meios sociais, essa vertente atinge principalmente a área comercial e profissional. Se por um lado é positivo, pelo fato de questionarem os métodos da empresa em que estão e levando os a criarem seu próprio negócio. Por outro é contraproducente já que essa atitude os leva à um caminho individual, sem a troca e melhorias de idéias.', 'A origem desse padrão vem sido construído desde o século XIX. Quando ocorreu uma corrida; não somente bélica, mas também de auto afirmação nacional das capacidades cientistas , filosóficas e físicas. Mas que se diluiu com períodos de guerras ostensivas. Chegando à um tempo de calmaria mundial, a população se ver cercada de tecnologia, que avançava sem parar. Novamente começa um período de evolução tecnológica e afirmação, dessa vez individual. Onde gênios desse meio são exemplos para uma nova geração que cresce pensando ter muita capacidade e talento.', 'É preciso analisar mais à fundo tais ídolos, mostrar sua trajetória, que apesar de produzir resultados incríveis, é totalmente real. Resultante de pesquisas e cooperação entre outros indivíduos. Puxar aquilo que inflama o ego dessa geração de volta à terra, execrando o simples sem excluir o extraordinário.']",80,80,80,0,80,320
94,Altimos,"['A Constituição federal de 1988, documento jurídico mais importante do país prevê,em seu artigo 6º, o direito à saúde como inerente todo cidadão brasileiro. Conquanto tal perrogativa, não tem se reverberado com ênfase na prática quando se observa a exclusão de pessoas com doenças neurológicas na sociedade e carência de profissionais da educação para auxiliar os necessitados, dificultando ,dese modo, a universalização deste direito social tão importante. Nessa perspectiva ,é necessário que medidas sejam tomadas de imediato para que uma sociedade integrada sejam alcançada.', 'Desa forma, a exclusão de pessoas com doenças neurológicas da sociedade, faz com que se sintam inseguras para realizar atividades do dia a dia. No seriado he good doctor o personagem Shaun e um médico autista , mais com mais com diversas qualidades, porém um de seus pacientes recusa ser atendido por um profissional com problemas mentais, então ele se fecha e tem grandes dificuldades para voltar a praticar a medicina .De maneira análoga isso, fora da ficção presenciamos variados casos parecidos.', 'Em segunda análise, destaca-se a carência de profissionais da educação como impulsionador do problema. De acordo com Paulo Freitas ""Se a edução sozinha não transforma a sociedade, to pouco a sociedade muda .Diante de tal exposto, observa-se que é crucial a ajuda de professores para que as crianças com psicose possam ter desenvolvimento melhor quando adultos.', 'Diante dos fatos mencionados é necessário que o governo disponibilize verbas, para contratar professores e financiar palestras para sociedade ,por meio de divulgações nas redes sociais ,televisões e rádios ,a fim de proporcionar conforto aos autistas . Tal ação pode ainda fazer com que o compartilhamento dessas informações faça a notícia chegar a mais pessoas, eito isso cidade poderá caminhar para a completude.']",160,120,120,160,160,720
55,Preservação da cultura indígena,"['O termo indígena concerne ao indivíduo que habitava no país anteriormente a um processo colonizador, o qual, quando associado ao Brasil, representa um episódio de exploração, além de desrespeito a sua cultura . Diante disso, é preciso entender a importância de valorizar e garantir os direitos dos povos nativos. Nesse sentido, convém ressaltarmos as causas e consequências dessa problemática.', 'É fundamental,  pontuar que os índios ainda sofrem discriminação, pois há quem julgue suas pluralidades de culturas como inferior e a invisibilidade social é o âmago da questão . De acordo com o portal de notícias do G1, o principal problema é demarcação das terras onde ocorre conflitos com a bancada ruralista que tetam suprimir os direitos garantido na Constituição Federal. Em virtude dos fatos mencionados, é lamentável o descaso a esse fenômeno, ao considerar que os indígenas fazem a preservação do meio ambiente e os empresários do agronegócio visam somente a exploração e o lucro.', 'Em consequência disso,  há uma vulnerabilidade social e uma perca ambiental e humana, pois, resultam-se pequenos genocídios geográficos e culturais. Consoante o sócio-fundados do Instituto Socioambiental (ISA), Marcos Santili, historicamente já deu pra aprender que os indígenas não irão desaparecer e já lutam há mais de 500 anos contra as maldades feitas. Sendo assim, é necessário analisarmos  s possíveis soluções para mitigar esse desafio.', 'Portando, o Governo Federal deve ter rigor as leis de preservação as terras indígenas, por meio de investimentos na FUNAI e outros órgãos que visam a proteção desses povos; além de promover palestras educacionais para difundir a importância e a luta de sobrevivência dos nativos. Espera-se, com isso, uma integração social com respeito e a diminuição de uma dívida histórica.']",120,120,120,120,120,600
70,,"['É imprescindível, os impasses que nossa sociedade enfrenta com relação aos numerosos jovens infectados pelas DSTs , entre elas; sífilis, gonorreia, HIV, HPV, os dados são assombrosos nos mostrando a necessidade de combater esses males. Contudo  a melhor arma de combate é a prevenção.', 'Embora grande parte dos casos de infecção pelas DSTs,  ocorra através do contato sexual, é importante salientar que existem diversos outros meios contaminação, como por exemplo, em transfusões de sangue, no compartilhamento de lâminas, piças , alicates de unha, da mãe para o bebê, durante toda a gestação e, ou durante o parto como é o caso do HIV, entre outros . Segundo a OMS (Organização Mundial da Saúde), a cada ano, mais de 5 mil pessoas contra algum tipo de doenças sexualmente transmissíveis. Por esses e outros motivos é que se deve trabalhar melhor com as informações transmitidas, especialmente aquelas direcionadas ao público jovem.', 'Além disso, é de conhecimento geral o descaso nos setores educacional e hospitalares que a sociedade brasileira sofre, o que acarreta maiores prejuízos aos meios comunicativos, posteriormente às próprias informações deturbadas e consequentemente a quem recebe esses informes, sem grande preocupação em assimilar tudo que lhe foi passado.', 'Destarte, torna-se evidente a necessidade de conscientização através de programas e campanhas, que devem ser realizadas pelo Governo juntamente com o Ministério da Educação e a OMS, dando ênfase quanto ao uso do preservativo, falar sobre os ricos com relação ao uso de drogas injetáveis. Ressaltando o valor da consciência coletiva e individual, pois dessa forma, os órgãos nacionais não terão que lhe dar com uma bola de neve já formada, apenas contornar sua evolução e disseminação.']",120,120,120,120,120,600
