prompt,title,essay,c1,c2,c3,c4,c5,score
58,O planeta precisa de você,"['A Amazônia é um bioma importantíssimo para o Brasil e para outros países.', 'Os motivos para o desmatamento da Amazônia são diversos, os mais importantes fatores que tm provocado à derrubada florestal são: o desmate para a pecuária intensiva, avança da agricultar de grãos e desmate para a especulação fundiária. Esses desmatamentos vem acompanhados de queimadas, pois é uma forma na preparação do solo para fazer s plantações de agricultara extensivas. Existem também incêndios naturais devido elevação das temperaturas.', 'A falta de incentivos ao controle do desmatamento acaba prejudicando os animais, plantas, pessoas, ou seja, o planeta como um todo. O que acarreta na extinção de alguns animais e plantas.', 'A população deve cobrar dos governantes a fiscalização ambiental mais severa para a diminuição de tantos desastres como o bioma tão importante.', 'Faz-se necessário que as empresas privadas, ONGs e a sociedade se una para a preservação desse bioma, criando métodos para usar o solo sem agredi-lo evitando o desmate e a contaminação do solo, e plantando mais árvores.']",120,80,80,120,40,440
50,Belicismo científico,"['No famoso Anime ""Naruto"", o personagem antagonista Orochimaru, a partir de seus numerosos experimentos científicos, consegue desenvolver uma técnica que lhe permite tornar-se imortal, e que, posteriormente, lhe ajuda a restaurar seus braços, antes necrosados . De maneira análoga à animação japonesa, destaca-se a importância da ciência como algo imprescindível na manutenção da vida humana , sendo oportuno analisar as intempéries que se opoem ao seu desenvolvimento pleno , no âmbito social brasileiro.', 'De acordo com o escritor britânico, Oscar Wilde,  ""a insatisfação é o primeiro passo para o progresso de um homem ou de uma nação"". Evidenciando o supracitado, salienta-se o desempenho fundamental dos profissionais da área da saúde no século XX, que criaram uma forma de combater a pandemia de gripe espanhola coletando  o plasma contendo anticorpos de indivíduos que haviam adquirido imunidade contra a doença, e injetando-o no organismo de pacientes que haviam contraído o vírus . Entretanto, nos últimos anos, cientistas e pesquisadores têm enfrentado dificuldades devido à falta de investimento em pesquisa , que impede que sejam feitos avanços significativos no aprimoramento de tratamentos e na descorberta da cura de doenças como o câncer.', 'Adicionalmente, há fatores que obstaculizam a resolução do impasse. Os recentes contingenciamentos de verbas destinadas à pesquisa científica , realizados pelo Governo Federal, têm contribuído para que pesquisadores trabalhem de forma limitada e, muitas vezes, improdutiva . Ademais, tais reduções de recursos mostram-se ainda mais graves em face do atual cenário de pandemia vivido pela comunidade internacional, inclusive pelo Brasil, que requer ações complementares às medidas preventivas já tomadas, de incentivo à higiene pessoal e isolamento social.', 'É urgente, portanto, o emprego de medidas que atenuem o problema. Cabe ao Executivo destinar valores excedentes de outros setores da sociedade ao campo científico , priorizando-o acima de outros campos menos essenciais , possibilando a produção de uma vacina contra o novo coronavírus em caráter emergencial . Complementarmente, as autoridades de saúde locais, mediante a imprensa, devem continuar mantendo a sociedade informada sobre a forma correta de higienizar as mãos, bem como outras ações de proteção . Dessa forma, fazer-se-á com que se atravesse tal epidemia global com uma menor taxa de mortalidade, e que o Brasil se torne referência em produção científica, pois, consoante ao pensamento do roteirista Charles Chaplin,  ""a persistência é o caminho do êxito.""']",160,160,160,160,120,760
82,,"['O hábito do automedicação está presente na vida de vários Brasileiros ,geralmente,em detrimento da falta de informação,porém,em outros casos,mesmo um indivíduo informado opta por se automedicar movido por uma cultura que está enraizada na sociedade. Diante disso,é necessário medidas para atenuar tal flagelo.', 'Segundo o Instituto de Ciência,  Tecnologia e Qualidade(ICTQ),76,4% da população ingere medicamentos sem prescrição médica e ? dentro desse percentual ? 61,4% das pessoas conhecem os riscos deste  hábito. Tal fato corrobora que à  automedicação faz parte da cultura da sociedade e deve ser tratada como um problema de saúde pública,uma vez que,ela  é responsável por várias internações nos hospitais do Pais .', 'Além de ameaçar a saúde pública,este  costume é também um problema para a econômia  nacional,tendo em vista que,a  maioria dos medicamentos só podem ser comercializados sob prescrição médica,porém,esses produtos podem ser facilmente encontrados no mercado clandestino. Contudo,com alto índice de vendas no mercado negro,os tributos dessas mercadorias não chegam aos cofres públicos.', 'Logo,é necessário campanhas para desenraizar a automedicação da cultura da sociedade por meio de propagandas conscientizadoras nas instituições midiáticas;realizar projetos educacionais contra a automedicação nas escolas de educação de base com a participação efetiva de todos os alunos. Juntamente a isso,é necessário também a intensificação das fiscalizações no mercado ilegal de medicamentos,para dificultar que pessoas desinformadas consumam remédios sem avaliação médica.']",120,160,160,120,160,720
58,Consumismo e Meio Ambiente,"['Muitas são as mudanças percebidas a partir da Revolução Industrial nos séculos XVIII e XIX. Com o avanço tecnológico o consumismo foi aumentando e causou grandes impactos ambientais, tais como: a exploração de recursos naturais como também uma maior produção de lixo . Tendo como autor dessa problemática, a sociedade. Logo é evidente a necessidade de reverter essa situação.', 'Primordialmente, é válido destacar que a exploração de recursos naturais tem crescido significativamente, e a grande protagonista são as indústrias. Sendo ela responsável por produzir resíduos prejudiciais ao meio ambiente. Contaminado assim os rios, o ar, as florestas e também os seres que habitam no ecossistema terrestre. Logo é evidente como essa situação deve ser mudada.', 'Além disso, é importante destacar que,  a produção em massa de lixo estar intrinsecamente ligadao consumismo humano. De acordo o (Pnuma) estima-se que a produção de lixo no mundo deve ter um aumento de 1,3 bilhões de toneladas para 2,2 bilhões de toneladas até o ano de 2025. E esses problemas são efeitos de hábitos não cociente. Assim, esse é outro fator preocupante sobre essa situação.', 'Mediante ao exposto, medidas devem ser tomadas para combater o problema. Para isso o Ministério do Meio Ambiente de conscientizar a população sobre a prevenção ambiental, realizando projetos e palestras nas comunidades e nas escolas. Mostrar para indivduo a real situação do problema exposto, divulgar a importância de ter um consumo consciente. Só assim começaremos a reverter o índice de poluição no Brasil.']",160,80,40,120,40,440
95,Debate sobre o marco temporal,"['De acordo com artigo 231 da Constituição federal. ão reconhecidos aos índios sua organização social, costumes, línguas, tradições e os direitos originários sobre as terras que tradicionalmente ocupam, competindo União demarcá-las, proteger e fazer respeitar todos os seu bens.. Diante disso, na realidade brasileira os conflitos por demarcação de terras é um serio problema para o pas. Dentre tantos fatores temos: indígenas com risco de perder suas terras e reações d população a respeito de seus direitos s terras.', 'Em primeiro plano, sabe-se que os conflitos de terras são algumas das causas da disseminação desse comportamento. Diante disso, o marco temporal, uma ação que defende que povos indígenas só podem ter posse de terras que estavam sob o uso dessa população em 5 de outubro de 1988. O Supremo Tribunal Federal (STF) teve que resolver conflitos entre indígenas e produtores que disputavam a erra indígena Raposa Serra do Sol, na época foi favorável aos povos originários.', 'Ademais, a população indígena sem direitos para de crescer no pas. Mais de mil indígenas e apoiadores com medo dos impactos da disputa organizam uma manifestação em Brasília favor de seus direitos. Essa foi uma das maiores manifestações feita por esses povos.', 'Portanto, para efetivar o a conscientização sobre o marco temporal é necessário que o governo - Órgão responsável pelos Três Poderes promova campanhas que explorem mais debates sobre o marco temporal em parceria com a mídia por meio de verbas governamentais e ajuda a esses povos, a fim de promover uma sociedades mais tolerante. Só assim o pais será mais desenvolvido e tolerante.']",160,120,120,160,160,720
90,TRANSFOBIA NO BRASIL,"['Nota-se que a transfobia existente assim no Brasil, como em muitos outros países não é atual, e sim transcendente de vários séculos. A Grécia e Roma Antiga, por exemplo, foram períodos onde a valorização do corpo e o ""perfeito"" eram muito prezados e destacavam apenas as qualidades das pessoas nas obras produzidas na época. Nesse prisma, destacam-se dois aspectos importantes: modo como a sociedade trata as pessoas transgêneras em relação à sua aparência e o preconceito a elas com seus direitos como cidadãos.', 'Em primeiro plano, podemos destacar o padrão estipulado pela sociedade, o que virou algo caótico e alvo de inúmeras críticas, pois muda a forma de pensamento das pessoas e as influenciam a diversos procedimentos para fazerem parte dessa estética. Em 2008, o SUS instituiu o Processo Transexualizador, permitindo o acesso a procedimentos e cirurgias de modificação corporal. A criação desse projeto foi tanto como um avanço, todavia, ainda há desafios para gestores e trabalhadores do SUS e principalmente para a população trans que enfrentam a ineficácia e a falta de importância dada a essa causa. Dessa forma, ainda é preciso voltar a atenção a esses projetos que são muito importantes para o desenvolvimento da sociedade transgênica.', 'Além disso, é notório o preconceito que predomina fortemente na sociedade em relação s pessoas transexuais, como a falta de oportunidade de emprego e ainda quando conseguem, lidam com a homofobia em ambiente de trabalho, são humilhadas em ambientes públicos sem o menor pudor e são alvos de preconceito em redes sociais, aumentando as taxas de suicídio entre a sociedade LGBT . ""A democracia surgiu quando, devido ao fato de que todos são iguais em certo sentido, acreditou-se que todos fossem absolutamente iguais entre si."" diz Aristóteles, todos somos iguais, somos cidadãos, porém diferentes entre si, com nossos respectivos valores.', 'Portanto, fica evidente a necessidade de medidas que venham conter a transfobia no Brasil. Por conseguinte, cabe aos órgãos governamentais  fazerem a melhoria dos serviços dispostos a essa comunidade  a fim de gerar um desenvolvimento nessa área. Somente assim, poderemos ter uma sociedade mais pacífica dadas as oportunidades.']",160,160,160,200,160,840
76,Equidade ou iniquidade de gênero em questão no Brasil?,"['Não é de hoje que se discute a igualdade entre homens e mulheres. Sempre houve vários tipos de distinção entre eles, como por exemplo: as péssimas condições de trabalho reivindicadas pelas mulheres com a chegada da Revolução Francesa; o direito ao voto feminino conquistado apenas no século XX; e até mesmo extremo domínio dos pais ou do marido sobre elas, fato este provado na bíblia, quando a mulher tinha que casar com um noivo escolhido pelo pai.', 'Mas pode-se perguntar: a equidade é para homens e mulheres, porque se fala apenas da mulher? É por que as questões recaem-se sobre elas, tendo-se em vista que apenas os homens tinham vários direitos . O sexo feminino é o que mais sofre em alguns casos . No Brasil, as diferenças de gênero afetam o salário, pois muitas mulheres só conseguem empregos mais simples, com cargos mais baixos, como por exemplo: empregada doméstica, caixa de supermercado, recepcionista.', 'Além de tudo isso, a mulher é discriminada por ser o sexo frágil, que não aguenta sobrecargas . Mas isso é equivocado, pois ela tem condições para suportar as relações de trabalho e familiares: prova disso é quando ela engravida e tem que cuidar dela mesma, do filho, da casa, do trabalho, sinais esses de resistência.', 'Mas será que tem solução? Acreditando, tendo consciência e seguindo bons exemplos, sim . É cada vez mais importante ""criar juízo"" para situações que envolvem os sexos opostos: a mulher pode e tem capacidade para comandar cargos elevados. É também importante criar mais leis que impeçam qualquer diferença de tratamento entre os gêneros, como salários diferentes, ""as vagas só para homens"", etc, assim como fiscalizá-las. Desta forma podemos, talvez um dia, chegar ""aos pés"" da Islândia, país com índices baixíssimos de iniquidade de gêneros.']",120,120,80,120,80,520
40,Corpo perfeito,"['Esteriótipos de beleza, seja ela masculina ou feminina são comum na sociedade desde séculos passados. Na literatura fica bem claro o tipo de mulher e seus dotes físicos valorizados em cada movimento literário. Entretanto, nos últimos tempos as pessoas têm encarado o padrão de beleza como algo primordial e peculiar em suas vidas.Os recentes acontecimentos evidenciam que as pessoas têm mudado seus ideais de vida, seus objetivos, colocando seu alvo maior como o corpo perfeito, submetendo-se a cirurgias desnecessárias, horas longas de academia e dietas absurdas, pondo sua saúde em risco. Toda essa idealização da beleza física não se propagou a toa; a mídia através da televisão e da internet, tem disseminado padrões dia-a-dia , dando evidência maior a beleza, ao corpo escultural, incentivando cada vez mais adolescentes, jovens e adultos a encararem esse novo modo de vida, juntamente também com a medicina voltada a estética que com a ajuda da tecnologia tem lançado no mercado novas técnicas, novos produtos, como o botox, a lipoaspiração, a bichectomia, o hidrogel, entre outros; incentivando também ao consumismo exagerado. É impresindível insistir no fato de que a saúde é muito prejudicada nesse meio . Nessa caminhada pela busca do corpo perfeito muitos adquirem danos a saúde física como infecções e alergias, que às vezes levam a morte. Toda via não é só saúde física que tem complicações, mas também a saúde mental, pois certas pessoas ficam tão obsecadas pelo tal objetivo, que desenvolvem um certo tipo de psicose, e na tentativa do corpo ideal recorrem a meios ílicitos, ou golpistas .Nesse sentido pode-se presumir que vivemos hoje a ""era da futilidade"", pois em meio a tantos problemas que a tempos são combatidos e têm importância maior, as pessoas voltam-se para si mesmas para sua satisfação pessoal. Em suma talvez se houver uma maior propagação dos inúmeros riscos a saúde, e dos danos causados a sociedade, as pessoas ""caiam na real"".']",160,200,160,200,80,800
68,,"['Segundo o pensamento do filosófo irlândes Edmund Burke, um povo que não conhece a sua história está fadado a repeti-la . Portanto, é fundamental conhecer a história brasileira, a fim de compreender a formação da sociedade atual. Nesse contexto, entende-se a necessidade de valorizar os agentes históricos de uma nação e, em especial, os patrimônios materiais que os representam. Entretanto, sabe-se que o descaso estatal e o desconhecimento da população brasileira frente sua composição histórica ameaçam diretamente a valorização do patrimônio histórico nacional.', 'Em primeira ánalise, deve-se pontuar o estudo da história em âmbito escolar. Consoante Mortimer Jerome Adler no livro ""A arte de ler"", um sistema educacional e a cultura em que existem tendem a perpetuar-se reciprocamente. Nesse sentido, observa-se que o número de brasileiros que visitaram o Museu do Louvre em Paris em 2017 foi superior ao número total de visitantes no Museu Nacional no mesmo ano. Tal fato deve-se a ignorância de parte da população em relação a riqueza histórica do Brasil e a abordagem abstrata da história em sala de aula, limitada aos livros didáticos.', 'Ademais, o patrimõnio histórico de uma nação deve ser preservado em virtude das gerações futuras. Assim, o processo de identificação da identidade nacional de cada cidadão torna-se mais dinâmico. Todavia a improbidade administrativa verificada em museus, bibliotecas e outras instituições que correspondem ao patrimônio histórico brasileiro mostra-se como uma ameaça a manutenção da história no Brasil. O incêndio no Museu Nacional e a falta de recursos para essas instituições mostram o descaso estatal no tocante valorização dos agentes históricos brasileiros.', 'Portanto, observa-se a importância do acervo histórico brasileiro através da compreensão da história nacional. Desse modo, o governo deve promover uma parceria público-privada com o intuito de arrecadar recursos voltados diretamente para a conservação da história brasileira. Nas escolas e universidades, o Ministério da Educação  deve incentivar visitas aos museus e as cidades históricas, como Salvador, na Bahia, e Ouro Preto, localizada no interior de Minas Gerais. Dessa forma, o Brasil poderá consolidar a valorização de seu patrimônio histórico.']",160,160,160,160,160,800
73,A luta do negro por seu lugar na sociedade,"[""Já dizia um diplomata : '' A escravidão permanecerá por muito tempo como característica nacional do Brasil.''Joaquim Nabuco, jornalista e abolicionista que defendia o fim da escravidão que deveria ser realizada numa consciência nacional dos benefícios que resultariam a sociedade brasileira . Mas após a assinatura da Lei Áurea pela princesa Isabel que libertou os escravos de seus senhores uma nova escravidão faz jus as palavras deste senhor: O preconceito, a marginalização e a sociedade opressora ."", 'Segundo pesquisas do IBGE cerca de 55% da população brasileira é considera negra ou parda. Mora em locais de risco, favelas ou comunidades. Em sua maioria não possui acesso aos serviços básicos, educação e qualidade de vida . Tem o maior índice de mortes assassinatos ainda na juventude. Grande parte da população carcerária é de negros e não possuem o ensino fundamental completo.', 'Mesmo com a criação de programas de auxílio e incentivo  voltado também para a população negra, poucos fazem uso, por desconhecimento ou por falta de incentivo e conscientização. Dificuldades para encontrar emprego e socialização, busca por dinheiro rápido e em abundância os levam para o caminho mais fácil das drogas e a marginalização.', 'É preciso buscar políticas públicas mais eficazes, focando justamente nas áreas onde habitam, buscando valorizar a primeira infância. transformar escolas e o ensino em qualidade. Buscar a motivação, conscientização que vale a pena adquirir conhecimento. Garantir inserção no mercado de trabalho e torná-lo mais vantajoso que o crime organizado.']",120,120,80,120,120,560
137,Biotecnologia como fonte de soluções,"['Os organismos transgênicos possuem propriedades múltiplas. Aparentemente, eles podem ajudar no combate à fome e         à         algumas doenças. Esse é um claro exemplo de que o avanço científico e tecnológico pode trazer muitos benefícios para a humanidade.', 'E é por         isso, que         o Brasil é um dos                 países                que mais produzem alimentos geneticamente modificados, como                 grãos e fibras                , pois reconhece a importância da biotecnologia para a agricultura. Existem muitos                 países                , como Nepal e África do Sul, em que a produção desses alimentos seria muito útil para seus habitantes,         pois, é         de conhecimento internacional que nesses                 países, existe uma grande quantidade de pessoas desnutridas. Os organismos transgênicos certamente          ajudaria          na maior conservação dos alimentos.', 'Além disso, de acordo com José Graziano, presidente da FAO, é possível alterar a estrutura genética de um macho do mosquito Aedes         aegypeti         , desse modo, ao soltá-lo, ele não procriaria, o que traria uma diminuição dos casos de dengue nas regiões brasileiras.', 'Pode-se         observar, que         os                 organismos geneticamente alterados                representam soluções para muitos problemas da humanidade. Diante disso, a biotecnologia deve ser cada vez mais explorada e potencializada, a fim de trazer sempre melhores resultados para a sobrevivência do homem e do meio em que vive.']",120,80,80,80,120,480
39,"Saia justa, o novo look da presidente","['O “impeachment” é a perda de um mandato por conta de crimes de responsabilidade. É um processo conduzido pelo Poder Legislativo, que recebe, acata a denúncia e julga o denunciado. Tal processo é assegurado pela Constituição Federal, de 1989, Lei. 1079/50,  e já foi utilizado, em 1992, quando Fernando Collor renunciou ao cargo de presidente da república . Hoje, com base nas descobertas e graves denuncias o impeachment foi novamente acionado, e é necessário refletir se a presidente deve perder o mandato.', 'Atualmente, na sociedade brasileira, por conta do avanço da operação lava-jato , e a constatação da participação, nos esquemas de lavagem de dinheiro e corrupção, de vários políticos do PT (Partido dos Trabalhadores) e, também, de outros partidos, existe um intenso debate a respeito de uma possível participação da presidente nos esquemas de lavagem de dinheiro e corrupção, somada a isso é possível de se notar uma insatisfação de boa parte dos brasileiros que anseiam a saída de Dilma Rousseff da presidência da república através do impeachment.', 'Todo esse reboliço se deu por conta de uma operação realizada pela polícia federal denominada “lava-jato”  que já ultrapassou a vigésima fase. Esta operação está investigando o que hoje é considerado pelos críticos como sendo o maior caso de corrupção da história do Brasil. A presidente Dilma é acusada pelo crime de responsabilidade e este crime é a base para a solicitação do processo do seu afastamento. É importante salientar que a outra parte da população e políticos favoráveis à continuidade do governo Dilma acusam que a Direita está tentando aplicar um golpe contra a democracia.', 'Portanto, diante dos avanços da operação lava-jato , se for constatada a participação da presidente nos casos de corrupção e lavagem de dinheiro, ela deve perder o mandato assim como aconteceu em 1992, quando “os caras pintadas” e o Poder Legislativo, através de meios legais, conseguiram tirar do poder um presidente corrupto.']",120,120,120,120,120,600
63,"Grandes empresas, grandes impactos ambientais","['Não é de hoje que desastres ambientais atingem o Brasil e o mundo. Em 5 de novembro de 2015 o rompimento de barragem em Mariana, Minas Gerais  acarretou na morte de 19 pessoas e os sobreviventes sofrem com doenças de pele e respiratórias, afirma o site BBC news. Além do martírio humano, há os danos causados ao meio ambiente e tudo que o envolve.', ""Referente a esse acontecimento, é possível lembrar do que disse Albert Schweitzer: ''Vivemos em uma época perigosa. O homem domina a natureza antes que tenha aprendido a dominar a si mesmo''. Grandes desastres ambientais são causados justamente pelo fato de grandes empresas não se importarem com a devastação que o meio ambiente sofre por causa de suas ações."", 'A lei 9605/1998, artigo 225 fala em punição civil, administrativa e penal (geralmente prisão para empresas e seus agentes que lesarem o meio ambiente). Esta lei, no entanto  não parece ser suficiente para atender a responsabilização final, visto que grandes corporações nunca são devidamente punidas. Após mais de três anos, a tragédia de Mariana não tem punidos e isso reflete a enorme vantagem que os empresários tem sobre a lei.', 'Mary Daly afirmava que devemos olhar para a Terra e seus planetas irmãos como coexistindo com a gente, em vez de feito pra nós, Definitivamente isso não é o que acontece. Tendo em vista que é preciso deter a ação de grandes corporações, é necessário reformular a lei, tornando-a mais severa. Entretanto, apenas mexer na lei não resolve o problema. É preciso fazer a lei valer a pena e para isso o governo federal tem que punir e não permitir tais empresas de se aproveitarem da nossa natureza. É urgente a necessidade de por a lei em prática.']",120,160,120,160,120,680
47,Sou Mil PE,"['Por conta da pandemia de coronavírus o isolamento social começou a fazer parte da rotina de milhões de brasileiros, principalmente os jovens que frequentam as escolas e universidades. Assim, a Educação a distância(EAD) foi a forma encontrada pelas instituições públicas de ensino para resolver o problema da falta de aula presencial. Porém, EAD vem sofrendo bastante com os desafios, tais como a democratização do acesso à internet e a falta de experiência dos alunos com as tecnologias utilizadas por eles no estudo.', 'A priori, é importante destacar que grande parte dos jovens brasileiros não possuem acesso à internet, o que se torna um problema para as escolas que passaram a trabalhar com EAD. Por esse motivo, a eficácia do programa acaba se tornando baixa, visto que não atende todos de forma igualitária. Portanto, seguindo a constituição Federal brasileira que diz que a educação é direito de todos , fica evidente que essa forma de lecionar é falha e não respeita as normas do Estado.', 'Ademais, também é fato que muitos alunos sentem dificuldades com o manuseio dos celulares e computadores utilizados pelos professores no ensinamento à distância. Logo, esse é mais um motivo que comprova que o EAD ainda precisa resolver vários problemas que impedem seu funcionamento. Posto isso, pode se citar como exemplo os povoados do sertão nordestino que receberam o acesso à internet. Entretanto , muitos não conseguiram ainda se adaptar com a nova tecnologia.', 'Destarte, é substancial que o Governo melhore o EAD para que ele se torne acessível a todos os jovens. Para isso, o Governo Federal deve disponibilizar para os estudantes, que não possuem boas condições financeiras, um valor mensal destinado ao pagamento de planos de internet. Com isso, os jovens que não possuem rede Wi-Fi em casa,  terão a chance de acessar as aulas online. Além disso, o Ministério da Educação deve enviar, aos que preferirem, as atividades impressas e os livros utilizados para pesquisas. Com essas medidas, a Educação a Distância irá se tornar mais eficaz e fará com que o isolamento social não interfira no aprendizado.']",160,160,160,160,160,800
69,Transição agricola,"['Segundo a teoria Malthusiana, a produção de alimentos não acompanharia o ritmo de crescimento da população. Quando Thomas althus apresentou sua teoria, ele não preveu o avanço tecnológico que ocorreria nos próximos séculos (vide a Revolução Verde do século 20), mesmo assim, sua tese serviu de alerta aos países para questões ligadas à alimentação. Dessa forma, algo semelhante ocorre atualmente, ou seja, há preocupação quanto ao uso de agrotóxicos. No entanto, isso não deve ser tratado como problema crônico, haja vista, que no mínimo servirá como incentivo ao surgimento de novos meios produtivos.tr', 'Hoje, o pensamento sustentável permeia na maioria das nações mundiais, prova disso, é que os ambientalistas condenam o uso abusivo de agrotóxicos, uma vez que, eles trazem prejuízos ao meio, assim como, ao homem. No entanto, vale lembrar que o mundo vive um momento de transição, pois, a sustentabilidade começa a se popularizar no mundo. Com isso, cresce a produção orgânica que nas próximas décadas será a vertente de maior poder econômico na produção agrícola, logo, é esperado que uso de pesticidas caia em desuso.', 'De acordo com o Ministério da Agricultura, no Brasil, apenas 5% da produção de alimentos é orgânica, prece pouco, porém, segundo a FAO(Organização das Nações Unidas para Alimentação e Agricultura), existe uma tendência mundial de crescimento desse mercado. Os dados da instituição mostram que até 2040, a media mundial será de 40% de alimentos produzidos sem uso de produtos nocivos. Isso, sem contar as novas tecnologias que surgem e aumentam esse percentual. Assim, não há o que temer,  pois, o futuro terá produção com respeito ao meio.', 'Por fim, a lógica mundial é que progressivamente haja diminuição no uso de agrotóxicos. Então,  basta apenas acompanhar essas mudanças com medidas que visem amenizar os problemas do presente . Ou seja, os Estados devem agir facilitando o financiamento agrícola e descontos em impostos para produtores com consciência ambiental. Asim como, incentivar a agricultura familiar, porque, eles são os grandes responsáveis pelo alimento livre de venenos que chegam na mesa do brasileiro.']",120,120,120,120,120,600
87,Erotização Infantil,"['O filósofo grego Pitágoras advoga que os homens são miseráveis, pois não entendem os bens que estão aos seus alcances. Nessa perspectiva, pode-se compreender que a erotização infantil dr -se por consequências do trabalho infantil, pelas mídias sociais e a falta de diálogo com os responsáveis.', 'Em primeira abordagem, cabe pontuar que como consequência do trabalho infantil , leva crianças a não só trabalhar como adultos ademais também a se portar como tais. Dessa forma, jovens se tornam ""adultos"" cedo demais, impossibilitando comportamentos que coincidem a sua respectiva idade.', 'Outro ponto significativo ,merecedor de destaque é a falta de diálogo dos filhos com os pais , em relação as mídias sociais. Observa-se que jovens estão cada vez mais sendo influenciados pelo o que veem em redes sociais que nem sempre costumam ser de boa índole..  Dessa forma, o diálogo com os mais é importantíssimo para o bom desenvolvimento das crianças.', 'E imprescindível que, diante dos argumentos expostos que haja uma mudança objetiva na sociedade .Nesse sentido , o governo juntamente com o ministério da cidade, ministério da suade, ministério da educação , a a principio priorizar a educação de menores, desenvolver projetos supervisionados por um assistente social , para aqueles que também não tem uma boa estrutura familiar possam suprir a necessidade de orientação. Como dizia Nelson Mandela ""sempre parece impossível, até que seja feito""']",160,160,120,160,160,760
88,O sofrimento que o desprezo causa em pessoas com doença mental,"['Doenças mentais são pouco notadas na atualidade, apesar de estarem dentro da nossa própria casa. Muitas são s dificuldades para quem vem sofrendo com essa doença no qual pode acabar piorando sua situação com autocobrança, sentimento desprezo da sociedade que dificulta a procura por ajuda, sensação de inferioridade, abandono ou ignorância por parte dos pais, que, por sua vez, não dão o devido valor a situação. A falta de recursos e prioridade,  não ajudam no combate doenças mentais, mesmo após situações e cenários que mostram como é de extrema importância tratarmos de imediato esse estigma que no Brasil se torna cada vez mais desvalorizado e totalmente apagado.', 'Entre os anos de 2016 e 2017, durante o desespero causado em famílias pelo o jogo ""Baleia Azul"", o estigma se ampliou ainda mais, causando morte de vários adolescentes e crianças porém parece não ter sido o bastante para procurar um meio de acabar com todo esse sofrimento. Geralmente dizem que é apenas uma fase, que passará logo ou é um problema que se resolvendo rezando, mas não é! Se trata de uma doença que atinge milhões no mundo inteiro, no brasil situação vem estando cada vez pior, principalmente com a remoção monetária dos cofres de instituições que tratam deste tipo de estado. O governo está se tornando cada vez ignorante às doenças mentais e junto mídia que apesar dos altos casos, evita tocar nesse assunto. A maior parte dos causadores desse tipo de estado físico, se encontra nas mídias sociais que estão se tornando cada vez mais ativa com o decorrer do avanço tecnológico tornando-se uma fraqueza e um possível refúgio para os que estão sendo afetados por este estigma e como estão em estado enfraquecido pela doença, se tornando alvos ainda maior para aqueles que desejam machucar e abrir essa ferida que os machuca tanto ao ponto de tirar a própria vida.', 'Encontrar uma solução que feche mesmo que um pouco esse estigma relacionado doença mental e até aumentar a procurar por ajuda, é muito difícil! Mas podíamos ter um começo com o aumento de informação sendo dada pelos telejornais, revistas, companhias, etc... O governo podendo se tornar uma forma de apoio aos centros de ajuda psicológicas às campanhas de combate ao desprezo público por essas pessoas muitas são as soluções e poucas são feitas, mas o julgamento é imenso e pesado.']",160,120,120,160,120,680
50,A superação clínica com inteligência no Brasil,"['No século XX o desconhecimento científico da população sobre a varíola fez muitas pessoas morrerem por não acatarem as medidas do ministro da saúde Oswaldo Cruz e até entrar em confronto com as autoridades. Portanto é saudável escutar as forças de saúde e ter segurança e harmonia de bem estar social.', 'A ciência é todo conhecimento sistemático, observável e que põe experimento para análise de fatos, por isso é confiável e seguro. Um profissional da área de saúde passa vários anos e estuda com profundidade sobre as doenças. Um exemplo de outras doenças que foram combatidas graças a orientação dos profissionais com o conhecimento tecnológico  são: o câncer e a aids que não tem cura mas são superadas com tratamentos e coquetéis de vitaminas . Os países que não levam a ciência a sério sofrem os acentuados danos como foram os casos da Itália, Espanha e França em relação pandemia atual.', 'Especificamente com respeito ao korona-vírus que surgiu na China, é graças a rápida adaptação à ciência que as autoridades de saúde chinesa declinam os gráficos de contágio . Entre as medidas orientadas pelos médicos está não sair de casa para não contagiar ou ser contagiado. Lavar sempre as mãos e usar máscara quando necessário. Unido a isso o aparato de infraestrutura do governo na demanda de profissionais e construção de novos hospitais segundo a demanda de seus ministros de saúde. Graças a guerra dos médicos e enfermeiros na consicentização do povo no Brasil são menos de 6.500 casos em comparação com o Estados Unidos que chegam a mais de 213.000 . É possível que houvesse menos caso todas as autoridades estivessem de acordo, mas em detrimento da economia há discordâncias.', 'Por tudo que foi exposto não se pode negar que é preciso ouvir as orientações de saúde dos ministros e secretários responsáveis pelo bem estar do povo. O Governo Federal , estadual e as prefeituras devem apoiar os profissionais no combate a mais essa pandemia de gripe. Uma das formas é através dos meios de comunicação.  Tvs e rádio, mais ainda pelos cibernéticos como redes sociais. Já superou-se várias pandemias com a inteligência e está será também superada.']",120,160,120,160,0,560
52,Gravidez precoce,"['O paradigma de vida de muitos adolescentes é nitidamente acerca de devaneios e turbulências ,sendo 70% dos abusos são em crianças e adolescentes no brasil . Uma gravidez quando jovem pode acarretar vários problemas ,desde parar os estudos até ter condições de sustentar o filho ,podendo ter um efeito profundo na saúde das meninas durante a vida.', 'Grandes influências podem ser por sêries e filmes ,como exemplo,""sex education"",que mostram cenas que podem fazer a pessoa a ter uma influição sobre os atos,e sem o discernimento de precauções sobre a realização acaba ocorrendo a gravidez precoce.', 'Portanto, deve ter o diálogo entre os pais desde a pré-adolescência para ter a consciência sobre as devidas atitudes, e o ensinamentos na escolas sobre o tema.']",120,40,40,80,40,320
58,"O risco da falência da floresta, pela ganância do homem.","['A floresta amazônica é a a maior floresta tropical do mundo e abrange em sua área total pelo menos 7 países. Além da sua vasta extensão territorial ela possui grande diversidade de espécies de plantas e animais, vários destes encontrados apenas neste local, os chamados hotspot. Portanto nota-se a importância da floresta para a sobrevivência de diversas espécies que tem nela seu habitat.', 'Porém devido a falta de consciência e respeito de diversas pessoas este bioma está cada dia mais ameaçado, diariamente são encontrados diversos focos de incêndio e desmatamento criminosos nesta área, a maioria deles causados por grandes fazendeiros que se acham no direito de destruir áreas preservadas para a expansão da agricultara e pecuária.', 'No ano de 2019 até o mês de agosto as queimadas aumentaram cerca de 60% se comparados aos últimos 3 anos, números assustadores que se mantidos podem gerar consequências graves e devastadoras na floresta como por exemplo a extinção de várias espécies e perda de grande parte da biodiversidade local, assim sendo a floresta perderá seus componentes de recuperação e corre serio risco de virar apenas história a ser contada.', 'Como medidas de proteção da floresta,  o Brasil recebeu ajuda de custo de países para o auxílio a prevenção de queimadas e desmatamentos, porém é importante que sejam adotadas medidas severas de punição aos infratores que destroem este bioma além de campanhas de conscientização da importância da preservação da mesma para a manutenção da vida na terra.']",120,160,120,160,120,680
96,Aids atualmente,"['Ao         passar dos anos, as discussões sobre a aids         veem         perdendo destaque,                que pode         ser         tanto         pela         utilização de drogas que prolongam a vida dos doentes, quanto         pelo         distanciamento da juventude atual         a         preocupação         de         prevenção. Como entender este comportamento?', 'Apesar dos estudos avançados que a medicina apresenta         atualmente a         vacina até hoje não existe. Já os remédios ajudam a fazer da aids uma doença controlável, embora ainda grave.', 'Esta é         a         geração mais bem informada dos que as outras e mesmo assim         ignoram         o preservativo, por não         terem         medo da aids e por         confiarem         no parceiro.                 Só usam a camisinha nas primeiras relações e, assim que ganham a confiança do parceiro, abandonam.', 'Dados mostram que milhares de brasileiros são infectados, porém grande parte não tem ciência disto.', 'Atualmente existe cura e remédios para todo tipo de doença mas não vale botar a vida em risco sem se         previnir         . Uma vida         saudavel         e bem cuidada vale mais a pena.']",120,120,80,80,0,400
118,Intolerância,"['Os                 rastros de rebeldia                estão presentes em quase todas as manifestações populares ocorridas no Brasil este ano. Os ""black         blocks""         - os penetras mascarados dos protestos que se aproveitam para vandalizar o local - acabaram transformando grande parte dessa cena de evolução política do país em vergonha, ofuscando as intenções da sociedade. Tanto fizeram, que essas intenções praticamente silenciaram, o medo dos conflitos inevitáveis com policiais se espalhou e os protestos já estavam adquirindo                 consequências mal interpretadas                . Assim acontece, também pelo mau uso da informação e da comunicação, que gera                 desrespeito por todas as partes                , como no caso do Instituto Royal - acusado de utilizar indevidamente cães da raça Beagle em pesquisas.', 'Esses cães tão carismáticos tornaram-se alvo de questionamento de ativistas que acusavam o Instituto de maus tratos. Essa notícia         mau          formulada                caiu em mãos erradas. No embalo das manifestações, atos de vandalismo marcaram esse episódio: carros queimados, sequestro e abandono desses animais e depredações no local da manifestação.', 'Sem                 o verdadeiro conhecimento                dos procedimentos da pesquisa, nenhuma conclusão pode ser tirada. Uma ação popular não pode ser movida pela emoção. Afinal, as pesquisas tinham um ótimo propósito a favor da saúde do homem, porém, nem por isso devemos parar de questionar e cobrar esclarecimentos em relação ao uso de animais em pesquisas para o avanço da medicina, pois cabe apenas ao homem defendê-los.', 'O nome e a imagem do Instituto, assim como a credibilidade dos procedimentos desse tipo de         pesquisa         agora estão em jogo.                 Medidas mais caras, talvez, teriam sido melhor empregadas nesse tipo de caso.                Pois, assim como na política, é melhor a prevenção de um problema, do que lutar contra ele depois.']",120,160,120,160,120,680
15,Corpo humano em dia,"['Tudo em excesso faz mal. Com a alimentação não é diferente. Segundo uma pesquisa da BBC Brasil, ela mostrou que quase 40% da população adulta do mundo - e cerca de 20% das crianças e adolescentes entre 5 e 18 anos - já sofrem de sobrepeso ou de obesidade. No Brasil, isso não é diferente do resto do mundo. Sendo assim, quais seriam as causas do aumento da obesidade e como acabar com ela e ter uma vida mais saudável?', 'Sabe-se que o excesso de uma má alimentação tem sido o principal fator para o aumento de peso da polução brasileira. As redes de fast food - comida rápida - são as principais causadoras e campeãs em termos de aumento da obesidade. A maioria dos brasileiros, principalmente as crianças, são apaixonados por esse tipo de comida e, claro, também pela comodidade e praticidade que elas proporcionam, além da saciedade momentânea. No entanto, nesse tipo de alimentação esconde vilões, como o sódio, principal potencializador da hipertensão, ou seja, causa a parada do coração, bem como o açúcar, que aumenta o sobrepeso das pessoas.', 'Além disso, o sedentarismo também contribui para o aumento da obesidade no país. Muitas pessoas passam mais tempo em casa, ainda mais agora com a era das redes socias, conversando no Facebook e no Instagram, por exemplo, do que pedalando, nadando e caminhando em espaços públicos e abertos, enfim, exercitando-se. Tudo isso tem um impacto no corpo, como o acúmulo de gorduras, aumentando, assim, o peso desses indivíduos. E em casos mais graves, levando até à morte, uma vez que a obesidade, segundo levantamentos, tornou-se a segunda causa de mortes no mundo.', 'Conclui-se, portanto, que medidas simples ajudariam a diminuir a obesidade da maioria dos brasileiros. Como alimentar-se em casa e de preferência com alimentos de origens conhecidas, como as que são feitas em casa, livres de conservantes. Além disso, passar a frequentar mais parques e academias para não deixar o modismo do sedentarismo acompanhá-los. Só assim, eles terão a oportunidade de ter uma vida mais saudável, além de manter a saúde do corpo humano em dia e longe do sobrepeso.']",160,160,160,160,160,800
44,REDAÇÃO,"['Podemos notar na série “As telefonistas"" uma inspiração em um problema real do Brasil: luta pelos direitos das mulheres na sociedade, a série espanhola aborda a história de 5 mulheres que buscam o fim da desigualdade de gênero, é a inserção das mulheres em qualquer âmbito social, seja: trabalho, esporte, política, entre outros . A sociedade possui um pensamento de que o homem é superior à mulher em tudo, no Brasil pessoas de gêneros diferentes, mas que ocupam o mesmo cargo recebem salários diferentes, sendo o salário do homem maior que o da mulher, a porcentagem de mulheres que ocupam cargos políticos é relativamente baixo com isso é perceptível que a superioridade masculina ainda persiste em pleno século XXI.', 'Contudo, é notável que capacidade de executar diferentes atividades, não são definidas de acordo com o gênero, logo não há diferença entre homens e mulheres, exemplos de conquistas femininas é o direito do voto a todos, acesso à educação: escolas e faculdades, que possuem uma grande importância para o movimento feminista. Portanto, medidas são necessárias para resolver esse impasse, e como já disse o filósofo Imannuel Kant “O ser humano é aquilo que a educação faz dele"".', 'Dessa forma, o Ministério da Educação em parceira com o Ministério legislativo breve propor a criação de uma lei que regulariza os direitos igualitários, e informar os mais importantes marcos conquistados por mulheres que participarão do movimento feminista por meio de campanhas e ações sociais que visam agregar essa questão para a sociedade.']",160,80,80,200,80,600
50,Cientistas,"['A pandemia do coronavírus vem assolando os diversos países do mundo, o Brasil é um exemplo deles. O primeiro caso de um infectado foi detectado na China, e logo se espalhou pelos continentes, pois ele é de fácil e rápida propagação.', 'Os cientistas tem um papel importantíssimo no combate desse vírus, porque é só através da ciência que se pode pôr fim nele . Os estudiosos vêm cada vez mais tentando entender a Covid-19 e criar uma vacina contra ele,como os do setor de imunologia do Incor.', 'Está havendo a corrida e até mesmo a união entre os países, para tentar encontrar uma cura, pois o vírus atinge uma esfera global, trazendo  impactos tanto para a saúde das pessoas, como para a economia. Então nasce dessa forma um interesse geral na batalha contra a Covid-19. Alguns cientistas da área da robótica dos EUA, Japão e china dizem que robôs podem ajudar nesse processo, evitando que haja o contato e assim a proliferação. Está tendo um grande esforço por parte deles para amenizar e combater.', 'É crucial nesse momento que haja um apoio tanto por parte do governo (financiando e dando os materiais necessários), quanto por parte das pessoas( apoiando e respeitando a quarentena) à esses heróis , que são os cientistas.']",160,160,120,120,80,640
60,,"['Em meio ao aumento alarmante do desemprego e o índice de idosos que tende a ultrapassar o número de jovens, acarretando uma diminuição nas contribuições previdenciárias, a reforma da previdência surge, então, com o intuito de equilibrar as contas públicas, reduzindo gastos. Mas ela permeia um debate onde de um lado é uma iniciativa importante e do outro é prejudicial. Nesse sentido, é possível destacar pontos positivos e negativos da reforma .', 'Em primeiro lugar, vale ressaltar quais são os seus aspectos positivos e essenciais. Visando buscar uma igualdade nos pagamentos das contribuições,  foram propostas medidas para balancear os pagamentos direcionados à previdência logo,  os que recebem um salário maior contribuirão mais e aqueles que recebem menos contribuirão de acordo com esse rendimento. Além disso, a idade mínima para se aposentar por idade vai se alterar periodicamente, conforme pesquisa do IBGE , não se mantendo em 65 anos para os homens e 62 para as mulheres. No entanto, há aspectos que vão prejudicar grande parcela da população se forem aprovados.', 'Não obstante, podemos dizer que possivelmente haverá um aumento da pobreza a médio e longo prazo. A redução de 60% nos valores das pensões e auxílios afetará 30 milhões de brasileiros que dependem desses benefícios para sua sobrevivência e de suas famílias. Logo, é fundamental que deputados e senadores proponham mudanças no texto base que concedam 100% dos valores de pensões para famílias carentes e sem outra renda, para que os que dependem dos auxílios não atinjam a linha da pobreza. Ademais, muitos autônomos, desempregados, trabalhadores informais e idosos acima de 50 anos que estão desempregados não conseguirão completar a contribuição mínima de 20 anos de carteira assinada para, assim, se aposentarem.', 'Fica evidente, portanto, que a reforma previdenciária é de suma importância, apresentando aspectos positivos, mas faz-se necessário uma melhoria nos aspectos negativos, especificamente no período mínimo de contribuição à previdência . Cabe ao poder público sancionar propostas que possibilitem, de acordo com cada caso, que o cidadão se aposente antes da idade mínima obtendo benefícios menores ou possa se aposentar depois,  com benefícios maiores e dessa forma dificultar que a população carente seja extremamente prejudicada com a nova reforma.']",120,160,120,160,120,680
90,.,"['Na série televisa original Netflix, Control Z a personagem Isabella, transexual, é vítima de diversos tipos de preconceito  incluindo a transfobia por parte dos colegas de escola, retratando uma parcela das dificuldades enfrentadas por essas pessoas, mesmo atualmente. Infelizmente essa realidade não está presente apenas no universo cinematográfico, mas também na sociedade atual. No Brasil o quadro de violência e homicídios contra pessoas trangêneros é crescente a cada ano, o que deixa essa parcela da população mais fragilizada, sendo assim esta teme a cada dia mais ser quem realmente é.', 'Temas que dizem respeito sexualidade dos indivíduos ainda são considerados tabus, não sendo discutidos nem apresentados em locais que influenciam um pensamento, como escolas, sendo assim estas muitas vezes, não saberão lidar e nem solucionar situações transfóbicas, marginalizando essas pessoas mais uma vez. A forte negligência do estado, que tem o dever de proteger qualquer cidadão contra crimes de preconceitos, reforça a marginalização desses indivíduos, tornando estes vítimas mais frágeis, já que não são, de certa forma, protegidas de maneira pratica e funcional.', 'Em contrapartida, a representatividade oferecida, mesmo que ainda em pequenas proporções, pela mídia inicia um processo importante de apoio a essas pessoas transgêneros, a inclusão dessas pessoas nesse meio, como na série Control Z citada na introdução, em que a atriz que faz a personagem Isabella pertence comunidade transgênero de fato, faz com que esta minoria social se sinta representada . A conscientização e o apoio da população em geral é essencial, e a inclusão de maneira efetiva desta minoria é de extrema necessidade  já que muitas perdem oportunidade pelo simples fato de pertencerem a esse grupo.', 'Dado o exposto, medidas são necessárias para resolver o impasse. Segundo Kant “ O ser humano é aquilo que a educação faz dele”endo assim, o governo junto ao ministério da educação poderia organizar campanhas e palestras com profissionais especializados, como psicólogos, e pessoas da comunidade LGBTQ+ para além de apenas falar sobre, ter experiências para contar a respeito. Outrossim a rigidez para o combate de crimes de ódio deveria ser aplicada para que as leis realmente fossem funcionais para todos os cidadãos.']",160,160,160,160,160,800
54,A Proeminência do uso das vacinas,"['No filme Maze Runner: A Cura Mortal, os protagonistas iniciam uma   para encontrar a um agente que age contra uma determinada doença que pode ceifar a vida de quem não adquirir esse artifício . A trama do filme explana que a vacinação para combater doenças é demasiadamente vital para a sobrevivência do indivíduo, e é dessa forma que é possível fazer uma analogia com a realidade vivida nos tempos contemporâneos, expondo a importância das vacinas.', 'Muitas doenças foram erradicadas ao longo da história, um exemplo é o sarampo que na maioria dos países é inexistente, esse fato se dá pela evolução da medicina, onde muitos cientistas desenvolveram métodos para combater tais imbróglios, que são as vacinas. Com o decorrer do tempo, as vacinas foram se mostrando eficientes e por consequência disso, auxiliando na vida saudável e na longevidade da sociedade como um todo. Do recém nascido ao idoso,  é indubitável seguir a risca todo o processo de vacinação que é imposto pelo sistema de saúde, dessa forma corroborando para que as enfermidades não o prejudiquem.', 'Em contrapartida, deve existir todo um aparato para que as vacinações exerçam suas funções de maneira correta e ordenada e assim se tornar eficazes. Não são todos os países que possuem condições econômicas e tecnológicas de fazer o uso desses métodos, isso acarreta em novos surtos de doenças que, em outros lugares já foram exterminadas, exemplo disso foi o retorno do sarampo no Brasil, em meados de 2018,, causando exacerbadas adversidades no país e consequentemente levando pessoas a morte. Um grande alvoroço se alastrou pelo território brasileiro, fazendo com que a população ficasse temerosa e em virtude disso, procurar as devidas precauções para evitar o sarampo.', 'Tendo em vista os fatos apresentados cabe ao Ministério da Saúde por meio de palestras em escolas e locais públicos, conscientizar e aconselhar a comunidade a procurar unidades básicas de saúde ou instituições privadas para receberem as vacinas e dessa forma, evitando a contração de vírus e doenças que os prejudiquem.']",120,120,120,120,80,560
116,A humanidade se autodestrói,"['Imaginamos         que, as         chuvas são as únicas responsáveis pelos desastres ambientais ocorridos recentemente, achamos que somos frágeis em meio         á         força ambiental. Mas, será mesmo que somos tão frágeis assim,         aponto         de não conseguirmos evitar ou pelo menos amenizar desastres de tamanha gravidade?', 'Em meio ao mundo desenvolvido                que estamos, acredito         que, esses         desastres podem sim ser evitados ou pelo menos amenizados. É ridículo dizermos que em pleno século XXI, com tanta tecnologia, somos fragilizados pela natureza, e mais ridículo ainda é culparmos as chuvas por tamanhos desastres, sabendo         quê         se tivéssemos moradias em bom estado e lixo reciclado, grande parte dessa tragédia seria         evitada, o fato é,         não respeitamos o ambiente, e por isso o ambiente se revolta, e quem sofre? Somos nós mesmos, afinal perdemos bens materiais e ainda pior perdemos vidas, bens irreparáveis, e de certa forma dói na consciência pensar que tudo poderia ser evitado, e usamos desculpas, culpando as chuvas                o governo, ou qualquer outra coisa que não seja nós mesmos.', 'Concluindo que, nossos descuidos causam desastres que prejudicam a nós, e que o problema da população pode sim ser resolvido se você trabalhar para que eles se resolvam.']",120,120,80,80,0,400
94,País de desiguais,"['A Constituição Federativa de 1988 -norma de maior hierarquia do sistema jurídico brasileiro- assegura promover o bem de todos, sem quaisquer formas de discriminação. No entanto, no cenário brasileiro, observa-se justamente o contrário, quanto questão dos desafios para a inclusão de autistas na sociedade, do qual impossibilita que uma parcela da sociedade desfrute desses direitos  na prática. Nesse sentido, tornam-se fatores predominantes o preconceito populacional bem como a carência no sistema educacional.', 'Sabe-se que o autismo é um transtorno neurológico que dificulta a integração social além da habilidade cognitiva, tendo seu grau mudando em cada caso. Segundo o filósofo Paulo Freire ""A inclusão acontece quando se aprende com as diferenças e não com as igualdades.”. Sob tal ótica, é percebido a ignorância de grande parte da população quando se trata da doença, que gera um preconceito, que  por sua vez, causa uma marginalização dos portadores e exclusão dos mesmos.', 'Paralelo a isso, vale ressaltar a falta de apoio das instituições educadoras que aumentam a exclusão dessas parcelas, que não só dificulta o desenvolvimento acadêmico e social, mas também na inserção no âmbito do trabalho. O site ""autismo e realidade"" relata que 80% das pessoas com Transtorno Espectro Autista (TEA) estão fora do mercado de trabalho; haja vista que enfrentam situações difíceis no quesito social e profissional, já que não possuem a preparação exigida.', 'Entende-se, portanto, que a exclusão das pessoas autistas é um mal para a sociedade. Sendo assim, cabe ao Ministério da Educação, em parceria com órgãos vinculados, promover atividades com profissionais especializados a fim de melhorar o desempenho educativo das pessoas autistas além de criar aulas dinâmicas que visem a interação social dessa parcela . Ademais, a sociedade deve se mobilizar nas redes sociais para conscientizar as pessoas dos problemas enfrentados pelos autistas e da importância da inclusão desses indivíduos na sociedade. Dessa forma, será possível a execução do pleno direito ao bem de todos.']",160,160,120,200,120,760
73,,"['No Brasil, o número de homicídios é assustador , cada vez mais os jovens são assassinados, sendo a maior parte deles, negros. Desde a escravatura,  até os dias atuais, os afrodescendentes lutam por um lugar digno na sociedade. Porém, a desigualdade e o preconceito ainda são muito presentes, logo, esta realidade deve ser mudada.', 'Diferentemente das outras raças, a taxa de homicídios dentre negros e pardos vem aumentando, com base em dados da  ONU. A Alemanha Nazista, o Apartheid, e a Era Jim Crow ,  são amostras de que o preconceito racial é um empecilho mundial.', 'Um dos desafios que os negros enfrentam, dentre vários outros, é em relação ao mercado de trabalho, algumas empresas contratam somente pessoas de ""boa aparência"" excluindo os negros de suas ocupações.', 'Para combater a essa desigualdade e o preconceito, o Governo Federal, junto com o Ministério do Trabalho, poderia  disponibilizar cargos em instituições federais somente para negros , e através da mídia promover campanhas para a conscientização da população, e incentivar empresas privadas para a contratação. Assim, poderíamos ter uma maior inclusão desse grupo na sociedade.']",120,120,80,120,120,560
74,Machismo que fere e mata,"['Morre uma mulher a cada uma hora e meia no Brasil, de acordo com um estudo do Ipea em 2013  acerca do feminicídio no Brasil. Além disso, a ONU afirma que um terço das mulheres sofreu ou sofrerá abusos sexuais no decorrer de sua vida. Indo além: engana-se quem crê que a agressão contra a mulher se limita à violência física; existe ainda a degradação verbal e moral que humilham e diminuem a mulher pelos simples fato de ser mulher. Estes são dados que revelam uma cultura onde o machismo está enraizado e ainda é visto com naturalidade por muitas pessoas.', 'Em 2015, foi registrado um estupro a cada onze minutos, onde as principais vítimas eram adolescentes e crianças, e não são raros os casos em que isso ocorria com membros da própria família. Mais chocante é o fato de que os agressores são tidos como loucos ou problemáticos, quando na verdade encontram-se perfeitamente inseridos na sociedade e ainda encontram pessoas que buscam justificativas para a agressão: é o caso de comentários sobre a roupa que a vítima estava usando ou o jeito como se porta. Isto é o que se chama ""cultura do estupro"", termo que viralizou devido ao caso da jovem que foi estuprada e filmada por trinta homens no Rio de Janeiro  em 2016.', 'É um cenário comum para uma mulher que está andando na rua ouvir comentários ou assovios, inclusive olhares que incomodam . O que também é comum ouvir as seguintes frases em defesa disso, onde homens afirmam que ""mulher não sabe aceitar elogio"", que olham devido a ""roupas provocativas"", que ""olhar não mata"" . Entra em discussão se estes são casos de assédio ou se o homem estava no seu direito; inclusive, é devido a essa discussão que muitas vezes os agressores saem impunes. É assédio ou não? Para sanar esta dúvida, basta refletir sobre a seguinte frase: ""o seu direito acaba onde começa o dos outros"". A partir do momento em que você invade o espaço pessoal de outra pessoa e a ofende, isso se torna assédio.', 'O machismo fere e mata. Enquanto homens muita vezes saem impunes de situações de agressão e assédio, mulheres sofrem cada vez mais, até mesmo em ambientes onde deveriam se sentir seguras, como sua própria casa. Mulheres saem não apenas com traumas e danos psicológicos, mas também com hematomas e sem vida destas situações. Para reverter este quadro, é necessário uma mudança na educação das crianças no ambiente escolar e em seus lares; é necessário ensinar a garotos a respeitar a mulher, em vez de ensinar a garota a tomar cuidado com garotos. É necessária uma educação de igualdade de gênero, uma visibilidade maior a casos de agressão e conscientização da população sobre pequenos atos machistas que mal se percebem, mas que estão presentes em nosso cotidiano, através da ação da mídia, e que as leis sejam aplicadas com mais vigor para que não haja impunidade dos agressores. Apenas assim conseguiremos reverter, a longo prazo, essa cultura que oprime e fere.']",120,120,120,120,120,600
131,Quais são os verdadeiros interesses representados?,"['O horário de propaganda eleitoral          gratuita, é          um horário                reservado em rádios e TVs em época de         eleição         para expor a proposta de governo de cada candidato a determinado cargo político. É televisionado ou transmitido via         radio         durante trinta minutos em todos os canais ou estações.                 Com o objetivo de induzir a escolha do pleito.', 'A grande dúvida é se o objetivo do horário é         alcançado a partir do momento que         a audiência nesses horários específicos         são muito baixas         , pois a maior parte da população brasileira não assiste a essa programação.                 Tirando o foco da audiência e          focando          na veracidade do que é proposto, porque o que passa nesses horários políticos          são feitos          pelos próprios candidatos e é desse fato que          surge          as          perguntas,         até         aonde         essas informações são verdadeiras?         até aonde          essa montagem é uma construção         que que         só beneficia o         candidato         não tendo a verdade como base? Só com a propagando eleitoral não temos como saber.', 'Seguindo a duvida         do parágrafo anterior, talvez o objetivo seja alcançado                 a partir do momento que ele garante os interesses de quem os constroem que no caso são os próprios candidatos, que nele delatam seus feitos que a maior parte da população não sabe se são verídicos, demostram carinho e humildade com a população mais carente.                Podemos até dizer que são usados recursos psicológicos bem pensados que         ajudem         na popularidade daquele candidato .', 'Podemos perceber nesses horários          também, figuras          que não possuem postura de representante de um país ou          estado          que parecem          que ali estão          para brincar com seus futuros governados,          Partidos          políticos que apelam trazendo consigo pessoas deficientes                  portadoras de alguma dificuldade, seja          ela física ou Mental          (este um bom exemplo          de alguns recursos psicológicos usados          para conseguir voto), como um apelo desesperado de seguidores.', 'Como conclusão dos assuntos abordados         o espaço reservado         a         propagando eleitoral gratuita deixa a                 desejar não representando assim o eleitor sendo apenas mais um meio de divulgação para os candidatos a voto beneficiando-os de forma abrangente por ser transmitida em dois dos maiores e mais usados meios de transporte de informação.                Melhor seria se esse espaço fosse usado por pesquisadores ou         jornalista         sem         vinculo         algum com os candidatos, com o único objetivo de contar                 a verdade sobre o caminho eleitoral de cada partido                .']",120,120,120,80,120,560
75,,"['Os estudos das civilizações antigas nos permitem concluir que o ser humano é um ser social, e que para conviver em sociedade precisou conhecer os limites uns dos outros. O corpo social da contemporaneidade evidencia um retrocesso ao tempo do conhecimento, e a ausência desse saber desencadeia incógnitas como a revogação ou não do estatuto do desarmamento que produz mudanças socioeconômicas  no Brasil.', 'O estado psíquico constitui um dos obstáculos para se viver em sociedade, entretanto a proposta não prevê uma avaliação do estado mental do indivíduo que passará o porte. Este fator põe em risco a vida de muitos civis e corrobora para índices cada vez piores de segurança, que serão refletidos na economia do país.', 'É evidente a presença de marginais no cotidiano amedrontando a comunidade, e esta presença se tornaria cada mais perigosa devido a facilidade com que os malfeitores passariam a ter para usufruir do porte de armas indiretamente . Não obstante, se nota ainda que entre a população existe imperícia do manuseio o que acarretaria inúmeros acidentes domésticos e conflitos armados entre civis despreparados e criminosos habilidosos.', 'Em suma  a perca dos valores  e limites entre sociedade, a desconsideração da saúde mental, o despreparo populacional e o deficitário quadro de segurança pública no Brasil compõe as problemáticas a serem sanadas, entretanto o livre porte de arma não seria a solução. Investimentos governamentais na construção de presídios e policiamento nas ruas seriam medidas adequadas, mas a erradicação só seria possível por meio da educação populacional, acabando assim com as bases da violência. ""A educação é a arma mais poderosa que você pode usar para mudar o mundo."" - Nelson Mandela']",120,120,120,120,120,600
59,Por uma distribuição melhor,"['É de nosso  conhecimento que a fome no Brasil é uma das principais causas de desequilíbrio situacional , dentre os demais podemos  citar fatores que formam essa realidade como o próprio desemprego e a falta de equilíbrio social existente em muitos lugares no país.', 'Dentre as causas que levam a essa realidade de muitos passarem fome,  são oriundos diversos problemas como o desemprego que na maioria dos casos é gerado por falta de incentivos e contratações de setores como os privados, em que empresários usem a mão de obra informal ou contrate bem poucos , visto que a mesma ainda é cara aqui no Brasil e os pequenos empresários não tem ainda condições de contratar por estarem começando seus negócios.', 'Outro fator que determina para resultados de situação de fome é a falta de política do destino de alimentos, visto que seu desperdício ocorre em muitos lugares como restaurantes, refeitórios de muitas instituições de ensino, e também em centros de distribuição de verduras e frutas, onde neste ltimo o valor nutricional é colocado em segundo plano, pois visa-se o bom aspecto para que seja exportado ou comercializado para os principais supermercados do país, os demais alimentos então são simplesmente descartados no lixo.', 'Com essa analise , é importante vermos como a fome é o resultado de principais problemas que vão atingindo o Brasil, sendo que muitas famílias não tem como obter meios necessários em adquirir alimentos de qualidade para sua mesa. É preciso que se gere uma política educacional a respeito de como vamos distribuir melhor nossa  renda oriunda de impostos, como também boas orientações por parte do governo de como instituições, empresas, dentre outros,  vão destinar os alimentos que produzem, sendo assim vai resultar em uma melhora de situação em nosso quadro social e portanto menos desigualdade.']",120,120,80,120,120,560
48,Sus,"['Muito se discute o desafio e a importância do Sus  na sociedade brasileira. É notório que é o meio mais eficaz para acolher os cidadãos, é de suma importância a valorização dos postos, upas e hospitais públicos, pois com todas as dificuldade eles procuram atender a população . Dentre tantos fatores relevantes, destacam-se: a má infraestrutura, falta de equipamentos, remédios, leitos e muitos outros elementos essenciais para saúde de todos.', 'Em primeiro análise, evidência as dificuldade no cenário contemporâneo, os hospitais de países sub-desenvolvidos  tiveram colapsos nas redes públicas de saúde. O Brasil tem enfrentado esse problema que infelizmente tem matados muitos seres humanos, o Sus tem tento resistência para prosseguir, entretanto a falta de equipamentos e a colaboração dos poderes dificulta e acabam deixando pacientes sem leitos ,e sem serem atendidos , pois muitos sofrem com a precariedade.', 'Além disso, precisa-se que médicos, enfermeiros, técnico em enfermagem possam ter os seus pagamentos corretamente , pois nem todos os profissionais de saúde tenham seu salário certo, diante dos fatos, note-se o esquecemos da valorização dessas pessoas de suma importância para a sociedade brasileira. Por isso, muitos precisam ter conhecimento da realidade, ajudando indiretamente e diretamente.', 'Dessa forma, portanto o Sus é entrada mais eficaz para a nação, vale lembrar que são postos, upas e hospitais que acolhem todos os pacientes. É essencial que os governos, federal, municipal e estadual tenham a colaboração de ajudar, tendo parceria com ministério da Saúde para cuidar da vida de todos, com projetos, investimentos em leitos, equipamentos, infraestrutura e muitoss outros. Dessa maneira, acaba amenizandoesse problema tão alarmante.']",160,120,120,200,160,760
76,O desafio de ser mulher no Brasil,"['Atualmente no Brasil, as mulheres vêm conquistando seu espaço na sociedade, mas não tem sido fácil superar tantas dificuldades, principalmente com relação as desigualdades e o preconceito pelo simples fato de serem mulheres. Muitos homens e até mesmo mulheres ainda pensam de forma arcaica, considerando que lugar de mulher é dentro de casa cuidando da família, mas sabe-se que hoje muitas mulheres trabalham fora e ao mesmo tempo cuidam de suas famílias, promovendo uma boa qualidade de vida para seus filhos.', 'Ser mulher em um país ainda machista como o Brasil é buscar constantemente o desejo pela igualdade e reconhecimento, pois no trabalho  apesar de terem conquistado cargos importantes, ainda possuem salários inferiores aos homens que tem cargos menores . Outro fator é a questão racial, se ser mulher é difícil imagine se for negra, é pior ainda, a maioria das mulheres não conseguem bons empregos porque além de serem mulheres, são negras, trazendo à tona a sociedade racista que ainda é muito presente no país.', 'Constantemente, é possível presenciar casos de violência contra a mulher, infelizmente muitos homens acham que são donos de suas companheiras, e quando elas ousam querer um pouco de liberdade eles partem para a agressão, e tristemente muitos acabam ceifando a vida dessas mulheres.', 'Diante disso, as mulheres têm reagido, com apoio das leis e da justiça que buscam preservar a integridade e garantir a igualdade entre homens e mulheres, o caminho é longo, mas é perfeitamente possível que todos possam viver em uma sociedade igualitária e mais justa, sem exceções, buscando sempre um futuro melhor.']",120,120,120,120,120,600
88,",","['Na série ""Atypical"" é retratada a vida de um jovem autista e como seus familiares enfrentam as dificuldades que tal transtorno  impõe. Dessa forma, Atypical demonstra a realidade do estigma associado a doenças mentais e como impacta a vida dos que sofrem destas. Nesse sentido, é importante analisar como a falta de informação e a negligência quanto a saúde mental impulsionam a problemática em questão.', 'Em primeiro lugar, é necessário mencionar como o escasso conhecimento provoca esse empecilho. Sob esse viés, o estigma surge a partir da ignorância de não buscar o conhecimento. Dessa maneira, o indivíduo adquire o preconceito sobre doentes mentais ao obter poucas informações relacionadas a como esses problemas afeta e prejudica o sujeito. Assim sendo, a sociedade possui ideais divergentes do princípio de Sócrates,  que visava sempre obter o conhecimento, o que é uma atitude maléfica para o bem-comum.', 'Além disso, faz-se mister ressaltar como a banalização da saúde mental propulsiona esse conflito. Diante disso, o pouco interesse em investir no bem-estar psicológico, por parte da população e do governo, fortalecem o estigma relacionado a esses transtornos. A exemplo disso, foi criada a campanha ""Setembro Amarelo"" para relembrar a comunidade de que essas doenças merecem e devem ser tratadas assim como qualquer outra enfermidade.', 'Portanto, é dever do Ministério da Saúde, direcionar  políticas públicas para o povo por meio do Sistema Único de Saúde (SUS), com a finalidade de enfatizar a necessidade de tratar doenças mentais corretamente e, por conseguinte, essa atitude irá amenizar o estigma existente. Logo, as políticas públicas devem ser ações, como: disponibilização de consultas acessíveis a todos, material informativo sobre os sintomas das principais doenças, que poderão ser distribuidos em postos de saúde. E  por fim, dificuldades como aquelas enfrentadas pelo jovem de Atypical serão menos frequente em vista da diminuição do preconceito.']",160,160,160,200,200,880
44,sem título,"['Segundo Simone de Beauvoir, ""ninguém nasce mulher: torna-se mulher"", mas infelizmente na sociedade atual diversos cidadãos ainda não pensam dessa forma e isso ocorre principalmente no mundo dos esportes, meio no qual muitas pessoas fazem distinção das atletas, fazendo com que elas, muitas vezes, passem por situações que acabam sendo abusivas para provar o seu sexo. Dessa forma há a configuração de um problema causado por procedimentos invasivos e pela discriminação de gênero.', 'De acordo com Hannah Arendt, ""a essência dos direitos humanos é o direito a ter direitos"", no entanto, não é isso que vem acontecendo, tendo em vista todos os procedimentos exorbitantes que violam o corpo das mulheres, pelos quais as mesmas tem que passar no mundo esportivo para provar a sua sexualidade, já que é algo obrigatório, estabelecido pela IFFA (Associação internacional das federações de atletismo), sendo algo totalmente desagradável e isso faz com que nós nos questionemos sobre até quando uma mulher vai ter que provar que de fato é mulher.', 'Além disso, vale ressaltar a grande discriminação de gênero que ocorre nesse meio. Conforme Jhon Locke ""as leis fizeram-se para os homens e não para as leis"", porém apesar de existir normas que penalizam atos discriminatórios , esse ainda é um problema persistente em nosso meio social, por não reconhecerem que ser mulher vai além das características impostas pela sociedade, com isso, este problema prossegue apoiado por uma política estrutural machista que acaba prejudicando diversas atletas, tanto em âmbito social quanto profissional.', 'Portanto precisa ser encontrado uma medida para amenizar tal questão, como a criação de leis, feitas pelo poder legislativo e colocadas em prática pelo poder judiciário, defendendo e visando assegurar os direitos das atletas, condenando atos considerados abusivos e qualquer tipo de preconceito contra elas, freando o problema.']",160,160,160,160,120,760
45,Abuso de autoridade no Brasil,"['Quando falamos de abuso de autoridade no Brasil podemos pensar em diversas situações ocorridas como a força policial, pessoas que se aproveitam de seus respectivos cargos para benefício próprio, fazem coisas por debaixo dos panos sem pensar em consequências e de toda uma sociedade que será afetada por atitudes descabíveis.', 'Nos últimos anos as estatísticas vêm mostrando um grande aumento na porcentagens de PMs envolvidos em abusos de autoridade, muito dos casos acontecem por se tratarem de pessoas negras a violência usada é muito grande, as vítimas são encurraladas sem a menor chance de se defender ou se explicar do ocorrido ou engano que estar acontecendo no momento da abordagem, infelizmente alguns casos são fatais vítimas são mortas por golpes ou tiros desnecessários, chegamos a nos perguntar se realmente era pra ser uma abordagem comum!? temos bastantes exemplos desses casos que ocorrem com frequência. Mas por que isso acontece tanto? será que pensam que não haverá consequências que aquela vida não é importante que por ser uma pessoa negra é um "" bandido"", por diversas situações a própria imagem da polícia fica manchada.', 'Para esse problema tão constante deveria ter punições mais severas, mais treinamento e conscientização para saberem agir nessas ocasiões, com leis mais rígidas poderão pensar mais antes de agir, e depois de imobilizar os suspeitos derem a chance de uma explicação pois muitas vezes pode ser um pai de família em uma situação desagradável e daí tirar conclusões e tomar as medidas cabíveis e usar a força quando necessário.']",160,120,80,120,80,560
94,Os desafios para a inclusão dos indivíduos com transtorno do espectro do autismo.,"['Segundo o Instituto brasileiro de geografia e estatística há cerca de 45 milhões de indivíduos portadores de alguma deficiência no país. Apesar desse cenário é perceptível a falta de medidas para inclusão dessa camada da sociedade, sobretudo, para os indivíduos portadores do Transtorno do Espectro do Autismo (TEA). É evidente que esse panorama tem como origem inquestionável a omissão do Estado, que negligencia as políticas de inclusão do país , principalmente quando se trata da educação de jovens com espectro.', 'Em primeiro lugar, é válido ressaltar a ausência de medidas governamentais para se combater os desafios de inclusão dos cidadãos portadores do transtorno do espectro do autismo no país. Nesse sentido, esse revés permeará no corpo social brasiliano dificultando, desse modo, a universalização de direitos essenciais garantidos na instituição  como a educação e o trabalho que muitas vezes não chegam a ser acessível aos portadores do TEA. Na série, televisiva, ""typical"", é retratada a vida de um garoto autista que ao longo trama está ingressando na faculdade. Da mesma forma, fora da ficção, essa realidade também poderia ser concretizada, caso houvesse medidas mais efetivas de inclusão.', 'Ademais é fundamental salientar o crescente número de jovens com autismo no ambiente escolar. No entanto, as características do autismo são muito diversas, o que exige profissionais com preparo e metodologia adequada para atuarem na educação desses indivíduos. Nesse segmento, podemos afirmar que há um ""deficit"" na educação brasileira. Bem como, é evidente que o corpo social já está habituado a esta problemática  o que torna ainda mais complicada as ações para se combater esse entrave. Paralelo a essa realidade, é válido ressaltar a afirmação do sociólogo indiano Jido krishnamurt, ""não é sinal de saúde está adaptado a uma sociedade doente.""', 'Drepreende-se, portanto, a necessidade de se combater esses obstáculos. Para isso, urge ao governo federal , através do ministério da educação , garantir uma melhor capacitação dos professores e uma maior disponibilização de materiais adaptados . Outrossim, é mister que as instituições formadoras de opinião promovam debates amplos e constantes acerca da importância de garantir o respeito e a igualdade de oportunidades a essa parcela da população , a partir de diálogos e feiras culturais em ambientes educacionais. Assim, se reduziram os empecilhos existentes hoje em relação à inclusão de portadores do transtorno do espectro do autismo no Brasil.']",160,200,120,200,160,840
81,,"['Temos muitos direitos garantidos pela constituição brasileira  que são desrespeitados cotidianamente. A liberdade de expressão é um deles que percebemos por atos de intolerância religiosa. O desrespeito à manifestação da fé alheia deve ser combatido.', 'Muitos têm dificuldade de conviver com as diferenças. Seja cor de pele, orientação sexual ou religião são motivos de agressões, físicas ou verbais, por parte destes  preconceituosos. No mundo temos guerras embasadas em desrespeito às crenças ? como no norte da África ?? em que um grupo sequestrou meninas que, para os extremistas, estavam indo contra o islamimo. Na França ? um jornal foi atacado por fanáticos que se sentiram ofendidos por uma charge. Na cidade do Rio de Janeiro ? uma jovem foi apedrejada quando saia  de um terreiro de candomblé.', 'Somos diferentes e isto é ótimo. A variabilidade em todos os aspectos é importante para a evolução da sociedade. O governo precisa apurar, tratar e punir os denunciados através de canais como o Disque Direitos Humanos (disque100). As escolas precisam abordar aspectos de todas as religiões  gerando um espaço saudável de discussão sobre espiritualidade. Os pais precisam ensinar seu filhos que não temos que concordar com todos e seguir sua fé, mas respeitá-los.']",160,120,160,120,160,720
47,educação  é  para todos,"['A constituição de 1988 garante educação para toda a sociedade. Com crescimento e as inovações tecnológicas já era de se esperar que a educação à distância globalizasse muito rápido ,mas será que o Brasil está preparado?', 'No intuito de conter o avanço da pandemia fez-se necessário a implantação do ensino à distância , no entanto a sociedade não está preparada, este é um fator que já deveria ter sido elaborado para qualquer situação emergencial . As instituições educacionais e os profissionais não tiveram treinamento e nem apoio da secretaria de educação.', 'Em uma primeira perspectiva nota-se a desigualdade social que hordinalmente vem aumentando cada vez mais, o número de evasão escolar já passa dos 50% de alunos e tende a aumentar , pois a tecnologia não chegou para todos. Por mais que tenha o acesso à internet falta recursos primordiais, não só para os alunos mas também para os profissionais.', 'A filósofa alemã Arendt, questiona o processo de massificação da sociedade, o qual forma indivíduos alienados e incapazes de questionar algumas situações, é ,assim caminha a humanidade. Outrossim faz-se necessário que os órgãos competentes tome uma iniciativa emergencial para o treinamento de professores entre outros profissionais, é preciso mais investimento na área da educação , tornase um procedimento imprescindível para democratizar o ensino, a sala de aula de aula digital tem que ser implantada nas regiões onde há um número alarmante de desprovidos de aparelhos eletrônicos a fim erradicar o analfabetismo.']",160,120,80,120,40,520
69,O exagero uso.,"['Desde a Revolução Verde, na década de 1950, o processo tradicional de produção agrícola sofreu drásticas mudanças,  com a inserção de novas tecnologias que visam à produção extensiva. Entretanto, no momento presente, as mudanças ainda vêm ocorrendo drasticamente com o uso indiscriminado de agrotóxicos, que por consequência esta prejudicando a saúde da sociedade brasileira. Nesse sentido, convem analisarmos as principais causas, consequências e possível solução para esse impasse.', 'A constituição Cidadã de 1988,  garante a saúde de qualidade como direito a todos e dever do estado, sendo o compromisso dese prover o acesso igualitário as ações e aos serviços para sua formação e proteção, todavia o Poder Executivo não efetiva esse direito. Assim, a realidade é o oposto desse direito, pois o uso abusivo dos agrotóxicos vem prejudicando cada vez mais a saúde da população. De acordo com o portal de noticias G1, no Brasil o consumo é equivalente a 7,3 litros de agrotóxicos por pessoa todo ano. Diante desse exposto, é inadmissível que a sociedade se prejudique por falta de negligência por meio de fiscalização do poder público.', 'Faz-se, mister, ainda  salientar a falta de informação sobre os riscos desse uso exagerado,  como impulsionador do problema. Outro ponto relevante é o conceito de Modernidade Líquida  do sociólogo polonês Zygmunt Bauman, que explica a queda das atitudes éticas pela fluidez dos valores, a fim de atender aos interesses pessoais, aumentando o individualismo. Desse modo, o sujeito, ao estar imerso nesse panorama líquido, acaba por perpetuar o aumento da produtividade proporcionada pelo uso de defensivos agrícolas em detrimento da saúde humana e do meio ambiente. Diante de tal contexto, a escassez sobre a divulgação desse uso e seus graves efeitos que são prejudiciais à sociedade brasileira.', 'Portanto, indubitavelmente, medidas são necessárias para resolver esse impasse. Cabe ao Executivo Federal, por meio do Ministério da Agricultura estabelecer uma multa ao exagerado uso de agrotóxicos e uma efetiva fiscalização por meio de visitas frequentes em locais de grande produção agrícola, com intuito de estabelecer o uso relevante na produção, a fim de promover alimentos mais saudáveis aos consumidores. Ademais, o Ministério da Saúde em parceria com a ídia, deve promover campanhas e propagandas sobre os riscos intensos desses venenos, por meio de comercias televisionados e redes sociais, com o intuito de alertar a sociedade sobre as graves doenças que podem desenvolver com esse uso, assim deixando as pessoas bem informadas. Dessa forma, o Brasil pode superar o uso que vem ocorrendo drasticamente desses produtos desde a década de 1950.']",120,160,160,160,160,760
58,,"['No Brasil, a falta de preservação da floresta amazônica não é um problema atual: desde a época da Ditadura Cívico-Militar, com o Projeto de Desenvolvimento Nacional, a exploração de recursos naturais foi estimulada com o intuito de promover retorno financeiro ao país, mas, tal política gerou diversos problemas ambientais e sociais, como o desmatamento, que ainda são vigentes no século XXI e demonstram-se nocivos população, tornando seu combate essencial.', 'Em primeira análise, o ciclo do desmatamento consiste em devastar uma área, queimá-la para limpar o solo e depois utilizá-la para pecuária ou agricultura. Dessa maneira, há perda da biodiversidade daquele espaço e do ciclo da água - pois as plantas são responsáveis por devolvê-la para o ambiente através da evapotranspiração ou da filtração, que mantém os lençóis freáticos -, podendo resultar na savanização da floresta amazônica que, ao perder suas características tornando-se um cerrado, causará danos catastróficos à oferta de comida e água mundial, pois é a responsável pelas chuvas que abastecem outras regiões do Brasil, país grande exportador de alimentos.', 'Além disso, por ser a maior floresta tropical do planeta, a Amazônia era a principal retentora de carbono devido a alta taxa de fotossíntese, porém, de acordo com o Instituto Nacional de Pesquisas da Amazônia, graças a grande quantidade de queimadas, sua capacidade de absorver carbono está chegando a zero. Este fato potencializa o aquecimento global, que tem o gás carbônico como principal contribuinte, urgindo, portanto, a necessidade de preservação do ambiente.', 'Assim, para resolver o impasse, torna-se imprescindível que o poder legislativo crie incentivos fiscais, como o abono ou desconto em algum imposto, para empresas que não promovem as queimadas, diminuindo o impacto ambiental. Também é preciso que o Ministério do Meio Ambiente crie mais Unidades de Conservação afim de conter o desmatamento, protegendo a floresta local. Desse modo, e com o auxílio do Ministério da Educação e Cultura através de propagandas nas redes sociais à favor da Amazônia, a importância de preservar a floresta estará enraizada nos brasileiros.']",120,160,120,160,120,680
82,,"['A automedicação configura-se como a utilização de medicamentos por conta própria ou por indicação de pessoas não habilitadas, visando tratar doenças cujo sintomas são percebidos pelo usuário. Embora ela solucione casos de enfermidades triviais, como por exemplo, dores de cabeça e resfriado, é necessário atentar não só para os benefícios  bem como para os malefícios decorrete  da cultura da automedicação.', 'O ato de automedicar-se já está fortemente solidificado na cultura das sociedades contemporâneas,  não raro  nota-se  pessoas ingerindo remédios sem prescrição médica para aliviar cefaléias  ou gripes. Sob o ponto de vista positivo, tal atitude ocasiona a minimização da leva de casos de doenças ccorriqueiras para os hospitais, os quais se encontram em colapso na atualidade, especialmente o SUS (Sistema Único de Saúde). A Organização Mundial da Saúde descreve a automedicação como necessária para certos sintomas em que não seja preciso a observação de um médico ou ida ao hospital.', 'Contudo, o uso indiscriminado de medicamentos como antitérmicos, analgésicos e antiinflamatórios  são os que mais causam intoxicações, de acordo com a ANVISA (Agência Nacional de Vigilância Sanitária). Não apenas o uso indevido desses como também de antibióticos trazem implicações, como por exemplo, o desenvolvimento de bactérias mais resistentes aos efeitos dos antibióticos.', 'Portanto, é indispensável que o ato de automedicar-se seja realizado cautelosamente, tendo em vista as indicações, contra-indicações e efeitos colaterais para o tratamento de doenças triviais. É necessário que o Ministério da Saúde juntamente com as secretárias de saúde estaduais promovam campanhas envolvendo o esclarecimento dos efeitos prós e contras da automedicação por parte de alguns. Embora essa contribua na minimização de casos de doenças leves que podem ser solucionadas em casa, ela também pode ser danosa para a saúde daqueles que a fazem de maneira indevida.']",200,200,160,160,160,880
87,A Influência da Mídia Sobre a Erotização Infantil,"['A erotização infantil é uma consequência da publicidade e do marketing que possuem caráter persuasivo e circulam em diversas plataformas midiáticas. Por atuar como ""quarto poder"" na sociedade, a mídia consegue manipular os indivíduos de acordo com seus interesses. As crianças, por não terem senso crítico formado, são mais suscetíveis a serem influenciadas por propagandas veiculadas pela mídia. O problema da erotização infantil não envolve somente a mídia, mas também diz respeito aos pais.', 'Nas últimas décadas, nota-se o quanto as crianças tem amadurecido precocemente e encurtado a infância. Em decorrência às tecnologias e o marketing feito por influenciadores digitais, as gerações mais novas se tornaram mais consumistas e se expositivas, devido a internet e as diversas plataformas digitais como por exemplo Instagram, Tiktok e Youtube. A superexposição infantil pode levar a erotização da mesma, podendo desencadear problemas psicológicos futuramente. Um exemplo é a cantora mirim Melody, que com 11 anos era sexualizada na internet e gerou uma enorme repercussão sobre como estaria o estado psicológico da cantora ao decorrer dos anos. No cerne deste problema, os pais devem sempre supervisionar os filhos e se policiarem sobre a exposição de seus filhos.', 'No filme ""A Pequena Miss Sunshine"", é retratado o sonho de Abigail, uma menina que deseja se tornar miss mirim. Quando a personagem chega ao concurso, se depara com várias garotas da sua idade que utilizavam muita maquiagem e roupas que não pareciam ser para crianças vestirem. Ademais, a pedofilia também é abordada no filme, pois em concursos assim as meninas são expostas e sexualizadas. Apesar de ficcional, o filme pode ser relacionado com a vida real, já que em ambos alguns pais estimulam o comportamento ""adulto"" sobre as crianças e mesmo que passe despercebido, sempre há pessoas com ms intenções.', 'Portanto, cabe aos pais monitorarem seus filhos e os alertarem sobre os perigos da superexposição e os problemas que podem ser ocasionados. Também cabe ao Estado, incentivar por meio de campanhas e palestras em escolas, a denúncia de casos que violem a integridade das crianças. Além disso, a parte lúdica e cognitiva são desenvolvidas na infância, ambos sendo fundamentais para a aprendizagem, criatividade e relacionamento com as pessoas, fatores que são muito importantes para a formação de cada indivíduo.']",160,160,160,160,160,800
44,Comprovação Feminina,"['Quando se aborda o tema competição, é natural de se pensar que isto consiste em pessoas comparando suas habilidades, sejam físicas ou intelectuais, para decidir quem terá o melhor desempenho. De fato em um sentido literal, sem considerar outros fatores, essa seria a definição. Entretanto pensando de forma igualitária, existem regras e algumas medidas aplicadas ao esporte principalmente, onde os profissionais devem seguir essas exigências, mas nem todo regulamento consegue ser verdadeiramente inclusivo.', 'O escritor e jornalista George Orwell disse que: ""Somos todos iguais, mas alguns são mais iguais do que outros"", essa percepção trás reflexão de que mesmo que haja igualdade predominante, terá quem não se encaixe, como ocorrido no meio esportivo feminino, onde a atleta Caster Semenya foi impedida de competir por ter um nível elevado de testosterona (hormônio responsável pelos músculos, aparece em maior quantidade nos corpos masculinos). Esse acontecimento exige um certo cuidado nos detalhes para se discutir, pois, deve-se lembrar que ela enfrenta um problema hormonal que não se ocasionou por intenção da mesma, porém essa condição trás privilégio aos olhos da organização, é exigida uma medicação para controlar esse problema afim de que nenhuma candidata saia em desvantagem, o que pode parecer ético mas uma infelicidade para a atleta que se preparou muito psicologicamente e fisicamente.', 'É muito importante a preocupação da instituição com o uso de hormônios como forma de obter vantagem, mas nesta situação a decisão que foi tomada em consequências de causas naturais, pode causar um abalo emocional na competidora que terá visão de ser menos feminina é passa o constrangimento de comprovar que independente dessa condição é como as outras mulheres. A Federação Internacional de Atletismo  poderia criar uma categoria para que as mulheres com essa diferença e até mesmo para as mulheres transexuais que desejam participar, possam se sentirem incluídas e respeitadas, o uso de um remédio ou comprovação feminina não seriam necessários evitando toda essa situação, obvio que para uma medida como essa será necessário estudo e preparação, mas certamente é possível.']",160,160,120,120,160,720
149,Ideia de Outro Mundo,"['O planeta Marte atraiu muitas atenções em agosto passado devido a um projeto que pretende colonizar                 a região                . Esse projeto alemão da empresa Mars One permitiu a inscrição de                 todos indivíduos                maiores de dezoito anos, desses muitos inscritos quatro serão ?felicitados? com uma         viajem         ao planeta vermelho. A expedição possui um porém, já         apresentada         aos candidatos, a passagem para Marte é só de ida.', 'Desde os primórdios o ser humano é apaixonado pelo espaço, e nunca, como hoje, estivemos tão perto de desvendar mistérios galácticos que tiravam o sono de nossos ancestrais. Mas será que é válido, simplesmente                 pela                curiosidade humana, enviar quatro indivíduos a outro planeta sem direito a retorno?                 Não, soubemos                esperar longos anos                 para muitas          pergunta         , podemos esperar também mais alguns anos de segurança, para que haja volta.', 'As pessoas que se inscreveram provavelmente cegas pela fama e renome que terão em livros de         história nem se quer         sabendo dos detalhes da expedição da Mars         One          toparam                morrer em Marte.                 Há contrapropostas que dizem que tudo precisa pioneirismo, nem tanto, na época das navegações os países eram colonizados com garantia.                Quem garante que na expedição da Mars One equipamentos não se quebrem, comidas não         se faltem         e desastres não aconteçam? Sempre é         Melhor         prevenir do que remediar, para que os livros de história e o planeta vermelho não acabem manchados de sangue.']",120,120,120,120,80,560
89,Pandemia,"['Durante o ano de 1918, uma epidemia de gripe espanhola alastrou-se pelo Brasil. Nessa, evidenciou-se o enorme fosso que havia entre os pobres e abastados do país: aos primeiros, restava apenas instituições de caridade, enquanto os segundos podiam refugiar-se em fazendas no interior. Outrossim, a pandemia de Covid-19 demonstrou o quanto essas desigualdades ainda perduram em nossa sociedade e, consequentemente, dificultam a conscientização da população diante da crise econômica. Logo a coesão social só irá ser promovida a partir do combate dessas disparidades.', 'Em primeira análise, salienta-se que os principais opositores às medidas de isolamento social argumentam que essas embargam a economia e causam desemprego. Entretanto, um estudo da Universidade Estadual de Campinas (Unicamp) e da Universidade do Texas projetou que o isolamento social mitiga os casos e mortes de Covid-19, mas não prejudicam fortemente a economia. Ademais, a estagnação financeira de nosso país é anterior a atual crise sanitária, e essa é agravada, sobretudo, pelas disparidades sociais.', 'Em segundo plano, destaca-se que a nossa Constituição defende a igualdade de todos perante a lei. Contudo, durante a pandemia, as evidências dos diversos entraves promovidos contra as populações mais vulneráveis tornaram-se mais escancaradas: vivem em espaços que dificultam o distanciamento social; não possuem empregos formais que lhes permitam o afastamento do trabalho e, até mesmo, o saque dos auxílios governamentais é feito diante de enormes filas nas agências bancárias. Sendo, assim, conforme o a perspectiva de Thomas Hobbes (filósofo inglês), as instituições têm um papel crucial na manutenção da estabilidade social e, por conseguinte, o Estado deve ser o principal defensor dessas populações e coibidor das desigualdades sociais.', 'Portanto, o combate das disparidades sociais é fundamental para a conscientização da população diante da crise econômica. Para isso, os Ministérios da Economia e da Cidadania devem  implementar um projeto de mitigação das desigualdades através de um maior repasse de recursos para o desenvolvimento das regiões vulneráveis; bem como os Ministérios da Saúde e da Educação devem promover campanhas educativas sobre a importância do distanciamento social para aplacar a pandemia através da mídia e redes sociais. Desse modo, o Estado cumprirá o seu papel de zelador social - como preconizado por Hobbes - e promoverá o fortalecimento da coesão social.']",200,160,160,200,160,880
84,Defender-se ou combater?,"['O porte de armas tem gerado controvérsias diante do cenário catastrófico decorrente de atos como o ataque na boate em Orlando e, anteriormente, o massacre de negros em uma igreja, também nos Estados Unidos.', 'Tal polêmica relaciona-se intrinsicamente ao conceito de micropoder de Foucault, uma vez que a posse de armas significa poder e autonomia para exercer a justiça, baseando-se nos valores de cada cidadão. Dessa forma, uma pessoa vê-se no direito e na liberdade de atirar em outrem para reestabelecer a harmonia em seu meio, ou, como nos casos citados, para destilar o ódio e canalizar preconceitos e racismos.', 'A partir de tal raciocínio, a posse de armas pela população civil (segue) na contramão do combate à violência, gerando um dispersor de atos violentos, como lutar contra a violência utilizando-se da mesma. Além disso, conflitos banais como brigas de trânsito e discussões domésticas podem tomar proporções trágicas, não se limitando a exaltações verbais.', 'O porte de armas pela sociedade civil como defesa pessoal trata-se, ainda, de uma medida superficial e pouco eficiente, quando se deve mover esforços para combater a violência e não procurar meios que considerem a sua continuidade.', 'Dessa forma, o uso livre de armas de fogo pela sociedade deve ser submetido a um estudo aprofundado, levando-se em conta a violência - problema que coloca em pauta tal questão - e se a adoção dessa medida significará grandes avanços ou retrocessos na luta contra esse malefício social.']",200,200,160,200,200,960
44,...,"['No século 18 , popularmente conhecido como "" era vitoriana "" uma mulher era avaliada como mulher perante a sociedade de acordo com o quão essa mesma aparentava ser feminina e comportada , atendendo a todas as normas de comportamento , desde usar apenas longos vestidos que cobriam quase que completamente seus corpos , até não poder em hipótese alguma sair na rua sem a companhia de seu pai ou marido .', 'É inegável dizer que hoje mesmo que vivamos em tempos modernos esse tipo de padrão estético e comportamental ainda assola a vida de muitas mulheres , em especial é coerente citar aquelas que praticam esportes , que por não serem consideradas femininas são frequentemente associadas a imagem de não serem realmente mulheres  , esse pode ser posto como o principal preconceito que leva testes invasivos de gênero em mulheres atletas .', 'Perante tal contexto é inquestionável destacar a necessidade de que as associações de atletas  prezem não só por respeitar a privacidade de suas atletas , estando cientes que tais testes podem ser considerados uma atitude abusiva , mais também estejam cientes que não existem características em termos de aparência consideradas exclusivas de apenas um gênero .azendo isso a identidade dessas mulheres será devidamente respeitada , comprovando que nenhuma mulher precisa provar para alguém que é realmente mulher.']",160,120,120,120,120,640
83,Em Busca da realização dos sonhos,"['O Esporte é muito importante na vida de todos, pois, ele agrega valores, e o respeito e o principal. Arte, beleza e encantamento é o que vemos no jogos Olímpicos! A união das nações na festa do esporte. Superação, alegria, amor e patriotismo, na face de cada guerreiro, onde a guerra é pala perfeição. E a arma é a superação de si mesmo. Vencendo os limites,escalando suas próprias fortalezas, conquistando o impossível com raça e fé.', 'É lamentável que no Brasil a política de esporte seja muito pouca. Todos não têm as mesmas oportunidades e incentivos necessários para se tornarem grandes atletas. E fazer de seu esporte sua profissão. Na maioria das vezes, os atletas brasileiros abandonam o esporte por falta de ajuda financeira, pois para se chegar ao topo é preciso muita dedicação e raça. Não é atoa, que, as grandes potências mundiais são as maiores medalhistas,elas investem em seus filhos com incentivos e precisão. Assim, promovem verdadeiras fabricas de campeões.', 'O que, um homem pode, um outro homem também pode! É triste ver, os atletas dos países, onde seus governantes não investem no esporte, eles chegam acanhados, pois sabem que a competição não terá o mesmo nível de competência, e não por culpa deles, e sim por falta de oportunidade, de ter um treinamento igual. O mundo seria bem melhor se todos tivessem os mesmos direitos e deveres.', 'O esporte é importante para todos. Pois, ele, distrai, diverte e ensina. Ele une as pessoas para torcer e acreditar que, a maior força da humanidade são os sonhos. E com apoio e incentivo, eles podem se transformarem em realidade. Porque, quando se mata um sonho, se morre junto com ele. O esporte é vida! Para atletas profissionais e amadores. .']",160,120,160,120,160,720
81,A Persistência da Intolerância Religiosa,"['A intolerância religiosa é um tema recorrente na sociedade atual. A intolerância religiosa é o ato de desrespeitar, ofender ou tratar de forma diferente aqueles que seguem uma religião diferente. Não são raros os casos relacionados a ela. Ela tende a aparecer de diversas maneiras, sendo uma piada ou chegando ao ponto de agressão.', 'O Estado laico é aquele que aceita toda forma de religião, além de não ter uma religião oficial ou negligenciar alguma outra. Mesmo com opções variadas de religiões, nenhuma delas é correta ou errada, muito menos melhor que outra. Mas porque  isso  ainda persiste na nossa sociedade ? É comum da população ter medo daquilo que lhe é estranho e ? tendo medo, ela tende a ser preconceituosas com o diferente. Isso é algo muito comum no nosso país, sendo que as religiões que mais sofrem preconceito são aquelas de origem africana.', 'A religião tem que ser algo independente do Estado, não interferindo em nenhum assunto de cunho político, ?  ou qualquer outro que não seja de sua finalidade. A tolerância é algo que deve sempre estar presente, assim como o respeito. Existe um Disque Denúncia  na Secretaria dos Direitos Humanos, mas as denúncias recebidas são poucas comparadas ao que realmente ocorre na sociedade, ?]  muitas vezes a pessoa não se pronuncia por medo do que pode ocorrer com ela. A população precisa ser mais tolerante para melhorar e a melhor maneira de se fazer isso é através  da conscientização, não só para não se praticar deste  desrespeito, mas para denunciar quem pratica deste  ato.']",160,120,120,120,120,640
59,,"['O Brasil é considerado o quinto país desigual  do mundo de acordo com dados da ONU (Organização das Nações Unidas)sendo a desigualdade parte constituinte de um problema gritante no Brasil, a diferença econômica. É de conhecimento geral que no regime capitalista os detentores dos meios de produção se tornam uma pequena parcela da população que é favorecida economicamente, enquanto o proletariado se torna uma massa de menor renda, como apresentando por Karl Marx. Todavia, isto se torna um problema quando a maior parte da população se encontra em uma situação financeira precária, como o que ocorre no Brasil.', 'Vale-se citar que as diferenças salariais e de oportunidades de emprego muitas vez tem base em preconceitos raciais e de gênero  gerando uma baixa renda e desfavorecendo estas pessoas a vidas dignas . No Brasil dados apresentam que a maior parte da população de baixa renda ou em situação de extrema carência é constituída por pessoas negras e transexuais que em conseqüência disto vivem em condições precárias, com menor – ou nenhum- acesso a saúde, alimentação de qualidade e educação.', 'Diante disto, na situação de pobreza a fome se torna uma das conseqüências mais dolorosas desta desigualdade, sendo esta uma necessidade básica que entra em necessidade, os seres humanos tomam medidas drásticas na busca de sua saciedade e da sobrevivência, acarretando em delitos como roubo, violência e formas ilegais de obtenção de dinheiro, dado vez a mais problemas sociais e se tornando uma grande bola de neve.', 'Portanto, em prol da sociedade, o governo deve visar políticas que diminuam substancialmente os privilégios as oportunidades e as rendas, com leis mais assertivas quanto a igualdade social e um estimulo maior ao acesso a educação de qualidade para crianças crescidas em situação de miséria, dando maiores chances de empregos. Em conjunto disto, cabe a população estimular as campanhas que propiciem ajuda aos necessitados como a doação de alimentos e roupas, e mesmo as campanhas educacionais.']",120,120,120,120,80,560
65,O jovem e a criminalidade,"['No Brasil, é assustador as taxas de criminalidade entre os jovens . Isso se deve a vários fatores, como a impunidade, estrutura familiar debilitada, evasão escolar e falta de oportunidade. A redução da maioridade penal, assistência social, nova base comum curricular e integração empresa-escola pode ser um grande passo para resolver o problema.', 'No país, os jovens são penalmente inimputáveis, ou seja, até os dezessete anos podem sofrer apenas medidas protetivas ou socioeducativas quando praticam atos infracionais, o que torna o crime viável a eles.', 'É fato, também, que os jovens que aderem ao crime são, na maioria das vezes, advindos de famílias de pequeno poder aquisitivo e desestruturadas, o que coopera ainda mais para o adentramento de jovens no crime.', 'Ainda assim , soma-se a isso a taxa absurda de jovens que evadem, principalmente, do ensino médio para uma sociedade em que faltam oportunidades de trabalho, ainda mais para inexperientes sem estudo.', 'O Estado, portanto, deve aprovar e sancionar a lei que reduz de dezoito para dezesseis anos a maioridade penal, criar um programa de assistência social para dar apoio as famílias mais vulneráveis, homologar a base comum curricular (BNCC) para o ensino médio e criar programas de integração empresa-escola para facilitar a entrada dos jovens no mercado de trabalho. Dessa maneira, a vida regrada será a melhor opção, culminando, assim, no afastamento dos jovens do crime.']",160,120,80,80,120,560
76,Transformação,"['Equilibrar a igualdade sempre é um grande desafio. Imaginem a igualdade antológica dos gêneros, é quase impossível . A desigualdade social, educacional e trabalhista sempre foi normal para a mulher. Desde o principio do mundo que ela foi tratada como uma coisa  e nunca com um ser igual.', 'Esse raciocínio tribal perdurou por milênios na historia da humanidade. Por ser mais fraca fisicamente , a mulher era deixada de lado para as grandes conquistas dos homens, assim sua única função era a procriação, se ela não fosse agraciada com a fertilidade, perderia a função de existir perante a sociedade patriarcal .', 'Hoje, milênios depois a mulher ainda tem que lutar por direitos dados por Deus e tomados pelos homens. Uma sociedade civilizada não pode permitir que pessoas igualmente capacitadas ganhem menos ou mais dinheiro para exercer a mesma função. Isso não é inconstitucional? Que a mulher se qualifique cada vez mais, porque nada supera o conhecimento. Que a ascensão feminina seja uma coisa  natural e nunca uma coisa  extraordinária.', 'Para equilibrar a igualdade dos gêneros é preciso que as mulheres sejam tão unidas quanto os homens. A mulher ainda é mais critica que os homens. Essa supremacia masculina milenar deixou sequelas, A presidente do Brasil Dilma Rousseff era duramente criticada por ser mulher. As criticas ás arbitras de futebol são cruéis e pejorativas. Não se pode ser tolerante com o desrespeito. As deputadas e senadoras são duramente ofendidas pelo machismo em pleno exercício do trabalho. Os salários no Brasil são diferentes porque o homem não aceita ser comandado por mulher. É preciso uma mudança de comportamento da sociedade. As escolas, as famílias e as religiões serão de grande ajuda nessa transformação']",120,120,80,120,80,520
84,Desarmamento um olhar humano.*,"['O porte de armas no Brasil, é um problema que a sociedade vive a anos, mas a partir de 2003 quando entrou (em vigor) o Estatuto do Desarmamento teve sua melhora em relação a mortes por portes de armas, (.) Mas agora o estatuto pode ser revogado, e isso trás uma discussão muito séria.', 'Sabemos que os maiores índices de mortalidade vêm por conta de armas,e quando entramos no assunto em questão que é a autorização de licenças ao porte de armas , devemos ter um olhar para a civilização e o fato (de) que isso afeta vidas, pois isso so fortalece indústrias de armamentos, e perdemos muito mais. Civis que usam de argumentos como para se proteger e por isso mantêm armas em seus lares, deveriam enchergar todo um consteto e ter empatia pelo próximo.', 'O Desarmamento é algo importante, e que deveria ser respeitado e ganhar mais força e leis mais rígidas, pois a população não ganhará nada se armas forem combatida por armas! Pois no final é uma vida que pode ser poupada. Então o Estatuto do Desarmamento precisa de mais força (e) visibilidade principalmente das grandes mídias, e um olhar humano da sociedade.']",120,120,120,160,200,720
36,"Escravidão no mundo, basta!","['Muitos povos já foram escravizados durante a história brasileira: os índios, os negros e seus decentes e imigrantes de diversas nacionalidade. Após décadas da abolição, o trabalho escravo ainda acontece nos dias atuais, o qual abrange pessoas em vulnerabilidade social.', 'É importante pontuar de início como, a escravidão moderna é um fato atual que afeta 45,8 milhões de pessoas em todo o mundo. As consequências desse tipo de prática são danosas para toda a população. Muitas crianças que poderiam estar estudando, jovens se profissionalizando e consequentemente, contribuindo para a evolução do país estão condenados a essa situação indígena.', 'É fundamental pontuar ainda, as situações hediondas que essas pessoas vem passando, como o tráfico de pessoas, a exploração sexual, o recrutamento de pessoas para conflitos armados entre outras. Práticas essas que ferem os direitos humanos, e consequentemente tirando o direito de muitos cidadãos.', 'Portanto para acabar com a escravidão moderna, são necessários conjuntos de medidas, e fiscalização precisa do governo, para confiscar produtos tenham mão de obra escrava e aplicar multas para desencorajar a prática no mercado. Além disso criar ouvidoria simplificada e funcional, para que as pessoas denuncie a prática.']",80,0,0,0,80,160
84,Um imperativo à vida,"['A instabilidade em muitas situações, faz com que surja a necessidade de estratégias de segurança para andarmos por esta lida de uma forma menos dispendiosa e insegura, fazendo com que o indivíduo sempre  se encontre numa constante busca por seguridade. Essa necessidade também incorre  concomitante com a nossa segurança pessoal.', 'Diante disso, em nossa nação, há alguns anos vem tramitando-se projeto em que favoreça a garantia do poder do uso de arma de fogo pela população,a chamada PL 3722/12, que  visa o direito à vida, seguridade, pessoalidade, atributos inerentes à condição humana. Ca futura  aprovação desse planejamento,permitirá a flexibilidade às antigas estruturas rígidas que foram reconstituídas, retornando ao cidadão o direito de defesa pessoal, fato inquestionável, principalmente em condições de tanto receio e violência.', 'Tal fato é comprovado, quando mostramos de forma democrática, através do referendo com mais de 60%, o favoritismo ao porte de arma pela população, rejeitando com grande força composições contrárias. Atenuando-se ainda mais o interesse de cada indivíduo num poder de proteção mais presente.', 'Insegurança, é o sentimento que paira sobre nosso país. É de grande pertinência e prioridade o uso legal do porte de armas, pois sua viabilidade possibilitará mais segurança. É louvável políticas de incentivo a proteção à vida, e deverá ser sempre mantidaa. “ Viver é sagrado!”, afirma os brocados(?) populares. Que todos como nação, tomemos consciência do verdadeiro patrimônio.']",120,160,160,120,160,720
95,luta pelos direitos,"['Na obra “Ensaio sobre a cegueira”, do escritor português José Saramago, o autor utiliza o termo “cegueira branca” para referir-se à nação que finge não enxergar os problemas presentes em seu meio social. Externo à literatura, a sociedade atual vai ao encontro com o exposto por Saramago, uma vez que, no Brasil, o corpo social tem o olhar pouco voltado acerca dos debates sobre o marco temporal. Nesse contexto, deve-se analisar como a negligência estatal e a falta de empatia social impulsionam tal problemática, com o intuito de solucioná-la.', 'Sob esse viés, é fulcral ressaltar como a negligente ação das entidades estatais perpetua o imbróglio. Nesse sentido, o filósofo contratualista John Locke afirmava, através do cetro social, que é um dever do estado garantir os direitos de toda a nação, como à segurança. Entretanto, é fato que isso não ocorre efetivamente no Brasil, visto que a falta de amparo para com os povos indígenas em luta contra o marco temporal, a exemplo, escasso apoio em protestos, é alarmante. Consequentemente, os povos indígenas ficam privados dos seus direitos e sem assistência governamental. Desse modo, urge uma mudança dessa postura estatal para bem-estar dos povos originários.', 'Outrossim, é imperativo pontuar a falta de empatia dos brasileiros como prorrogadora do empecilho. Nessa lógica, o sociólogo polonês Zygmunt Bauman disserta em sua obra “Cegueira moral” acerca da população que vive em tempos de modernidade líquida, no qual a indiferença ao próximo é habitual. Sob tal ótica, é notório que a liquidez citada por Bauman está presente na sociedade hodierna, tendo em vista o comportamento indiferente da nação, no que diz respeito falta de empatia com população indígena, por exemplo a violência. Logo, é indubitável a reversão dessa conjuntura nefasta para garantir a proteção dos indivíduos.', 'Portanto, diante do problema exposto, faz-se importante a criação de medidas para conter os impactos do marco temporal no cenário brasileiro. Para isso, o Estado, no papel da Fundação Nacional do Índio – FUNAI-, órgão responsável por proteger e promover os direitos dos povos indígenas no país, a fim de garantir os cumprimentos dos direitos dos índios, deve criar projetos, por meio da criação de grupos de apoio do governo, que ajudem tais sujeitos a lutarem por seus direitos. Ademais, cabe ao governo federal, com o objetivo de garantir a segurança e integridade indígena, criar grupos de segurança, através da convocação de policiais militares para vigiarem manifestações e locais de habitação. Destarte, não haverá debates sobre o marco temporal e o Brasil se afastará da sociedade de Saramago.']",160,200,160,200,200,920
48,Alvo de reclamações,"['Apesar de inúmeras críticas e reclamações hoje, em meio a pandemia do Covid-19 podemos  ver o quão importante é o sistema unico de saúde para os brasileiros, principalmente para pessoas de baixa renda.', 'O SUS é principalmente criticado em relação ao tempo que deve ser esperado, muitas pessoas reclamam de ficar esperando para serem atendidos, realizarem suas cirurgias, que muitas vezes é de extrema urgência, mas essas pessoas acabam não levando em consideração que é preciso ter vagas, que se deve ter calma.', 'Apesar de tudo isso podemos ver o quão importante é o SUS para pessoas que não tem condições para usufruir de uma consulta, um exame particular, que apesar da facilidade, da rapidez, não são viáveis pessoas de baixa renda.', 'São milhares de brasileiros precisando de consultas, exames, do SUS. Portanto, os brasileiros devem ter paciência, tudo pode se resolver com calma, reclamações são bem-vindas e críticas construtivas também, mas sempre tendo respeito.']",160,120,120,120,0,520
54,As vacinas em mãos de quem?,"['O papel da vacinação é imprescindível, afinal ela é um estímulo para o corpo humano produzir e desenvolver a imunidade para a proteção de doenças . Porém, é uma realidade que parte da população brasileira não tem estado com seus cartões de vacina em dia, permitindo assim que surtos de doenças anteriormente erradicadas venham surgir, a exemplo do sarampo, e que o poder público tem se mostrado negligente com a saúde em todas as regiões brasileiras.', 'O poder estatal por falta de políticas públicas agride a Legislação, dessa forma, a negligência estatal representa uma das causas da problemática, afinal, a saúde pública tem sido abandonada em todo o país, a falta de frequência em campanhas de vacinação, até mesmo a falta de estoque de vacinas é o reflexo disso. Por causa de todas essas coisas, o movimento anti vacina  tem crescido e se instalado por todo o país, convencendo famílias a deixarem principalmente as crianças sem a proteção necessária que as vacinas oferecem, deixando seus corpos de “portas abertas” para doenças graves, como atualmente é o caso do sarampo, onde inúmeras crianças morreram no Brasil em decorrência desta doença.', 'Portanto, é de responsabilidade do poder público a conscientização da importância das vacinas, a realização do controle do estoque destas nos postos de saúde, aumentar a frequência das campanhas de vacina, e também a criação de políticas para coibir os grupos anti vacina, a elaboração de estratégias para a redução de fake news , em virtude do problema à sociedade que isso vem trazendo.']",120,160,120,120,120,640
62,,"['Facebook, Twitter, Instagram: são algumas das redes socias nas quais indivíduos, muitas vezes por trás de um perfil “fake”, disseminam suas ideologias tendenciosas e incitam o ódio. Nessa perspectiva, o discurso de ódio nas redes sociais brasileiras é cada vez mais recorrente e suas possíveis causas são a falta de medidas de punição no ambiente virtual e falta de medidas educativas para impulsionar o combate de tal problemática.', 'Paralelo ao pensamento iluminista de Jean-Jacques Rousseau, o homem nasce como uma folha lisa, porém encontra-se presa a um caderno . Não é diferente com os usuários dentro dos ambientes virtuais que, certos da sua impunidade, destilam discursos de ódio e de cunho depredatório, presos a um perfil falso ou ao famoso anonimato . Ainda vale ressaltar que o pensamento intolerante desses grupos, considerados como “haters” nas redes sociais, é resultado de uma educação má estimulada e desenvolvida, pois, segundo o pensamento da escritora Helen Keller, “o resultado mais sublime da educação é a tolerância” . Nesse sentido, infelizmente, indivíduos não se preocupam com a punição, pois sabem das lacunas falhas da segurança cibernética e da falta de legislações referentes a esse contexto.', 'Outro olhar faz-se mister, mas direcionado aos programas educacionais que visam construir cidadãos mais conscientes e menos tóxicos. Para o filósofo e educador Paulo Freire, “se a educação sozinha não muda a sociedade, sem ela tampouco a sociedade muda”. Nessa perspectiva freiriana, o sistema educacional faz parte de um processo no qual todos devem cooperar para que a sociedade ascenda positivamente, diminuindo assim o ativismo extremista nas redes sociais, tanto no meio digital quanto no físico, e aumentando a mudança do comportamento dessa parcela da população que se julga detentora dos verdadeiros saberes. Como dito pelo discípulo de Sócrates, Platão, em reação do caos e da desordem em que a educação se encontra, apesar de suas raízes amargas, o fruto há de ser doce. Sem mais, é escuso qualquer argumento que defenda não ser a educação ferramenta transformadora.', 'Para tanto, medidas provisórias devem se principiar para mitigar tanto individualismo na internet. De início, o Ministério da Educação e Cultura (MEC), intrínseco do Governo Federal, deve implementar à Base Nacional Comum Curricular competências, conhecimentos e habilidades que estimulem um posicionamento adequado desses futuros cidadãos, como a criação de um Guia da Internet Nacional, por exemplo. Dessa maneira, “fakes”, anônimos, “haters” deixariam de existir e o “espírito digital do bem” seria compartilhado de geração para geração.']",120,160,120,160,120,680
93,A questão da falta de acesso do parto humanizado no Brasil,"['No documentário “O renascimento do parto”, nota-se uma abordagem que busca retomar o protagonismo da mulher no parto, a fim de se atender as necessidades da mãe do bebê com o mínimo de intervenção médica possível, desde que não haja riscos para os envolvidos. Em consonância com esse documentário, está a de alguns movimentos que ganharam espaço na sociedade brasileira, ao defender o parto humanizado. Muitos destes grupos solicitam a autonomia de decisão por parte da mulher e questionam as altas taxas de intervenções nos partos nacionais, uma vez que, segundo dados da OMS (Organização Mundial da Saúde), o Brasil realiza quase quatro vezes mais cesáreas do que os 15% considerados aceitáveis. Isso ocorre seja pela negligência ou pela precariedade governamental ao atuar nesse cenário . Assim, é necessário debater essa questão, para que o âmbito do documentário possa estar presente na realidade.', 'Nessa perspectiva, acerca da lógica referente às intervenções desnecessárias nos partos brasileiros, é válido retomar o aspecto quanto à omissão estatal nesse caso. No Brasil, existem poucas áreas especializadas em atender o público materno que intenciona o parto humanizado. Além disso, hospitais públicos, que atendem um elevado número de mulheres, apresentam debilidade em suas estruturas para atender um grande público. Tais conjunturas segregacionistas contrariam o princípio do “Espaço público”, da filósofa Hannah Arendt, que defende a total inclusão dos oprimidos- aquelas mulheres que desejam ter um parto humanizado e não dispõem de condições financeiras para custear um local especializado, nesse caso - na teia social.', 'Com isso, torna-se evidente que o desleixo governamental em atendimentos hospitalares eficientes, juntamente com a falta de informação a respeito das possíveis consequências de mediações desnecessárias durante o parto e a omissão dos benefícios do parto humanizado, contribui para a indução da mulher em optar por interferências médicas durante o parto.', 'Portanto, medidas são essenciais para resolver as atribulações relacionadas ao parto humanizado no Brasil. Para isso, compete ao Ministério da Saúde  investir na melhora da qualidade de partos humanizados em hospitais públicos ou locais gratuitos especializados nesse atendimento, além de,  investir em pré-natais públicos que informem as gestantes de forma transparente a respeito dos tipos de partos. Essas ações públicas devem ser feitas por meio de recursos fornecidos pelo Tribunal de Contas da União, a fim de potencializar o atendimento às gestantes de forma eficaz. Assim, as intervenções nos partos nacionais poderão ser reduzidas e a maior parte da população terá acesso aos partos humanizados.']",200,200,160,200,160,920
143,Criminalidade X Solidariedade,"[""A violência do trote universitário humilha e maltrata calouros em vários                 campos                brasileiros, são alunos veteranos que fazem do que deveria ser uma recepção divertida e         educativa, em uma 'brincadeira'         violenta e desumana."", 'Desde o início das          faculdades  ouve se         falar em trote, porém, o verdadeiro objetivo nunca foi a descortesia com os         novatos, e sim o introzamento         solidariedade e a transferência de culturas.                 A polêmica sobre o assunto já é tanta que transparece que sua função é o crime,                mas o motivo dessa violência sem fim é a falta de vigilância,                 o uso desregrado de materiais                e a certeza que não haverá uma punição justa.', 'Havendo uma         preparação         assim como         é organizado         campeonatos e jogos entre         cursos, pode se também ser feito tal recebimento         , com o envolvimento e a colaboração de todos da universidade e o apoio da         polícia militar         mantendo a segurança.', 'Desta forma         poderíamos transformar o que antes era um problema em uma ação de bem, com                 gincanas solitárias como recolhimento de sangue, arrecadação de alimentos         e, debates         sobre conhecimentos gerais, assim a maldade de alguns não seria prejudicial aos demais.']",120,120,80,80,80,480
87,Sexualização infantil,"['Não é novidade que com a chegada da internet e o mundo das mídias sociais as pessoas estão expondo cada vez mais suas vidas online, uma das formas de exposição mais sensíveis que há é envolvendo crianças.', 'Atualmente é cada vez mais comum observar crianças com um comportamento impróprio para sua idade, em alguns lugares vira um requisito, como se fosse necessário tal adultização, elas que muitas vezes influenciadas pela mídia desejam aparentar e agir como se fossem mais velhas tentam pular fases essenciais da vida para seu crescimento, se mostram de forma sexualizada  tanto online quanto em seu cotidiano. De forma geral, apresentam aspectos não saudáveis que não condizem com a sua idade, coisa que é prejudicial para a criança e poderá afetar seu desenvolvimento futuro, a infância é uma parte crucial da vida de qualquer pessoa e jamais deve ser negligenciada.', 'No entanto é de suma importância que os pais fiquem  atentos e não tentem incentivar tal comportamento em seus filhos, procurem supervisionar os conteúdos consumidos pelos pequenos e manter hábitos condizentes com a idade da criança.']",160,120,120,120,120,640
21,A paralisação nacional,"['O assunto mais comentado no final do mês de maio de 2018 foi a Greve dos caminhoneiros, com consequências que puderam ser sentidas em todo o país. Tais grevistas lutavam por condições dignas de trabalho e com preço de combustível acessível, pois os altos valores tornavam os transportes de mercadorias inviáveis no país.', 'A proposta da greve teria se iniciado de forma espontânea nas redes sociais. Uma das principais entidades que estava envolvida no movimento foi a Confederação Nacional dos Transportadores Autônomos, além de outros sindicatos relacionados à área. No decorrer do movimento, houve paralisação de caminhões e bloqueios de estradas, que impediam a passagem de automóveis, o que acabou causando a falta de combustíveis, alimentos, gás de cozinha e, em alguns lugares, até a falta de medicamentos.', 'Não demorou para o presidente negociar com os caminhoneiros: propôs uma redução de 0,46¢ no óleo diesel, o que, entretanto, não era suficiente, mas, como não houve o apoio da população geral, foi findada a greve .', 'Contudo, é de se perceber que o nosso país necessita de mudanças, as quais devem favorecer o povo brasileiro e não o prejudicar, como o que vem acontecendo. Por isso, é preciso que o povo lute, faça greves, manifeste, para o Governo ver que o verdadeiro poder está nas mãos do povo.']",80,80,80,80,0,320
52,Falta de conhecimento entre adolescentes,"['Sem nenhuma orientação, muitas adolescentes começando ali sua vida sexual,engravidam. Pois ignoram a existência de metados contraceptivos, deixando assim de lado grande parte da sua adolescência para cuidar dos seus filhos.', 'Ademais, são vários os casos de garotas entre 13 e 19 anos grávidas, por falta de conhecimento, talvez? ou por realmente quererem ter uma família cedo , Sabemos que com tudo isso é um impacto muito grande para a sociedade, pois deixam de frequentar a escolar, também acorrem problemas de saúde, o apoio da família muito pouco, deixando assim muitas vezes a mente da adolescente perturbada, chegando a muitas optarem pelo aborto ilegal, colocando assim nao só a vida da criança como a da própria adolescente em risco , ou deixam para a adoção, pois não tem nenhuma ideia de como cuidar de uma criança, durante esse período muitos sonhos são deixados de lado. Sendo assim um impacto socioeconômico muito Grande.', 'Muitos médicos dizem que a melhor solução é os metados contraceptivos como a camisinha, pílulas anticoncepcional, entre outros, a orientação também é muito importante, conversar, alerta sempre os jovens para não acontece uma gravides indesejada.']",120,80,40,80,0,320
63,Cultura da imprudência,"['“Eu vejo o futuro repetir o passado”. A composição de Cazuza é atemporal, uma vez que parece retratar o desastre ambiental ocorrido em Mariana e, posteriormente, em Brumadinho. Ambas as cidades mineiras foram vítimas de rompimentos de barragem por imprudência da mesma empresa – A Vale. Adiante, esse acontecimento levantou discussões tangentes à negligência ambiental por partes das grandes corporações e seus efeitos. Nesse sentido, é indubitável que tragédias como essas são fruto tanto da irresponsabilidade de empresas, tanto da falha fiscalização governamental.', 'A princípio, consoante ao economista brasileiro Hugo Penteado, vê-se que muitas empresas, tendo como prioridade o lucro, não dão a devida atenção aos impactos que suas ações podem causar ao meio ambiente. Nesse contexto, tem-se como exemplo a empresa Vale que, em ambas as barragens rompidas, havia optado por construir o tipo mais barato e, consequentemente, mais perigoso. Sob esse viés, percebe-se a importância das punições propostas na legislação ambiental, que muitas vezes é questionada quanto à sua rigidez.', 'Ademais, a Constituição Cidadã de 1988 considera dever do Estado proteger o meio ambiente. Entretanto, nota-se uma falha na fiscalização governamental no Brasil. Tal conduta possibilita a ocorrência de irregulares no cumprimento das normas ambientais por parte das empresas. Um exemplo é, novamente, a negligência no vistoria da barragem de Brumadinho, que era classificada como de “baixo risco”. Assim, percebe-se a necessidade de um maior monitoramento ambiental.', 'Portanto, urge que o Poder Público, em parceria com os órgãos fiscalizadores, promova uma maior fiscalização, através de vistorias mais regulares e rígidas, para que, assim, seja garantido o cumprimento das leis ambientais por parte das corporações. Ainda, o Poder Legislativo deve sancionar punições mais rígidas às empresas que não cumprirem as normas relacionadas ao meio ambiente.']",160,160,120,160,120,720
47,Os obstáculos do ensino EAD,"['A educação a distância (EAD) é uma estratégia de ensino que utiliza das novas tecnologias de informação e comunicação para educar sem ter a necessidade de o aluno estar presente na sala de aula. No entanto, no Brasil, há parcelas da população que, infelizmente, não conseguem usufruir desse método educacional. Tal problemática se dá, principalmente, por essas classes não terem acesso tanto  internet quanto a instrumentos para usá-la, dois elementos que, hodiernamente, são fundamentais para aproveitar dessa pratica de ensino no país.', 'Inicialmente, é imprescindível ressaltar que a inclusão social é um direito da humanidade proclamado pela Organização das Nações Unidas (ONU). Posto isso, observa-se uma clara ineficiência do Estado brasileiro em assegurar tal benefício, haja vista que, consoante ao Instituto Brasileiro de Geografia e Estatística (IBGE), cerca de 30% dos brasileiros não têm acesso  internet. Destarte, se compreende a exclusão desse grupo no aprendizado virtual, o que demostra um grande percalço a essa modalidade de ensino.', 'Ademais, os abusivos preços dos meios que possibilitam o ingresso ao círculo digital -computadores, celulares, “tablets” etc. – representam um obstáculo à democratização da educação a distância no país. Segundo estimativas da Pesquisa Nacional por Amostra de Domicílio (PNAD), mais da metade das famílias da nação vivem com apenas 400 reais por mês. Neste viés, percebe-se que essa majoritária parcela tem dificuldade em arcar com os excessivos valores desses instrumentos, portanto acaba incapacitada de usufruir tanto espaço virtual quanto das atividades disciplinares proporcionadas nesse ambiente.', 'Conclui-se, assim, ser imperativo que haja medidas para acessibilizar o ensino a distância. A fim de aumentar o alcance da prática do EAD e não depender da internet para realiza-lo, o Ministério da Educação ,  deve mobilizar aulas das mais diversas áreas do conhecimento e disponibiliza-las à sociedade por meio dos canais televisivos (TV Cultura, TV Senado, Canal Futura etc.). Dessa forma, mais brasileiros poderão usufruir da educação, mesmo que fora da sala de aula.']",160,200,160,200,160,880
48,SUS,"['O direito à saúde no Brasil  é universal e está instaurada na sua Carta Magna desde 1988. Atualmente, esse tema apresenta inúmeros problemas. No entanto, é de grande importância para os cidadãos brasileiros. Nessa perspectiva, aspectos administrativos e de desenvolvimento social devem ser analisados, respectivamente, sobre os desafios e a importância do SUS .', 'A priori, o SUS é responsável por assegurar saúde a todos os 200 milhões de brasileiros. Porém, existe no SUS uma discrepância em relação ao seu dever constitucional perante à sua administração e conceitos que a engloba . Segundo o médico Drauzio Varella, há uma conduta errônea do próprio sistema de saúde que está focado, unicamente, na doença e não na prevenção. Contudo, o Brasil apresenta auto índice de pessoas sedentárias, obesas e, posteriormente, terá um enorme número de idosos na sociedade. Dessa forma, é necessário que o SUS invista mais recursos na área de prevenção de doenças.', 'Outrossim, antes da criação do SUS, no Brasil, existia o INPS (Instituto Nacional de Previdência Social), que incluía serviços de saúde somente para trabalhadores formais e/ou com carteira assinada. Todavia, após a instauração do SUS, inúmeros benefícios para a sociedade podem ser observados. Porquanto, hoje, o Sistema Único de Saúde oferece, gratuitamente, transplante de órgãos, remédios para o tratamento do vírus HIV, além de campanhas de vacinação de várias doenças . Além disso, no cenário atual, o SUS é de enorme relevância para o enfrentamento da pandemia do novo coronavírus . Por isso, esse sistema é responsável por assegurar que a população brasileira possa obter mais saúde e, com isso, desenvolvimento social.', 'Em síntese, embora o SUS apresente inúmeros desafios a serem vencidos, ele também engloba uma enorme importância para a nação brasileira. Dessarte, o Ministério da Saúde em parceria com mídias televisivas deve elaborar projetos por meio de campanhas publicitárias e micro-séries fictícias para serem exibidas em horário nobre de emissoras de televisão, a fim de informar a população sobre a importância de hábitos saudáveis. Além disso, o ministério da saúde deve desenvolver aplicativos para celulares que vise dar dicas de uma vida mais saudável, exercícios físicos e informação sobre os direitos civis perante o SUS. Assim, será possível que a população usufrua melhor desse sistema de saúde.']",160,160,120,200,200,840
69,,"['Na década de 50 o mundo passou por uma grande revolução, a Revolução Verde, a qual veio para modernizar as práticas agrícolas, para aumentar a produtividade e assim ""matar"" a fome da população. Entretanto, trouxe também os agrotóxicos, os inseticidas, os quais por um lado  aumentam a produção agricola  por outro, tem causado sérios danos sanitários e ambientais para os brasileiros. Nesse sentido, faz-se relevante analizar as causas desse problema e suas principais consequências negativas na sociedade brasileira.', 'Em uma primeira ánalise, é notório que há o uso excessivo de agrotóxicos na agricultura brasileira, como a Organização Mundial de Saúde  publicou em 2015, o Brasil lidera o ranking de consumo desses produtos. A maior razão para isso se deve a falta de fiscalização da Anvisa nas platações e nos alimentos, pois sem a fiscalização, os agricultores usam os pesticidas visando somente o lucro e a produtividade sem  preocupa com os danos que esse uso exagerado pode causar.', 'Além disso, esses defensores agrícolas geram grandes danos ao ambiente, contaminando o solo, lençois freáticos, rios e lagos, pois  por negligncia dos agricultores o proprio sistema de irrigação da plantação,  facilita a chegada dos pesticidas aos corpos de água, poluindo-os e intoxicando toda vida lá presente. Ademais, os agróxicos prejudicam a saúde dos consumidores dos alimentos e dos trabalhadores agrícolas, que frequentemente sofrem com a intoxicação causada por esses produtos.', 'Dessa forma, urge que o Governo, por meio do Ministério da Agricultura e em parceria com a Anvisa invistam em ficalizações nas platações, fiscalizando uma vez ao mês, sistematicamente as plantações, analisando a quantidade de agrotóxicos que estão usando e os técnicos em vigilância sanitária, peguem amostras do solo para alanisar se está havendo prejuízos a esse, caso ocorra a negligência, possa haver uma punição para esses produtores . Além disso, o Ministério da Agricultura deve criar treinamento para os agricultores aprender a usar os defensores agrícolas sem prejudicar a saúde. Logo, diminuirá aos pouco esse problema no Brasil.']",120,120,120,120,120,600
86,Redes Sociais,"['Na série Bia, da Disney, a personagem Pixie era uma produtora de conteúdos para a internet, nos comentários de seus vídeos haviam criado a #isaboy, como forma de criticá-la por seu estilo de vestimenta, uma situação negativa e que perturbou psicologicamente por muito tempo .Fora das telas de televisão, o cenário se repete com frequência, sendo as redes sociais ditadoras de padrões que, se não forem seguidos, atraem falas perjorativas, que trazem uma série de impactos à saúde mental das pessoas, entre eles a depressão e consequentemente o suicídio.', 'Nota-se uma tendência humana de sempre impor padrões a tudo, em fatores religiosos, estéticos, culturais, entre outros infinitos, que assim como na série apresentada, se não forem seguidos atraem os comentários infundados e ofensivos dos chamados haters, e paralelamente aos impactos psicológicos sofridos por Pixie, muitas outras pessoas sofrem com a ação desses indivíduos.', 'Quando se falam das consequências ainda mais diretamente, um cenário claro é a depressão, considerada uma das doenças do século, ela pode levar ainda ao suícidio. Segundo pesquisas divulgadas por mídias digitais, uma pessoa se suicida a cada 40 segundos, e essa estatística pode se tornar ainda mais númerosa como resultado da autoestima ferida pelos haters.', 'Com base no que foi dito, medidas precisam ser tomadas. É responsabilidade das empresas de redes sociais acabar com os comentários perjorativos, através do banimento de seus autores, em um sistema onde outros usuários denunciem essas falas ofensivas e as empresas excluam os haters de suas plataformas, objetivando o fim de casos semelhantes ou piores que o de Pixie.']",160,120,120,160,160,720
89,12080,"['Quarto de Despejo, uma obra de Carolina de Jesus, narra a rotina nas comunidades pobres de São Paulo, marcada pelo sofrimento, dor, fome, angústia, desigualdade e preconceito. Esses lugares de baixo valor comercial, são historicamente construídos pela ausência de inclusão no sistema capitalista, no qual na situação atual são os principais afetados, tanto na disseminação da doença nos aglomerados, tanto economicamente falando, são famílias que não possuem recursos necessários para ficar “afastados” do trabalho.', 'Por conseguinte, é evidente a problemática e os impactos sociais causados pela pandemia: desemprego, fechamento do comercio, lotação da UTI , crescente índice de mortalidade, aumento da violência doméstica, quebra da educação e o desinteresse pelas atividades curriculares, entre outros. Especificamente, o desrespeito da “quarentena”, é um infinito looping brasileiro, pois sem uma eficácia dela em algum momento a economia é obrigada a parar em pró do distanciamento social.', 'Ademais, desde a teoria “Unicausal” o isolamento é comprovado na prevenção contra um agente especifico como vírus, mas muitos motivos são destacados pela população em conta dos descréditos do tema: a ausência de um planejamento do governo na precaução antes de declarar uma pandemia, a falta de políticas econômicas em suspender alguns impostos no momento de quarentena, adoção de medidas de segurança que só pioram o contato entre a população, a fiscalização precária e o fato de tornar o cenário atual uma corrida política entre os governos estaduais e a presidência.', 'Em suma, é necessária uma atitude dos governadores, deputados, do ministério da economia, da sociedade e das classes altas, com a convicção de ouvir esses manifestantes e aplicar um plano de curva do covid em que ambos concordem na eficiência, na finalidade de diminuir as revoltas e buscar a satisfação dos comerciantes, assim nos tempos visados ao remate do mercado esteja visível a sua aderência ao fechamento. Dentre a sociedade é um período de doar ao próximo, destacando as baixas classes e os indivíduos que prestam serviços ao redor.']",160,160,160,160,160,800
137,Os transgênicos e seus benefícios e malefícios,"['Sabemos que ao         falarmos         de transgênicos não podemos esquecer que o Brasil é         uns         dos que mais se beneficia com         esses novos métodos descobertos         que         estão         apenas na fase         de desenvolvimentos         e                 poderá                ainda                 ter novidades.', 'Além          disso          se não houvesse esse cruzamento desses          produtos          seria muito ruim para os          Países          que          tem          uma grande          quantidade          talvez até a maioria dos produtos transgênicos          comercializados          porque não haveria como produzir essa quantidade necessária para o          comercio         .', 'No         entanto         esses produtos transformados         contem         muitos agrotóxicos que não fazem bem para         saúde         podendo causar problemas                até mesmo                 atacar alergias e outros doenças                nos seres humanos                 e com o passar do tempo podemos ter um agravamento por parte dos transgênicos                .', 'E também é         possível         como ainda         esta         em         desenvolvimento         os transgênicos ainda         receba         mais transformações                 que não          seja  da natureza  seria         mais                 transformações          forçadas  que poderá         afetar muito a                 nossa vida                  até nos hábitos alimentares.', 'Nesse         caso         acho que devemos         tentar logico         manter os transgênicos porque         é          uma fonte de alimento para que não falte alimento nunca                .         mas também         com         consciência         tentar diminuir a quantidade de perigo                 para os nossos filhos e até netos          futuramente          e como fazer isso com pesquisas tentar encontrar uma forma de extinguir o risco para          Saúde  futuramente         .']",80,80,0,80,80,320
72,Compra de fake news nas eleições,"['Como dizia Albert Einstein, físico alemão  ""Todo o nosso progresso tecnológico, que tanto se louva, o próprio cerne da nossa civilização, é como um machado na mão de um criminoso"". Podemos adaptar esses dizeres para um grande problema atualmente:  fake news que mata a veracidade dos fatos.', 'Notícias falsas de certa pessoa pode se espalhar em meio a internet . Esse problema pode ocasionar a influência negativa no resultado das eleições esse ano no Brasil . Isso aconteceu na última eleição dos Estados Unidos, na qual orgãos investigam essas fake news  em favor do Donald Trump em detrimento da Hillary Clinton. No Brasil, ao invés de compra de votos a população teria a inovação de compra de fake news.', 'Algo muito comum no século 21 são as redes sociais. Mas justamente é essa ferramenta usada para o compartilhamento de falsas notícias  . Estudos do Instituto de Tecnologia de Massachusetts mostraram que as fake news são mais compartilhadas do que notícias verdadeiras. Os brasileiros acabam enganados com fatos mentirosos dos seus candidatos.', 'Diante desses problemas , soluções precisam ser feitas para que ocorra uma eleição limpa e democrática. Quando ocorresse a ""viralização"" de certa notícia, sem fontes concretas, a Justiça Federal deve analisá-la e julgá-la. Se caso comprovado que é falso, deve-se retirar a fake news de onde foi publicado, punir a plataforma digital e o autor dos mesmos. Em seguida deve haver um comunicado, em meios de comunicação confiáveis, sobre a situação ocorrida, para que as pessoas saibam da veracidade dos fatos. Também é interessante os meios de comunicação criar ""propagandas"" que ajudem a população identificar uma fake news. Essas soluções ajudariam combater falsas notícias nas eleições presidenciais de 2018 no Brasil.']",120,160,120,160,120,680
37,O homem é o cabeça da casa,"['É possível afirmar que a cultura do estupro no Brasil não terá afim enquanto houver tradição da suposta superioridade do homem sobre a mulher criada através da religião, da arte e da sociedade.', 'Relativo à religião, é possível afirmar que esta exerce forte influência em diversas. Dentro do cristianismo, religião que até hoje possui muitos adeptos declarados em nosso país, por exemplo, há diversas doutrinas que apresentam caráter machista. Entre os trechos que podem ser citados da Bíblia Sagrada, está aquele em que é afirmado que a mulher deve ser submissa ao homem. Neste contexto, quando raramente a vontade feminina é levada em consideração, fica limitada à vontade masculina.', 'No que se refere à arte, usualmente esta acaba por fazer papel parecido ao da mídia, cuidando simplesmente de reproduzir essas ideias aceitas pela maioria de forma a dar ênfase aos personagens que agradam essa massa. Percebe-se claramente isto na música onde vemos grande quantidade de pessoas fazendo sucesso às custas da denegrição da imagem da mulher e ainda da representação desta como objeto sexual. Seguido disto, há a aceitação do público e da divulgação deste tipo de conteúdo.', 'Nesse sentido, a sociedade acaba por reter tudo isso e adaptar à realidade, criando tradições que se concretizam e perpetuam por muito tempo, passando muitas vezes a serem consideradas incontestáveis. A educação é reflexo destes três itens e sofre as consequências desse aglomerado de costumes que é passado para muitas gerações. A popularização leva então à normalização do problema.', 'Considerando, portanto, estes aspectos, é possível afirmar que a cultura do estupro nunca vai ter fim. Bom seria, se o país assumisse seu papel como Estado laico e parasse de permitir essa tamanha influência de algo subjetivo como a religião em suas tradições e doutrinas, as manifestações culturais de desconstrução da figura feminina fosse sensuradas , nas escolas fosse ensinada a igualdade e respeito entre sexos de forma plena. A punição para aqueles que se sentem no direito de invadir um terrritório que não é são fosse mais severa, indo de anos de reclusão até a castração química.']",120,200,160,200,160,840
47,Tecnonlogia como tabu.,"['Segundo o filósofo Immanuel Kant: ""o homem não é nada além daquilo que a educação faz dele.""  Contudo, ao analisarmos os desafios para a educação a distância no Brasil, percebe-se que alguns obstáculos devem ser superados. Entre os fatores relacionados a essa problemática destacam-se a passividade governamental e a falha no âmbito educacional.', 'Em primeira análise, vale ressaltar a omissão das autoridades como perpetuadora do entrave. De acordo com Steve Jobs: ""a tecnologia move o mundo"". Porém, ao contrário do que diz o inventor os recursos tecnológicos são tratados como vilões nas salas de aula , o que dificulta a adaptação dos alunos aos estudos em plataformas digitais, já que geralmente são usados pelas pessoas como uma ferramenta de diversão.', 'Outrossim, a falha no sistema de educação também corrobora o impasse. Isso porque o investimento em computadores e tablets é mínimo, além de existir pouco interesse na capacitação de professores ao uso dessas tecnologias forçando-os a continuar com os meios de ensino antigos e ultrapassados . Dessa forma, a educação a distância passa a ser limitada aos estudantes que possuem materiais próprios o que  de acordo com dados do G1, não chega a 50% nas escolas públicas.', 'Infere-se, portanto, que o Governo Federal , no papel de Ministério da Educação, invista em material tecnológico adaptando as escolas ao uso e também na capacitação de professores por meio de cursos com o fito de levar educação de qualidade a todos para então, buscarmos a sociedade do futuro.']",160,160,120,160,160,760
47,...,"['""A tecnologia move o mundo"", assim como Steve Jobs preconiza em sua tese, a tecnologia perpassa diferentes âmbitos e fornece uma gama de possibilidades. Entretanto, no que tange à edução a distância os meios digitais podem não ser favoráveis. Concernente a isso, observa-se que a omissão do Estado e o não respeito pelos direitos democráticos são entraves da questão.', 'Em primeira análise, o governo não propicía condições adequadas para aulas virtuais. Desse modo, para Monteiro Lobato um país se faz de homes e de livros, indubitavelmente, para os governantes diferente não deveria ser . Haja vista que, o qual é omisso e não cria capacitação de doscentes e nem fornece mecânismos como, internet e computadores, para estudantes de baixa renda. Consequentemente, os discentes não tem resultados acadêmicos satisfatórios.', 'Em segunda análise, os direitos não são igualitários no Brasil. Nesse contexto, segundo o coeficiente de Gini, marcador que elenca 127 países em sua heterogeneidade social, o Brasil ocupa o décimo lugar como pas mais desigual do mundo. É nítido que, o conceito de democracia não é respeitado, pois nem todos têm acesso à oportunidades, claramente, um estudante com acesso à tecnologias fica favorecido em comparação a um aluno de baixa renda. Assim, tais indivíduos são prejudicados em seus estudos.', 'Portanto, os impasses devem ser solucionados. Dessa forma, cabe ao governo estadual - esfera responsável pela educação pública de um estado- criar oportunidades à estudates pobres, como fornecer internet gratuíta para tais, como o intuíto de mitigar problemàtica. Também, cabe ao agente Estatal criar programas sociais, tanto para professore e alunos, de capacitação e acesso às redes virtuais. Nessa perspectiva, tornar-se-á totalmente verídica a máxima de Steve Jobs.']",160,160,120,160,160,760
14,Imigrantes,"['A população do nosso país foi formada, em grande parte, por imigrantes portugueses, africanos (foram trazidos à força em navios negreiros), italianos, japoneses entre outros . Cada um fez parte de um período histórico dessa nação, com contribuições para a estrutura econômica, política e agrícola. Na contemporaneidade o Brasil continua a receber essas pessoas que vem de guerras, crises econômicas, perseguições religiosas e políticas e tantos outros motivos.', 'Nos últimos anos, migraram os haitianos, bolivianos, coreanos, angolanos, sírios e recentemente em 2018, os venezuelanos, que estão fugindo da crise em sua pátria.', 'A Declaração dos Direitos Humanos garante o direito à vida, à liberdade, ao trabalho e a educação, sem discriminação, a todo ser humano. A posição do Brasil deve ser a mesma do século XIX e XX, quando recebeu diversos imigrantes e agora na contemporaneidade , a de continuar aceitando a migração dessas pessoas, pois estará cumprindo os direitos humanos, que são inerente a todos independente da nacionalidade, idioma, etnia ou qualquer outra condição.', 'Eles migram carregados de necessidades básicas e elas devem ser atendidas com prioridade, como a documentação, moradia, saúde, educação, higiene, alimentação e renda. Mesmo o nosso país sendo subdesenvolvido, não pode deixar de garantir esse direito à vida aos imigrantes.', 'Em suma, há muitas ONGS e instituições religiosas que ajudam essas pessoas. O governo pode subsidiar esses lugares com o recrutamento de voluntários da área da saúde, educação (com foco no aprendizado da língua portuguesa) e orientar sobre a procura por trabalho e abrigos para os imigrantes.', 'É preciso, também, ter um olhar para os filhos deles, que estão em período escolar e orientar as escolas a desenvolverem projetos com os alunos sobre a xenofobia, o bullying e a discriminação; procurar trazer a cultura dessas crianças e adolescentes ao conhecimento dos discentes brasileiros, para que se desenvolva empatia e respeito à diversidade cultural.']",120,120,80,120,160,600
91,Cuidado que devemos ter com o negacionismo científico,"['A Ciência é fundamental para o desenvolvimento da sociedade, é responsável pelas mudanças sociais que ocorreram desde o seu surgimento. Pode ser comprovado com importantes movimentos históricos como a Revolução Verde, com a agricultura mundial aprimorando as suas técnicas do uso de solo, e também temos o Iluminismo que foi responsável por causa da mudança de mentalidade das pessoas por meio das ciências humanas.', 'Além disso, vale ressaltar que os avanços científicos, além da potência econômica, têm um papel fundamental na sociedade. Por meio dos medicamentos de baixo custo e também na criação de captação de água para levar pros lugares de seca, por exemplo, tornando-se possível com alguns problemas como a desigualdade social, que atinge a sociedade mais pobre fazendo com que acaba marginalizando a sociedade.', 'Para tanto, é indispensável que haja grandes investimentos nesse âmbito, assim como na melhoria da infraestrutura e na maior disponibilidade de verba para os cientistas. No entanto, dados coletados pelo jornal Estadão indicam que houve, em 2016, a pior crise financeira da história nos institutos de ciência dependentes do governo federal. Tal situação é, portanto, reflexo do descaso das autoridades governamentais e ocasiona prejuízos tanto à classe científica quanto à população em geral', 'Deste modo é muito importante tomar cuidado com o negacionismo científico pois isso acaba deixando fora da realidade . Logo, para a superação desse cenário preocupante, é papel do Ministério da Ciência, Tecnologia e Comunicações criar centros de pesquisas, com ampla infraestrutura e dotados das tecnologias mais avançadas, que reúnam cientistas em prol do surgimento de inovações que possam ser implantadas na sociedade, de modo a promover, sobretudo, o desenvolvimento social e econômico do país. Ademais, o governo federal deve instituir a ciência como área prioritária de investimentos, ao lado da saúde e da educação']",160,80,80,160,160,640
57,,"['Os Gregos já utilizavam o teatro como forma de conscientizar e ensinar a sociedade por meio de histórias que refletiam os problemas inseridos naquele contexto cultural e histórico. Além disso, com a evolução social e o advento de novas tecnologias, o jeito de representar também muda, no lugar de peças, surgiam os filmes e o cinema no modelo como entendemos hoje. Dito isto,paralelamente ao desenvolvimento desse novo tipo de arte, seu acesso se tornou cada vez mais restrito, sendo mais uma marca da segregação.', 'Antes de mais nada, é importante ressaltar que com a chegada da industrialização no Brasil, o exôdo rural acentua-se, acarretando no macrocefalismo e a periferização do meio urbano, devido a falta de infraestrutura e investimento do governo. Nesse sentido, este apartheid social dificulta o contato com o cinema por parte da população mais pobre, visto que todos os dias muitos brasileiros se deslocam de suas casas a seu local de trabalho a fim de obter um salário. Isto posto, a busca por lazer e bemestar seria ainda mais árdua , uma vez que espaços que reproduzem obras cinematográficas se concentram em regiões polarizadas economicamente.', 'Em segundo lugar, é interessante destacar que universidades renomadas já empregam filmes como prérequisito para realizar a prova de processo seletivo, como é o caso da FGV (Fundação Getúlio Vargas), reconhecendo a possibilidade de ensinar por meio do cinema. Assim sendo, ilustra o impacto do cinema na nossa sociedade e a importância de sua democratização.', 'Portanto, soluções devem sem tomadas a fim de mitigar esse problema. Segundo Hegel:""O Estado é o pai da população, e cabe a ele cuidar de seus filhos.""Por isto, cabe ao Ministério da cultura promover eventos relacionados ao cinema nas regiões periféricas do país. Ademais, cabe ao Ministério da educação acrescentar filmes na grade curricular de escolas públicas como ferramentas de ensino, aproximando a cultura da população carente. Pois, segundo Kant e Lamark, a educação e o meio, respectivamente,são essenciais para a formação do indivíduo.']",120,120,80,120,80,520
112,Máscaras da ideologia,"['No Brasil,                várias foram as tentativas de se reduzir a maioridade penal                 no país                . Muitas propostas de lei         para esse paradigma         foram reprovadas. Porém, o país vive um momento em que a         população         em sua maioria, clama por         este feito         com a errônea e ilusória convicção de que assim a violência se amenizará. Decrescer a idade de responsabilidade criminal no Brasil seria um equívoco.', 'Primeiramente, é importante destacar que o         problema existente acerca dessa questão, se deve         ao fato de que no Brasil medidas que aparentemente são simples não são adotadas seriamente,         como por         exemplo, um investimento de qualidade na educação do país. Se isso ocorresse, haveria uma boa possibilidade         dos         jovens não recorrerem         a         criminalidade.']",120,120,120,160,160,680
133,O papel do Estado é diminuir e não aumentar os problemas sociais.,"['Hoje a função do Estado está totalmente esquecida pelos         políticos         uma vez que não respeitam os problemas dos cidadãos e não praticam o que diz a Carta Magna. Dessa         forma          não oferece                saúde, segurança e educação de         qualidade         fazendo         com pessoas que tem         uma situação financeira melhor         possua         uma qualidade de vida satisfatória.', 'O Brasil é o país que menos utiliza o dinheiro proveniente dos impostos para o bem estar da          população         uma vez que a maioria dos políticos brasileiros utiliza o seu cargo como uma forma de se         beneficiar em detrimento de         solucionar os problemas da população. Isso acontece muito por meio do desvio de dinheiro de obras         superfaturadas,         recebimento de         propina         ocasionando o enriquecimento de forma ilícita de quem deveria cuidar dos cidadãos. Ocorreu exatamente isso no chamando         mensalão         em que uma grande quantidade de                 políticos                comprava votos de                 parlamentares                para utilizarem a favor do seu partido.', 'Consequente         o investimento nos serviços públicos é         insuficiente         ocorrendo uma verdadeira pane, principalmente na saúde, educação e segurança.         Na saúde         um número insuficiente de hospitais e equipamentos para exames. Na         educação         uma remuneração                 desproporcional                aos professores                 proporcionando                uma desmotivação desses profissionais. Já na         segurança dados         de homicídios semelhantes a um país em guerra. Assim, os problemas sociais tendem a aumentar em vez de diminuir.', 'Portanto, o Estado deve cumprir a sua principal         função por meio de um oferecimento de         qualidade dos         serviços proporcionando uma         qualidade de         vida         sem ocorrência dos problemas sociais. A população precisa pensar muito bem em qual candidato votar evitando que sejam escolhidas pessoas mal intencionadas.                 Assim sem corrupção e serviços públicos excelentes o Brasil pode ser desenvolvido.']",160,200,120,160,120,760
97,Solução imediata,"['E                já dizia a filosofia, o homem é um ser singular, autônomo, pensante, original, motivável e principalmente de pensamento livre e sem limites.         Ai         está o problema, até que ponto podemos chegar?', 'O problema sempre foi e sempre será o mesmo: o ser humano e sua mania descontrolada de agir por         impulso. Assim         esquecendo sua                 ideologia                , desobedecendo as leis, e fazendo                 coisas banais                .', 'Temos como exemplo as manifestações, que deveriam ser uma forma de                 expressar a luta                por uma democracia                 justa                , criticar o sistema falho e a                 injustiça                . Mas o que acontece na maioria das vezes é uma sanguinária                 luta por sobrevivência                , espancamentos e várias formas de vandalismo.', 'Portanto, para evitar esses tipos de problemas, deve existir bom senso e organização tanto da parte dos manifestantes quanto da dos policiais. Algumas ótimas ideias seriam usar as redes sociais e a mídia para divulgar campanhas pacificadoras; aumentar a fiscalização quando acontecesse tal evento, e por último usar a expressão sem limites para boas causas.']",120,120,80,80,120,520
50,Pandemias,"['Com o advento da pandemia do coronavírus (COVID-19), nota-se que a ciência e suas respectivas contribuições são de suma importância para a sociedade. É amplamente perceptível seus benefícios em situações como essa.', 'Em um primeiro momento, observa-se a importância da ciência  por exemplo no sequenciamento do genoma de um vírus .  Que possibilita a pesquisa e a construção de uma rede de dados multinacional.', 'Além disso, as pesquisas permitem a observação do comportamento de doenças multifárias na sociedade . Ademais a promoção  de pesquisas facilita o processo de busca por uma vacina ou drogas que freiem o impacto das doenças na sociedade.', 'Desse modo o Ministério da Ciência, tecnologia, inovações e comunicações (MCTIC) deve promover ações políticas que fortaleçam a rede de pesquisa em qual quer meio científico. Por meio do melhoramento econômico e estrutural de universidades públicas, local no qual se concentra a maior parcela dos pesquisadores brasileiros. Com o suporte técnico do governo federal as pesquisas tedem a mostrar cada vez mais resultados.']",160,120,120,120,80,600
94,Autismo,"['Diante do já conhecido cenário brasileiro  marcado por diversos estigmas relacionados a transtornos mentais depreende-se que os desafios para a inclusão das pessoas com autismo são enormes, tendo em vista que, o preconceito está amplamente difundido na concepção da população e que faltam políticas governamentais mais engajadas nesse processo de integração.', 'Não desconhecido é o fato de que o ser humano possui grande dificuldade em aceitar e respeitar aquilo que se mostra diferente . Situação essa que se refletiu na construção de uma sociedade amplamente vinculada a um contexto de preconceito em que aquele que se mostra distinto do padrão pré-estabelecido é julgado, discriminado e excluído de todo um convívio social . Fato esse que é explicitado na série “The Good Doctor”, em que o personagem Shawn, portador de Transtorno do Espectro do Autismo, enfrenta inúmeras dificuldades para conseguir atuar como médico, em virtude dos diversos entraves estabelecidos pelos demais médicos que desconfiavam da capacidade de Shawn. Nessa perspectiva evidencia-se a enorme dificuldade que os os autistas encontram no aspecto da inclusão social, visto que, o autismo é um transtorno que interfere justamente na interação social, com comprometimento da comunicação verbal e não verbal.', 'Logo, sob o viés supracitado, destaca-se a relevância da atuação do governo na desconstrução dos estigmas presentes na sociedade. Vertente em que tem se mostrado negligente, à medida que, apresenta-se pouco empenhado frente ao necessário aprimoramento das políticas inclusivas, que não garantem um atendimento de qualidade aos deficientes. Fato esse que no aspecto educacional demonstra-se ainda mais vigente, ao passo que, houve um aumento no número de alunos com necessidades especiais matriculados, o que demanda um maior suporte do governo, principalmente dos alunos autistas que necessitam de profissionais com preparação e didáticas específicas.', 'Portanto, conclui-se que é de extrema importância que o governo, representado por vereadores, senadores e deputados, criem leis, por meio do Legislativo para garantir os direitos das pessoas com autismo e que a Secretaria Nacional de Promoção dos Direitos da Pessoa com Deficiência, como órgão responsável pelos deficientes, promova campanhas de conscientização, para destruir o preconceito na sociedade e garantir a inclusão social dos autistas.']",160,160,120,160,160,760
51,o analfabetismo pode ser resolvido,"['Segundo Confúcio que diz "" não corrigir nossas falhas é o mesmo que cometer novos erros "", percebemos que através dessa frase ele nos faz uma alerta. No analfabetismo os erros são cometidos a partir do momento que o indivíduo não procura ajuda, não pretende sair da sua própria ignorância . Se a pessoa buscar soluções ela irá encontrar, mas por isso ela deve sair da comodidade em que está.', 'Uma pessoa que não consegue desenvolver equações, nem ao menos fazer uma interpretação de texto, possui o analfabetismo funcional. Quando a pessoa é ignorante e não quer frequentar as aulas, não quer ler, está indo em direção ao analfabetismo. A taxa de analfabetismo hoje, está grande, devido ao rompimento estudantil, também a falta de motivação.', 'Podemos caminhar para um lado aonde possam existir o mínimo de pessoas com o analfabetismo funcional, mas para isso precisamos sair da nossa ignorância, buscar a razão, devemos ser mais críticos, ler mais, praticar mais. Mas para isso ocorrer devemos mudar em primeiro lugar, analisarmos o quanto importante hoje, são os cálculos, as redações, para ingressarmos em uma universidade principalmente, e tudo isso para uma vida melhor.']",160,120,120,120,80,600
51,Analfabetismo funcional e seus perigos na era da informação.,"['No início da Revolução Francesa, o lema invocado era “Liberdade, igualdade e fraternidade”. Já no Brasil atual, a persistência do analfabetismo funcional demonstra que a igualdade na educação ainda não foi atingida . Por conseguinte, a sociedade brasileira fica muito mais exposta a perigos digitais na era da informação. Nesse sentido, convém analisar as principais causas, consequências e possíveis soluções para esse impasse.', 'Em primeiro lugar, os analfabetos funcionais tiveram uma educação básica de baixa qualidade, ou sequer estudaram . Como resultado, essas pessoas possuem dificuldade para interpretar textos simples. Além disso, elas podem não compreender mensagens irônicas ou enganosas na internet. Logo, o risco desse grupo acreditar em notícias falsas e disseminá-las é alto, visto que a maioria da população possui dispositivos digitais.', 'Conforme o Indicador Nacional de Alfabetismo Funcional (Inaf), registrou em 2018, por volta de 30% dos brasileiros entre 15 e 64 anos são analfabetos funcionais. Sendo o índice de 53% entre os mais velhos (50 a 64 anos), e de 12% entre os jovens (15 a 24 anos). Com isso, forma-se uma sociedade com poucos argumentos e críticas próprios . Pois, ao ler na rede uma matéria jornalística sobre política, por exemplo, este indivíduo não terá a capacidade de analisar, refletir e debater os prós e contras da mesma. Dessa forma, esses brasileiros podem tomar diversas decisões, políticas ou não, equivocadas.', 'Infere-se, portanto, que é necessário combater o analfabetismo funcional no Brasil. Sendo assim, compete ao Ministério da Educação , que é o órgão federal responsável por organizar o sistema de ensino no país, implantar no currículo básico e superior, técnicas de letramento atuais. Outrossim, cabe ao Ministério das Comunicações, como órgão federal que tem como missão proporcionar à sociedade brasileira acesso democrático e universal aos serviços de telecomunicações, realizar campanhas em comerciais de televisão e do Youtube dando visibilidade a esse tema e explicando a importância do letramento. Assim, com uma aprendizagem eficiente se gera uma população mais engajada e com maior criticidade, que lutará por uma educação mais igualitária como o lema da Revolução Francesa.']",120,160,120,160,160,720
51,Analfabetismo  É uma probema,"['Analfabetismo foi trânsito pelo aparte da Europa para o Brasil que pessoas tenho conhecimerdo e Judá na sua vida pessoal e no trabalho, assim. Histórias ajuda a indente vida atua atualmente.', 'Por que esse problema ainda pesite, todos as pessoas tendo uma probema relacionado sua vida e tenho dificuldade pobre. trabalho e família.', 'Quando óculo público são as vezes apononado ou esquerdo e acare aponomo dos alano que descuide da aula isso trais para o futuro grande probema pois se alano descide de estuda o país não deselve.', 'Para mudar esse realidade demo quê insetiva alunos,professor, como campanhas e palestra um futuro melhor']",80,80,40,80,40,320
54,O benefício da vacina na sociedade,"['As vacinas são extremamente fundamentais para a prevenção contra doenças, gerando imunidade como fator protetivo . Por isso, ao vacinar a população, há a diminuição da incidência de determinada doença.', 'Apesar de parecer, muitas vezes, custoso proteger toda a sociedade, a poliomelite e a varíola já foram erradicadas no Brasil devido à vacinação.', 'Porém, o número de casos de sarampo aumentou de tal modo que o Ministério da Saúde intensificou as campanhas para vacinar as pessoas que ainda não são imunizadas. Dentre os estados brasileiros confirmados com essa doença viral, São Paulo apresenta com maior intensidade .', 'Embora as vacinas sendo disponíveis nas Unidades de Saúde, o povo continua amedrontado em ser vacinado;  pois acreditando que a vacina não é algo benéfico e sim maléfico, causando reações adversas.', 'Consequentemente, a cobertura vacinal tem sofrido uma queda exorbitante , que aflige as autoridades sanitárias com a volta de doenças que estavam quase extintas.', 'Todavia, a vacina ainda é a forma mais eficaz para se evitar de contrair uma determinada doença. Portanto, as campanhas não devem cessar e sim serem mais intensificadas com propagandas e orientações de profissionais da área da saúde, incentivando a importância da vacina na vida de cada ser humano.']",120,120,80,120,80,520
83,O desenvolvimento atrelado as* práticas esportivas,"['O esporte, desde os tempos mais remotos, demonstra-se uma ótima ferramenta quando nos referimos à benefícios para o corpo humano, bem estar psíquico, integração social e desenvolvimento.', 'A prática esportiva tem muito a ensinar para o ser humano. Se olharmos para o passado, mais precisamente quando notamos o desenvolvimento das cidades-estados gregas (Esparta é um ótimo referencial), o esporte já contribui com sua função de desenvolvimento.  Proporcionando a expansão dos territórios gregos, desenvolvimento dos exércitos e ambientes de entretenimento.', 'A integração social possui seu lugar de destaque reservado no cenário esportivo. Olimpíadas e Paralímpiadas são poderossísimas ferramentas de relações interpessoais, união de variados grupos sociais, superação e alcançe de objetivos. Não somente essas duas competições que promovem esses benefícios, mas os próprios esportes em um contexto geral.', 'Estudos cíentificos também vêm demonstrando que as atividades decorrentes da prática esportiva trazem ínumeros benefícios para o corpo. A atividade acelera os batimentos cardíacos promovendo uma maior oxigenação dos tecidos, previne problemas cardíacos, melhora o racíocinio, garante um ótimo condicionamento físico, e etc.', 'Sendo assim, é defital importância que as práticas esportivas estejam presentes em larga escala dentro da sociedade. Incentivadas por órgâos públicos, órgãos veículadores de informação e grupos famíliares. Órgãos públicos poderiam estabelecer parcerias com clubes esportivos visando a promoção gratuíta de práticas à população de baixa renda. A mídia também poderia disseminar conteúdo referente aos benefícios da prática esportiva e as suas mais variadas formas. E os grupos famíliares tendo ciência destas informações, possam desde cedo aderi-las a sua rotina.']",120,160,160,200,200,840
86,Toxicidade das redes sociais,"['Jaron Lainer, músico e cientista de computação estadunidense, foi responsável por produzir a obra ´´Dez argumentos para você deletar agora suas redes sociais``. Em seu livro ele explora, através de uma dezena de tópicos, os efeitos nocivos que o uso indevido desses espaços virtuais acarreta no psicológico e na personalidade de uma pessoa. Outrossim, pode-se inferir que o impacto do uso das redes sociais no quesito saúde mental não é algo que resume-se apenas ao exemplar de Jaron, mas que está presente na vida da maioria da população, especialmente nos jovens.', 'Primeiramente, vale ressaltar que tal temática é muito discutida por psicólogos do mundo inteiro, pois se trata de algo intrinsecamente ligado a doenças mentais, como depressão, por exemplo, além de outros tipos de distúrbios. Em uma pesquisa realizada pela Instituição de Saúde Pública do Reino Unido, Royal Society for Public Health (RSPH), em parceria o Movimento de Saúde Jovem, foi revelado que 70% dos jovens entrevistados alegaram que o uso de determinada rede social fez com que eles se sentissem pior em relação a sua autoimagem.', 'Em segundo plano, ganha destaque a ideia de que, em espaços virtuais, seja pregada a imagem de uma roupa, rotina, de um estilo de vida, ou de um corpo perfeito, considerados ´´ideais``. Por conseguinte, é bastante comum que o público consumidor, composto basicamente por adolescentes, busquem enquadrar-se em uma realidade distante da sua, e isso acaba por trazer a seus cérebros um sentimento de insuficiência.', 'Nessa perspectiva, portanto, é necessário que os pais estimulem seus filhos a praticarem atividades que não envolvam práticas virtuais, a fim de que os mesmos passem menos tempo conectados na internet, por meio de um trabalho de conscientização. Desse modo, os jovens se sentirão cada vez mais independentes do mundo digital.']",160,120,120,200,120,720
71,Suicídio,"['O suicídio, nos dias de hoje, é uma das principais causas de morte no Brasil e no mundo  e dentre os jovens o número de casos é relativamente alto e vem acontecendo com certa constância entre esse público. A partir disso, surge um questionamento: O que leva os jovens a tirar a própria vida atualmente?', 'O suicídio nada mais é do que acabar, de certa forma, com um sofrimento na vida de uma pessoa. A juventude, principalmente, encontra nessa forma de morte uma solução para seus conflitos no mundo tão agitado em que vivemos . São vários os fatores que podem levá-los a cometer tal ato. Dentre esses fatores pode-se citar a depressão, os conflitos amorosos e familiares e a dificuldade de lidar com o sofrimento.', 'Augusto Cury em seu livro “Ansiedade: como enfrentar o mal do século”, diz que “a depressão abarca um número assombroso de pessoas”. Com isso, apesar de existirem tantas outras motivações, poderíamos afirmar que a depressão é a principal delas, justamente por se caracterizar por um sofrimento exacerbado diante de uma situação de dor emocional.', 'Portanto, percebe-se que o suicídio é tido como uma solução diante de uma situação de sofrimento. É de responsabilidade do poder público disponibilizar população psicólogos e profissionais capacitados para lidar com jovens que, porventura venham a desenvolver o pensamento suicida e dos pais, ao perceber essa forma de pensar, incentivá-los a frequentar seções de terapia e, assim, conjuntamente, descontruir o pensamento obsessivo ao suicídio e mostrar que esse não é o caminho a ser seguido.']",120,120,120,120,120,600
84,DIREITO DE ESCOLHA,"['“PORTE DE ARMAS PELA POPULAÇÃO CIVIL”', '(Diante de) Uma população que padece de uma educação de qualidade, de serviços de segurança de qualidade, onde o sistema jurídico é falho, não seria prudente, por enquanto, permitir o porte de arma de fogo para cidadãos civis. Ainda assim, esta fragilidade se da principalmente em consequência da legislação que hora é acometida por brechas que muitas vezes acabam impedindo a aplicação plena da lei.', 'Seria de bom proveito permitir ao cidadão de bem, transitar armado, possibilitando dessa forma que o mesmo faça sua própria segurança, já que as instituições públicas de segurança não estão conseguindo atender a demanda de ocorrências. No entanto, isto criaria um caos, já que cada um, na sua concepção de defesa agiria de acordo com seus princípios, enfim, a verdade é que o ser humano tem sede de poder, e arma de fogo seria uma maneira de manifestar esse poder.', 'Nada mais justo que um cidadão de bem poder se defender da ação covarde de bandidos, porém, fica uma pergunta* a ser respondida: Não raras vezes, nos meios de comunicação vemos a decisão de juízes, que decidem que um a pessoa mesmo diante de imagens da imprensa, mostram, por exemplo, um assaltante constrangendo, causando medo nas pessoas, e este segundo entendimento jurídico não está oferecendo perigo para a sociedade.', 'Logo, uma sociedade pautada por valores sociais, com boa educação, livre da corrupção, esta não precisa andar armada, pois já existem pessoas qualificadas, profissionais treinados para oferecer ao cidadão de bem a segurança que o mesmo necessita. Posto isso, seria muito mais importante e necessário fortalecer as instituições policiais, valorizando o profissional de segurança, aí sim, feito isso, depois de haver essa organização, poderia se pensar em dar ao cidadão de bem esta opção de possuir ou não um porte de arma.']",160,160,120,120,160,720
47,...,"['A partir do período vigente da sociedade do século XXI, nota-se a necessidade do isolamento social ocasionada pela pandemia do corona vírus. Nesse sentido, houve uma indispensável adaptação na educação presencial para as aulas remotas. No entanto, por ser uma transformação sem planejamento ocasionou em uma exclusão social entre os estudantes.', 'Em primeiro lugar, o vírus iniciou na China , posteriormente, o mundo conectado por meio da globalização, ocasionou em uma contaminação com alcance mundial, por isso pandemia . Dessa forma, houve uma necessidade de transformar a educação presencial em uma remota. Portanto, tornou-se indispensável tecnologia para a realização do ensino, uma vez que ajuda a manter o isolamento, mas aumenta a diferença de qualificação entre os alunos.', 'Em segundo lugar, de acordo com Fernando Sabino, escritor brasileiro, democracia seriam oportunidades iguais no ponto de partida e quanto chegada, dependeria de cada um. Nesse contexto, o Brasil, um país considerado democrático, necessita disponibilizar as mesmas oportunidades para todos os discentes para não haver discrepância na linha de partida. Ademais, segundo o IBGE , três em cada quatro pessoas possuem internet no Brasil, no entanto, persiste a diferença no acesso, em relação à qualidade, e na falta de.', 'Portanto, medidas são necessárias para resolver este impasse. Cabe ao Ministério da Educação , juntamente com o Ministério da Economia, doar aparelhos eletrônicos para estudantes prejudicados pela pandemia, por meio do uso dos impostos já pagos pela população. Dessa maneira, os funcionários do governo abririam uma enquete online para observar as condições da nação envolvendo a tecnologia, logicamente, quem respondesse a enquete não precisaria da doação. Além disso, através dos documentos de identificação que todos os cidadãos possuem como CPF e RG, filtrariam quem não respondesse, no entanto, para saber qual foi o motivo do silêncio, será necessário que o Estado se disponibilize a ir à residência dessas pessoas e, caso necessário, fazer uma doação a fim de estabelecer uma democracia no ensino remoto.']",160,160,120,200,160,800
78,Os dois lados da Reforma do Ensino Médio,"['É notório que a reforma do Ensino Médio é uma questão discutida por inúmeros órgãos educacionais , projeto que foi aprovado em fevereiro de 2017,   qual visa uma mudança no desempenho estudantil de modo a garantir um ensino melhor,  entretanto existem certos contrapontos em meio a isto .', 'A reforma do modelo de ensino foi anunciada pelo presidente Temer próximo ao término de 2016,  uma das propostas presentes no projeto é a de que a carga horária seja aumentada gradativamente das atuais 800 horas anuais para 1400 horas, com isso a sociedade brasileira terá um maior índice de desempenho em relação aos estudos , concluindo os processos de socialização secundária com certo êxito,  além disso o nível de jovens que poderão ingressar nas faculdades será consideravelmente benéfico para a economia nacional .', 'Sob outro ângulo, a reforma causaria grandes impactos nas populações menos favorecidas que dependem do trabalho ""braçal"" dos jovens para sobreviverem, isto é, com o aumento gradativo da carga horária os jovens não teriam tempo para trabalhar, afetando diretamente o sustento de determinadas famílias, ainda por cima as matérias que seriam abordadas nas escolas gravitariam na decisão muitas vezes ""imaturas""  dos estudantes, que não alcançariam o desempenho esperado por causa da má decisão.', 'Em síntese, tem-se que a reforma do Ensino Médio ""abrirá"" portas para um país mais desenvolvido educacionalmente, contudo as populações menos favorecidas sofrerão grandes consequências, sem contar com a tomada de decisões muitas vezes imaturas  em relação às  disciplinas escolhidas pelos alunos,  por conseguinte seria necessário uma reestruturação da carga horária para um pouco menos do que a proposta e uma melhora no âmbito da ""escolha"" pessoal das matérias , garantindo um desempenho relativamente satisfatório no progresso da nação.']",80,120,120,120,80,520
89,,"['Em meio a pandemia do novo coronavírus o estado adotou o isolamento social com a finalidade de combater o avanço da doença. Contudo, existem divergências de opinião entre a população acerca da adoção dessa medida ,pois o país enfrenta uma grave crise econômica. Nesse prisma, faz-se necessário analisar o cenário atual e a disponibilidade de meio alternativo que combata a doença.', 'Inicialmente, segundo o ex-ministro da fazenda do Brasil Henrique Meirelles, a crise é causada pela pandemia, não pelo isolamento. Em meio ao cenário de desemprego o isolamento social uma medida agressiva. Mas em contra partida, diariamente a vida de muitos brasileiros são ceifadas pelo novo coronavírus. Deste modo, sendo a vida um bem maior, a priorização do combate à pandemia proporciona condições para que as demais vertentes sociais possam ser redirecionadas.', 'Ademais, a Universidade de Oxford desenvolveu uma das primeiras vacinas contra o novo coronavírus. Entretanto, com a alta demanda mundial irá decorrer um grande período, no qual resultará com mais morte e danos econômicos, até a vacinação efetiva de boa parte da população. O isolamento social é a forma mais eficiente no momento para interromper a disseminação do vírus. Devendo a população se conscientizar sobre a importância dessa medida até a vacinação expressiva.', 'Portanto, cabe ao poder público em parceria com as mídias de grande acesso divulgar amplamente, tanto via telefone, quanto online com publicações nas redes sociais enfatizando a importância do isolamento com dados científicos que comprovem a eficácia desse método e os resultados futuros como a possibilidade de um recuperação significativa do sistema econômico. A partir dessas ações ,espera-se superar essa doença e buscar um Brasil melhor.']",160,120,120,200,160,760
76,,"['A desigualdade de gênero é um grande desafio social até hoje para as mulheres. Deste modo, há muitos preconceitos ainda enfrentados, falta de trabalho, de oportunidade e baixo salário, e tudo isso trata-se de questões históricas que ainda permanecem.', 'Neste sentido, antigamente mulheres tinham seus direitos, porém,  eram restritivos . Assim, dependia do pai ou do marido; cuidava somente dos trabalhos domésticos e dos filhos; não podia votar e seu casamento era arranjado. Por conseguinte, durante o século XX elas conquistaram seu direito ao voto, ocuparam espaços nas fbricas e nas instituições e não dependem de autorização dos maridos para trabalharem.', 'Desta maneira, apesar de terem alcançado seus direitos, até hoje lutam contra esses preconceitos típicos, como: possuir filhos, de poder engravidar ou por não haver capacidade para ocupar posições mais altas. Outrossim, os homens recebem de salário 73% a mais que as mulheres por possuir cargos melhores e mais elevado que as mesmas .', 'Em suma, as mulheres brasileiras ainda estão a luta de igualdade de sexo. Dessarte, deve-se dar as oportunidades da mesma maneira, respeitando as particularidades biológicas e não fazendo com que elas sejam inferiores.']",120,120,120,120,80,560
75,Livre porte de armas no Brasil,"['Um artigo do site Exame mostra que o Brasil é um dos países mais violentos do mundo, ocupando o 16º lugar no ranking. Para a maioria da população brasileira, a única forma de combater a violência é autorizando o livre porte de armas para civis. Mas o que acontecerá se todo cidadão possuir uma arma em casa? Essa é a forma mais sensata para combater a onda de agressividade que toma conta do país?', 'Muitas vezes, os policiais, que são encarregados da segurança pública e são treinados para manusear uma arma, acabam errando o alvo e atirando em pessoas inocentes. Se um policial que recebe treinamento é capaz de errar, quem dirá um civil comum? No Brasil, pessoas agridem ou assassinam por puro preconceito ou racismo, e quem sofre essas agressões quer fazer justiça com as próprias mãos. O brasileiro não tem estrutura psicológica para manusear armas e muito menos instrução para portar tal objeto.', 'Em muitos países onde o porte de arma foi proibido, o índice de violência caiu significativamente, o que se deve ao investimento na educação e a projetos de conscientização da população. No Brasil, infelizmente, os jovens não têm grandes perspectivas para o futuro, pois a educação é péssima e as oportunidades são raras para pessoas de níveis sociais mais baixos. Por isso, muitos jovens acabam seguindo o caminho da violência', 'Portanto, o que diminuirá a violencia no país não será o livre porte de armas  e sim a melhoria e o investimento na educação, o preparo e incentivo de jovens para o mercado de trabalho e projetos de conscientização . da população.']",160,120,120,120,120,640
89,Consciência Social,"['A partir do contexto pandêmico instaurado no mundo , ao final do ano de 2019, fez-se necessária a medida do isolamento social, a fim de manter o bem-estar coletivo. Entretanto, no Brasil, sabe-se que a economia foi fortemente afetada por este cenário, obrigando , assim, muitos cidadãos a abrirem mão da conscientização acerca do distanciamento em prol da manutenção de suas rendas. Logo, meios são necessários para reveter esse quadro, que seriam o fornecimento de mais informações e serviços prestados , assim como, também, da educação financeira.', 'De início, entende-se a importância das mídias e das prestações de serviços para a manutenção do afastamento. Sendo assim, de acordo com o teórico Pierre Bourdieu, o que foi criado como instrumento de democracia não deve ser convertido como mecanismo de opressão. Desse modo, diferente das fakes news, as informações verídicas e baseadas em estudos são cruciais para manter a população atenta sobre as normas e as regras atribuídas a prevenção do contagio ao vírus Sars-Cov-2.', 'Ademais, serviços governamentais como o “Auxílio Emergencial” atribuem uma segurança econômica aquela parcela impossibilitada de trabalhar na quarentena. Dessa forma, usados da maneira pretendida,a união entre esses dois bens sociais fortalecem para a reversão dessa situação nefasta. Outrossim, a educação financeira mostra-se uma arma poderosa contra a crise econômica na pandemia. De acordo com o filósofo Immanuel Kant, o homem é o que a educação faz dele. Diante disso, o quadro do coronavírus trouxe ao conhecimento público a impotância do entendimento sobre finanças pessoais em situação de isolamento. Dessa maneira,com esse bem em mãos, a população adquire mais segurança quanto a estabilidade financeira, no qual oferece aos indivíduos a possibilidade de resolver questões econômicas sem precisar sair de casa, sendo ,então, uma forma de prevenção e conscientização conquanto as regras no âmbito social atual em relação ao Covid.', 'Em suma, soluções são necessárias para a manutenção dessa conscientização do isolamento social. Cabe, assim, ao Ministério das Comunicações , em conjunto ao governo, por meio de verbas governamentais, criar mais canais de acesso informações de qualidade sobre as medidas e normas necessárias para manter a segurança das pessoas, assim como, também, ampliar os serviçoes de auxílios , através de decretos constitucionais , a fim de muda essa realidade de calamidade no Brasil.']",160,160,160,200,160,840
55,,"['Sob a perspectiva do autor José de Alencar, no livro ‘’O Guarani’’ que se passou no século XVII . A história tem por objetivos mostrar as interações entre índios e brancos e a cultura indígena. Nesse romance o relacionamento entre brancos e índios é amistoso, as maiores desavenças ocorrem entre as próprias tribos indígenas, devido as disputas territoriais e a busca por poder . Diferentemente do livro, a disputas por territórios ainda persistem atualmente no Brasil, além da discriminação sofrida pelos índios. Fazendo-se necessários meios para diminuir esse problema.', 'Sob esse viés,  permeia as discussões sobre a importância dos povos indígenas no país, eles são consideramos como referência cultural, afinal foram os primeiros povos a povoar o país. Em séculos anteriores eram alvos de dizimações pelo homem branco ao entrar em conflito por território. E atualmente as disputas tem-se intensificado pelo mesmo motivo. As migrações para os centros urbanos são visíveis, afinal busca-se refúgios nas grandes metrópoles. O que na maioria das vezes resulta em descriminação e na intensificação da desigualdade social, pois os índios podem apresentar dificuldades na adaptação frente a uma nova cultura que exigira fluência na língua portuguesa e na leitura.', 'Ademais, é de suma importância respeitar esse povo que contribuí de maneira significativa para o equilíbrio ecológico do planeta, pois são eles que cuidam da fauna e flora das florestas e protege contra invasores. Se os índios perderem a sua morada, seja por conflitos, seja por migrações ao logo dos séculos, isso causaria um descontrole no planeta que poderia resultar em vários danos, no clima, e eventualmente na agricultura, além do desiquilíbrio da biodiversidade. No entanto, deve-se ressaltar que é um direito do índio participar de maneira efetiva das Universidades, trabalhar e morar nas cidades ou permanecer nas florestas se for de sua exclusiva vontade', 'Tendo em vista a atual situação vivida pelos índios O Instituto Socioambiental (ISA) lançou uma parceria em defesa da cultura indígena. A campanha tem por intuito a sensibilização das pessoas e o apoio em favor da luta pela proteção do patrimônio ambiental brasileiro e defesa dos povos indígenas. O Brasil é a casa não só dos brasileiros, mas também dos índios  pois esses também são brasileiros, e possui os mesmos diretos. Sendo a valorização cultural e a diminuição da descriminação essencial no presente e no futuro do Brasil.']",120,160,120,120,120,640
9,O de cima sobe e o de baixo desce,"['Diante da decadência educacional que se espalha pelo Brasil, devido à má administração oriunda do pelo governo federal, fica claro que é bem provável que jovens de áreas periféricas a partir de agora terão mais dificuldades do que o comum para poder ingressar em universidades e institutos federais e, além disso, as falhas lacunas na política de cotas atual do Brasil prova provam que os mais privilegiados educacionalmente continuarão tendo acesso a à educação.', 'Em 2016, a USP aprovou apenas 34,6% dos alunos de escola pública, sendo que apenas 2,1% se referem a estudantes pretos, pardos ou indígenas (PPI). Com o congelamento de verbas para as redes federais de ensino, fica claro que estudantes de escolas particulares terão maior facilidade para entrar, uma vez que a vagas serão menores e a concorrência irá aumentar, aqueles que carregam uma maior bagagem educacional terá terão uma maior destreza para ingressar em tais institutos.', 'Na A atual portaria da política de cotas atual do Brasil, mostra que Brasil mostra que, para se ter direito as às cotas de escola pública, diz que para ter direito, o aluno deve ter estudado no mínimo três anos em escola pública, o que faz muitos pais tirarem os filhos que estudaram toda a vida acadêmica em instituições privadas, para colocá-los em escola públicas no ensino médio. Uma família que a vida inteira pagou educação privada, tem privada tem totais condições de contribuir com a universidade, e não tem motivos para querer tirar a vaga de alunos de escola pública.', 'Diante dos fatos apresentados, é essencial que o governo crie maneiras de fazer melhorias das nas políticas de cotas de universidades, mudando para maneiras mais rígidas de identificar pessoas com necessidades reais de estar lá.']",120,120,120,120,120,600
63,Mineração,"['Impossível se pensar a vida moderna sem os itens dependentes da mineração. Eletrônicos, eletrodomésticos e automóveis são exemplos de objetos que na sua fabricação são utilizados ferro, alumínio, cobre dentre outros. O problema são os rejeitos gerados na extração mineral que são em grande quantidade e tóxicos. As grandes empresas precisam minimizar os impactos e não deixarem acontecer casos de rompimento de barragens como de Mariana e Brumadinho ambas em Minas Gerais.', 'Toda empresa precisa de autorização do Estado para exploração mineral. São necessários Estudos de Impacto Ambiental (EIA) e Relatórios de Impacto no Meio Ambiente (RIMA). O problema brasileiro é legislação frágil se comparada a de outros países que proíbem, por exemplo, barragens consideradas de alto risco de rompimento . É o tipo mais barato e levou à morte centenas de pessoas e contaminou bacias hidrográficas importantes como a do Rio Doce e do Paraopeba nos casos de Mariana e Brumadinho respectivamente.', 'Até os escritores mineiros Carlos Drumond (Itabira) e Guimarães Rosa (Cordisburgo) criticavam em suas obras os impactos negativos da exploração descontrolada. “Quantas toneladas exportamos de ferro? Quantas lágrimas disfarçamos sem berro? ” Lira Itabirana . Por mais que a Constituição preveja o crime ambiental, os responsáveis quase nunca chegam a pena de prisão.', 'Destarte é preciso, portanto, mais rigor para emissão das licenças e fiscalização das atividades. O legislativo precisa propor leis que favoreçam a segurança mesmo que isso implique em redução dos lucros. Os órgãos de fiscalização ambiental precisam fazer vistorias em intervalos mais curtos e disponibilizar canais de denúncia anônima para que irregularidades  que possam estar sendo maculadas por gestores sejam descobertas antes de desastres. Os minerais são necessários, as mortes não.']",120,160,120,160,120,680
150,A escola vira um ringue,"['O primeiro ambiente                que a criança convive é                 sua casa, ou seja, família, vizinhos, igreja.                Depois disso vem a         escola         onde a criança vai         entra          pela primeira vez em um ambiente social                ,                que aprenderá                conviver com as diferenças,         que         para         muitos         uma tarefa fácil, para outros         impossível, por         isso tantos desentendimentos.', 'O grande         numero         de casos de violência nas escolas vem preocupando o poder         publico         e toda a sociedade. Na verdade é que                 ela                tem alcançado proporções         inadmissíveis, é          notório que por consequência disso o Estatuto da Criança e do Adolescente (ECA) e a Declaração dos Direitos da Criança e do Adolescente vêm se ampliando dia após dia para tentar amenizar a situação.', 'Hodiernamente                alunos         aderem-se         “gangues” para “tocar o terror”, usam isso para saciar sua necessidades, carência, pobreza, maus         tratos         entre outros fatores que geram as personalidades disruptivas.', 'Entretanto          estes órgãos          sozinhos não são suficientes para tal          combate ,a         educação começa desde os primórdios com a         família         que exerce o papel fundamental         como         determinar limites e normas, isto é, educar para         comporta-se         com os demais. A escola pode proporcionar disciplinas relacionadas ao tema, palestras e punições severas em casos especiais. Porém dependerá de cada aluno tomar a decisão de qual caminho seguir.']",120,80,0,0,120,320
87,,"['Atualmente com a valorização da internet, a sociedade concede cada vez mais a visibilidade de crianças e adolescentes, tornando-se um ato normal perante a mesma. Convém lembrar que, no passado, as meninas casavam-se antes mesmo de completarem quinze anos, e os meninos começavam a trabalhar cedo. Diante disso, é possível afirmar que o mundo cibernético influencia no desenvolvimento da criança?', 'Em primeiro lugar, a exposição de conteúdos inapropriados para menores é, no mínimo, deplorável. Com essas informações precoces as crianças terão dificuldades e diversos problemas até a sua fase adulta, pois elas aprendem tudo aquilo que vivenciam. Segundo psicólogos, as grandes mídias influenciam a normalidade da erotização infantil, deixando o público alvo mercê de conteúdos libidinosos, assim, como também, o avanço da tecnologia contribui para este contratempo.', 'Segundamente, é crescente a taxa de conteúdos depravados, cuja, crianças são protagonistas. É notório que os pais tem que ter muita responsabilidade ao \'""lançarem\'\' seus filhos nesse meio tecnológico, pois há um certo perigo por trás das telas, onde muitas crianças buscam atenção e acabam sendo vítimas da pedofilia, em consequência, impactando o corpo e a mente.', 'Desse modo, os pais tem um papel importante para a resolução deste barbilho, criando uma interação familiar para o entretenimento de seus filhos, os tirando de qualquer ambiente absurdo e/ou destrutor e precavendo-os de conteúdos imorais nas redes,  À vista disso, é necessário diminuir o uso de aparelhos eletrônicos para menores e, também, evitar atos impróprios que eles desconhecem. A educação social e moral começa dentro de casa.']",160,160,120,200,160,800
77,,"['Já na década de 20,em um tempo onde a homossexualidade era crime, Alan Turing ,o pai da computação moderna e responsável por decifrar os códigos nazistas durante a segunda guerra mundial, acabou sendo condenado à prisão e castrado simplesmente por ser gay. Atualmente, a homofobia ainda se faz presente em nossa sociedade, mesmo que de forma velada, por aqueles que não vêm a classe LGBT passível de direitos.', 'Podemos entender a homofobia como uma forma de colocar a outra pessoa na condição de inferioridade baseado na lógica heteronormativa . Esse preconceito, praticado até mesmo na forma de agressão física, explica o fato de que a cada 28 horas um LGBT é morto no Brasil. A estigmatização da homofobia ultrapassa as questões pessoais podendo ser percebida até mesmo no mercado de trabalho onde os índices de acessibilidade são baixos.', '“A discriminação e a violência baseada na orientação sexual são violações de direitos humanos” é o que defende o especialista  da ONU. Entretanto, o combate a essas violações é difícil no Brasil, haja vista que não há uma lei específica que criminalize e que distingue uma agressão homofóbica de uma ofensiva qualquer . Sem políticas de proteção do Estado a invisibilidade e a recorrência de casos assim tornam-se uma realidade.', 'Portanto, é função do Estado oficializar uma lei que criminalize a homofobia  além de criar delegacias especializadas em casos como esses visando dar mais assistência e segurança. Além disso, cabe às empresas destinar mais vagas a esse público a fim de fazer valer os direitos aos homossexuais. A escola também tem papel no âmbito de desenvolver projetos de conscientização juntamente com a família, para que no futuro, possamos ter uma sociedade que respeite toda e qualquer escolha de ser.']",160,160,160,120,120,720
138,Um ser corajoso exercita a responsabilidade,"['Coragem e covardia são sentimentos inerentes à raça humana e são demonstradas nas mais diversas situações do cotidiano.         As mesmas         andam paralelamente no âmbito das emoções. Isso ficou claramente exposto no episódio do naufrágio do navio italiano Costa Concordia em janeiro. Fica evidente que para cada indivíduo da sociedade o que é importante é a dosagem de tais sentimentos.', 'Não é raro um indivíduo se deparar         em         situações que exijam coragem física,                 como          fugir          de um criminoso,          de um desastre natural, para          salvar entes queridos, ou mesmo          os que a utilizam como          profissão, como policiais, bombeiros e salva-vidas.                No entanto, esse sentimento tem uma dimensão mais ampla.', 'A coragem ética é o que deve permear as relações humanas. Saber perdoar, agir com responsabilidade e comprometimento ou mesmo saber como lidar em situações tensas,         exigem         maturidade e         censo         crítico. Não é não medir as consequências ou enfrentá-las de qualquer jeito, mas é ter a capacidade de avaliar os riscos e ainda assim ousar, fazer o novo.', 'Foi o que faltou para o capitão Francesco Schettino da embarcação européia. Ao tomar a decisão de fugir do navio e abandonar os 4000 passageiros e tripulantes, ele não assumiu a responsabilidade pela vida dos demais, cometendo um crime. No Brasil, essa situação fica mais evidente no trânsito. A quantidade de motoristas envolvidos em acidentes graves e que não prestam o devido socorro às vítimas é alarmante, um grotesco sinal de covardia.', 'Logo, evidencia-se que a covardia e a coragem residem em cada indivíduo e sua manifestação depende, entre outros fatores, do caráter de cada um. Tais sentimentos são de extrema importância, pois podem lidar com a própria vida ou a de outras pessoas. É necessário exercitar a coragem ética nas pequenas decisões cotidianas, sem medo de frustrações ou equívocos, para que, ao lidar com situações extremas, maior seja a capacidade crítica de avaliar os riscos e agir com responsabilidade.']",160,200,160,160,200,880
68,Uma nação sem patrimônio histórico é como um homem sem memória,"['O patrimônio histórico de uma nação é de suma importância para suas futuras gerações. O que torna necessária a valorização e a preservação de todo esse patrimônio. No entanto, nem sempre é o que acontece e quando acontece o é de maneira ineficiente.', 'Patrimônio istórico é todo bem construído ou produzido por gerações passadas e que sobreviveram ao tempo, e servem como fonte de pesquisa e preservação cultural para as gerações futuras. Nesse sentindo, pode-se citar o Centro Histórico de Olinda (PE), o Pelourinho (BA), outros locais históricos do país além dos inúmeros Museus e Institutos espalhados pelo país que abrigam a essas herdades. A importância desse legado histórico reside no fato de que ele constrói nas gerações posteriores a sensação de pertencimento a uma cultura, história ou lugar. Além de fornecer impressões sobre o modo de vida dos seus antepassados.', 'Há diante disso a necessidade de valorização e preservação de tal herança para que ela não se perca. Valorizar a herdade histórica de um país é permitir que os povos e sociedades que a formaram possam continuar vivos na lembrança das futuras gerações e contribuindo para que essas gerações aprendam os conhecimentos herdados para uma maior evolução da humanidade.', 'Contudo  valorizar e preservar o patrimônio histórico nem sempre é algo executado, e quando é feito  é feito de maneira ineficiente, visto que no Brasil nos últimos 10 anos o fogo dizimou ao menos 8 prédios com tesouros históricos, culturais e científicos brasileiros , entre os quais está o recente incêndio no Museu Nacional do Rio de Janeiro, que teve destruído um acervo irrecuperável importantíssimo para o país e para o mundo;  além de ver parte de sua arquitetura (antiga residência da família real Portuguesa) destruída,  devido a negligncia das politicas publicas.', 'O Estado deveria  zelar por tudo aquilo que caracteriza sua nação, investindo e valorizando sua história, mas não o fez, não adotou medidas até certo ponto simples como a restauração desses prédios que abrigavam essas heranças, não adotou medidas de segurança tais como portas corta-fogo e detectores de fumaça, adotar essas medidas seria valorizar e preservar seu passado.', 'Dessa forma a importância de valorizar a herança histórica e cultural está no fato de que todo ser humano sempre precisou de um passado para garantir suas impressões e ações do futuro, e por isso deixar que o patrimônio histórico e cultural de um país se perca é tirar a oportunidade das gerações futuras fazerem o resgate de seu passado. E isso é infinitamente triste , pois uma nação sem patrimônio histórico é como um homem sem memória.']",120,160,120,160,120,680
86,As redes sociais e a saúde mental,"['A saúde mental,  é de longe um assunto que deveria ser abordado seriamente, já que a mesma reflete diretamente nas ações tomadas pelo indivíduo. É por isso que temos que ter em mente, os impactos do uso das redes sociais na saúde mental, que é de longe o maior vilão da vida saudável de qualquer cidadão. Mas porque a internet pode refletir tão negativamente na vida do usuário?', 'Não é de hoje que vemos milhares de pessoas se tornando ou querendo se tornar famosos nas redes sociais – tais como: “influencers” e “blogueiros” – essas pessoas são as que ditam a famosa “modinha” do momento, ostentam um corpo perfeito e padrão, além de usarem roupas de marcas famosas e caras . Mas o problema está no fato de que acabam influenciando muitos seguidores a seguirem o mesmo estilo de vida e hoje em dia são poucas as pessoas que conseguem um padrão de vida luxuoso, ainda mais com a atual situação que estamos vivendo, muitos perderam seus empregos e consequentemente o seu imóvel, sem dinheiro até para comida, mas mesmo assim, podemos ver esses blogueiros de sucesso realizando viagens e realizando festas com todo o dinheiro que eles possuem.', 'Outro ponto importante, é o fato de exibirem corpos perfeitos e incentivarem a prática de exercícios físicos e a alimentação saudável para conseguirem tal resultado. O principal problema quanto a isso é o fato de muitas pessoas acreditarem que  se fizerem isso, vão conseguir o mesmo tipo de corpo e dessa forma acabam realizando a prática de exercícios excessivos, por vezes param de se alimentar e acabam desenvolvendo problemas gravíssimos de saúde e distúrbios alimentares. Mas mesmo assim, quando não conseguem o mesmo padrão, se sentem horríveis e correm o risco de tentarem algo contra a própria vida tamanha a dor que os consomem', 'Dessa forma, podemos dizer que a maior parte das vítimas são os jovens que passam o tempo inteiro vidrados na internet. Assim, os pais poderiam restringir o uso desse instrumento para uma quantidade limitada de horas e as escolas poderiam fornecer atividades gratuitas e educativas para os alunos interagirem e conviverem socialmente com outros, durante este tempo longe das redes.']",160,160,120,160,120,720
91,A ciência é totalmente necessária (DS),"['Desde a antiguidade, os homens primitivos carregam consigo o comportamento de manada, ou seja, o sentimento de conforto ao acreditar em uma crença popular ou fazer algo que “todo mundo faz”. O problema é que o tempo passou e a inteligência humana não evoluiu , acreditando em tudo que se lê.', 'Atualmente, as redes sociais vêm adquirindo cada vez mais usuários e conectando o mundo, crescendo juntamente ao desejo popular de opinar e receber opiniões. Isto beneficia a comunicação interpessoal, porém, há também a desinformação em grande escala, através das fake news. Estas notícias falsas podem levar o povo a absorver conclusões distorcidas sobre conhecimentos científicos acerca de, por exemplo, contágio de vírus.', 'Um exemplo de negacionismo ocorreu na África do Sul, entre 1999 e 2008, onde presidente Thabo Mbeki negava a gravidade do vírus HIV e o surto que vinha causando. A consequência? Hoje o país tem quase 20% dos infectados do planeta inteiro. O negacionismo científico coloca vidas em jogo. Para Adriane Wasko, bióloga e geneticista do IBB-Unesp, Instituto de Biociências do campus de Botucatu (SP) da Universidade Estadual Paulista, um cenário de epidemia ou pandemia demonstra a importância da difusão de conhecimento.', 'Portanto, para lutar é preciso conhecer o oponente, ainda mais quando se trata da saúde humana. Se faz necessário que o Ministério da Saúde do Brasil, em conjunto com os órgãos de saúde como a Organização Mundial da Saúde (OMS), crie   campanhas de conscientização acerca da força que a ciência tem para vencer doenças e curar pessoas. Também são necessárias ações de informação da população, com boletins diários, na televisão e redes sociais e sem distorção, acerca do conhecimento científico atual, priorizando informativos sobre doenças e vírus em potencial como o SARS-CoV-2. Assim se espera que haja um melhor entendimento acerca da ciência, bem como as consequências de sua ausência.']",160,120,120,160,160,720
62,,"['Na Alemanha nazista pregava-se o extermínio dos grupos considerados indesejáveis, com a derrocada desse sistema e a promulgação da Declaração Universal dos Direitos Humanos pela ONU em 1948 que trouxe a baila uma gama de direitos, esperava-se que estes tipos de ideias baseadas em discursos de ódio não voltassem à tona. Entretanto, as questões de ódio voltaram a crescer e agora tem como espaço de disseminação o ambiente digital. Diante dessa perspectiva, cabe avaliar os fatores que favorecem esse quadro.', 'A internet surgiu com um objetivo de ser um ambiente democrático, onde todos pudessem ter acesso às informações de forma rápida e por varias fontes para que todos se relacionassem de forma harmônica. Contudo, este espaço passou a ser utilizado por alguns indivíduos para a disseminação de manifestações cólera  e isso tem causado vários problemas . Nota-se o crescimento e incitação discriminação,  em virtude de raça, religião, nacionalidade, orientação sexual, gênero, condição física ou outra característica. Percebe-se que a sensação de impunidade e o anonimato tem estimulado este tipo de conduta.', 'Faz-se mister, ainda salientar que muitas indivíduos realizam este tipo de conduta por acharem que ela é a correta e isso também funciona como impulsionador do problema. De acordo com Hannah Arendt, filósofa alemã, onde trás a voga o termo “banalidade do mal”, onde defende que a sociedade vem tornando o mal comum e o fazendo um hábito em diversos lugares. Diante de tal contexto, é notório que para alguns indivíduos o comportamento de disseminar ódio possa parecer normal. Porém, esta questão reflete sobre maneira nas vidas das pessoas que passam por esse tipo de constrangimento.', 'Portanto, indubitavelmente, medidas são necessárias, para resolver esse problema. Tendo em vista o grau da problemática, um olhar criterioso faz-se necessário . É preciso que os governos encontrem maneiras democráticas de controlar os discursos que ferem os direitos humanos, como a criação de uma agencia de controle de dados, onde todos os algoritmos passar por um crivo. Em adição, as grandes empresas da rede devem investir em educação para a não disseminação desse tipo de discurso, práticas como a do Google que criou o projeto “Somos Más” que atende 250 escolas espanholas e visa prevenir e sensibilizar os usuários da internet contra o discurso de ódio e é um bom exemplo de como devemos  agir para debelarmos  este mal que vem se espalhando pela rede.']",120,160,120,160,120,680
84,O Direito de defesa deve ser preservado,"['O recente massacre ocorrido em Orlando nos EUA, que deixou 49 mortos e cerca de 50 feridos em uma boate gay, fez ressurgir o debate sobre a posse de armas pela população civil. No Brasil, há mais de uma década está em vigor o Estatuto do Desarmamento, que restringe a posse e o porte de armas de fogo. No entanto, o Projeto de Lei 3722/12 pretende mudar esse cenário. Muitos especialistas concordam com a proposta, já outros a veem como um escândalo.', 'O Estatuto do Controle de armas, como é mais conhecido o PL 3722/12, diminui de 25 para 21 anos a idade mínima para comprar armas de fogo. Além disso, concede a qualquer cidadão, que cumpra alguns pré-requisitos, o direito de posse e porte das mesmas, ainda que respondam a inquérito policial ou processo criminal. Tal Projeto segue agora para análise do Plenário da Câmara dos Deputados.', 'A incapacidade do Estado de proteger os cidadãos e o direito à autodefesa têm motivado muitos a apoiarem essa proposta de lei. O fato de um grande número de pessoas possuírem armas nem sempre proporciona altas taxas de mortes. A África do Sul, onde existem 13 armas de fogo para cada 100 habitantes, apresenta um dos maiores índices de mortes a tiros do mundo.', 'Portanto, o direito de defesa de cada ser humano deve ser preservado. Todavia, para um país vencer a criminalidade é preciso investir em educação. Formar cidadãos conscientes e honestos seria uma maneira de neutralizar os homicídios. Ao passo que permitir às pessoas que se defendam é algo aceitável, pois o policiamento não se encontra em todos os lugares e momentos. Tornar mais rígidos os pré-requisitos para se ter uma arma de fogo é uma medida necessária. Porém, a verdadeira harmonia entre as pessoas será alcançada através do respeito e do diálogo.']",160,160,120,160,160,760
62,A violência sempre é uma derrota,"['Em um seriado da televisão americana chamado “Gossip Girl”, o personagem principal, Dan Hunphrey cria um site de comunicação com a opção de anonimato, o objetivo da ferramenta é de expor a vida de certas pessoas. Em meio á isso, pela opção de poderem comentar anonimamente muitos indivíduos disseminam o discurso de ódio. Fora da ficção o discurso de ódio nas redes sociais também é um problema, tornando necessário a tomada de novas medidas que resolvam a questão', 'Graças a terceira Revolução Industrial, as crianças recebem mais acesso a conteúdos explícitos e apelativos, desde filmes a redes sociais. Porm, segundo pesquisadores e psicólogos, durante a infância e adolescência, os jovens ainda estão em formação de caráter. Por isso, elas poderiam facilmente ser guiadas por informações errôneas adquiridas pela internet. Consequentemente sem o devido cuidado educacional elas se tornam menos complacentes sobre as diferenças,mais agressivas e  futuramente, extremistas.', 'Faz-se mister, ainda, salientar que pela facilidade de viralizar informações em meio á redes sociais, é comum a visualização de muitos conteúdos com discursos de ódio circulando. O que leva as pessoas a naturalizarem o fato, fazendo com que o numero de pessoas que denunciavam os discursos de ódio, caírem. Logo, esses discursos violentos ganham mais força sem a devida advertência. Segundo o filsofo Jean-Paul Sartre “A violência , seja qual for a maneira como ela se manifesta, é sempre uma derrota”.', 'Portanto, medidas são necessárias para solucionar a questão. Por mais que a educação amenizasse, ela não solucionaria o problema. Logo, o Pode Legislativo poderia criar leis mais eficientes, como a lei Carolina Dieckmann, que punisse os autores de discursos de ódio virtuais . E com a ajuda do Poder Executivo ter a devida atuação sobre a lei, evitando que o crime seja banalizado. Contudo, promover mais conscientização de que a população pode denunciar os agressores, não deixando o ato cair em normalidade, por meio da própria internet. Dessa forma os discursos de ódio poderão ser solucionados.']",120,160,120,120,120,640
46,Precariedade e falta de acesso,"['A privatização de água e esgoto é um dos temas que tem gerado discussão em diversos estados brasileiros nas assembléias legislativas, surgindo os pós e contra essa medida. Este debate, tem como interesse tornar as necessidades em relação a disponibilização do saneamento básico a população uma responsabilidade de empresas privadas que não possuem nenhuma ligação ao poder público . Com isso, o Estado não se responsabilizará mais na oferta de saneamento essenciais para o povo. Esta política de irresponsabilidade do Governo a questões sociais, é ligada ao neoliberalismo, política que se preocupa com a individualidade e o lucro. Entretanto, as populações carentes sofrem mais com essa medida, no que acarreta prejuízo em diversas áreas, como saúde e higiene.', 'Ao tornar o saneamento básico privado, haverá encarecimento da prestação desse serviço, por isso, as comunidades serão as mais atingidas . A população suburbana já é prejudicada com a precariedade do tratamento de água e esgoto, privatizar tornaria esta população mais vulnerável ainda a doenças infectocontagiosas . Já que , a maioria das favelas não possui tratamento adequado do esgoto e sofre com a falta de água com ocorrência.', 'O subdesenvolvimento do país, mostra que o Brasil é constituído por maioria de pessoas pobres, e que também há aqueles que vivem em extrema pobreza . Com isso, subentende que as políticas públicas são de mais urgência, sendo o Governo responsável em desenvolver políticas sociais para a melhoria de vida desta população pobre. Desenvolver políticas públicas e sociais é ir de encontro aos direitos cruciais de um cidadão. Além disso, é respeitar os direitos humanos de uma pessoa, sendo estes acesso a educação, moradia, alimentação, saúde, liberdade de ir e vir, ou seja, necessidades básicas de um ser humano. Dessa forma, o acesso a água e esgoto também, é um direito para a sobrevivência.', 'O termo privatização, divide a população entre os que possuem capital e os sem capital, ou seja, o acesso seja do que for fica comprometido . Portanto, privar uma pessoa de algo é retirar direitos. Dessa forma, a privatização do saneamento básico não é uma medida solucionavel em nada para o povo, mas sim, só retira funções de um governo. Sendo assim, o Estado junto ao poder legislativo dos estados deve procurar formas através de planejamento, ofertar melhores condições de saneamento para as populações.']",120,160,120,120,160,680
5,A controvérsia dos insumos agrícolas,"['No século XXI, é fato que inúmeros debates sobre os mais variados temas ganharam destaque, sobretudo aqueles que versam sobre a relação entre a sociedade e a natureza. Uma dessas discussões reflete sobre a forma mais correta de se referir aos produtos químicos usados em lavouras. Nesse sentido, convém ressaltar alguns aspectos relativos à essa problemática.', 'Com isso, é válido esclarecer que o uso desses insumos tem como objetivo o combate às pragas e doenças as quais afetam o desenvolvimento saudável e eficiente das plantas, sendo esse o único meio disponível aos agricultores para esse fim. Logo, por possuir esse papel de ""defender"" as lavouras, há quem defenda que a forma mais justa de nomeá-los seria como ""defensores defensivos agrícolas"". Assim, usar-se-ia fiél ao benefício trazido pelas substâncias ao homem.', 'Não obstante, existem parcelas da sociedade que advogam uma maneira mais negativa de referenciar referir-se a esses produtos. Por essa ótica, chamariam-nos de ""agrotóxicos"", visto que prejudicariam a saúde humana, causando efeitos como, por exemplo, aumento da chance de geração de doenças; além disso, teriam impacto também no equilíbrio do meio ambiente.', 'Por conseguinte, a decisão mais assertiva de como nominar essas substâncias é a primeira, uma vez que não há dados conclusivos que comprovem seu verdadeiro impacto no ser humano e na natureza. No entanto, é mister que pesquisadores, com o devido apoio financeiro do Ministério da Ciência e Tecnologia, realizem mais estudos nessa área, para não só pôr um fim na escolha da nomenclatura correta, mas também averiguar os reais efeitos dos defensores defensivos agrícolas.']",120,120,80,80,160,560
47,Redação 15,"['A EAD é uma modalidade de ensino muito boa e útil, já que leva o ensino de grandes faculdades à pessoas em locais distantes dela, por exemplo. Contudo, para que esse processo ocorra, é necessário que essas pessoas tenham o equipamento que vai fornecer aulas elas e que saibam como o utilizar. No Brasil, apesar de o EAD estar presente para alguns, outros enfrentam impasses e, além disso, não é a melhor forma de ensino para a educação infantil, que é muito afetada.', 'Primeiramente, é necessário ressaltar o contexto de pandemia que o mundo enfrenta e que , no Brasil, fez a discrepância decorrente da elevada desigualdade social tornar-se mais visível. A pandemia tornou, entre outras coisas, o EAD obrigatório caso o indivíduo queira se manter ativo no ensino. Entretanto, esses indivíduos sofrem com entraves por não terem o equipamento necessário: no estado do Pará, por exemplo, há 800 mil estudantes com dificuldades em se manter nos estudos - alguns por conta da adaptação e muitos por não terem sequer acesso à plataforma EAD, fato que poderia ser contornado se esse fosse aplicado em redes televisivas, que cobrem 84% dos domicílios no Brasil, segundo o IBGE .', 'Ademais, o EAD não é tão eficaz ao se tratar de educação infantil, já que as crianças perdem o auxílio direto dos professores, o que é essencial para o aprendizado delas . Outrossim, as crianças têm de se interagir entre si para um bom desenvolvimento. Dessa forma, o EAD não deveria substituir completamente as aulas presenciais, que são de suma importância para os futuros adultos:  deve ser apenas uma alternativa temporária para enquanto durar a pandemia.', 'Em síntese, o EAD é um avanço importante, mas que deve ser bem planejado para ser aplicado de forma eficiente. Para durante a pandemia, o MEC , aliado à emissoras de televisão, com o intuito de ter maior alcance de transmissão do ensino para os estudantes, deveria transmitir aulas através de televisões diariamente, junto de atividades, durante a semana e em um horário fixo. Desse modo, o EAD teria um grande alcance no território nacional.']",160,160,160,200,160,840
83,"Prática esportiva, algo essencial.*","['No mundo em que nos encontramos hoje, nos deparamos com uma situação espantosa, pois as pessoas estão deixando de lado a prática esportiva, que deveria ser algo praticado realizada todos os dias. Mas por que isso está acontecendo? Acreditamos que a revolução industrial nos trouxe diversas novas tecnologias, o que está deixando as pessoas viciadas, e com desculpas de não terem tempo para a prática esportiva.', 'Esta situação é complicada, pois aquele que deixa de praticas os exercícios, tende a se tornar uma pessoa sedentária e, consequentemente, correndo risco de (contrair) várias doenças, como a asma, distúrbios alimentar, e até o cancêr.', 'Incentivar é o primeiro passo que podemos dar a todos, pois o Brasil é forte em talentos esportistas. Mas, nesse ponto, temos uma situação que deixa as mulheres aflitas, o Brasil incentiva e tem muitos investimentos nas modalidades masculinas, mas quando falamos nas femininas ninguém sabe de nada. Temos grandes talentos femininos, como a seleção feminina de futebol. Muitos dizem que Marta é melhor que Neymar, mas ela com toda sua humildade diz que não existem comparações entre ela e Neymar.', 'Vamos todos incentivar, apoiar e apoiar. Este é um grande passo que podemos estar dando em uma sociedade em que a tecnologia tomou conta.']",120,160,120,160,200,760
83,Os múltiplos benefícios da prática esportiva,"['No contexto da Pré-História, o homem era nômade, isto é, não tinha habitação fixa, por isso, estava constantemente mudando de lugar. Com o passar do tempo, devido a domesticação dos animais e o domínio de ferramentas para a produção agrícola, o homem passou por um intenso processo de sedentarização. Essa mudança trouxe consigo a necessidade de o ser humano praticar exercícios para ter, no mínimo, uma vida mais saudável.', 'As práticas esportivas não se restringem à contemporaneidade, os Jogos Olímpicos, por exemplo, tiveram sua origem no século VIII a. C, na Grécia. Neste ano, 2016, os Jogos aconteceram no Rio de Janeiro, cidade do ‘’País do futebol’’, assim como é conhecido internacionalmente por causa do grande valor que é dado no país à prática do futebol.', 'É inegável dizer que o esporte traz muitos benefícios para quem o pratica. Além de ajudar na socialização de crianças e adolescentes, é um auxílio na melhoria da qualidade de vida do indivíduo, diminuindo os níveis de estresse, e combatendo doenças ligadas ao sedentarismo que leva à obesidade, como diabetes, infartos, problemas circulatórios, entre outros.', 'Diante disso, é possível perceber que a prática de exercícios é mais que necessária, e nos ensina que podemos viver mais e melhor. Cabe ao Estado promover, por meio do Ministério do Esporte, o incentivo à realização de exercícios físicos com o oferecimento de prêmios como recompensa aos praticantes de tais atividades. É imprescindível que a família atue juntamente com a escola no ensino das crianças, desde a mais tenra idade, sobre os benefícios que trazem a prática do esporte.']",160,200,160,200,200,920
89,Adesão ao isolamento social em meio a crise econômica,"['O romance ´´Ensaio Sobre a Cegueira``, escrito por José Saramago, retrata o surgimento do ´´mal branco``, uma espécie de cegueira altamente transmissível. Ao longo da trama, os contaminados, assim como aqueles com quem tiveram contato recente, são isolados em um hospício. Logo, entretanto, todos estão infectados, exceto uma mulher. Egoísmo, escassez de provisões e discórdia fazem-se presentes no decorrer da narrativa. Fica claro que a realidade apresentada na obra relaciona-se ao cenário atual: o mundo está enfrentando a pandemia do novo coronavírus, acompanhada de uma crise econômica, e a medida profilática mais eficaz, na ausência de vacina, é o isolamento social.', 'Em primeiro lugar, vale destacar que a sociedade contemporânea é caracterizada pela solidariedade orgânica. Segundo Émile Durkheim, pai da Sociologia Moderna, o individualismo hodierno, decorrente do sistema capitalista vigente, tem como consequência a redução da consciência coletiva, característica de sociedades primitivas, em que predominava-se o auxílio mútuo em prol da comunidade. Assim, hoje há uma maior objeção a empenhos de vantagens comuns, como o isolamento social. Sendo necessária, portanto, a adoção de ferramentas conscientizantes diversas, que provem que as recompensas não são apenas de caráter coletivo  mas também individual, para a obtenção de engajamento.', 'Além disso, o negacionismo científico, tão cotidiano, é um forte empecilho na conscientização popular. Na Alegoria da Caverna, escrita por Platão, os prisioneiros, vivendo na penumbra, mostram-se relutantes a aceitar a realidade retratada pelo cativo liberto, preferindo acreditar que o mundo limita-se à caverna onde sempre viveram. Paralelamente, o povo, alienado por fake news e discursos de políticos que menosprezam a ciência, encontra-se imune às tentativas de conscientização. Logo, para convencê-lo da importância da quarentena, faz-se necessário muni-lo de informação.', 'Portanto, é mister que os veículos midiáticos chequem a veracidade dos conteúdos por eles transmitidos, garantindo autêntico esclarecimento a seus telespectadores, assim como discorram sobre os artifícios usados na disseminação das fake news, estimulando-os a serem mais analíticos. Urge também que os líderes políticos portem-se adequadamente ao cargo ocupado, agindo de forma exemplar. Assim, as ferramentas conscientizantes já adotadas, como palestras, distribuição de panfletos e mensagens propagadas por alto-falantes, intensificadas, surtirão efeito, já que houve a remoção dos ´´antolhos`` que impediam a adesão a novas perspectivas.']",160,160,120,200,160,800
92,"Verde, azul e amarelo","['No livro ""Minha Luta"" de Adolf Hitler, o autor começa seu discurso de ódio com preconceito e discriminação contra vários grupos de pessoas, inclusive com sentimento xenofóbico. Atualmente, devido ao coronavírus, o mundo expressou ataques na mesma proporção contra os orientais . A experiência mostra que pequenos preconceitos levam a grandes tragédias, portanto é preciso abordar as causas e consequências desse fenômeno para apresentar soluções viáveis.', 'Em primeiro lugar, uma causa relevante dessa situação surgiu com o advento da evolução industrial e o avanço tecnológico que permitiu povos asiáticos emigrarem para outros países em busca de oportunidades. Com isso as populações leigas sem costumes com culturas e perfis diferentes do seu sentem estranheza e tendem a fazer análises insensíveis. Esquecem assim que ali está um ser humano . No caso do Brasil a constituição de 1988 protocola repúdio por qualquer forma de preconceito, discriminação e xenofobia.', 'Em segundo lugar, como consequência das circunstâncias, segundo dados das Organizações Unidas após a pandemia de Covid-19 aumentaram os índices de discriminação e até crimes contra o povo oriental, chineses, japoneses, coreanos e outros. Até mesmo crimes de sangue.  Devido falta de compreensão das populações nativas ou de perfil local e falta de empatia. A Carta Magna de Direitos Humanos não pactua com essas condutas.', 'Portanto cabe soluções, a exemplo Verde: é conveniente que o Ministério da Cultura faça publicidade em respeito aos estrangeiros ou naturalizados com características orientais. Eles tem seus direitos assegurados pela lei e dessa forma será combatido com mais eficiência a discriminação e mostrar assim que há uma punição justa para crimes contra os semelhantes.']",160,120,120,120,120,640
59,Fome,"['A fome no Brasil é uma realidade em inúmeras famílias, todos os dias, enquanto você faz suas refeições há muitas outras pessoas querendo apenas um terço do seu prato ou um pedacinho de alguma coisa que faça seus estômagos pararem de doer e seus corpos se fortalecerem. Alguns não têm a quantidade de alimentos necessária para uma refeição satisfatória e outros não tm alimento nenhum.', 'A produção de alimento não é o problema aqui, o Brasil é um dos maiores produtores de alimentos do mundo, e como há mais de 800 milhões de pessoas sem ter o que comer? Uma das respostas pode nos dar a solução para o problema: o desperdício. No Brasil cada pessoa desperdiça mais de 40 quilos de comida por ano, de acordo com um estudo realizado pela Fundação Getúlio Vargas.', 'Se cada um de nós colocar apenas o que vai comer no prato e o que restar ao invés de jogar fora dar para alguém passando fome?  Nos restaurantes e lanchonetes o que sobra é jogado fora porque não podem vender o que foi feito ontem e se no final do expediente fosse deixado em sacolas na frente do estabelecimento para quem tiver fome? E se houvesse um meio de conectar quem tem fome com quem tem comida que serve para comer sobrando mas que vai pro lixo, uma ONG por exemplo, não ia resolver tudo mas já seria um pontapé inicial.']",120,80,80,120,40,440
69,,"['A Revolução Industrial foi responsável pela expansão da agricultura e, posteriormente, pela introdução do agronegócio. Nesse contexto expansionista, houve o aumento da produção alimentícia e, consequentemente, fez-se necessário inserção de agrotóxicos como auxiliares no combate pragas. Entretanto, recentemente, tais produtos vêm sendo utilizados de forma indevida e excessiva, causando transtornos ambientais e comprometendo a saúde da população.', 'Primeiramente, observa-se que o Brasil se tornou, em 2008, o maior consumidor de agroquímicos do mundo, dominado por empresas como Monsanto, Bayer e Syngenta, apresenta um percentual de uso equivalente a 5,2 litros de veneno por habitante ao ano, um número exacerbado quando comparado à produtividade agrícola desse território . Desse modo, o emprego exagerado e inadequado desses produtos é resultado, principalmente, da subordinação brasileira em relação a essas instituições, que por serem responsáveis pelo aumento da economia, acabam por “monopolizar” o país.', 'Em segunda análise, nota-se que a aplicação de defensivos agrícolas gera um círculo vicioso: quanto mais se usa, maior o impacto ambiental e maior a necessidade de uso, em quantidades intensas e cada vez mais tóxicas. Dessa forma, fauna e flora são comprometidas por tais produtos, que por terem alta toxidade, exterminam outros tipos de vida que podem ser benéficas a uma lavoura, por exemplo, resultando em um desequilíbrio biológico, causando ainda, extinção de espécies, além da poluição aquática e dos solos.', 'A saúde também é prejudicada pela utilização de insumos químicos, visto que grande parte dos alimentos disponíveis estão contaminados, desencadeando assim, casos de intoxicações, que variam de aguda a crônica, além de paralisias e em situações mais extremas  o desenvolvimento de um câncer, devido ao alto poder de mutação apresentado por esses insumos. O Instituto Nacional do Câncer afirma que não existe dose segura para a aplicação de pesticidas, e que estes podem se acumular no corpo, gerando problemas ainda mais complexos para o indivíduo.', 'Entende-se, portanto, que a utilização de agrotóxicos é bastante prejudicial e não agrega de forma positiva a vida da população, já que os malefícios superam vantajosamente alguns possíveis benefícios . Desse modo é dever do Governo restringir as aplicações o mais breve, visando à total proibição, “desmonopolizando” assim, o Brasil e evitando complicações no contexto ambiental e humano. Ademais, sociedade deveria optar por alimentos orgânicos e agroecológicos, evitando a ocorrência de doenças causadas pelo consumo de agroquímicos . Destarte, o país não possuirá desgastes devido à negligência de grandes produtores e consumidores de pesticidas.']",120,160,160,160,160,760
84,Disparando a paz,"['Nos primórdios da sociedade humana e na formação das várias sociedades posteriores, a arma foi considerada um instrumento de uso restrito à defesa pessoal. No prolongamento da linha do tempo do desenvolvimento social, o que se nota é que o armamento deixou de constituir uma defesa e passou a ser um ataque mortal. Como destacava Thomas Hobbes, o homem é lobo de sua própria espécie e, basicamente, os instrumentos de ataque seja uma arma branca ou não, tornaram-se uma ferramenta básica de concretização do pensamento de Hobbes. O violento instinto humano deve ser descarregado antes que a esperança de um mundo sem violência seja morta.', 'Infelizmente, casos de ataques à mão armada não são exemplos apenas em outros países, pois a imagem do Brasil já foi manchada de sangue em várias cenas violentas. A começar pelo caso “Lindemberg Alves”: no ano de 2008, o jovem Lindemberg mata a namorada, ou seja, um típico e rotineiro caso no país de violência passional. Em 2011, o caso “Realengo”: um homem armado ataca uma escola primária no Rio matando algumas pessoas e deixando várias feridas. O fator constante que une esses dois casos é que a violência poderia ter sido coibida caso a liberdade de compra e circulação de armas no país tupiniquim fosse melhor vigiada.', 'Em termos, essa relativa “liberdade” na aquisição de armas existe em solo verde e amarelo por conta da fraqueza do atual sistema controlador do porte. Segundo infográfico publicado no site UOL, na Alemanha, uma arma pode ser utilizada apenas seguindo critérios rigorosos como tendo autorização específica, ter acima de 21 anos e reativar a licença anualmente. No Brasil a lei até existe, mas seu cumprimento é escasso. Para tanto o investimento em um sistema de verificação on-line seria uma vantagem no que diz respeito à manutenção de armas. Assim, o portador recebe além de uma correspondência física, um correio eletrônico para que compareça a um local de avaliação do registro de sua arma.', 'Portanto, esse modo de vigilância é uma forma de evitar que armas sejam manipuladas por mãos de má índole, pois exige, anualmente, que o portador comprove a necessidade do porte e uso de um objeto letal. A vida das crianças de Realengo e da namorada de Lindemberg não voltará, mas com o compromisso sério do desarmamento começaremos a disparar na sociedade um comportamento um pouco menos selvagem daquele visto por Hobbes.']",200,200,160,200,200,960
56,A atual situação carcerária do Brasil. Como reverter essa situação.,"['Há pouco mais de dois anos e meio, em 2017, a guerra das facções criminosas em prisões evidenciou a grave crise do sistema prisional brasileiro, mostrou sua fragilidade e chamou atenção mais uma vez para um dos principais problemas dos presídios brasileiros: a superlotação. Evidencia-se, portanto, que a diminuição do número de presos evitaria tragédias como rebeliões e mortes de detentos e agentes de segurança em cadeias  .', 'Segundos estudos divulgados pela Pastoral Carcerária, o Brasil possui a terceira maior população carcerária, ficando somente atrás de China e Estados Unidos. Há quem pense que a despeito dos muitos presídios inaugurados o quadro da superlotação tende a se agravar, pois na realidade,  só fazem fomentar ainda mais a banalização das prisões e suas barbáries. Neste sentido, o intitulado movimento “luta antiprisional no mundo contemporâneo” tem-se mobilizado para frear o crescimento do número de presos e promover ações para reduzi-lo.', 'Por todos esses aspectos,  medidas são necessárias para resolver esse impasse. Através do sistema judiciário brasileiro, o estudo sobre a diminuição de presos provisórios que cometeram crimes sem gravidade e que poderiam esperar pelo julgamento em liberdade . Assim como o estudo pelo poder legislativo acerca da Lei das drogas, para aplicação de penas alternativas  tais como interdições temporárias de direitos, principalmente quando se tratar de presos que teriam atendido imposição ou pedido para levar drogas aos companheiros . Acreditando que, segundo Confúcio, filósofo Chinês, “não corrigir nossas falhas é o mesmo que cometer novos erros”.']",120,160,120,120,120,640
86,Impactos do uso das redes sociais na saúde mental,"['No filme ""Medianeras"" de Gustavo Toretto, é retratado um futuro distópico em que as redes sociais controlam e manipulam seus internautas, a fim de moldar as opiniões presentes na sociedade. Nesse sentido, a narrativa foca na trajetória de dois personagens: Martin e Mariana, que vivem sozinhos em seus apartamentos em Buenos Aires, frequentam os mesmos lugares, moram muito perto um do outro, mas não se conhecem devido ao fato de estarem presos as bolhas virtuais . Fora da ficção, é fato que a realidade apresentada por Toretto pode ser relacionada ao mundo cibernético do século XXI: gradativamente, as redes sociais corroboram para problemas psicológicos e influenciam no comportamento do público, preso em uma enorme bolha virtual.', 'Em primeiro lugar, é importante destacar que, em função das novas tecnologias internautas estão cada vez mais expostos a uma quantidade ilimitada de dados e informações, consequência do uso descontrolado da internet a partir do uso diário individual. De acordo com o filósofo ygmunt Bauman,vive-se em um mundo de liberdade ilusória: onde somos facilmente influenciados sem que percebamos com facilidade. Assim, os usuários são inconscientemente influenciados pelas redes sociais.', 'Por conseguinte, nota-se um forte poder de influência das redes sociais na coletividade cibernética: ao utilizar essas redes, internautas são cada vez mais expostos a sofrerem problemas sociais, podendo levar ao suicídio. Em um episódio da série televisiva Black Mirror, queda livre, um aplicativo controlava a vida social da sociedade, fazendo as mesmas viverem exclusivamente para serem bem vistas na sociedade e causando delírios quando não se é alcançado o resultado desejado.', 'A partir do exposto, é mister que o stado tome medidas para mitigar esse impasse. Para a conscientização da população brasileira a respeito do problema, urge que o Ministério de Educação e Cultura(MEC) crie , por meio de verbas governamentais, palestras que informem aos usuários da internet o perigo iminente presente no dia-a-dia com o uso excessivo dela, sugerindo aos usuários a não exporem seus sentimentos a essa tecnologia. Somente assim será possível combater essa problemática presente na sociedade e ,ademais, estourar a bolha virtual que as novas tecnologias estão construindo no século XXI.']",160,160,120,200,160,800
69,Os prós e contras do uso de agrotóxicos,"['O uso de agrotóxicos no Brasil é um tema que está tendo bastante repercussão . Agrotóxicos ou pesticidas são produtos usados para o combate pragas em plantações, sem eles existem grandes problemas com pragas, porém, eles podem causar muitos problemas ao meio ambiente e saúde humana.', 'Todas as plantações podem ter pragas e sem proteção a perda de produtos é muito grande, o jeito utilizado para lidar com esse problema é o uso de pesticidas que previnem um ataque de uma determinada praga à plantação.', 'Porém os pesticidas podem contaminar o solo, as águas e o ecossistema da região, causando até a extinção de várias espécies  e a inutilização de solos e fontes de água como rios e lagos.', 'Com a contaminação das águas, solos e até s vezes  os produtos muitas pessoas se contaminam, podendo ocorrer a contração de várias doenças como o câncer.', 'Resumindo , sem eles as colheitas rendem menos e os preços sobem e com eles há a chance dos consumidores e o meio ambiente saírem prejudicados.']",120,80,80,80,40,400
67,Ìndio,"['Com a chegada dos povos europeus América, se promoveu um clássico exemplo de eurocentrismo que se repercutiu pela exploração das terras, escravidão dos nativos assim como seu massacre quando conveniente por parte dos conquistadores. Estes eventos ocorreram no século XVI, porém ainda temos como pauta o desrespeito ao indígena e de sua área de vivência no século XXI, cabendo salientar suas contribuições, seu desafio atual', 'Os jesuítas consideravam os indíos como “gentis” no sentido de serem almas que precisavam ser catequisadas e ensinadas os valores cristãos para se tornarem indivíduos, ignorando todo o conjunto de crenças, culturas, línguas que aqueles diversos povos tinham e construíram ao longo de sua história, sendo tão desmerecida que muito se perdeu de seus antigos costumes  já que sua tradição era passada oralmente. Felizmente  há estudiosos que por meio da tecnologia e pesquisa revivem estes traços culturais permitindo que estes conhecimentos não entrem em extinção, já que são importantíssimos para o entendimento de nossa identidade nacional. A designação de lugares e várias palavras de nosso  vocabulário são proveniente de idiomas indígenas, e em vários momentos a literatura recorreu aos costumes indígenas como matéria prima de sua arte, como ocorreu no Romantismo e Modernismo.', 'A promulgação dos diretos humanos, afirma que todos tem direito moradia, assim como a propriedade privada, o índio mesmo que não esteja inserido na sociedade da mesma maneira , ele tem os mesmo direitos independente de seu estilo de vida, como diz a constituição “ a justiça não faz diferença dos incluídos dos excluídos da sociedade”, então o estado deve promover a segurança destes para que suas propriedades sejam preservadas e que a expansão da fronteira agraria não ultrapasse seus limites. Como dito por Rousseau  o inicio dos conflitos na sociedade se teve com a determinação da propriedade privada, porém o que temos  no caso é um desconhecimento de propriedade privada do índio, tendo que brigar com latifundiários e se por sempre em alerta para manter suas terras em segurança.', 'Portanto cabe ao Estado, a implantação de leis mais rígidas em relação a invasão de propriedade indígenas, leis que favoreçam e legitimem a terra indígena, cabendo também ao índio o livre direito sobre esta propriedade como qualquer outro cidadão, e os infratores deste direito sua devida punição como exige a constituição. Espera-se com essa medida que ocorra a diminuição das invasões e valorização do índio como cidadão. “Justiça não é dar a todos a mesma coisa, é dar a todos o que lhe é necessário” Rick Riordan, deste modo o que é necessário ao índio é a proteção de sua terra, seus costumes e sua dignidade como ser humano.']",120,160,120,160,120,680
74,"Feminicídio, um debate social","['O Brasil é um país culturalmente patriarcal, porque carrega uma herança de imagem masculina como representação econômica, política e familiar. Por isso os senhores de engenho no período colonial, estabeleceram uma construção social frente uma sociedade ainda em formação. Logo, adentrar em questões envolvendo feminicídio objetiva uma discussão plural, entrelaçando grandes problemas atuais que juntos criam barreiras a esta estância discutida, são eles: desigualdade social, analfabetismo, desemprego e outras políticas públicas precárias.', 'Nesse contexto, a violência sexual, verbal, moral e psicológica,  é uma realidade que acarreta alarmantes índices de homicídios contra mulheres – segundo a Organização Mundial da Saúde (OMS). Então, precisa haver um diagnostico de situações concretas, buscando entender as situações socioeconômicas, culturais, políticas e religiosas e, dessa forma, equacionar fatores concretos que levam à violência ao sexo feminino . No entanto, percebe-se a influência cultural-machista  como resistência a este cenário injusto, cujos noticiários mostram mulheres buscando proteção policial, mas, às vezes são ignoradas, ou atendidas por autoridades (homens) que já pronunciaram dizeres absurdos, tal qual o juiz Edilson Rumbelsperger Rodrigues, de Sete Lagoas (MG), em que o magistrado qualificou a Lei Maria da Penha de ""herética"" e ""antiética em 2007.', 'Ademais, temos a vivência interiorana, principalmente nas regiões do Norte e Nordeste, onde os índices de feminicídio são maiores, pelos dados do Mapa da Violência de 2015 . Além disso, muitos nessas regiões vivem à margem da linha  pobreza e grande parcela de homens e mulheres é analfabeta, coexistindo desde a infância com brigas familiares, espancamentos entre cônjuges, abusos sexuais e outras problemáticas. Em paralelo, situações como a temática aqui abordada, apenas colabora para violentar cadê vez mais a vida de uma mulher com direitos democráticos. Portanto, é um quadro real e preocupante no país no qual as políticas públicas são ineficazes, quando existem. E somado a corrupção política, o agravo torna-se hiperbólico.', 'Com base nessas considerações, medidas são necessárias para resolver o impasse. Embora a Lei Maria da Penha exista para coibir violência contra a mulher, a agressão, selvageria e barbárie ainda ganha espaço no Brasil e óbitos entram para estáticas a cada dia . Então é imprescindível uma revisão normativa, a lei deve fazer-se rigorosa e punitiva em todas as estâncias sociais. Para, enfim, normatizar relações sociais saudáveis, justas e iguais em direito.']",120,120,120,160,80,600
83,O papel de mudança,"['O esporte está presente em nosso cotidiano, contribuindo em diversas maneras, não só para o corpo, como também para a mente, e sociedade.', 'A prática de exercícios, influência no desenvolvimento de toda a massa muscular, no entanto, a falta de acompanhamento médico, escolha de locais poluídos, uso inadequado do equipamento, uma vez que surgirá inúmeras lesões, como consequência.', 'Além disso, a realização de atividades esportivas, tem extrema importância no bem estar psicológico, ou seja, contribui para que o individuo tenha mais disposição e concentração em tudo que for realizar durante o dia, por exemplo, nos estudos, no caso de um estudante; pois ajuda também, principalmente os jovens, a terem uma vida digna sem precisar optar pela criminalidade, mas na busca dos seus direitos básico, educação, saúde, cultura.', 'Relativo ao esporte tem como papel, não apenas promover o espirito de competição, mas a inclusão social de todas as pessoas a possibilidade de conviver em sociedade, independente de sua classe social, condição financeira, etnia ou cultura, inclusive a formação da própria identidade.', 'Por conseguinte, é impresncendível que as práticas esportivas sejam levadas a toda população, através das escolas e palestras com atletas mostrando como o esporte pode mudar e ajudar qualquer um a superar as próprias dificuldades.']",80,120,160,120,200,680
149,Viajem  para o Futuro,"['O projeto Mars One, que visa colonizar o planeta Marte, é inovador e         ousado. Principalmente, por que         tem como         objetivo, selecionar         pessoas consideradas comuns, que tenham coragem suficiente e o sonho de morar em outro         planeta;         para realizar uma         viajem para o          planeta                vermelho.', 'A partir disso, evidencia-         se, que         essa é uma experiência         única;         tanto para os candidatos escolhidos, como também para toda         humanidade. Uma vez, que         através desse projeto seria possível se saber mais de                 Marte; coletar informações que possam contribuir para o avanço cientifico;          além, também,          da oportunidade de se criar uma nova civilização.                Portanto, fica         claro         a importância que esse projeto pode representar         em         nossa sociedade,                 de modo que traria avanços significativos.', 'Contudo, é necessário avaliar o impacto e os         riscos, no qual         os selecionados seriam submetidos. Em primeiro         plano         , é fundamental que essas pessoas estejam em boas condições físicas e psicológicas.         Ainda, é preciso que esses, estejam bem preparados e equipados;         tendo em         mente         que o         ambiente         de Marte é muito hostil e perigoso.', 'Em suma, torna-se         evidente, que         a colonização de         marte         será um grande passo para a humanidade e         mesmo, os         obstáculos para         tal, poderão         ser vencidos, caso haja investimentos         e, muito         esforço e dedicação de todos os envolvidos.                 De tal maneira, que essa seja considerada uma          viajem          para o futuro.']",80,120,160,120,120,600
128,Desenvolver sem agredir o meio ambiente,"['O Brasil se sente confuso em relação a defender o meio ambiente ou se desenvolver economicamente, principalmente após a publicação do relatório do IPCC que aponta situações climáticas catastróficas, porém duvidosas.', 'Nos dias atuais, as pessoas parecem se preocupar mais com as mudanças climáticas, não só pelas alterações causadas(enchentes, secas prolongadas, mudanças bruscas de temperatura) mas também pela extrema atenção que a mídia dá a estes fatos. É importante ressaltar que essas mudanças estão ocorrendo sim, mas até que ponto se pode confiar na veridicidade de relatórios como o do IPCC? Este possui uma reputação abalada após ter se confirmado que houve fraude em uma de suas pesquisas.', 'Mesmo estando nesse conflito, o Brasil tem tomado boas medidas para diminuir os impactos causados ao meio ambiente, como a adoção de novas fontes de energia. O país possui uma matriz energética equilibrada, que pode servir de exemplo a outros países.', 'O Brasil, uma nação emergente, não deve deixar o desenvolvimento econômico de lado, principalmente por ser membro de blocos econômicos, como o BRIC (juntamente com a Rússia, Índia e China constituem uma economia promissora) e o G-20, que reúne as 20 maiores economias do mundo.', 'Apesar de não se ter relatórios confiáveis em relação ao clima, o Brasil deve fazer o possível para desenvolver sem agredir o meio ambiente, utilizando como alternativa o desenvolvimento sustentável.']",200,200,160,200,200,960
49,A sociedade do espetáculo,"['Na série antológica ""Black mirror"" o episódio intitulado ""Rachel,Jack e Ashley O"", aborda o tema da manipulação tecnológica na qual uma boneca é criada para persuadir as pessoas a fazerem o que ela diz. Fora das telas isso é uma realidade atualmente, pois existem os influenciadores digitais que manipulam as pessoas que os seguem, além de viverem uma vida de aparências.', 'Primordialmente, a manipulação dos influenciadores em relação aos outros indivíduos precisa ser conquistada, para gerar confiança e manipula-los mais facilmente a comprarem das marcas que estão divulgando . Além disso, a necessidade de se tornar exemplo para os seguidores provoca a perda da própria identidade pessoal.', 'O livro ""A sociedade do espetáculo"" de Gry Debord  discute a teoria de que todas as pessoas vivem em uma performance constante e sempre aparentam a perfeição. Na época atual essa teoria é visível pois os influenciadores digitais constroem uma outra vida nas redes sociais, vivendo  de aparências e sendo denominados perfeitos.', 'Portanto, é preciso medidas para resolver o impasse. Para que haja melhora na convivência nas redes sociais tanto para os influenciadores digitais quanto para os seguidores, urge que o Ministério da Ciência e Comunicação  faça uma campanha de conscientização por meio das redes sociais,  com o intuito de os indivíduos não serem influenciados . Espera-se assim, uma redução da performance mencionada na teoria da ""sociedade do espetáculo"".']",120,160,120,160,120,680
48,SUS no Brasil,"['A série ""Sob Pressão, transmitida na televisão aberta, relata as diversas dificuldades no atendimento em um hospital público. Do mesmo modo, o Brasil vem vivenciando esta realidade em seu Sistema Único de Saúde (SUS), sendo necessário encontrar caminhos para melhorar assistência à saúde pública, já que, este serviço é importantíssimo e único para a maioria da população. Diante desta perspectiva, dois aspectos tornam-se relevantes, o grande número de atendimentos e a carência de profissionais de saúde.', 'De fato, o SUS brasileiro está disponível para uma população com mais de duzentos milhões de pessoas, que podem utilizar os diversos serviços de saúde, como imunização contra doenças e intervenções cirúrgícas mais complicadas, sendo estas assistências sem custo para os indivíduos. Entretanto, na contemporaneidade, o sistema de saúde vem enfrentando uma doença perigosa, a Covid 19, que pode causar a morte rapidamente, sendo o maior obstáculo, os leitos de UTI que são insuficientes para as pessoas que dependem deste serviço . Conforme dados da Fiocruz, 81 % da população depende do sistema público de saúde, demonstrando a importância de preparar este para atender todos os indivíduos.', 'Além disso, no serviço público de saúde existe a falta de médicos, bem como a má distribuição destes no país. Isso se deve, na maior parte, pelos baixos salários que são pagos aos médicos do SUS e as precárias condições dos hospitais e postos de saúde, como a falta de infraestrutura, equipamentos e remédios. Segundo dados do Conselho Federal de Medicina, o Brasil possui um médico para cada 470 habitantes, na região Sudeste, e no Norte este número é muito menor, sendo um médico para 973 pessoas, gerando filas de espera para o atendimento da população.', 'Portanto, é imprescindível buscar meios para um funcionamento mais eficiente do sistema público de saúde, na qual o governo e o Ministério de Saúde devem investir maiores recursos financeiros para ampliar os leitos de UTI e o quadro de profissionais de saúde, a fim de melhorar a assistência à saúde desta parcela de pessoas. Somente assim, não observará mais no país o quadro visto na série ""Sob Pressão"".']",160,200,160,200,160,880
0,Multiculturalismo carnavalesco,"['O carnaval no Brasil é uma tradição que simboliza a alegria do povo brasileiro. Todos os anos, os festeiros foliões surpreendem com as fantasias criativas, exuberantes e muitas vezes ousadas. Infelizmente, surpreendem, nem sempre porém, nem sempre surpreendem de forma positiva, pois pois, dependendo da escolha dos adereços, pode podem causar polêmica, principalmente por vivermos em um momento histórico em que tanto se discute a respeito do multiculturalismo.', 'O Brasil é um país que possui uma diversidade cultural muito grande e é reconhecido por ser ter um povo acolhedor. No entanto, a fama não impede que existam situações que causam polêmicas relacionadas à discriminação. Muitas vezes, pessoas se encontram em polêmicas por descuido, outras por desrespeito.', 'A fantasia carnavalesca, com referência indígena, da atriz Alessandra Negrini da atriz Alessandra Negrini, com referências indígenas, é um exemplo de polêmica relacionada ao multiculturalismo. Enquanto alguns interpretaram a fantasia como uma forma de desrespeito cultural, outros entenderam que se tratava de uma fantasia como outra qualquer e que o importante é o momento festivo, e que o objetivo da fantasia foi sair da ""fantasia habitual"" e apenas entrar no clima carnavalesco.', 'Diante da situação, o importante é manter o diálogo e ouvir sempre os dois lados, pois a ofensa ofensa, nesse caso caso, entra no campo da interpretação, pois pois, no caso em questão questão, não se observa uma ofensa direta. O cuidado deve ser no sentido de não enquadrar tudo o que é diferente como ofensivo, pois nesse caso tudo seria desrespeito a culturas diferentes.']",120,120,80,120,80,520
58,,"['A preservação da floresta amazônica é crucial à biodiversidade, pois viabiliza uma dinâmica ecológica equilibrada à fauna e a flora e, também, aos povos tradicionais ali viventes (indígenas e ribeirinhos). Diante dessa perspectiva, no entanto, falar em desmatamento e queimadas é adjetivar negativas preponderantes ao Brasil – extinção de espécies, desertificação do solo e deslocamento da população indígena, por exemplo. Logo, tais discussões podem ser respondidas por uma legislação ambiental questionável e favorecedora ao agronegócio. Além disso, a fiscalização ambiental na Amazônia ainda necessita de melhorias e as diretrizes educacionais do país precisam proporcionar ênfase aos estudos ambientalistas.', 'Nesse contexto, infere-se uma discussão política, econômica e social, visto que problemas envolvendo direitos indígenas, derrubada ilegal de árvores para fins agrícolas e incêndios equacionam índices estatísticos preocupantes. Pois, o avanço do agronegócio de soja vem prejudicando a população nativa e, consequentemente, a floresta amazônica. Assim, a apropriação de terras indígenas e ribeirinhas e a expulsão deles para outras localidades – resulta na perda de identidade cultural, manifestações constantes e até genocídio. Desse modo, embora exista uma legislação ambiental vigente  esta não garante direitos efetivos ou denota normatização ineficiente para punir ilegalidades.', 'Por conseguinte, observa-se uma fiscalização deficitária pela qual venha anular os efeitos da devastação ambiental na Amazônia. Então, diante das queimadas que assolaram a floresta, desprende-se uma conjuntura administrativa e política deficiente, seja por não salvaguardares as extensas terras amazonenses ou falta de punição e prisão aos garimpos ilegais e à biopirataria - contrabando de animais e plantas. Para tanto, desenvolver visão preservacionista é crucial para criar futuras gestões ambientalistas eficazes, mas, a realidade mostra um sistema de ensino que não estabelece obrigatoriedade nisso . E, como reflexo, negativas do desmatamento destroem a maior floresta tropical do mundo.', 'Com base nessas considerações, constata-se a importância em buscar proteger a floresta amazônica. Nesse caso, cabe ao Ministério do Meio Ambiente , por intermédio de uma PEC (Proposta de emenda constitucional), revisar as leis protecionistas, tornando-as mais efetivas e severas aos agressores do meio natural. Além disso, o Ministério da Educação  por meio da nova base curricular de ensino – precisa incluir de forma obrigatória – o aprendizado em estudos ambientalistas e proteção da Amazônia. A partir disso, resoluções mais objetivas devem preservar e conservar uma Amazônia mais segura às próximas gerações.']",120,160,120,160,120,680
54,Um vorpo,"['Considerado um dos fundadores da sociologia, Émile Durkheim ressaltou a interdependência das atividades desempenhadas pelas instituições sociais e por seus membros. Nessa perspectiva, as ações perpetradas pelos cidadãos têm extrema importância e influenciam em todos os setores do tecido social. De forma análoga, a vacinação é um ato que tem repercussões em diversos segmentos da sociedade, uma vez que este não apenas contribui para a estabilidade econômica de um país, mas também é benéfico à saude populacional.', 'A vacinação impacta positivamente a saúde populacional. A exemplo dos dados divulgados em 2019 pela Secretaria de Saúde do estado de São Paulo, que explicitam os baixos índices de vacinação contra o sarampo e o consequente aumento de casos relacionados a este na região, altas taxas de aplicação de vacinas em um país relacionam-se à atenuação da incidência de hospedeiros de determinados antígenos virais. Essa situação, por conseguinte, corrobora a eficiência destas em conter o recrudescimento dos sintomas e mortes relacionados a diversas enfermidades virais. Em decorrência disso, torna-se indubitável o fato de que as vacinas têm importante função para a sociedade, tendo em vista que estas são fundamentais para a saúde populacional se manter estável.', 'Além disso, a economia de uma sociedade pode ser afetada negativamente por baixos índices de vacinação. Respalda tal afirmação uma pesquisa acadêmica da Universidade da Carolina do Norte, dos Estados Unidos da América, que constatou, em 2016, que a economia de um país sofreria mais prejuízos com tratamento de enfermos do que com a realização de campanhas de vacinação . Somado a isso, a ausência e o insucesso de tais campanhas, por fomentarem a incidência de doenças virulentas, desestimulam o turismo nas regiões afligidas por estas, ocasionando a diminuição dos lucros oriundos de tal atividade. Infere-se, desse modo, que a vacinação é importante para a sociedade, impactando a economia, um setor social que, tal como ressaltou o filósofo alemão Karl Marx , é essencial para quaiquer agrupamentos humanos.', 'Desse modo, torna-se inegável a utilidade das vacinas para uma sociedade, sendo sua ampliação essencial para a manutenção das estabilidades da saúde populacional e da economia. Assim, as Secretarias Municipais de Saúde do Brasil devem designar funcionários aptos a aplicar vacinas a parques, escolas e ginásios de localidades cujos índices de vacinação estão em níveis insuficientes, tencionando aumentar o número de indivíduos imunizados contra doenças virais. Concomitantemente, o Ministério do Turismo deve desenvolver propagandas que divulguem as campanhas de vacinação desenvolvidas. Mediante essa atitude, poder-se-á tornar o país atrativo a turistas preocupados com a saúde, e manter a população imunizada a diversas enfermidades']",120,160,120,160,120,680
9,Desigualdade na educação,"['A crise econômica das universidades públicas tem sido muito discutida nos últimos meses. Enquanto alguns defendem a privatização, outros insistem em que deve ser mantido o ensino público e gratuito. Entre os dois extremos, existem aqueles que defendem que doações e parcerias privadas devem ser incentivadas, além de serem criadas mensalidades proporcionais aos para estudantes de alta renda. Porém, acima de qualquer discussão de sobre essas opiniões, deve-se ressaltar a desigualdade econômica existente no Brasil.', 'De fato, o direito à educação deve ser oferecido a qualquer pessoa que busque uma oportunidade, porém, isso deve ser feito de forma que todos tenham a mesma chance. Visto que, muitos que muitos dos estudantes de universidades públicas fazem parte dos 20% mais ricos do país, se faz necessária adoção de políticas que garantam a igualdade na disputa das vagas para um ensino público e de qualidade.', 'Com o objetivo de amenizar essa situação, o governo federal, divulgou federal divulgou no mês de Maio maio, alguns cortes que serão feitos em relação as verbas, antes, às verbas antes direcionadas a determinadas universidades públicas. De acordo com o governo, esses recursos serão destinados aos ensinos fundamental e médio, visando promover maior qualidade na educação básica pública. Essa decisão causou vários protestos pelo Brasil, tanto contra como a favor à medida aplicada tanto contra a medida como a favor dela.', 'Portanto, é possível concluir que parte da população apresenta vantagens no processo de ingresso às universidades públicas, em relação aos menos favorecidos economicamente. Resultando economicamente, o que resulta no monopólio da educação gratuita. Essa situação influência influencia negativamente a realidade de muitas pessoas, que acabam pagando a conta dessa crise criada na gestão das universidades públicas brasileiras.']",160,120,80,120,80,560
84,Desarmamento,"['É indiscutível que, o Estatuto do Desarmamento trouxe resultados eficientes em relação ao declínio do número de homicídios por arma de fogo no Brasil, pode-se comprovar essa realidade por meio de várias pesquisas realizadas,como as 160 mil mortes evitadas durante o período de implementação do estatuto,segundo ilustrações do Mapa da Violência de 2015.', 'Alguns argumentam que a flexibilização no controle da posse e do porte de armas dará a população uma possibilidade de segurança maior, pois eles teram como se defender dos criminosos, além disso os defensores do Projeto de Lei 3.722/2012 argumentam que o estado terá um maior controle de armas adquiridas de forma legal,e portanto saberá quantas armas estaram circulando no país,isso sem contar que seram mantidas algumas exigencias para a compra e o porte de armas.', 'Outros,porém relatam que ao facilitar o controle de armas para os civis fará com que os índices de criminalidade aumente , pois terá uma maior circulação de armas de fogo no país,tornando a seguraça pública uma ameaça,tazendo à tona um retrocesso na história ao combate do desarmamento no Brasil  impedindo grandes avanços em nossa sociedade, Há registros históricos de que um estatuto com maior rigor no controle de posse e porte de armas de fogo tem uma maior eficácia no  controle da violência e consequentemente no número de mortes por armas de fogo,é claro que não se pode impedir cada assalto,homícídio ,enfim,mas podemos implantar regimes cada vez mais rigidos em nossas leis.', 'Em vista dos argumentos apresentados, percebe-se que uma maior flexibilidade em virtude do armamento de civis, não é a melhor solução para se manter diante de uma sociedade que ainda precisa de muitas explicações sobre tudo  que uma arma pode representar em suas mãos,e que o estatuto do desarmamento ainda é a melhor opção para que os índices de criminalidade caiam,  portanto é preciso uma concientização maior da sociedade através de palestras sobre os efeitos e os impactos do estatuto do desarmaneto e sobre esse novo Projeto de Lei 3.722/2012 para que aja um maior esclarecimento e consequentemente uma decisão consciente para o melhor da população.']",120,160,200,200,200,880
64,Educação Sexual,"['Abortos irregulares. Gravidez indesejada. Aspectos políticos e sociais. Aumento de ISTs. Fake News. Infelizmente, é nesse contexto de problemas em que vive hoje o jovem brasileiro com a ausência da educação sexual e de informações válidas. Para tentar lidar com essas dificuldades, diversas medidas devem ser tomadas, desde o investimento em educação, transitando por uma seleção de professores capacitados, até a inclusão da educação sexual nas escolas no Brasil, já que é de extrema importância debater esse assunto delicadamente na contemporaneidade brasileira.', 'Em primeira instância, nota-se que no momento atual do Brasil, é visível que uma onda conservadora está dominando o país, por isso é importante esclarecer tabus a respeito do ensino sexual . A princípio, o papel da família na educação sexual é inquestionável, os familiares desempenham um dever importante de ligação afetiva da criança e do adolescente, ensinando que ela é amada e que por isso pode amar outras pessoas. Os pais estão sempre educando os filhos do ponto de vista sexual, mesmo não se dando conta disso, a forma de como o casal de relaciona e trata seus filhos é uma forma de aprendizagem sexual. Então, é indiscutível o dever da família, os parentes precisam se preparar e se conscientizar do seu papel no ensino sexual .', 'Em segunda instância, compreende-se que,  a escola possui um dever significativo na educação sexual. Desde os anos 80, pesquisas mostram que a sociedade de forma geral, como pais e educadores, vem defendendo o papel da escola, pois é tarefa dela também na questão de trabalhar os temas, ela é responsável pela formação integral dos jovens, é responsável pela formação da pessoa em si, e que a escola tem como diferencial a presença de crianças e adolescentes de idades semelhantes, a escola é um lugar de debate, de discussões, de reflexão e de troca de ideias. O instituto é prestigioso, e ele deve assumir o seu dever apoiado pelo setor da educação, que, segundo o filósofo alemão Immanuel Kant: ""O ser humano é aquilo que a educação faz dele"".', 'Em suma, o fato da docência sexual ser um tabu inexplorado no Brasil, é necessário debater esse assunto aos poucos. Com a liderança do Ministério da educação, líderes educacionais, escolas, professores e pais, devem conversar sobre a implantação do ensino sexual nas escolas e, descartando imediatamente o projeto ""Escola sem partido"" , pacificamente, que a princípio seria apresentado na educação infantil, a fim de trabalhar os temas de acordo com as suas idades, que por sua vez, o ensino infantil é a base de tudo. E que posteriormente seria apresentado ao ensino fundamental e médio, não ensinando o ato sexual em si, mas sim com esclarecimento de dúvidas, prevenções, de conhecimento do seu próprio corpo, da importante participação de parentes, com profissionais capacitados, a fim da tão sonhada evolução na educação brasileira.']",120,160,120,160,120,680
28,O Brasil recentemente,"['O Brasil passou, recentemente, por um processo de impeachment da presidente da Republica , Dilma Rousseff. Além do baixo apoio do congresso e dos vários escândalos de corrupção envolvendo seu governo, houve também muita pressão de grupos denominados suprapartidários que organizaram diversos protestos exigindo sua saída do poder.', 'Esses grupos, liderados por jovens que se diziam apartidários e que tinham então somente o objetivo de livrar o Brasil da corrupção, obtiveram expressiva adesão popular, milhares de pessoas saíram às ruas protestar contra a corrupção. Houve também bastante pressão em cima de deputados e senadores para que votassem a favor do impedimento.', 'Porém, passado pouco mais de um ano desse complexo processo, o que se vê atualmente é um certo conformismo da sociedade, mesmo com noticias de corrupção chegando todos os dias até nós. Os próprios grupos que obtiveram destaque na organização de protestos não agem mais com tanta intensidade. Diante disso a pergunta que se faz é; se a corrupção continua então por que praticamente acabou a pressão popular?', 'Algumas pessoas defendem a teoria de que os grupos que se diziam imparciais, foram, na verdade, financiados por partidos de oposição e isso explicaria a apatia desses diante da atual situação. Há também quem diga que o que motivou tamanha mobilização foi o odio a então presidenta, ou seja, o processo ocorreu em caráter personalissimo e, por isso, mesmo havendo corrupção no atual governo a reação das pessoas não é a mesma.', 'Somado a isso temos uma população cansada de lutar e não obter resultados, a impressão que dá é de que as pessoas desistiram da batalha. Gastou-se muita energia imaginando que a saída de uma pessoa ou de um grupo político resolveria nossa situação e ao perceber que se trata de um problema bem mais complexo, as pessoas jogaram a toalha. Pois bem, o gigante continua deitado em berço esplendido . Eternamente? Só o tempo vai dizer.']",200,200,160,120,160,840
76,,"['Hoje no Brasil temos uma diferença salarial de quase 30% a menos para as mulheres entre 25 a 64 anos em relação ao salário dos homens da mesma faixa de idade, tendo em vista esse dado estamos cientes das diferenças de direitos entre homens e mulheres. Aqui podemos ver a baixa quantidade de mulheres em faculdades de exatas e a luta das mulheres pelos direitos iguais, a equidade é a justiça para com indivíduos do mesmo sexo tentando chegar a igualdade dos direitos trabalhísticos.', 'As mulheres são mais pobres que os homens isso é fato , mas isso não significa que elas estudam menos ou escolhem profissões menos remuneradas, nas mesmas profissões que os homens elas apresentam as mesmas diferenças salariais, isso significa que elas ganham menos pelo fato de serem de outro sexo.', 'As mulheres ocupam um número muito pequeno em cursos de exatas como matemática, física, química, isso poderia ser explicado pela cultura ou pelo pequeno número de professoras nessa área, as mulheres compõe apenas 20% das engenharias e 40% das economistas , esses fatos podem comprovar o por que que as engenharias no Brasil tem uma proporção menor do que a de outros países .', 'Dessa forma o estado poderia tratar com igualdade as mulheres em vista de seus esforços na sociedade, promover mais oportunidades não só para as mulheres mas para qualquer indivíduo independente de sua raça, direitos iguais para todos.']",120,120,80,80,80,480
50,A transmissão,"['A grande pandemia, o COVID-19, que teve início na China e se espalhou para o mundo em pouco menos de um mês é um enorme perigo para a população por conta da sua alta taxa de contaminação.', 'Para que não haja contaminações, os líderes mundiais decretaram um estado de quarentena para todos os países, mas, nem todos os cidadãos respeitam esse decreto, o que fazer pra impedir isso?', 'Primeiramente, como é transmitido o Coronavírus? Esse vírus é transmitido a partir da saliva, espirros, tosse e etc, e de acordo com algumas investigações, foi descoberto que ele é capaz de ficar até três dias numa superfície de plástico ou aço; então para que a quarentena? Para impedir que haja contaminação; e aqueles que não seguem o decreto da quarentena? Infelizmente o governo não consegue manter tudo sob um controle completo e essas pessoas acabam se contaminando, claro que até quem está se isolando corretamente pode acabar contaminada por conta da falta de higienização, mas as chances são menores.', 'Com isso em mente, percebe-se que é necessário criar novas regras e leis para controlar ou até mesmo cessar essa pandemia. Caso contrário, vai ser possível que o governo isole completamente os infectados como aconteceu no cenário fictício da animação japonesa “Black bullet”, em que mostra o governo isolando completamente os infectados priorizando a saúde dos saudáveis, tratando os infectados até mesmo como criminosos; pode não chegar nesse ponto, mas pode ser algo próximo.', 'Então como impedir a transmissão do vírus? Não há como garantir totalmente, mas uma ideia é, a implantação de multas; com a economia atual, as pessoas não vão querer receber multas por algo tão simples como sair de casa, mas como já foi dito, não há como garantir totalmente, então nos resta confiar nos cidadãos e em suas capacidades de pensar na saúde dos outros como também em sua própria .']",120,80,80,120,40,440
44,"Let Her Run""","['A luta das mulheres pela igualdade dentro do esporte tem sido muito mais do que uma simples discussão. É uma grande causa a ser enfrentada.', 'Consegue-se observar o crescente aumento de mulheres dentro do esporte ao longo de décadas.', 'Entretanto, o que se observa na realidade,  é que nem todas as atletas conseguem seu lugar dentro do esporte,  por causa das exigências impostas a elas, para que atinjam o ""padrão de excelência"", exigido pela empresa esportiva.', 'Esse cenário é reflexo do que ocorre dentro do esporte masculino, onde os atletas devem sempre estar no ""padrão"", onde estão sempre sujeitos a exames para detectar algum tipo de alteração hormonal, onde, se detectada, o atleta poderá ser desqualificado, já que alguns hormônios, a testosterona por exemplo, pode melhorar a performance dos atletas nas modalidades praticadas pelos mesmos.', 'Porém, existem atletas femininas,  que atm frequente alterações hormonais, como o aumento da testosterona, e muitas acabam sendo desqualificadas por esse motivo.', 'Uma solução adequada para essa situação seria algum medicamento ou tratamento para essas atletas para que possam inibir a quantidade desse hormônio, para que consigam fazer sua performance sem medo de serem desqualificadas.']",160,120,80,120,120,600
50,Ciência a favor da vida,"['O infortúnio do conoravírus – Covid 19 – terá consequências que ainda sequer podem ser dimensionadas para a população mundial, seja do ponto de vista econômico ou do ponto de vista da saúde. Em virtude desse cenário no qual se estabeleceu o caos, a esperança mais provável é de que a solução seja proveniente do campo científico . Para os mais religiosos, isso não reflete uma cisão com sua  fé, mas ato de sensatez; como disse Louis Pasteur ""um pouco de ciência nos afasta de Deus. Muito, nos aproxima"".', 'A ciência não se opõe à religião, e vice-versa. O coronavírus deve ser enfrentado com boa medicina, e, também com a solidariedade e compaixão por todos aqueles que se expõem ao risco para prover cuidados às pessoas que foram acometidas pela doença . É preciso considerar também que, apesar de todas as recomendações de especialistas e autoridades da área da saúde, há pessoas que insistem em contrariá-las, expressando não apenas incredulidade quanto à potência da Covid-19, como também atuando  de maneira irresponsável, expondo seus pares à disseminação de um vírus que já se alastrou pelo mundo afora e provou sua letalidade.', 'Devido à dimensão do problema, também se faz necessário que o governo desenvolva parcerias com o setor privado. Por exemplo: fomentar pesquisas sobre vacinas e tratamentos, acelerar as testagens na população, fornecer equipamentos de proteção individual para todos os profissionais que atuam diretamente no combate ao vírus, enfim, o momento é de unir esforços de todos os setores da sociedade em prol de uma causa que vai muito mais além que um indivíduo.', 'Por fim, menosprezar investimentos em ciência e tecnologia seria ignorar as evidências e colocar em risco a capacidade de resposta para o futuro do Brasil. Resta destacar que em algum dia a epidemia irá acabar; seja porque se encontrará uma vacina, seja porque surgirá um tratamento eficaz;  mas de qualquer forma a ciência terá papel fundamental nessa jornada.']",160,160,120,160,0,600
63,A Terra clama por soluções,"['Uma das questões mais recentes e faladas no mundo é o impacto ambiental que as grandes empresas causam em nossa Terra. Ao analisarmos , por exemplo no Brasil, essa corrosão de nosso nicho ecológico está muito crescente atualmente, um problema não só para os brasileiros, mas para o mundo. Alterações ambientais são os maiores lapsos e ruínas que o ser humano causa a todos, seja para as pessoas, animais e plantas.', '“Vivemos em uma época perigosa. O homem domina a natureza antes que tenha aprendido a dominar a si mesmo. - Albert Schweitzer”', 'O fato mais recente do maior país da América do Sul, o Brasil, indica o maior exemplo de grandes corporações que não se importam com o seu ecossistema. A Vale, empresa de mineração, deixou que duas de suas várias barragens se rompessem e efetuassem, infelizmente, milhares de falecimentos , sonhos desfeitos, futuros destruídos, e um meio ambiente danificado . Em dados publicados pelo jornal digital GLOBO junto ao IBAMA, dos R$784,9 milhões, apenas 3,4% das multas foram pagas, o que mostra que brechas na regularização e morosidade da justiça cooperam com a impunidade desses responsáveis.', 'Em contrapartida  vemos o grupo O Boticário, em matéria alegada pelo jornal digital EXAME, que observando a fase atual, decidiu saber se os ingredientes contidos em seus xampus e sabonetes afetam o sistema hídrico, e como diminuir o números desses segmentos para reduzir os impactos causados por eles. Grande visão de um mundo melhor e mais correto, além de ser uma boa propaganda para a empresa.', 'Portanto, ao analisarmos os fatos mencionados e toda as alterações ambientais causadas pelos seres humanos, direta ou indiretamente, as multas devem ser maiores e mais eficientes, nas escolas o ensino ao meio ambiente deve ser mais intenso e aberto desde o tempo da pré-escola até o último ano do ensino médio. Maiores ações de empresas, como a do O Boticário, devem ser mais frequentes, como campanhas à favor do planeta por meio do governo influenciando o povo brasileiro a diminuir seus hábitos mais comuns, são obrigatórios.', 'Se cada um fizer, um pouquinho que seja, o planeta Terra, com certeza, será um mundo melhor para todos e futuras gerações.', '“Só se pode vencer a natureza obedecendo-lhe. – Francis Bacon”']",120,160,80,120,80,560
92,Preconceito Amarelo (DES),"['“Uma burrice coletiva sem explicação”, foi assim que Gabriel, o Pensador definiu as discriminações e preconceitos da sociedade. É preciso que se combata esta burrice, visto que nada a justifica. Mas como lutar contra o preconceito?', 'Influenciadores sociais têm despertado o combate às discriminações no mundo, defendendo minorias e pessoas fragilizadas. O fato é: os asiáticos em nada se diferem de qualquer outro povo, são iguais, têm capacidades e fraquezas semelhantes. A frase “Enquanto a cor da pele for mais importante que o brilho dos olhos, haverá guerra”, de Bob Marley, o mais conhecido cantor compositor de reggae de todos os tempos, mostra que o pensar no outro como alguém inferior, alimenta o desrespeito.', 'Segundamente, Nelson Mandela, um dos mais poderosos símbolos da luta contra regimes segregacionistas e racistas, disse que ninguém nasce odiando outra pessoa por cor de pele ou origem. Isso enfatiza que o preconceito é algo ensinado e induzido, não sendo natural. Somente a ignorância permite pensar que um chinês tem culpa sobre a infecção pandêmica do SARS-CoV-2 no mundo, pois este é um vírus que, como todos os outros, se modifica e infecta facilmente os organismos, não precisando de interferência ou indução humana. Os discursos de ódio precisam acabar, pois pessoas podem entrar em depressão devido à dor do desprezo.', 'Por fim, Mandela também disse que, se as pessoas podem aprender a odiar, elas podem ser ensinadas a amar. É necessário que as instituições que defendem a igualdade social, como a ONU – Organização das Nações Unidas – movam-se, fazendo campanhas de conscientização em todos os continentes do mundo, afim de abrir os olhos da sociedade e mostrar que todos os humanos têm o mesmo valor. Além disso, no Brasil é preciso que se cumpra o artigo 5º da Constituição federal de 1988, que diz que todos são iguais em direitos e deveres perante a lei, e que as entidades responsáveis fiscalizem e tomem medidas cabíveis quanto aos praticantes de preconceito. Desde que o mundo acorde sobre o respeito, é provável que acabem, quase ou totalmente, as ofensas racistas.']",160,120,120,160,160,720
63,,"['A produção de bens de consumo é essencial para a vida das pessoas, visto que para viver com certos confortos em áreas como: saúde, educação, segurança, lazer...  É necessário ter alguns itens que não são produzidos pela natureza apenas . O exemplo de medicamentos, equipamentos para tratamentos de doenças, deslocamento e meios para pesquisa. Porém, é fundamental pensar nessa produção a partir do viés ecosustentável, mas caso isso não ocorra é fundamental pensar em meios de penalidades para que os erros não se repitam. Para isso  é preciso aumentar ou criar mais sanções para mitigara a sensação de impunidade.', 'Tais represálias podem abranger desde multas, proibição da atividade da corporação em território nacional, mais fiscalizações por parte do Estado e ou desativação em território nacional da empresa.', 'Para tanto, é fundamental que as represálias como as multas, pois ao saber que qualquer passível terá um alto custo a quem o fizer o responsável pelo dano irá repensar em um meio de produção mais sustentável ou perderá um lucro significativo . Mas, é preciso se fiscalizada, também, por parte do Estado e da sociedade. Com isso saberemos , se de fato, está ocorrendo a implantações de meios de prevenção, já que muitos podem burlam ou não minimizar os riscos de modo efetivo, caso notem que não há quem observar se o que foi proposta está sendo cumprindo.', 'Do mesmo modo, é preciso criar meios para que as corporações revitalizem as áreas que sofreram impactos ambientais, para que o local volte a ser o mais despoluído  ou que possa assim, custeado por essa, haver a descontaminação no decorrer dos anos, independente do tempo que dure a medida. Com esse tipo de ação será possível recuperar e assim não deixar áreas com passível ambiental sem dar à devida chance a natureza para recuperação.', 'Logo, as sanções são um meio de mostrar as corporações que produzem sem o devido respeito à legislação ambiental ,que existem agentes legais de prontidão para limitar as ações e aplicar o que  lei exige , seja de multa a revitalização ou proibição da atividade. Porém é fundamental, além de punir, desenvolver políticas públicas ambientais  para evitar novos impactos e modificar a cultura de produção, para que o desenvolvimento tecnológico ocorra de modo mais sustentável, já que a nossa matéria prima é limitada e há gerações que precisaram usufruir delas também.']",120,160,120,120,120,640
71,,"['O suicídio no país tem apresentado aumento significativo nos últimos anos, principalmente entre os jovens. Segundo dados do Ministério da Saúde, cerca de 11 mil pessoas morrem por suicídio todos os anos, e os jovens correspondem a cerca de 30% dos casos. Sabe-se que entre as principais causas desse problema estão às doenças mentais e o preconceito da população em discutir a questão socialmente.', 'De acordo com a Organização Mundial de Saúde- OMS, em torno de 90% dos casos de suicídio está relacionada com alguma doença mental. Esse dado evidencia a importância de investimento na saúde mental, com tratamento e prevenção, tais como acontece nos cerca de 2000 CAPS distribuídos pelo país. A existência desses mecanismos é de suma importância, mas suas ações e área de atuação não são suficientes para absolver a demanda da população.', 'Mas, apesar de as doenças mentais serem consideradas as principais causas de suicídio, outro ponto deve ser levado em conta: O preconceito da sociedade. O mito que discutir sobre o suicídio,  incentiva a sua prática, criou uma sociedade que não possui aparato de ajuda para as pessoas necessitadas, que incentiva assim, o isolamento social. É certo que, essas praticas aliada ao crescente consumo de drogas e álcool pelos jovens, somado com a pressão de padrão de comportamento criado pela redes sócias, tornam o ambiente mais suscetível a prática do suicídio.', 'Torna-se evidente, portanto, que a crescente prática de suicídio pelos jovens é grave e exige soluções imediatas. Desse modo, o estado deve aumentar a abrangência de CAPS pelo país, facilitando o aceso de pessoas portadoras de doenças mentais e propensas ao suicídio. Além disso, restringir com fiscalização e punição rígida o consumo de álcool e drogas pelos menores de idade . A família e os amigos devem ser atentos a possíveis mudanças de comportamento e buscar auxilio profissional quando for o caso, além de incentivar a escola do filho a realizar palestra de orientação sobre o tema suicídio. Nesse sentido, podemos criar maneiras mais eficazes de combater essa prática que destrói o indivíduo e sua família.']",120,160,120,120,120,640
75,,"['Sob a perspectiva do cineasta Sergio Leone na ficção “Era uma vez no Oeste”, em 1968, foi arquitetado de maneira realista a violência que se tinha na época, com acesso armas as pessoas resolviam suas diferenças em carnificinas, que tinham como motivação disputa de terra, dinheiro e poder. Não muito diferente de hoje a violência é ocasionada pela desigualdade, na qual muitos brasileiros que vem de famílias desestruturadas, carentes se entregam ao crime. Desta maneira temse discutido muito se a lei que garante a flexibilidade à posse de armas pelos cidadãos podem trazer segurança e diminuir a atual criminalização do país.', 'De acordo com os dados de segurança pública divulgados pelos O jornal estado de São Paulo no primeiro semestre de 2017, no Brasil foram registrados 28,2 mil homicídios dolosos, lesões corporais seguidos de morte ou latrocínio e casos de roubos seguidos de morte e o número de mortes por armas de fogo só tem aumentado. Na ocasião, o IPEA (Instituto de pesquisa Econômica Aplicada) chegou a comparar os dados de violência no Brasil e no mundo a conclusão que os atentados terroristas do mundo nos cinco primeiros meses de 2017 não superam a quantidade de homicídios registrados em três semanas de 2015 no Brasil.', 'Diante das evidências argumentadas no texto , sugere-se que a legalização do porte de armas para civis não é a melhor maneira de possibilitar segurança das mesmas, notado que há a possibilidade de aumentar a violência, e não diminuir a matriz do problema que é a desigualdade social, a falta de emprego, educação e a saúde que são os maiores desencadeadores de delinquência . Como exemplo fale-se citar os Estados Unidos que apesar de ser um país desenvolvido, com leis eficientes, e com a legalidade de armas para a população também registrou vários incidentes por armas de fogo como o tiroteio em um festival de música em Las Vegas em 2017. Diante dessa informação, há a necessidade do Brasil melhorar primeiramente estabilidade econômica e educacional do país .', 'Logo, um possível caminho para trazer segurança a sociedade é por meio das políticas públicas , visando projetos de incentivos educacionais de qualidade principalmente nas periferias onde tem-se as maiores comunidades carentes. Os meios de comunicação por intermédio de palestras poderão contribuir ao colocar em debate o tema, como forma de conscientização dos riscos de se ter uma arma em casa. “A violência é uma questão de poder. As pessoas se tornam violentas quando se sentem impotentes”, segundo Friedrich Schiller. As armas foram feitas exclusivamente para matar, e mais armas não significa mais segurança ou paz.']",120,120,120,120,120,600
52,"Gravidez precoce, breve reflexão","['A reposta para esta pergunta está atrelada a análise de dois fatores: o primeiro seria de ordem mais pontual, ou seja, as consequências de uma gravidez precoce na vida de meninas e meninos em fase de crescimento; e o segundo seria os efeitos dessa questão na sociedade.', 'Considerando as especificidades da puberdade, observamos que além das transformações biológicas, a adolescência é um momento em que se inicia uma série de questionamentos, dentre eles,  os aspectos inerentes a mesma. E, quando essas perguntas não são bem esclarecidas, podem impulsionar a curiosidade por experiências, que requerem um mínimo de amadurecimento, como é o caso da sexualidade. Nesse âmbito, a iniciação sexual precoce e sem a devida informação pode acarretar uma gravidez não planejada, que na vida de adolescentes, principalmente das meninas, pode significar a interrupção de projetos característicos dessa idade, como os estudos, passando a assumir responsabilidades próprias de um mundo adulto.', 'Ao analisarmos esse aspecto no contexto mais amplo, percebemos que ele pode gerar, além de consequências socioeconômicas, situações de ordem estrutural, especialmente se atentarmos para o fato de que muitas dessas adolescentes tornam-se mães, sem ao menos estarem psicológica e emocionalmente preparadas para lidarem com as adversidades do mundo. Nesse sentido, a maternidade precoce exigirá um certo aparato de assistência, que em meios mais vulneráveis, demandará do poder público ações na área da saúde e da educação para atender as particularidades dessa mãe e dessa criança.', 'Portanto, acreditamos que a gravidez na adolescência é um problema, mas este poder ser evitado por meio de políticas que trabalhem massificamente a informação sobre os efeitos de uma prática sexual deliberada e sem o devido cuidado, procurando conscientizar sobre as responsabilidades envolvidas na mesma.']",120,120,80,120,40,480
83,,"['Durante o processo de formação do estado brasileiro entre os séc XV ao XXI, nota-se um frequente problema de exclusão social. Desde o período da escravidão, uma das minorias que são excluídas e inferiorizadas por um grupo expressivo da sociedade, são os negros. Com isso, percebe-se que essas e outras minorias convivem com uma difícil realidade, que pode ser amenizada de algumas maneiras através do esporte.', 'O racismo está muito presente na sociedade brasileira. De acordo com Durkheim, o fato social é uma maneira coletiva de agir e de pensar dotada de exterioridade e generalidade, seguindo essa linha de raciocínio, percebe-se que o preconceito também esta sendo passado de forma hereditária. Portanto um esporte que mostra a cultura trazida pelos negros e ensina indivíduos a terem diciplina é a capoeira, um meio de inclusão e uma atividade que vai contra o racismo.', 'Um outro fator a ser analisado, é o de que pessoas com menores condições financieiras também são descriminadas e vivem uma injusta realidade. Entretando, para Aristóteles, a política deve ser utilizada de modo que, por meia da justiça, o equilíbrio seja alcançado na sociedade. Mantendo esse pensamento em foco, o esporte pode ser utilizado com uma atividade meio, tendo como objetivo de diminuir a exclusão.', 'Uma outra classe a margem da sociedade, é a dos portadores de deficiência física. Entretanto, esses individuos receberam como forma de inclusão um evento de estrutura global, as paraolimpíadas, atividades como forma de inclusão por meio das competições esportivas.', 'Entende-se, portanto, que o esporte pode ser utilizado como um caminho eficiente para incluir as minorias. Com isso, nota-se que é necessário uma via de mão dupla, na qual deve-se aumentar de um lado os investimentos e de outro a divulgação de ONGs e projetos sociais que utilizam-se do esporte para que o equilíbrio na sociedade seja alcançado.']",120,160,160,200,200,840
43,A Prática do cancelamento,"['Para o ecritor Buckminster Fuller  ""A humanidade está adquirindo toda a tecnologia certa por todas as razões erradas"".Logo que essa expressão se encaixa bem na atualidade,como a cultura do cancelamento,uma vez que as pessoas são menosprezadas, pelas redes sociais por cometerem algo errado ou por pensarem diferente. Nesse contexto encontra-se a má influência midiática e os transtornos psicológicos.', 'A princípio,a internet está cada vez mais agressiva, onde o ódio está dominando um instrumento que era pra ser de descontração. De certo que por uma influência midiática,as pessoas estão se tornando escravas das redes,isto é,tudo tem que ser igual,como a forma de pensar e agir,um padrão imposto pela mídia,e que todos devem seguir.', 'Ademais,o cancelamento das redes, afeta as pessoas causando danos como doenças psicológicas,em virtude de ser julgada e linchada virtualmente,a pessoa pode carregar traumas,que acarreta a depressão .De certo que cancelar não é o melhor caminho para a mudança,essa atitude pode resultar em problemas maiores,temos que praticar a empatia,como dizia o pensador Confúcio  ""Não corrigir nossas falhas é o mesmo que cometer novos erros"".', 'Torna-se,evidente,portanto,para que a cultura do cancelamento seja banida,o Ministério da Tecnologia(MCTIC) ,junto com as redes sociais Twitter e Instagram, deve por meio de discussões,campanhas e relatos,criar vídeos e anúncios,que conscientizem as pessoas usuárias da internet,com a finalidade de que o cancelamento não é o melhor formato de punir alguém. Bem como, para a resolução da outra problemática, devem ser usados os mesmos mecanismos,com a finalidade de que todos possam desfrutar da melhor forma possível a internet']",160,120,120,200,160,760
7,Criptomoeda,"['A tecnologia tem crescido tem se desenvolvido muito nos últimos anos e possibilitou evoluções em inúmeras várias atividades e áreas na qual em que temos contato, inclusive na economia. Mas toda essa evolução não parou nos caixas eletrônicos e internet bankings, recentemente temos ouvido falar da moeda digital ou a criptomoeda criptomoeda, que está crescendo e e, em passos curtos curtos, conquistando seu espaço no mundo.', 'Podemos afirmar que a criptomoeda traz vantagens interessantes, como a praticidade no momento de usar seu ""dinheiro"" dinheiro, para fazer algum tipo de troca no nosso mundo capitalista capitalista, e a dificuldade de roubo. Entretanto, há desvantagens que provocam uma reflexão profunda sobre o uso da criptomoeda neste momento. O acesso ao novo sistema monetário seria através da internet, mas nem todos os países estão prontos para isso. No Brasil, por exemplo, pouco mais de sessenta por cento da população tem acesso à internet, isso significa que parte da população teria mais dificuldades em termos de poder aquisitivo por não ter acesso à internet.', 'Outra grande preocupação seria o fim dos bancos, esse bancos. Esse acontecimento aumentaria demasiadamente o número de desempregados, causando maior desigualdade e miséria nos países, principalmente os emergentes. Além disso, há também as questões de segurança, quanto mais a internet cresce e ganha valor, mais hackers bem capacitados aparecem, o que coloca em risco a segurança do dinheiro virtual e também de dados pessoais.', 'Todavia, a criptomoeda seria um ótimo sistema monetário quando se pensa em um futuro, onde em que os países já estejam bem desenvolvidos e igualados em termos como empregabilidade e meios de comunicação, caso contrário comunicação. Caso contrário, o processo dificultaria ainda mais a inclusão de diversos países emergentes na globalização. Como disse Yla Fernandes ""é preciso subir degrau por degrau, não se chega lá em cima sem passar por cada etapa"". Para o bom funcionamento da criptomoeda é necessário que problemas mais simples sejam resolvidos.', 'Diante das informações apresentadas apresentadas, seria interessante, caso a implantação do novo sistema monetário se torne uma meta global, que os países, junto com órgãos competentes, como o Ministério da Ciência, Tecnologia, Inovação e Comunicação, Ministério da Economia e Ministério da Educação, no caso do Brasil, invistam no desenvolvimento de profissões futuras, aumentem a porcentagem de acesso à internet de qualidade dentro dos países e trabalhem a preparação e adaptação dos funcionários de bancos à criptomoeda evitando futuras crises econômicas.']",120,120,120,120,80,560
46,a melhor solução - S,"['Na série Burden of Truth, a advogada Joana,  defende uma empresa que presta serviços de saneamento privado, em uma pequena cidade, onde vários episódios de doenças surgem entre os moradores . Saindo da ficção, a realidade existente,  entre países em que o saneamento básico é terceirizado,  não é diferente. Nesse sentido, problemas ainda mais sérios em âmbito social, podem ser acarretados, em países em que a fiscalização não é eficaz.', 'Em primeira análise, empresas privadas, se tornam mais difíceis de se fiscalizar, já que são fornecedoras de serviços, onde dificilmente haverá órgãos responsáveis, pelo acompanhamento de seus atos . Onde a cobrança, se torna de livre ganho, investidores enriquecem às custas da população em geral de menos abastadas, como dizia o filósofo Marquês de Sade, “não há paixão mais egoísta do que a luxúria”.', 'Em segundo plano, a não fiscalização correta, o que se pode notar em muitos países pelo mundo, pode acarretar doenças, contaminações, insegurança à população, uma vez que há relatos de acontecidos parecidos nos Estados Unidos da América e Europa . Nessa perspectiva, pode-se notar, graves problemas com a privatização de serviços essenciais para a população, tornando-se impressendível o cuidado em sua criação, assim como o escritor João Guimarães Rosa falava, pois assim teremos uma água de qualidade que é igual a saúde ou a liberdade, que só se tem valor quando acaba.', 'Dessa forma, medidas para atenuar o impasse devem ser tomadas. Portanto, é indispensável que o Ministério da Saúde , mediante a criação de secretarias planejadas no ambiente, fomente a discussão crítica e ativa sobre a privatização do saneamento básico. Isso deve ser feito por meio de pessoas especializadas no assunto, a fim de que seja revisto e pautado, o que é melhor a população brasileira. Somente assim, tal embate no Brasil, poderá ter a melhor solução.']",160,160,120,160,160,760
51,A necessidade de uma restruturação na educação brasileira,"['O Brasil apresenta uma estrutura de ensino ultrapassada, segundo o que dizem muitos especialistas. E isso reflete a atual situação do país em exames de avaliação, como o PISA , o qual mensura por meio de provas o desempenho escolar de alunos de muitos países, e o Brasil possui uma performance ruim em matérias como português e matemática . Assim, sendo necessária uma reforma no ensino do país a fim de combater uma grande deficiência: o analfabetismo e analfabetismo funcional. Tendo em vista o fraco poder de políticas públicas em mitigar tal fenômeno.', 'Em primeiro lugar, vale destacar o prejuízo que uma população mal instruída pode trazer a um país, uma vez que a educação é essencial para o desenvolvimento humano e técnico-científico. Contudo, o Brasil adota um modelo de ensino  pouco eficiente e por isso é nítido o atraso quando comparado a outras nações de igual nível econômico. Portanto, é sabido adotar  novas formas de alfabetização e um novo currículo escolar o qual tenha o aluno como foco; ou seja, ensinar os alunos de acordo com suas dificuldades a fim de melhorá-lo e um ensino voltado a suas vocações, dessa maneira evitando até mesmo vasão escolar, sendo esta um fator que muito contribui para o pouco desenvolvimento dos níveis de alfabetização.', 'Ademais, destaca-se uma questão em que os alunos passam muito tempo numa escola aprendendo matérias,  que observando de uma forma pragmática, pouco irão agregar a uma futura carreira profissional, o que acarreta em muito tempo e recursos sendo investidos de forma desnecessária . Além do mais, há um acentuante desigualdade social e econômica entre as regiões e isso há forte impacto, pois os maiores índices de analfabetismo funcional estão nas regiões mais pobres, Então, sendo necessária uma intervenção estatal mais forte, posto que a pobreza contribui para o aumento de tal problemática, já que a falta de oportunidades leva muitos jovens em idade produtiva a abandonar o meio escolar.', 'Portanto, é valido afirmar que a educação nacional passe por reformulações visando a diminuição do analfabetismo funcional, assim como outras deficiências inerentes ao ensino brasileiro. Para isso, cabe ao governo federal, em conjunto com o Ministério da Educação e das secretarias estaduais e municipais, propor um novo modelo de ensino para as escolas brasileiras, com base em matérias que incentivem a leitura, que vise instigar o aluno a ter prazer em aprender e de forma que melhor seja aproveitado os recursos humanos, materiais e financeiros do Estado.']",120,160,120,160,120,680
25,A homofobia em pauta,"['A homofobia vem aumentando diariamente, praticada por pessoas que dispõem de uma série de informações, opiniões, mas se recusam a aceitar o próximo, sobretudo se ele for julgado como “diferente” do que é acostumado se ver. Um dado alarmante, que necessita de atenção redobrada para que ao menos possamos sonhar com uma sociedade igualitária.', 'Em 2017, até o mês de maio, 117 pessoas foram assassinadas no Brasil devido à homofobia. É um assassinato a cada 25 horas, segundo o Grupo Gay da Bahia(GGB). Em 2016, consoante a Associação Internacional de Lésbicas, Gays, Bissexuais, Transgêneros e Intersexuais, 340 LGBTs foram mortos no Brasil. Em 2015, foram registradas 318 mortes, segundo informações do grupo.', 'Vale destacar que a homofobia não se expressa apenas na ocorrência de homicídios. Os homossexuais são constantemente agredidos, tanto fisicamente, quanto através de descriminalização em locais públicos, no entanto, as vítimas não podem fazer um boletim de ocorrência por um ataque homofóbico, pois na Constituição brasileira não existe uma penalização severa, além de prestação de serviços à comunidade ou então pagamento de cestas básicas, resultando em um incentivo ao crime.', 'Muitas vezes a homofobia vem acompanhada pelo racismo, “quando se trata de negro e gay, os estigmas ficam um pouco pior, pode-se dizer que a exclusão é dupla” . Quando se é branco e tem uma boa renda, a homossexualidade é tratada de forma mais compreensiva .', 'Em virtude dos fatos mencionados pode-se concluir que, odiar alguém a ponto de matar só porque esse alguém possuiu uma orientação sexual diferente da sua, é sim uma doença a ser combatida, afinal todos tem o direito de escolher ser feliz, de poder andar de mãos dadas com a pessoa amada, sem ser tratado de forma diferente. A educação sexual deveria ser obrigatória em todos os níveis escolares; o governo necessita criar uma lei mais severa e punir exemplarmente os agressores; e conscientizar a sociedade sobre o que é respeitar, e principalmente sobre o que é amar.']",0,0,0,0,0,0
86,O Black Mirror da Vida Real e Suas Consequências,"['O episódio ""Nosedive""  da série ""Black Mirror""  retrata uma sociedade em que o indivíduo,para ter um bom status em suas redes sociais,precisa demonstrar ter sempre uma vida feliz e perfeita,algo que não faz bem para seu emocional e não reflete a realidade da vida de ninguém. Fora da ficção as redes sociais funcionam de maneira análoga,por isso é necessário discutir a relação entre redes sociais e saúde mental e sanar os problemas nessa relação.', 'Primeiro,é necessário saber quais os problemas que as redes sociais trazem para o emocional de seus usuários e porque eles são trazidos. Logo que alguém entra em uma rede social é bombardeado por postagens de corpos e vidas,aparentemente, perfeitas e,normalmente,esses perfis perfeitos têm milhões de seguidores,assim essa pessoa acha que para ser aceita precisa ser perfeita,mas acaba se frustando ao não atingir esse padrão irreal,assim fazendo com que essa pessoa se sinta inferiorizada .Outro ponto a se destacar é que,segundo o livro ""Galáxia da Internet"",as relações interpessoais nas redes sociais são mais frágeis,por exemplo:basta uma pessoa deixar de seguir outra no Instagram para que uma amizade virtual,de anos,acabe. Um desses fatores ou a combinação deles pode fazer o usuário dessas redes sociais desenvolver transtornos alimentares,depressão e ansiedade.', 'Em segundo plano,é preciso saber porque essas mazelas se perpetuam. Segundo a empresa Global/Weblendex o brasileiro passa cerca de 20% do seu dia em redes sociais,então o brasileiro é constantemente afetado pela falsa perfeição dos influenciadores,que a usam para vender produtos,além disso com os novos editores fica difícil saber o quanto do que se vê na internet é real,além disso as pessoas ficaram tão obcecadas pelas redes que esqueceram de viver fora delas.', 'Portanto,o impasse precisa ser resolvido. Para isso,o Ministério das Comunicações fará,por meio dos veículos de mídia,uma campanha para desmistificar a perfeição nas redes sociais. Paralelamente,o Ministério da saúde,com a ajuda do MEC(Ministério da Educação),colocará nas escolas psicólogos para ajudar os jovens emocionalmente prejudicados pelas redes sociais e o MEC deverá,por sua vez,promover palestras nas escolas que incentivarão os alunos a diminuir seu tempo nas redes,porque como diria Immanuel Kant:""o homem é aquilo que a educação faz dele"".É esperado que outros países ajam como o Brasil. Assim,não mais,a sociedade viverá em um episódio de ""Black Mirror"".']",200,160,160,200,160,880
72,Atenção para as desinformações.,"['Fake ews um problema atual e sério  que contamina a sociedade em todo o mundo, trazendo consequências e danos graves para a população. xcessiva quantidade de informações passadas pelas redes sociais nem sempre são filtradas pelos usuários, ao qual compartilham sem ter a responsabilidade de verificar a veracidade das notícias.', 'Estudos demostraram  que mais de 60% dos adultos americanos têm o abito da leitura desse tipo de notícias nas redes sociais, e que as fake news são compartilhadas mais do que notícias verdadeiras. Segundo informações de vários jornais do mundo (New York Times, Folha de São Paulo, Corrieri della Sera entre outro) as eleições de 2016 entre Hillary Clinton e Donald Trump teve circulação de notícias falsas nas redes sociais, difamando a imagem da concorrente  dando favorecimento ao atual presidente dos Estados Unidos.', 'Em tempos de eleições esse perigo é evidente, por ser um momento importante, quando o cidadão exerce a sua cidadania em prol do país, despencam informações e propagações de notícias falsas entre os concorrente, porque a vitória das eleições para eles é o principal foco no momento ,  usuário em contrapartida deve buscar fontes seguras de informações dos atuais candidatos que irão administrar o país, devendo exercitar o extinto crítico de cidadão e pesquisar sobre os fatos publicados.', 'Portanto esse problema que já está globalizado é combatido com pessoas que buscam informações em fontes seguras, não compartilham sem antes buscar a veracidade das notícias. Palestras em escolas que espoem aos alunos as consequências desses atos são importantes. Uma geração que a todo momento está conectada deve ter responsabilidades daquilo que compartilha.']",120,120,120,120,120,600
70,Como combater o aumento das DSTs entre os jovens brasileiros?,"['As doenças sexualmente transmissíveis (DSTS) são doenças causadas por vírus, bactérias ou outros micróbios que se transmitem, principalmente através das relações sexuais sem o uso de preservativo com uma pessoa que esteja infectada, e geralmente se manifestam por meio de feridas, corrimentos, bolhas ou verrugas.', 'Segundo o Ministério de Saúde, em 2005  os casos de HIV passaram de 16,2% para 33,1% por 100 habitantes, na faixa etária de 20 a 24 anos. Ainda convém lembrar as dsts mais comuns entre os jovens que são: Aids, gonorreia, sífilis, hepatite b, hepatite c, herpes genital, clamídia e HPV (Human Papillomavírus).', 'Em todavia, em  matéria publicada pelo Governo de São Paulo, é possível ver que os números de casos realmente é maior entre os jovens. Segundo o Programa Conjunto das Nações Unidas sobre HIV e Aids (unaids), 35% dos novos casos ocorrem entre 15 a 24 anos. Outro fator existente, em 2007 a 2013, os casos de sífilis por transmissão sexual em jovens em São Paulo aumentaram 603%, só em 2016 1,8% milhões de pessoas contraíram HIV em todo o mundo.', 'Em virtudes dos fatos mencionados , cabe s autoridades  assim como escolas e pais, conscientizar os jovens utilizando abordagens diferentes, e isso deve começar desde cedo e não somente na juventude. Além da educação sexual nas escolas, palestras e cursos para jovens e pais com uma abordagem mais efetiva podem ajudar a desmistificar os dsts nos dias de hoje.']",120,160,120,120,120,640
13,Arma não simboliza segurança,"['É de conhecimento geral que, todo armamento representa perigo. Uma vez que, aprofunda as tensões sociais existentes, pois, uma sociedade armada é mais violenta.', 'Segundo a OMS (Organização Mundial da Saúde)  o Brasil é o décimo primeiro país com a maior taxa de homicídios no mundo. Logo, podemos observar que vários conflitos sociais ocasionam um aprofundamento da violência e a posse de arma não é a solução para isso, visto que, ela foi criada no intuito de sub-julgar e não proteger.', 'Uma sociedade armada é mais violenta, segundo nicolau maquiavel o poder trás estabilidade e prestígio, contudo, e é necessário ser um poder representado pelo estado. Instaura-se um comportamento de disputa para a concentração de poder quando entregue a sociedade. Os indivíduos começam a presumir autossuficiência. Logo, deixa de importa-se com os direitos de todo ser humano e agem, deliberadamente, dado que, tem em suas mãos o que define o destino de uma vida.', 'Portanto, é necessário que a mídia, o governo, escolas e a família elabore medidas que abordem a reflexão sobre o armamento da sociedade civil. Assim, é necessário a elaboração de projetos sociais para combater a proliferação do entendimento que armas são a solução para a minimizar a violência no Brasil.']",120,40,0,0,0,160
95,Lu Terras Indígenas,"['Historicamente os direitos à terra pelos indígenas sempre foram violados, a começar pela colonização dos portugueses, que dominou estes povos e o lugar onde eles viviam. No entanto, a questão atual é o marco temporal, isto é, uma ação que está sendo julgada no STF (Supremo Tribunal Federal) a qual defende que as demarcações de terras indígenas sejam realizadas somente se os povos originários estivessem nestes locais no 5 de outubro de 1988. Caso seja aprovado, os problemas ambientais e as questões hídricas no Brasil serão acentuados.', 'Ademais, a maioria dos indígenas se encontram na região amazônica, um dos biomas mais prejudicados no mundo pelo desmatamento. Assim sendo, estes povos primitivos contribuem na preservação do meio ambiente, porque seu sustento advém da natureza. Portanto, caso o marco temporal seja aprovado, a Floresta Amazônica será mais destruída pelos grandes latifundiários, que terão base jurídica para destruírem ainda mais este bioma.', 'Além disso, o país tupiniquim apresenta outro grande problema: a crise hídrica. É fato que o agronegócio sustenta esta crise, pois o clima brasileiro que, a cada ano que passa está mais seco, a necessidade de irrigação para a produção de alimentos é fundamental. Entretanto, os indígenas utilizam estas águas para a própria sobrevivência, ora na pesca, ora no transporte, ora na higiene pessoal. Portanto, a preservação dos rios se torna mais benéfico para esta população.', 'Em suma a discussão sobre o marco temporal deverá ser ampla e bem fundamentada, para que não só os indígenas sejam prejudicados, mas também toda a população brasileira. Assim, compete ao poder legislativo,  elaborar leis mais específicas sobre as demarcações de terras indígenas, a fim de garantir os direitos constitucionais dos povos originários, por meio de discussões e de estudos de caso para que este processo seja menos burocrático. Hoje os indígenas ficam expostos à violência por causa da morosidade da justiça.']",160,160,160,200,160,840
79,como podemos mudar,"['Celas superlotadas e insalubres. Epidemias de doenças. Má alimentação. Problemas que recorrem desde as mais antigas civilizações como Egito e Grécia, onde se acreditava que por meio de tal era capaz de reabilitar os delinquentes. Atualmente, diante das diversas situações   o aprisionado se sente cada vez mais desprezado e excluído da sociedade. Diante disso   percebe-se a necessidade de uma mudança no sistema carcerário.', 'Em primeiro lugar, a superlotação das celas tornam cada vez mais a situação dos presos desumanas, pois desrespeita a Constituição Federal no artigo 5, que deixa claro que ninguém será submetido a  tortura nem a tratamento desumano ou degradante. Entretanto   este  direito é desrespeitado quando ha  falta de médicos para atender os prisioneiros, além de atividades para os distrair, para que não adquiram problemas mentais e físicos pelo sedentarismo. Diante disso, fica claro  a necessidade de uma maior atenção aos presídios.', 'Então, mudanças inicialmente no julgamento dos crimes para impedir o  superlotação das prisões, aliada  a uma maior atenção do governo para a construções de centros especializados em manter os presos trabalhando durante o dia, impedindo que fiquem sedentários, além de uma maior contratação de médicos para atender os prisioneiros impedindo que fiquem doentes, dissipem doenças, além de selecionarem os alimentos adequados a serem consumidos por eles.', 'Portanto, cabe ao governo juntamente com a   OAB (organização dos advogados do Brasil)  realizarem mutirões de julgamentos de casos para aliviar a lotação das prisões e também formar parcerias com o ministério da saúde para uma maior disponibilidade de médicos para o sistema carcerário.   Além de oferecer subsídios a empresas que aceitarem oferecer emprego para presos durante o dia. Desta  forma conseguiremos formar um sistema carcerário eficiente e humano.']",160,120,120,160,160,720
81,,"['O Brasil, em pleno século XXI, ainda enfrenta o problema da intolerância religiosa. O combate a essa questão é um grande desafio devido, principalmente, ao fato do país ser majoritariamente católico e de outras religiões serem pouco conhecidas. Por isso, diariamente ? pessoas de diversas religiões sofrem com a discriminação e com a violência física e moral.', 'A maioria da população brasileira segue a religião católica,  isso deve-se a  influência dos colonizadores portugueses que instalaram no Brasil a crença católica. Com isso, outras religiões são pouco difundidas e conhecidas   como: a evangélica, espírita, judaica e afro-brasileira, o que acarreta na discriminação de quem as segue. Além disso, a violência física e moral contra pessoas de diferentes religiões têm   no que diz respeito a  liberdade de expressão dos indivíduos, o que é uma situação inaceitável.', 'Portanto, para impedir a continuidade dessa situação, é imprescindível a ação governamental, impondo o pagamento de multas e criando leis mais rígidas para punir aqueles que agredirem pessoas de outras religiões, pois é dever do Governo proteger essas pessoas da violência física e moral. Ademais, é necessário que as escolas promovam palestras sobre as diversas religiões e sobre a importância de respeitar as diferenças, criando cidadãos concientes e comprometidos com o bem estar  de toda a população.']",160,120,120,160,160,720
60,,"['A desigualdade social no Brasil é um fato que infelizmente vem crescendo a cada ano. Com as crises recorrentes no país aumentando o índice de desemprego e as propostas  atuais para a Reforma da Previdência podem colaborar com o desenvolvimento desse problema social.', 'Pode-se afirmar que a grande expansão territorial que o Brasil apresenta promove uma variedade de realidades sociais existentes, ficando assim difícil que seja justo os decretos apresentados pela Reforma da Previdência. Com o atual governo Bolsonaro umas das propostas seria igualar, independente da classe social, a idade mínima de contribuição para o recebimento do benefcio, sendo 65 anos para homens e 62 para mulheres  ou 35 e 30 anos, respectivamente, de contribuição com mínimo para ambos de 20 anos. Dessa maneira, não sendo justo com as classes menos favorecidas ou populações de zona rural, que provavelmente não conseguiriam atingir essa meta devido ao grande esforço físico e carga horaria que apresentam, aumentando o índice de miséria nacional.', 'Além disso, outro decreto da Reforma da Previdência que contribui com a desigualdade,  é a redução percentual de pensão por morte. A expectativa de vida atual do brasileiro, segundo o IBGE , é em torno de 76 anos, sendo que a maior taxa de mortalidade são de homens, comparada com com a de mulheres. Por consequência disso, é evidente que na maioria dos casos muitas famílias perdem o principal meio de sustento, e com isso reduzir o valor da pensão para os familiares pode dificultar o desenvolvimento social, por exemplo, de um indivíduo dependente da renda para continuar os estudos e ingressar no mercado de trabalho futuramente.', 'Portanto, conclui-se que determinar regras generalizadas para a Previdência em país amplo como o Brasil não é uma maneira justa com todos. Dessa forma, é necessário a reformulação do projeto e discussões construtivas entre responsáveis pela Previdência com Governo Federal e representantes regionais que possam apresentar a realidade atual de cada Estado e assim desenvolver soluções que agregam a todos de forma justa.']",120,160,120,120,160,680
36,A persistência da escravidão,"['A escravidão é um fato decorrente há séculos e ainda se faz presente. Principalmente por pessoas com baixa renda e grau de escolaridade, com isso perde sua liberdade e contudo seus direitos, ocorre com mais frequência em países pobres e nos países ricos é mais comum entre rivalidades de empresas.', 'Mesmo com tantos avanços da humanidade, a escravidão não foi abolida mas um pouco esquecida. Os dados apontados demonstram o quanto é contínuo, em muitos os fatos a escravidão moderna não tem todas as proporções do passado, mas traz consigo a principal consequência, de não se sentir humano e cidadão.', 'A liberdade na qual é imposta para todos os cidadãos, sobretudo o escravizado não leva consigo o mesmo. Levando em prática uma vida baseada no trabalho forçado em alguns dos fatos com baixo salário e mais persistente sem remuneração alguma.', 'Em muitos os casos a sociedade se omite para expressar essa realidade, é preciso tomar iniciativas pelo combate em abolição a escravidão. Apoios à ""walk free"" fundação na qual tem o incentivo com o fim da escravidão. O sujeito merece total apoio e ajuda. Afinal todos temos direitos e aqueles que por consequência-os perdem, é preciso ter o consentimento na ajuda de fazer essas pessoas se sentirem o humano que devem ser.']",0,0,0,0,0,0
79,Segunda Chance,"['Quem educa a criança jamais punirá o adulto. Educar é preciso para o sistema mudar, a realidade prisional do Brasil é de caos total, não existe um projeto de reabilitação e ressocialização dos condenados, e sim um deposito  de gente entregues ao azar. Nesse país se uma pessoa for pobre, preto, ignorante e sem profissão pior pra ele. Agora, se for tudo isso e ex- prisioneiro é o fim dele. Isso mesmo, aqui, a sociedade não perdoa os erros do outro, quem comete um erro pagará a vida inteira, se for pobre.', 'No ano de 2000, um jovem estudante baiano roubou três livros de uma livraria para estudar. Foi parar no presidio da Mata escura na hora, sem julgamento nem condenação. Em julho de 2013  Thor Batista, filho do empresário Eike Batista, foi condenado por homicídio culposo. Pena? Prestar serviços comunitários por dois longos anos. Ora, parece brincadeira, só que não é, e tudo parece muito injusto para se transformar   já que a injustiça já vem de brinde na saga de grande parte da população menos favorecida brasileira.', 'Como melhorar um sistema injusto onde a força da injustiça é aceita como normal? Onde você é ensinado a acreditar que não vale nada e que não presta para nada? Tem que haver uma mudança de valores urgente, tem que acreditar. Não pode tratar essas pessoas como lixo. E  dever desses estabelecimentos resgatar a dignidade humana dos que cometeram erros, e não,  condená-los a uma pena eterna.', 'A educação é o único caminho, os presídios têm que gerar renda, eles devem ser obrigados a trabalhar e estudar, nada de armas nem drogas. E muito menos comunicação com a vida fora dos muros da prisão  afinal é pena ou férias? O que aconteceu em Manaus não deve se repetir nunca mais nem no Brasil nem no mundo. Violência só gera mais violência, o governo deve pensar na frente, prisão deve ser um lugar para dar uma nova chance para alguém e não o fim de toda humanidade restante. Bandido bom é transformado em cidadão.']",160,120,120,160,160,720
48,2,"['Na obra ""Utopia"", do escritor inglês Thomas More, é retratada uma sociedade perfeita, na qual o corpo social padroniza-se pela ausência de conflitos e problemas. No entanto, o que se observa na realidade contemporânea é o oposto do que o autor prega, uma vez que a saúde pública no Brasil apresenta barreiras, s quais dificultam a concretização dos planos de More. Esse cenário antagônico é fruto tanto da corrupção, quano dos desafios intrínsecos . Diante disso, torna-se fundamental a discussão desses aspectos, a fim do pleno funcionamento da sociedade.', 'Precipuamente, é fulcral pontuar que a corrupção deriva da baixa atuação dos setores governamentais no que concerne à criação de mecanismos que coibam tais recorrências. Segundo o pensador Thomas Hobbes, o Estado é responsável por garantir o bem-estar da população, entretanto, isso não ocorre no Brasil . Devido à falta de atuação das autoridades , a lavagem de dinheiro acaba sendo um dos principais meios de corrupção que desvia verba destinada a saúde pública no Brasil. Desse modo, faz-se mister a reformulação dessa postura estatal de forma urgente.', 'Ademais, é imperativo ressaltar os desafios intrínsecos como promotor do problema. Partindo desse pressuposto, as longas filas de espera, a falta de infraestrutura, assim como, a escassez de remédios retrocede os caminhos de desenvolvimento da saúde pública no Brasil. Tudo isso retarda a resolução do empecilho, já que os desafios intrínsecos contribu para a perpetuação desse quadro deletério.', 'Assim, medidas exequíveis são necessárias para conter o avanço da problemática na sociedade brasileira. Dessarte, com o intuito de militar os desafios da saúde pública no Brasil, necessita-se, urgentemente, que o Tribunal de Contas da União  direcione capital que, por intermédio do Ministério da Saúde, será revertida na criação de novas policlínicas com o intuito de desafogar as longas filas de espera em todo o Brasil . Desse modo, atenuar-se-à, em médio e longo prazo, o impacto nocivo dos desafios da saúde pública no Brasil, e a coletividade alcançará a Utopia de More.']",160,160,120,200,160,800
86,"Conectados, porém doentes.","['É inegável que o avanço da tecnologia ao redor do mundo teve diversos pontos positivos, como na comunicação, comércio, medicina e já vem sendo usado na educação. Mas também tem causado grandes complicações, algumas delas vem com o uso excessivo das redes sociais,  tal abuso pode ocasionar na vida de um usuário um mal irreparável como problemas na saúde mental ou até uma certa dependência. Diante dessa perspectiva, cabe avaliar os fatores que favorece sem esse quadro.', 'Percebe-se que ao mesmo tempo que o ambiente das redes sociais aparenta ser atrativo e benéfico, também tem um lado nocivo e perigoso. Os problemas do mau uso da internet tem afetado a vida de diversas pessoas, principalmente entre jovens e adolescentes, pois, ficam muito mais tempo conectados nas redes sociais e por causa disso estão mais expostos. Segundo uma pesquisa publicada pelo site Mobile Time, 89% das crianças e dos adolescentes brasileiros são usuários de internet. Um dos perigos é que nem todos os pais têm acesso ao que os filhos estão fazendo nas redes sociais, eles podem até estar com algum problema emocional ou sua saúde mental pode estar sendo alterada dependendo do conteúdo que estão consumindo.', 'Outro ponto que vale ser pontuado, é que todos podem ser afetados negativamente pelo mau uso da internet. A maioria das pessoas querem expor suas ideias e gostos nas redes sociais, mas esquecem que todos temos o livre direito da liberdade de expressão e que nem sempre o que é bom para um é bom para todos . Comentários negativos vem ocasionando problemas na saúde mental de muitos usuários, o que pode estar contribuindo para o mal do século XXI que segundo a OMS (Organização Mundial da Saúde), é a depressão, uma doença silenciosa e maligna que vem matando muitas pessoas no Brasil e no mundo.', 'Diante de tudo que foi exposto, é nítido que medidas devem ser feitas para o combate desse obstáculo. Para isso seria necessário um parceria entre família e escola,  fazendo debates, palestras e criar um ambiente propício para que todos possam falar sobre o tema. Outra maneira efetiva seria o aperfeiçoamento do apoio do MS (Ministério da Saúde), como um maior efetivo de psicólogos e agentes sociais para auxiliarem a população e um treinamento voltado para saberem lidar com as diferentes idades e gêneros. Dessa maneira, assim evitaremos os impactos das redes sociais na saúde mental da sociedade brasileira.']",160,160,160,200,160,840
60,,"['A partir dos conceitos apresentados em relação à reforma da previdência, três partes merecem destaque especial. O primeiro é a questão da idade minima estabelecida; o segundo é em respeito à prestação de serviço do servidor e por fim as despesas que são relacionadas ao meio, além da economia apresentada para os cofres públicos com essa atitude do governo.', 'Na mesma relação que se aponta o problema e não uma solução, é visto que a elevação de idade é ainda um dos maiores tabus no caso, pois a mesma tende a se estender, outro caso são as situações de funcionários do auto escalão da administração pública e do próprio governo tem tido mais vantagens que o trabalhador mais braçal e com renda mínima, pois este aposentou cada vez mais cedo e com benefícios bem mais significativos.', 'Por outro lado observa-se que se esta atitude governamental é a saída para diminuir tais gastos e certos privilégios além de esperados investimentos em serviços públicos e mais tranquilidade na renda de aposento do trabalhador ao final de sua jornada, então é a melhor forma encontrada para corrigir um problema que pode gerar um deficit no futuro e causas de inflação no país.', 'Tendo em vista os aspectos observados no decorrer dessa abordagem , pode-se observar que na verdade a reforma seja a saída mais eficaz para se evitar um problema generalizado maior, porém é sensato que o governo faça uma divulgação mais exata principalmente para o público mais leigo no assunto, a exemplo das principais redes de televisão, rádio e sites de maior credibilidade na internet, para que essa informação de tal importância possa ficar cada vez mais acessível a todos, garantindo portanto a disposição até naqueles que não concordam com esse fato.']",120,120,120,120,120,600
8,Autenticidade de informação,"['É indubitavelmente correto afirmar que que, com o passar dos anos, um número maior de pessoas tenha cada vez mais dúvidas e feito mais questionamentos sobre a ciência, como por exemplo, as pessoas que são contra as vacinas e os grupos terraplanistas, não acreditam no que o governo diz, tendo assim uma certa incredulidade sobre suas afirmações feitas, a pós-verdade.', 'A internet é a principal fonte utilizada para espalhar tais informações, convencer ou achar pessoas que pensam da mesma forma, como aconteceu no caso dos grupos terraplanistas a partir do ano de 2014. Nesse sentido, muito mais pessoas passam a ter acesso, assim então, duvidando dos fatos que o governo-lhes governo lhes apresenta.', 'Não obstante, como citado no supracitado, há também pessoas que são contra a vacinação, que que, assim como os grupos terraplanistas, duvidam e questionam de sua eficácia, sendo um grande risco para a saúde global, onde pois pode haver o descontrole de doenças, sem o seu devido tratamento. Todavia, também pode ser considerado tal ato como ignorância da parte dessas pessoas a não acreditarem. Com base no que diz Immanuel Kant ""O homem não é nada além daquilo que a educação faz dele"", cabe a à pessoa decidir como vai de fato usá-la nos âmbitos sociais.', 'Em suma, se há provas do que foi dito sobre determinado assunto, há, sim, como depositar certa confiança e não duvidar. O governo deveria tentar apresentar novamente provas concretas para comprovar a autenticidade de suas afirmações científicas para que essas pessoas passem a acreditar no que for apresentado a elas.']",80,80,0,80,0,240
45,Autoridades imparáveis,"['Atualmente, um assunto que tem ganhado repercussão, debates e discussões é o abuso de autoridade no Brasil. Alguns exemplos como policiais, desembargadores, pessoas do poder público, entre outros, tentam se usar de sua posição para poder passar por cima da lei. Vemos algo que prova a estupidez e falta de humildade de muitos seres humanos .', 'Num país onde os sorrisos e as frases bonitas são eleitos para governarem, e nos bastidores se rouba, se vende e se corrompe, também é notável que muitos concursados ou indicados ao poder agem como se a lei não tivesse valia para eles. Se cria uma imagem de que um desembargador não pode ser multado por um policial militar “comum”, este “chefe” pode chamar o seu próximo de “analfabeto” sem mesmo ter provas disso, e fazendo afirmações pejorativas. Muitos líderes ou superiores que gerenciam pessoas pensam que estão “encima” de seus comandados, enquanto deveriam entender que “pisar no pescoço” de alguém não indica autoridade.', 'A autoridade deveria começar pelo respeito, e esse, em relação às leis e ao próximo. A lei é para todos, desde o gari ao presidente da república. A lei é para todos, e o respeito vem desde a infância, o problema é que se criam crianças que pensam que o preto tem um valor diferente do branco, que o juiz é alguém mais digno que o gari, que dinheiro torna alguém superior a outros.  Um pensamento brilhante de Augusto Cury, diz “Há pessoas tão pobres, que só têm dinheiro. Há pessoas tão incultas, que só têm cultura acadêmica”, estas duas frases esboçam que poder, dinheiro e títulos não constroem um ser humano digno ou importante, há muito mais que isso na vida, e o início de tudo é o respeito.', 'Se faz necessária uma educação melhor das crianças desta geração, assim como das vindouras, acerca de respeito e humildade. Há muita gente que, após ter recebido fama e poder, parecem ter se tornado soberbas e arrogantes. As pessoas têm sua personalidade e seus valores guardados durante a vida, e os revelam quando recebem poder e liberdade. É de urgente importância que as famílias ensinem os pequeninos e jovens de que: “doutor”, “senhor”, “excelentíssimo”, entre outros, são só títulos, mas o que define quem alguém realmente é, são suas atitudes.']",120,120,120,120,0,480
96,O mal do século,"['A Aids surgiu nos                 anos 70, na África, porém, até o início dos anos          90          não era um assunto muito divulgado na mídia                , fazendo com que a falta de informação facilitasse o contágio das pessoas pelo HIV.', 'Nos dias atuais, mesmo com inúmeras campanhas sobre o combate e a prevenção da Aids, infelizmente, ainda existem         sujeitos         que não se cuidam e afirmam não ter medo de contrair o vírus HIV, podendo assim, transmitir a doença para outras pessoas e aumentar o índice de infectados.', 'Os indivíduos          soro positivos          são vítimas de um extremo preconceito até os dias de hoje, porém, cada vez mais vêm sendo divulgadas informações sobre as formas de contágio do HIV, tornando os cidadãos mais conscientes.', 'Os remédios existentes retardam o desenvolvimento da Aids, porém, não é o suficiente. Precisa-se de mais investimentos em pesquisas ao combate da doença, para que a vacina contra o HIV se torne realidade, e de mais campanhas conscientizando a população a se prevenir da doença, para         que         assim, possa ser combatido esse “mal do século”.']",120,80,80,80,80,440
134,O poder emana do povo,"['Juntamente com a Copa das          Confederações no Brasil, o país          foi marcado por protestos e manifestações. Inicialmente, uma multidão buscava a redução das tarifas de ônibus, entretanto, com o passar dos dias, com ajuda das redes sociais, atos equivalentes se espalharam nacionalmente reunindo várias pessoas pelas ruas a protestarem por melhorias em vários setores e, principalmente, contra a corrupção.', 'Na abertura do grande evento esportivo supramencionado, após ser anunciada para discurso, a         Presidenta         foi vaiada pelo público que se encontrava no estádio Nacional localizado em Brasília,                 conhecido como Mané Garrincha                . O mau comportamento da torcida foi muito comentado e, para muitos, representou a insatisfação do povo brasileiro contra os altos gastos do Governo Federal com as reformas dos estádios para os eventos esportivos no país.', 'Durante várias manifestações, aconteceram em muitas cidades atos de vandalismo, dos quais         resultaram em         destruição e violência contra o patrimônio público e de alguns particulares. Algumas pessoas foram presas e a polícia muitas vezes agiu para se defender e conter alguns exaltados dentre a multidão.', 'Até o momento, alguns grupos ainda se reúnem e novos protestos estão sendo feitos em algumas regiões do país. Entretanto, o Governo Federal declarou que uma reforma política será realizada, em muitas cidades houve a redução das tarifas dos transportes públicos, a PEC 37 foi rejeitada e a Secretaria Geral da Presidência informou que será criado um observatório participativo a fim de viabilizar um canal de diálogos com jovens através das redes sociais.', 'O povo brasileiro por muito tempo vem vivenciando escândalos políticos, desvios de verbas públicas e sofrendo com a calamidade dos serviços públicos de péssima         qualidade, destarte,         as manifestações pacíficas têm fundamentos válidos e         constitucionalmente é assegurada         . Entretanto, não bastam somente protestos esporádicos para que haja uma verdadeira mudança do cenário de corrupção do país. A sociedade deve ir além e exercer efetivamente seu poder através de maior fiscalização dos gastos públicos e buscar punição severa para aqueles que comentem atos de improbidade administrativa.']",160,200,120,160,120,760
71,Suicídio contemporâneo,"['O suicídio é um problema social crescente entre os jovens contemporâneos. Solidão, bullying, negligência familiar e educacional estão dentre os fatores, porém principais, que direcionam ao suicídio juvenil.', 'Dito o sociólogo Bauman  em uma de suas teses: “Vivemos tempos líquidos. Nada é para durar” obre a presente Modernidade Líquida entre as pessoas, onde as relações se desprendem mais rápido uma das outras, causando o isolamento gradativo do indivíduo, principalmente o dos adolescentes.', 'Outro fator é a defasagem direcionada aos jovens nos meios familiares e educacionais. Onde inclusive é mostrado na trama Thirteen Reasons Why, que a escola na série se esquiva da tarefa em buscar formas para sanar o bullying e responsáveis que não abordavam esta problemática com a devida importância, levando a protagonista Hannah Baker- vítima do isolamento, violência, patrões sociais, negligência familiar- ao suicídio.', 'Portanto, é preciso abordar mais tais causas levadas ao suicídio, em prol há desconstrução dos moldes líquidos e conscientização educacional e familiar. Para tanto, a mídia pode implementar campanhas publicitárias com o suporte de definição, fatores, prevenções ao suicídio juvenil e a importância da coletividade social diante desta problemática.', 'Outra implementação é de palestras educacionais para alunos e responsáveis sobre tais influências negativas e positivas que a atitude de ambas- Instituição e pais- transmitem aos jovens.', 'Está situação está longe de ser solucionada, mas o começo para tal realidade, está nas primeiras mudanças.']",120,120,120,120,80,560
55,A importância de preserva uma Identidade,"['Antes mesmo da colonização dos europeus os índios já pertenciam ao território brasileiro, após anos de resistência colonização eles conseguiram dominar novamente as suas terras, mas a urbanização e o desmatamento vem expulsando e proibindo a permanência dos índios nesses lugares,o que vem gerando grande questionamento sobre a proteção desses povos e o desequilíbrio ambiental.', 'Apesar de existir leis que protejam os índios e proíbem a invasão dessas terras de nada tem adiantado esses leis ,pois grande parte de tribos indígenas tem suas terras invadidas para implantação de áreas urbanas e da agricultura, o crescente capitalismo e a usura financeira vem destruindo não apenas s tribos indígenas mas a natureza que está entrando em colapso mundial, a morada de milhares de seres vem sendo destruídas. O rail apesar de ter uma rica vegetação e biodiversidade tem destruído sua própria identidade, tem destruído sua própria história,sua própria cultura,tem escolhido mal as pessoas responsáveis por órgãos que protegem esse povo.', 'A FUNAI foi criada com o intuito de proteger e assegurar os direitos dos povos indígenas,mas após a criação desse órgão o governo não se desempenhou em criar mais politicas de proteção  esses povos, que tem deixando impune as pessoas que violam os direitos desses povos e contribuindo para a proliferação de descumprimento dessas leis ,que provavelmente contribuindo para diminuição desses povos já que são tirados de suas terras e são considerados ""selvagens"" onde alguns tentam seguir a civilização,""é essa tal civilização que destrói as floresta e tiram morada de vários selvagens"" o conceito de civilização precisa ser revisto em uma sociedade tão destrutiva de valores.', 'É dever do estado fazer com que as leis que protegem esses povos sejam cumpridas, preenchendo essa falta de justiça ao descumprimento da mesma  ,o governo deve criar leis mais burocráticas invasão de terras desses povos e punições mais severas, é dever do Estado proteger a identidade de uma nação, de um país.']",120,120,80,120,40,480
90,Durkheim e os transgêneros no Brasil,"['Segundo o sociólogo alemão Émilie Durkheim, a sociedade pode ser comparada a um ""corpo biológico"", por ser, assim como esse, composta por partes que interagem entre si. Desse modo, para que esse organismo seja igualitário e coeso, é necessário que todos os direitos dos cidadãos sejam garantidos. Porém, isso no Brasil não ocorre, pois a população trans ainda é excluída de seus direitos e sofrem com o preconceito histórico-estrutural, no qual o país foi fundamentado.', 'No âmbito laboral, os transgêneros sofrem com o estigma sexista de empregadores que dificultam sua inserção no mercado de trabalho, mesmo sendo uma mão-de-obra qualificada. Segundo o 1º mapeamento de pessoas trans da cidade de São Paulo, realizado pela secretaria municipal de direitos humanos da capital paulista, apenas um pouco mais da metade dos entrevistados (59%) exercem alguma atividade remunerada - diversas ainda no mercado trabalhista informal. Esse dado mostra o quanto a população LGBT , na qual as pessoas trans fazem parte, é excluída do mercado formal de empregos e, consequentemente, desamparada de direitos trabalhistas que todos os cidadãos brasileiros devem gozar.', 'Tal conjuntura de exclusão e preconceito pode ser explicada pela formação histórica da sociedade tupiniquim, herdada de uma imposição portuguesa extremamente religiosa e autoritária. Nesse contexto, o Brasil foi fundamentado pela figura do homem sendo o patriarca de um núcleo familiar e a mulher como um elemento de cuidado da vida doméstica, configurando, assim, uma divisão sexista do modo de viver. Em um arranjo social dessa natureza, gays, lésbicas, bissexuais e transgêneros são alvos de preconceito e de violência.', 'A exclusão social e a discriminação enraizada as quais sofrem os transgêneros no Brasil, portanto, ainda é um grande desafio na construção de uma sociedade mais justa e igualitária. Cabe ao governo federal  inserir essa parcela da população brasileira em mais trabalhos nos mais diversos setores do mercado, através de uma legislação que exija dos empregadores incluírem as pessoas trans no quadro de composição de seus funcionários, destinando, no mínimo, 25% das vagas de empregos para transgêneros, negros e mulheres. A escola, juntamente com o apoio dos pais, também exerce um papel transformador na formação de novos brasileiros. Com o uso de filmes educativos, ferramentas de aprendizagem, palestras, grupos de discussão entre as famílias e relatos de pessoas trans abordando o tema com os pequenos ajudará a mitigar o preconceito histórico-estrutural desde os primeiros anos da formação de novos cidadãos, que estarão mais aptos de garantirem e respeitarem os direitos inerentes de cada pessoa no país, construindo a sociedade mais igualitária e coesa descrita por Durkheim.']",160,200,160,160,200,880
29,"Solução rápida, problema complexo","['Muito se fala acerca dos dependentes químicos e traficantes pela sociedade , mas pouco se conhece de fato. O crack e outras drogas podem ser encarados de várias maneiras, mas sua face mais conhecida é a de uma simples má escolha a que o indivíduo se submete. Porém, num país tão marcado por desigualdades e pobreza a droga, muitas vezes, não é apenas uma escolha, é uma saída desesperada ou ainda o próprio sustento.', 'Para a atual administração de São Paulo, a questão dos viciados é vista como problema de saúde pública e a aposta da prefeitura está nas internações compulsórias. Metaforizando, estão buscando curar os sintomas, mas não as causas da doença.', 'Ademais, a longo prazo, um morador da cracolândia internado a contragosto, morador de rua e que garante sua renda através de ações criminosas teria alguma chance de se recuperar socialmente depois do devido tratamento? De conseguir um emprego, moradia e educação de qualidade para manter-se longe das drogas? Salvo alguns casos, a maioria retorna à estaca zero, levando consigo milhões de reais investidos.', 'Assim, a internação compulsória, além de ser uma prática agressiva e que fere claramente os direitos humanos já que nem todos os dependentes necessitam desse tipo de tratamento, se mostra eficiente apenas a curto prazo – enquanto o dependente está na clínica sendo controlado por medicamentos - e relativamente agradável às classes superiores que passariam a não mais temer a região do centro de São Paulo.', 'Por fim, o primeiro passo para a redução do número de usuários e traficantes nos próximos índices é garantir á população menos favorecida da cidade e mais vulnerável à influência das drogas, os serviços básicos e principalmente educação e os programas preventivos como o Proerd, realizado pela PM nas escolas. Aos dependentes, a solução emergencial ainda é a internação, desde que depois de recuperados a prefeitura possa reintegrá-los na sociedade e não simplesmente lançá-los à própria sorte.']",200,160,160,120,160,800
63,,"['Desde o inicio da civilização,  o homem busca cada vez mais evoluir conforme  suas necessidades diárias aumentando seu conforto e bem estar. Com a Revolução industrial e o surgimentos de automóveis, máquinas à vapor e entre outros, as industrias utilizam muitas vezes a matéria prima extraída da natureza como a água, o petróleo, frutas, legumes e até mesmos os animais, usados com diversas utilidades em nosso cotidiano, mas o uso exagerado e sem conscientização da população e grandes corporações trazem diversos impactos ambientais e ecológicos para nossa sociedade, são exemplos: exploração e extinção de animais e plantas, poluição do meio ambiente e aquecimento global.', 'Nesse ano de 2019 no Brasil, o país sofreu mais uma consequência desse mal uso de recursos naturais, o que causou o rompimento da barragem Brumadinho, a lama afetou, segundo cientistas, algumas das últimas áreas significativas de Mata Atlântica e Cerrado de Minas, local considerado refugio de vidas selvagens, tragédia parecida com o rompimento da barragem de Mariana à 3 anos atrás, o que ocasionou em 19 mortos e milhares de pessoas sem água e abrigo devido a enxurrada de lama no local.', 'No entanto, apesar da Constituição Brasileira, no artigo 225 (3°)  falar em punição civil, administrativa e penal para empresas ou agentes que prejudicarem o meio ambiente, esta lei na prática fica insuficiente, pois, uma vez dada a condenação civil e/ou administrativa, o processo criminal sai de cena.', 'Portanto, medidas são necessárias para resolver esse impasse, abe a polícia civil junto ao Estado e Ministérios do Meio Ambiente (MMA) e Minas e Energias (MME), investigarem a fundo denuncias e condenarem casos de irregularidades de empresas que colocam em risco vida de pessoas e fauna no geral, evitando assim, ferir os direitos humanos direta ou indiretamente como defende Organizações das Nações Unidas (ONU), formada por países que se reuniram voluntariamente para trabalhar pela paz e o desenvolvimento mundia.']",120,160,120,120,120,640
62,,"['No que se refere ao discurso de ódio nas redes sociais, pode-se perceber que é um grave problema presente na sociedade moderna, visto que o anonimato que muitos ""perfis"" disseminadores desse tipo de discurso possuem aliado a impunidade desses casos, que muitas vezes resultam em crimes como o racismo, xenofobia, homofobia, etc. São fatores que contribuem para a continuidade da disseminação de ódio nesses meios.', 'É possível afirmar que o anonimato nas redes sociais é um dos grandes auxílios dessa pratica, visto que os indivíduos se escondem através de ""perfis fakes"" onde não são reconhecidos e podem expressar todo tipo de opinião, sem que sejam punidos legalmente. É cada vez mais frequente a criação desses ""perfis"" dado que a máxima punição seria a exclusão da conta devido ao anonimato. Vale ainda ressaltar que o direito liberdade de opinião e expressão promulgada como direito de todos na Declaração Universal dos Direitos Humanos, em 1948. Reiteradamente é utilizada como desculpa para a pratica desses discursos, que tentam disfarçar comentários preconceituosos e intolerantes com ""Apenas minha opinião""- frase regularmente encontrada em conjunto com discursos de preconceito.', 'Somado a isso, podemos dizer que a impunidade desses casos é algo frequente, já que devido a dimensão das redes sociais que engloba diferentes países, regiões, culturas, religião, raças e orientação sexual, se torna um meio de divergências, onde a ignorância e preconceito regem os discursos de ira. Com essa grande dimensão é difícil a supervisão de todo meio de comunicação e informação e ainda  em alguns casos  é impraticável identificar os autores dos discursos.', 'O discurso de ódio, portanto, torna as redes sociais um meio cada vez mias hostil, sendo um problema social. Cabe então ao governo em consonância com a mídia promover mudanças no modo de punição e além disto, criar propagandas para conscientizar os internautas da gravidade dos discursos de ódio e suas consequências legais, com a finalidade de tornar mais evidente as discriminações e preconceitos presentes nos discursos para que possam ser denunciados.']",120,120,120,120,120,600
87,A inocência de uma criança,"['A erotização infantil é um assunto que precisa ser abordado com cautela, pois é necessário que haja bom senso ao discuti=la, quando prefere referir o assunto uma criança . É através dela que o ser humano passa a se conhecer, descobrindo seus gostos e o que faz ele sentir prazer. Quando há uma curiosidade que se desperta na pré-adolescência, na maioria das vezes, começamos a descobrir novos detalhes sobre nosso corpo, levando os questionamentos aos pais, ou alguém em que sintamos à vontade para conversar, a partir daí desenvolve-se um aprendizado natural.', 'Levando em conta esses aspectos tão importante para o crescimento saudável das nossas crianças, devemos nos cuidar cada vez mais com relação àquilo que elas assistem na televisão, internet, redes sociais, e afins, pois series como já existiram na Netflix, por exemplo, acabam distorcendo toda uma realidade inocente e infantil de uma criança. As crianças merecem todo o respeito e cuidado, pois nessa idade é que se encontra o momento ideal de aprendizado, com relação à tudo o que está sua volta.', 'O que elas assistem pode influenciar o desenvolvimento sexual, psicológico e emocional dos pequenos. A situação fica pior quando falamos de uma criança com tanta exposição na mídia e rede sociais, o responsável por ela precisa ser notificado e lembrado do mal que causa a uma pré-adolescente que vive como se fosse adulto. Muito se fala sobre isso, principalmente, os psicólogos, eles frisam muito a importância de viver cada momento único da vida. Mas por parte das autoridades, não vemos manifestação alguma, isso só aumenta a nossa preocupação. Como estarão essas crianças no futuro? Quando forem adultos de verdade, vão agir como adultos?']",160,120,80,120,0,480
49,O papel dos influenciadores digitais em época de isolamento social,"['No livro “O diário de Anne Frank”, Anne retrata os anos de confinamento vivido por sua família judia durante a segunda guerra mundial. Analogamente, com o mundo vivendo uma pandemia, devido ao Covid-19, nota-se a complexidade da aplicação do isolamento social. Nesse contexto, os influenciadores digitais exercem um papel fundamental, visto que propagam conteúdo a milhares de indivíduos, por meio das redes sociais. Diante disso, cabe discutir acerca dos efeitos que esses desempenham na sociedade brasileira.', 'É importante pontuar, de início, que no Brasil não existe uma legislação concreta que classifique e regulamente a atuação dos influenciadores digitais. Isso tem trazido insegurança, tanto para quem publica quanto para quem os seguem, já que a maioria dos influencers utilizam as redes sociais com o caráter profissional. Assim, esses têm se apresentado de uma forma que o ter é mais importante que o ser , prova disso é a exposição de vida perfeita com a divulgação de festas, do glamour, das roupas de marcas, do status social, enfim, uma superficialidade que tem influenciado nos comportamentos e decisões daqueles seguidores. Logo, como já dizia a filósofa, Hannan Arendt, “Uma existência vivida inteiramente em público, na presença de outros, torna-se, como diríamos, superficial”.', 'Ademais, é de suma importância manter o distanciamento social como forma de controlar o avanço do Covid-19. Nesse sentido, os influenciadores digitais exercem uma função essencial, visto que através da propagação de conteúdo e sua influência - tanto no comportamento quanto na tomada de decisão de seus seguidores - podem ajudar de forma positiva ou negativa em relação ao isolamento social . Assim, ficou evidente o ato irresponsável, mau exemplo, que a digital influencer,  Gabriela Pugliesi, publicou fotos da realização de uma festa em seu Instragam, contrariando as recomendações da OMS quanto ao distanciamento social.', 'Portanto, nota-se a necessidade da aprovação, por parte do Poder Legislativo , de um ato normativo que possa regulamentar a classificação e a atuação do digital influencer . Cabe ainda ao Conselho Nacional de Autorregulamentação Publicitária agir de forma mais eficaz referente a identificação do conteúdo transmitido de forma irresponsável e orientar melhor os influenciadores digitais, por meio de uma cartilha contendo as recomendações necessárias daquilo que é divulgado. Logo, será possível que esses propaguem informações que sejam capazes de ajudar os sujeitos a formarem opiniões críticas. Outrossim, possam auxiliar os cidadãos a seguirem as recomendações da OMS sobre o isolamento social, para conter o avanço do Covid-19.']",160,160,160,160,120,760
71,,"['Segundo dados da OMS, o suicídio é a segunda principal causa de morte entre os jovens no mundo. Hodiernamente, diversas são as causas que levam os adolescentes a cometerem tal ato. Nesse contexto, é de suma importância que medidas sejam adotadas para que esse problema seja exaurido.', 'Ainda sobre esse ângulo, pode-se citar a depressão, bullying e homofobia, como exemplos e razões que levam o indivíduo a agir dessa maneira. A série de TV, 13 Reasons Why, mostra o drama e pressão sofridos por uma adolescente que deixou fitas contando o motivo que levaram-na a tirar a própria vida.', 'De acordo com o psicanalista Erick Erickson, o jovem passa, durante a adolescência, pela crise de identidade. Essa tensão acaba se agravando quando somado fatores como, por exemplo, a ""vida perfeita""vista nas redes sociais, preconceito sobre a sexualidade, medo de desapontar pessoas que amam, etc.', 'É fato exposto, portanto, que há múltiplos fatores e contribuintes para a situação do suicídio entre os jovens brasileiros. É imperioso que o Ministério da Educação  ofereça palestras nas escolas para alunos e pais, a fim de esclarecer sobre o assunto. É mister, também, que o Ministério da Saúde ofereça atendimentos psicológicos para população jovem, com intuito de prevenir quaisquer atitudes fatais. Ao Ministério das Comunicações, juntamente com a mídia, cabe o papel de veicular a importância da família nesse cenário. Desse modo, será possível reduzir o número de casos de atentados contra a própria vida.']",120,120,120,120,120,600
54,Vacinação,"['A Peste Negra foi uma epidemia que matou milhares de pessoas durante a Idade Média devido ao pouco conhecimento científico da época. Entretanto, na sociedade contemporânea, com grandes avanços na área da saúde com a criação de vacinas, ainda há uma negação perante alguns grupos de pessoas sobre a eficácia e funcionalidade desses medicamentos.', 'Devido ao crescente número de movimentos antivacinas na sociedade brasileira, o número de pessoas imunizadas contra doenças vem caindo, acarretando no reaparecimento de doenças já erradicadas do país . O descaso de indivíduos com a vacinação deixa a população não imunizada - por fatores sociais ou até mesmo de saúde - em risco. Essa negligência afeta, principalmente, crianças e idosos que possuem um sistema imunológico já fragilizado. O que resulta no aumento da morbidade e mortalidade.', 'Nota-se também,  que há a falta de informações para a população em relação às vacinas, deixando-as suscetíveis a falácias . Esses discursos pretenciosos geram um retrocesso não só em relação a esses medicamentos, mas em outros setores do desenvolvimento científico, dando espaços para teorias da conspiração.', 'Desse modo, para evitar que isso continue ocorrendo, postos de saúde conjuntamente a veículos de mídias, devem agir por meio da divulgação do conhecimento e demonstrar a importância da vacinação para o bemestar da sociedade e da saúde pública.']",160,120,80,120,80,560
117,Não é decisão humana,"['Por infelicidade, um indivíduo que gozava de perfeita saúde contrai uma doença ou sofre um acidente e vê sua vida mudar radicalmente, pois será privado de praticamente tudo o que fazia anteriormente e que de agora em diante tudo que resta é esperar pela morte e enxergar diariamente a evolução da doença e os tristes efeitos que esta         trás.', 'Sem dúvidas é um imenso sofrimento não só para o doente como para todos os que estão ao seu         redor         familia, amigos e até         para os         próprios profissionais da saúde que estão envolvidos e nada podem fazer para minimizar o sofrimento de todos. Mediante         a tanto         sofrimento, surge         então a         hipótese         que         talvez a eutanásia         seria          a melhor opção para todos, principalmente para o          doente morrer         que ficar em uma cama sem vida ativa ou até mesmo inconsciente.                 Porém, partindo de princípios éticos, morais e até mesmo legais, nenhum indivíduo tem o direito de privar o outro da vida e nem mesmo o próprio indivíduo tem o direito de          suicidar         , portanto independente dos motivos, a eutanásia é uma forma de colocar um fim         a         vida e é considerado crime.', 'Os indivíduos devem agir em conformidade com a lei, respeitando         o         direito natural, que é o direito         a         vida, e         o         direito positivo, que                 considera          homicídio privilegiado crime e se aplica          devida sanção. obviamente também se deve levar em conta o quanto todos sofrem com essa situação,                porém em todos os casos os princípios da vida devem se sobressair, considerando que independente de         estágio,         doença, a vida não deve ser interrompida propositalmente.', 'Aceitar a eutanásia é considerar comum o detrimento de uma         vida é         tomar uma decisão que não cabe ao ser humano, independente de crenças, dogmas entre outros. Portanto nenhum indivíduo tem o direito de decidir a hora de interromper uma vida. Deve-se dar o devido apoio ao doente e sua família, procurando         minimizar         as dores e o sofrimento, acolhendo-os e amparando-os em cada fase da         doença essa         [doença. Essa] é a forma mais prudente de agir perante a doença, respeitando a vida, as leis e fazendo o que é competência         humana         amparar, apoiar, auxiliar e não pôr o fim em uma vida.']",120,160,120,120,160,680
91,Realidade Tupiniquim,"['A obra “O grito”, do artista norueguês Edvard Munch, coloca em destaque um ser que experimenta extremo desconforto e pânico diante do desconhecido. Essa representação vai de encontro à ausência do sentimento de estranhamento social diante os efeitos do negacionismo científico na sociedade brasileira, visto que, contrário ao pensamento do personagem a sociedade não mais se espanta, sendo indiferente a não compreensão do problema. Nesse sentido, torna-se evidente que essa situação tem origem no pouco incentivo governamental. Assim, não só tabus referentes a tecnologia, como também o acesso ao sistema de saúde nacional intensificam esse quadro.', 'Nesse contexto, é indubitável que a falta de informação cria-se um preconceito sobre as descobertas cientificas. A célebre série brasileira “O escolhido”, mostra resistência da população ribeirinha do pantanal ao não permitirem a vacinação da sua aldeia, devido as suas crenças religiosas. Analogamente, essa narrativa não destoa da realidade tupiniquim, em que parte da população não acredita nos benefícios proporcionados pela ciência, pois há um enraizamento de um tabu, no qual a tecnologia significará o fim do ser humano, cristalizado pela continua desinformação referente as novas descobertas que transformam e salvam vidas. Dessa forma, o que devia ser motivo de alegria e comemoração, transforma-se em desconfiança e medo.', 'Outrossim, destaca-se o difícil acesso ao sistema de saúde como propulsor do problema em questão. Conforme matéria divulgadas pelo “portal de notícias G1”, 60% dos habitantes do interior do país não têm acesso a profissionais da área da saúde. Destarte, em razão da falta de médicos a medicina alternativa(curandeiros) está crescendo cada vez mais, consequentemente, o negacionismos cientifico ganha ainda mais força, devido lentidão e burocratização do SUS , as pessoas veem tal medida como única opção para tratar as suas enfermidades.', 'Portanto, medidas são necessárias para resolver esse impasse. Logo, o ministério da Saúde deve criar uma campanha de conscientização sobre os benefícios científicos e os seus mitos, por meio de divulgação massiva nas principais mídias, tais como Rede Globo, Revista Veja e Grupo Folha. Desse modo, o tecido social se despenderá de seus tabus e compreenderá a importância da tecnologia para o nosso bem-estar. Espera-se, como essa medida, minimizar os efeitos do negacionismos científico no Brasil. Ademais, o governo federal deve criar nas regiões do interior do país, escolas profissionalizantes, dessa maneira terá mão de obra qualificada para atender toda a demanda existente e proporcionar uma vida melhor aos brasileiros.']",160,200,160,200,160,880
56,O vão entre a punição e a humilhação,"['O livro Laranja Mecânica, escrito por Anthony Burgess, retrata Alex, um jovem infrator, que após ter cometidos violentos crimes, passa por um processo de punição que o submete ao consumo de drogas e tortura psicológica. O resultado deste procedimento, é a intervenção no livre arbítrio d personagem, que sofre consequências físicas ao agir ou pensar violentamente. Fora da ficção, o sistema carcerário brasileiro, embora não cometa medidas extremas como a do universo de Laranja Mecânica, é um ambiente violento e falha em proporcionar a recuperação e reinserção dos presidiários na vida pública.', 'À princípio,  filósofo iluminista Jean-Jacques Rousseau,  teoriza que o homem nasce cru, nem bom, nem mal, porém é corrompido pela sociedade. Mediante a uma sociedade ética e justa, o indivíduo tende a ser corrompido por tais valores. Já, inserido em uma sociedade hostil, como a presente no sistema carcerário brasileiro, os comportamentos aéticos que o fizeram ser condenado, tendem a se manter ou potencializar. Presídios com a infraestrutura vulnerável, celas lotadas, presidiários com pouco acesso a higiene pessoal e abusos físicos, sexuais e psicológicos, são características que compõem o cenário de grande parte das penitenciárias, que recebem centenas de novos presidiários diariamente no Brasil.', 'Segundamente, promulgada pela ONU , em 1948, a declaração universal dos direitos humanos garante a todos os indivíduos o direito à vida, à segurança, ao bem-estar social, entre outros. Direitos esses, que são violados na sociedade carcerária. E que, geralmente, não recebem atenção da grande mídia. O pensamento punitivista que perpetua parte da população brasileira corrobora com o descaso do Estado perante a precariedade das condições de vida dos presidiários brasileiros.', 'Apresentados tais fatos, cabe ao setor legislativo que elabore leis que garantam a dignidade e saúde dos detentos, como, por exemplo, uma lei que garanta s mulheres presidiárias o acesso a absorventes mensalmente . E cabe ao Governo Federal, a construção de mais alas nas penitenciárias, afim de findar o problema de superlotação. Além de fiscalizar, rigorosamente, a conduta de policiais e funcionários do sistema penitenciário, evitando que ocorra abusos de poder. Podendo, assim, evitar atos desumanos na sociedade brasileira semelhantes ao ocorrido no universo utópico de Anthony Burgess.']",120,160,160,120,120,680
66,Alegoria Algorítmica,"['Em 2014, um simples quiz denominado de ‘’thisisyourdigitallife’’, acessado por meio do Facebook, influiu à vitória de Donald Trump nas eleições estadunidenses, e 4 anos mais tarde, nos escândalos envolvendo o vazamento de dados dos usuários dessa rede social. Nessa perspectiva, manipulação de informações através desse meio, consolida à internet não só como uma ferramenta de aquisição ao conhecimento, mas também a torna cada vez mais entrelaçada às decisões pessoais do indivíduo, que pela silenciosa ditadura dos algoritmos, o induz desde um padrão de consumo, até mesmo a formação crítica de opinião associada a seu comportamento.', 'Indubitavelmente, a internet, sob o viés da Era dos Algoritmos, assume contornos específicos na vida do usuário, que tende pela praticidade e abrangência desses artifícios tecnológicos, a solucionar problemas de seu cotidiano, já que seus dados se transformam em informações de grande valor às empresas. Dessa maneira, o consumo apresenta-se como fruto de escolhas previamente selecionadas e responsáveis por criar uma falsa sensação de liberdade à pessoa, que é restringida pela presença dos ‘’trending topics’’ ilustrados por publicidades.', 'Paralelo a isso, o vazamento dos dados oriundos de 87 milhões de perfis do Facebook, sendo 440 mil brasileiros, relaciona-se à inobservância estatal em assegurar os direitos à segurança e privacidade previstos no Marco Civil da Internet (lei 12965/2014), isso porque, o controle ilegal de tais conteúdos incide em ações que tendem a influenciar formação política e social da sociedade, que por sua vez mantém-se fomentada pela comodidade e falta de verificação na busca de conhecimento. De fato, tal conjuntura,  assemelha-se à Alegoria da Caverna proposta pelo filósofo Platão: o homem cômodo, acorrentado à caverna e alimentado somente pelas sombras do mundo exterior refletido na parede seria incapaz de atingir o conhecimento inteligível, isto é, verdadeiro.', 'Diante do supracitado, para reversão de tal cenário, é necessário ação colaborativa entre o Ministério Público e o Ministério da Educação no fortalecimento do Projeto Ministério Público pela Educação Digital nas Escolas a fim de intensificar presença de especialistas no espaço escolar os quais expliquem as devidas medidas proteção a serem tomadas na internet, bem como fornecer orientação s famílias no controle desse uso. De mesmo modo, a mídia, com seu caráter socializador, deve desenvolver comerciais televisivos os quais contenham de fragmentos da lei 12965 ou exemplos cotidianos que instruam população ao manuseio consciente de seus dados pessoais.']",120,160,160,160,120,720
46,Privatização,"['Jeca Tatu é um emblemático personagem criado pelo escritor Monteiro Lobato com o intuito de alertar sobre as doenças acometidas pela falta de saneamento básico. No âmbito real, atualmente, embora o direito ao saneamento básico seja amparado pela Carta Magna brasileira, muitas pessoas ainda não têm acesso a esse recurso. Diante disso, uma possível privatização desse setor se tona iminente. Nesse sentido, vale analisar quais os papeis do Estado e empresas privadas em assegurar que todos os indivíduos do país possam ter acesso a esse serviço básico.', 'A princípio, é necessário afirmar que segundo o pensador Thomas Hobbes, o Estado é responsável por garantir o bem-estar da população. Todavia, com a privatização de empresas estatais, o governo tem como função fiscalizar a eficácia desses serviços prestados por essas corporações. Entretanto, a privatização por si não garante que esse serviço atinja toda a população. Nessa ótica, outrora, com a privatização do setor elétrico, foi necessário que o Estado elaborasse uma política pública denominada “Luz para Todos” para que esse direito se tornasse homogêneo a todo o contingente brasileiro. Dessa forma, o Estado ainda tem a função argumentada por Hobbies de assegurar o bem-estar de toda a população.', 'Outrossim, as empresas privadas que oferecem serviço à população devem manter a qualidade desse recurso e, além disso, garantir que seja seguro e eficaz a todos. Um exemplo contrário disso,  é o desastre do rompimento das barragens de minério de ferro da empresa privada Vale, registado na cidade de Mariana, em Minas Gerais. Ademais, no caso de saneamento básico, o desafio dessas empresas é assegurar que a população possa ter acesso à água potável, tratamento de esgoto, limpeza urbana, entre outros. Para isso, essas empresas privadas precisam ser fiscalizadas para assegurar que elas oferecem esse serviço com boa qualidade.', 'Verifica-se, portanto, que a privatização do saneamento básico é um grande desafio no Brasil. Sendo assim, o Governo Federal, como instância máxima de administração executiva, deve atuar em favor da população, através de criação de políticas públicas que viabiliza a fiscalização de empresas privadas que detêm a missão de assegurar a qualidade do saneamento básico para todos. Em conjunto a isso, o governo ainda deve implementar nessas políticas públicas medidas para baratear as mensalidades desse recurso em lugares com discrepâncias sociais, para que assim possa ser possível um serviço de qualidade e homogêneo a toda a população. Desse modo, os brasileiros afastar-se-ão do Jeca personagem criado pelo Lobato.']",160,160,160,200,160,840
78,Reforma do ensino médio,"['Embora apresente significativos destaques no cenário geopolítico internacional - configurando-se como um expressivo exportador de commodities - o Brasil apresenta um sistema educacional caótico e defasado, em que um considerável número de alunos não se interessa em se fixar no meio escolar . Nesse âmbito , muito se discute no círculo social a respeito da reforma do ensino médio como uma tentativa emergencial de elevar a educação nacional por intermédio de mudanças na grade curricular dos estudantes.', 'A priori, o Brasil é uma nação que, historicamente, valorizou o materialismo econômico em detrimento do conhecimento intelectual. Como exemplo disso, ao desembarcar no território recém descoberto, o europeu colonizador procurou satisfazer unicamente as necessidades econômicas da metrópole portuguesa. Desse modo, não houve uma preocupação em formar o cidadão para a vida culta e intelectual, visto que a sociedade brasileira sempre esteve voltada para o processo de acúmulo de riquezas como um meio necessário ao desenvolvimento social, moral e financeiro.', 'Dessa forma, é importante destacar que a reforma do ensino médio deve ser realizada, porquanto a esfera educacional necessita de uma infraestrutura escolar de qualidade . No entanto, vale ressaltar que esse processo deve ocorrer de forma lenta e gradual , levando em consideração as circunstâncias históricas e culturais da educação brasileira . Nesse sentido, é mister que a esfera governamental possa promover um maior envolvimento da comunidade no que diz respeito a reformulação do ensino médio. Através  de plebiscitos e consultas públicas virtuais, o cidadão poderá opinar sobre as as decisões que envolvam o seio escolar fomentando, desse modo, uma maior democratização das ações governamentais mediante a opinião pública.', ""Destarte, segundo o filósofo Rousseau, a educação se apresenta como elemento imprescindível no desenvolvimento do jovem cidadão. Dessa maneira, no intuito de promover mudanças benéficas no cenário educacional, é mister que os setores midiáticos possam agir no sentido de informatizar  a população sobre os desafios enfrentados pela educação e suas possíveis mudanças no contexto atual, por intermédio de debates televisivos e documentários dotados de imparcialidade. Por fim, a esfera social - por meio das Ong's e secretarias - deve incentivar os jovens a lutar pelos seus direitos na esfera educacional e política brasileira, através  de palestras ministradas por sociólogos e debates ativos no seio escolar  o cidadão será impulsionado a questionar sobre as transformações ocorridas no ambiente escolar e suas implicações para o seio coletivo.""]",120,120,120,120,120,600
20,Emigração,"['Desde o período do Brasil colônia, o fluxo de migrantes tem sido intenso, sendo que a chegada de portugueses e espanhóis nas Américas foi apenas o início do aumento da movimentação de indivíduos no continente, principalmente no Brasil. Apesar deste fato, atualmente existe um forte sentimento de necessidade de emigração surgindo entre os jovens brasileiros.', 'Tendo em vista que muitos indivíduos da faixa etária de 16 a 24 anos logo irão ingressar no mercado de trabalho, um dos principais argumentos utilizados para justificar o desejo de sair do país é a ideia de baixa estabilidade econômica no Brasil. A dinâmica do funcionamento dos países geralmente sofre alterações de acordo com decisões a ações políticas, sendo elas relacionada direta ou indiretamente ao setor da economia. Com isso, o cenário instável da política na contemporaneidade contribui para a manutenção desta ideia que grande parte dos jovens possui em relação aos setores da economia.', 'Além disso, argumenta-se que a falta de investimento do governo em saúde e em educação pública - tanto básica como superior - é um ponto determinante para a preferência por outros países. Saúde e educação são fatores imprescindíveis para o desenvolvimento do país, uma vez que estão ligados à qualidade de vida da população e com o desenvolvimento de novas ideias. É possível observar, no Brasil, o fenômeno denominado “fuga de cérebros”, que está relacionado ao fato de pessoas com alta qualificação profissional e/ou acadêmica migrarem para outros países, levando para estes locais conhecimento e tecnologias que poderiam ter sido aplicados e utilizados no país de origem.', 'Ademais, existem também fatores culturais, como a influência de filmes e séries, altamente presentes no cotidiano de parte da população jovem, que enaltecem o modo de vida dos estrangeiros, principalmente dos norte-americanos e dos europeus. A partir destes fatores, é possível afirmar que a inversão do fluxo migratório no Brasil é justificado tendo em vista diversos setores da sociedade, como a economia, a cultura e a política.']",120,120,120,80,80,520
85,,"['A Ditadura Militar instaurada no Brasil em 1964, extinguiu a democracia para o povo brasileiro. Entretanto,ao fim desse período governamental os direitos democráticos voltaram a fazer parte da política,mas ainda é nítido que esse sistema não é igualitário para as classes sociais.', 'No momento em que o poder político foi controlado pelos militares,o sistema democrático foi extinto no país. Um exemplo disso foi os Atos Institucionais (AIs) instaurados durante a Ditadura. Eles representaram historicamente a dissolução da democracia,em que os cidadãos sofreram várias formas de opressões como relatado no filme ´´Pra Frente,Brasil´´ de Roberto Farias. Esse episódio mostra que os brasileiros ficaram proibidos durante 21 anos de representarem as suas opiniões,e isso trouxe um grande retrocesso para o desenvolvimento nacional.', 'Com o fim dessa forma de governo,a soberania popular voltou a ser efetivada no Brasil e com isso os brasileiros puderam expressar as suas reivindicações através do voto direto entre outras formas. Entretanto, hoje,em pleno século XXI é evidente que a democracia não é devidamente decisiva,pois à população rica mantém os privilegios sobre os pobres e isso agrava as desigualdades sociais. Por isso,a real proposta da lei de iniciativa popular é conceder maior participação política para o povo lutar pelos seus direitos sejam eles políticos,econômicos e sociais.', 'O Congresso Nacional que possui como umas de suas principais funções elaborar,debater,aperfeiçoar e aprovar as leis,deve criar uma regulamentação que haja  de forma realmente democrática,a fim de acabar com as mazelas sociais ,atender as principais queixas dos cidadãos e acabar com a supremacia da elite brasileira em prol de seus interesses. Assim, o Estado agirá de forma democrática oferecendo aos cidadãos a participação nas tomadas de decisões para o bem público.']",160,160,200,200,200,920
83,Os prós e os contras da atividade física,"['A prática esportiva é um viés que pode levar a dois caminhos distintos: um positivo – embasado em comportamentos saudáveis, e um negativo - que leva a busca da perfeição e do sucesso desmedido.', 'Nesse sentido, o que as redes de comunicação mais mostram é o lado positivo, aquele que leva a inúmeros benefícios, tais como: qualidade de vida, sociabilidade, longevidade, saúde, etc. Sempre levando à população exemplos de superação, bem como a incentivando a melhorar seus hábitos.', 'Assim, tal modalidade deve ser incentivada para todos, desde crianças até idades mais avançadas, pois é realmente é uma grande vantagem para o ser humano. Mesmo atividades competitivas são vantajosas, uma vez que a pessoa aprende a lidar com suas dificuldades, a respeitar os demais participantes, a entender que nem sempre o melhor vence, a superar suas deficiências, e ainda serve como referência para futuras gerações.', 'Por outro lado, quando a atividade foge ao controle da pessoa, levando-o à competitividade desmedida e a busca de resultados a qualquer custo, torna-se um perigo emocional e físico para quem o pratica.', 'Um exemplo disso é o uso de anabolizantes, tanto para alcançar um corpo perfeito como para burlar uma competição e estar mais resistente que o oponente; além de tal uso ser um ilícito, pode gerar várias complicações de saúde para quem faz seu uso, sem contar com a parte psicológica, que pode ser afetada também numa possível derrota não esperada.', 'Ademais, a ocorrência de cobrança além dos limites naturais ao homem é um problema, porque pode levar a tentativa de prejudicar o próximo, de sempre querer ser o melhor, e ate a depressões .', 'Com isso, conclui-se que é preciso ter cuidado com o rumo que os exercícios podem levar, sempre devendo pensar no lado positivo e no ganho a curto e longo prazo.']",120,160,200,160,200,840
89,Os efeitos da pandemia na economia,"['Em meio a pandemia do -19, governos e população enfrentam um dilema: lockdown ou não? Alguns dizem que o Brasil não pode parar e que devem-se abrir até os serviços não-essenciais, outros preferem ficar em casa e só sair em casos extremamente necessários, seja para preservar a própria saúde e a dos que moram consigo, seja para não piorar o estado decadente do sistema sanitário nacional.', 'Quanto maior o índice de isolamento social, menor o índice de transmissão do vírus, logo, menos infectados. Quanto menos infectados, maior abertura para fazer o que estávamos acostumados no pré-pandemia. O problema é que levaria tempo para a transmissão cair, e o povo é imediato.', 'A economia logicamente será afetada neste período de pandemia e não só no Brasil. Como manda o prefixo pan, o mundo todo está sofrendo as consequências da diminuição da produção, da queda do poder aquisitivo da população entre outros efeitos do vírus, então o mundo todo tem que se aliar para combater o novo coronavírus.', 'Assim, é necessário que os governos  façam seu trabalho e tomem decisões para o benefício do povo, tenham firmeza e fiscalizem o distanciamento. É preciso também que as pessoas tenham consciência de que o isolamento pode ser indesejado, afinal, somos seres sociais, mas, unidos, tudo passará mais rápido.']",160,120,80,120,120,600
82,O esclarecimento é a chave do combate,"['Em países desenvolvidos, o número de medicamentos de venda livre tem crescido nos últimos tempos, assim como a disponibilidade desses medicamentos em estabelecimentos não farmacêuticos, o que favorece a automedicação. Nesses países, no entanto, os rígidos controles estabelecidos pelas agências reguladoras e o crescente envolvimento dos farmacêuticos com a  orientação dos usuários de medicamentos, tornam  menos problemática a prática da automedicação. Já no Brasil onde, de acordo com a Associação Brasileira das Indústrias Farmacêuticas (ABIFARMA), cerca de 80 milhões de pessoas são adeptas da automedicação, a má qualidade da oferta de medicamentos, o não-cumprimento  da obrigatoriedade da apresentação da receita médica e a carência de informação e instrução na população em geral justificam a preocupação com a qualidade da automedicação praticada no País.', 'A negligência dos governos com a saúde publica faz esse problema virar  cronico . O povo não têm  seus direitos constitucionais respeitados, e assim o direito a especialistas médicos, exames e odontólogos  que poderiam prevenir doenças, e  garantir a saúde, tornam-se um luxo para quem pode pagar. A população de baixa renda, é  a que mais sofre. Sem instrução, informação e orientação minimamente adequada para sanar as suas angustias , recorrem  livremente á automedicação sem se preocuparem  e sem saber das consequências.', 'Para diminuir essa prática, é preciso mais que vontade, é necessária uma ação conjunta  sociedade e governo, campanhas maciças na TV explicando os riscos, e  esclarecimento da população através  das escolas, associações de moradores, igrejas, feira livre, tudo que tiver fluxo de pessoas, é  uma oportunidade para se falar sobre o assunto. As  vezes, as pessoas erram, porque  não conhecem o certo. Mas, quando conhece o correto, poderá até errar, mas, será  mais difícil fazer o incorreto, por querer, e não, só por pura ignorância. Só com o conhecimento se pode fazer escolhas, sem ele, somos escolhidos pela estupidez. Se a automedicação é uma doença, o esclarecimento, a informação, o conhecimento e principalmente o acesso a um serviço de saúde eficaz promovido pelos governos. São a cura .']",120,80,80,40,80,400
45,Destrato e violência - S,"['Na série ""Scandall"" a advogada Olívia defende um abuso de autoridade, vivenciado por uma jovem, que é acuada após um romance com o então presidente do Estados Unidos, com uma sucinta ameaça, tenta acabar com o possível escândalo presidencial . Fora das telas a afronta vivenciada pela jovem,  se torna evidente em casos repercutidos no Brasil, como,  o destrato a um guarda civil por um desembargador, e a violência contra uma mulher negra feito por um policial militar, se tornando uma problemática.', 'Em primeira análise, a arrogância gerada pelo alto escalão de cargos públicos, que em seu destrato sobre um cidadão, considerado pelo lavor um inferior por conseguinte a não punição, gera descaso, remetendo a não punição exacerbando a fragilidade da população, diante tais fatos mencionados, Michel de Montaigne dizia que ""a covardia é a mãe da crueldade"", demonstra sucintamente o sentimento que cidadãos passam.', 'Ademais, a violência ocasionada por cargos de defesa da população,  evidencia a falta de preparo em ocorrências, gerando abordamentos inconsistentes com a ação, ocasionando iracúndias desnecessárias, passíveis de se evitar, Vitor Coelho Vieira disse uma vez que, ""os policiais e soldados são a salvação, a perdição está em quem os comanda"", nessa ressalva basta um cuidado com policiais,  para que eventos como esse supracitado deixe de acontecer.', 'Enfim, a problemática do destrato e da violência, são cabíveis de se evitar. Diante disso o Ministério da Defesa , deve criar dois projetos de leis, um para fiscalizar o treinamento com cursos de humanização para policiais, e um para punição de altos cargos, com diminuição de salários para ambos, com ressalva para o não cumprimento, a perda do cargo concomitantemente, a fim de evitar que aconteça abusos de autoridades no Brasil.']",120,160,120,160,120,680
0,Apropriação cultural,"['Todos os anos, foliões vão as às ruas fantasiados ou utilizando simbolos das mais diversas culturas culturas, como a indígena indígena, por exemplo. Uma simples tradição, que que, no entanto entanto, vira polêmica por para aqueles que não aprovam essa prática, alegando ser desrespeitosa e perpetuacão de perpetuar estereótipos, alcunhando a prática alcunhando-a de apropriação cultural. Todavia esses se esquecem que o uso desses símbolos é um fenômeno não apenas natural e espontâneo espontâneo, como também benéfico para uma sociedade.', 'Primeiramente, é importante pontuar que a cultura de um povo não é algo fechado e restrito, pelo contrário, é um processo dinâmico sujeito a mudanças no decorrer do tempo. O intercambio intercâmbio cultural entre povos é um fenômeno que permeou toda a história da civilização. A cultura ocidental é resultados o resultado das trocas culturais que se originaram do no período helenístico. Outro exemplo se dá na formação da rica e diversificada cultura brasileira brasileira, construída sobre o tripé do povo dos povos indígenas, africana e europeia africanos e europeus.', 'Além disso, o uso desses símbolos representa uma forma de preservação da memória histórica de um povo. Durante o carnaval, os blocos de rua e desfiles de escolas de samba cumprem esse papel papel, homenageando as diversas culturas por meio dos figurinos e enredos com mensagens de união e tolerância tolerância, promovendo assim um belo espetáculo. Outro exemplo é a capoeira, uma prática originada dos escravizados escravos que se difundiu no país e hoje representa a luta daquele povo contra o regime escravagista. Dessa forma forma, a assimilação de culturas presente nessas manifestações promove inclusão e memória histórica.', 'Desse modo, fica evidente que a crítica negativa ao uso de fantasias não faz sentido diante a da natureza espontânea desse processo. Ademais, não considera a importância da apropriação cultural à medida que contribui para o amadurecimento de uma sociedade. Sendo assim, o folião pode celebrar ainda mais mais, sabendo que a fantasia de índio não é instrumento de depreciação depreciação, mas sim de representatividade.']",160,200,160,200,160,880
3,A tecnologia a serviço da medicina,"['É indiscutível a importância da tecnologia na medicina atual. Com ela, tornou-se possível chegar a diagnósticos rápidos, possibilitando, assim, o imediato tratamento. Diante do grande avanço, a perspectiva de vida humana se prolongou, fazendo com que as pessoas se pessoas atentassem para o acompanhamento da saúde.', 'Com todo esse aparato tecnológico tecnológico, foi possível a criação de próteses e sua implementação no corpo humano. O aparelhamento cirúrgico tornou-se peça fundamental para que fossem realizados os transplantes de órgãos e a instalação de aparelhos que acompanhassem o funcionamento de alguns deles. Com o uso da ciência, pesquisas puderam ser desenvolvidas para a criação de órgãos artificiais para substituírem os que já não funcionavam regularmente.', 'Diante de tanta tecnologia hospitalar, criou-se no ser humano a expectativa de viver mais e o sonho da eternidade. Para que isso acontecesse, praticamente todos os órgãos do corpo humano deveriam ser substituídos ao longo da vida, tonando as pessoas verdadeiros robôs. Além disso, essa possibilidade estaria restrita às famílias que possuíssem elevado potencial econômico.', 'É preciso que a medicina continue avançando de forma a proporcionar ao mundo formas de combate às doenças e métodos de cura. O avanço que atenda somente a uma parte da sociedade trará a sensação de superioridade sobre a humanidade, podendo gerar conflitos de grandes magnitudes. É necessário que os órgãos públicos destinem recursos para que as pesquisas de aprimoramento continuem sendo realizadas, para que de fato a tecnologia esteja a serviço de toda a sociedade.']",120,80,80,120,120,520
83,"Nossos Sonhos, A Gente é quem Constrói","['Disciplina,competitividade,companheirismo,equilíbrio,superação,coragem,determinação,humildade e igualdade. Uma pessoa que pratica um esporte, terá mais saúde, porque ajuda o corpo á ficar mais forte, a mente á ficar mais leve e, com isso, terá uma saúde melhor. Podemos aprender tudo de bom com a prática do esporte! Esse texto será pequeno para escrever todos os benefícios trazidos por ele.*', 'Já os que praticam profissionalmente, terão muita resignação, muito isolamento perto das competições, e muita disciplina. A vida de um atleta profissional não é nada fácil, convivem com dores constantes e as vezes se machucam feio, e passam por longo tempo de recuperação. Mas, para eles tudo vale a penas, pois escolheram o esporte para suas vidas. E se tornam vencedores.  Orgulham suas Nações e o mundo.', 'O esporte é muito importante para a vida de todos, pois é cheio de valores e dignidade. Uma pessoa que tem contato com um esporte muito provavelmente será um cidadão melhor para o mundo. Muitos campeões pelo mundo, entraram no esporte, porque eram indisciplinados e rebeldes, então, os pais, vendo aquilo, colocaram os filhos em um esporte para eles adquirirem disciplina. Esse foi o caso de Rafaela Silva, a primeira medalhista de ouro do Brasil, nas Olimpíadas do Rio de Janeiro de 2016! Ela é um caso claro de que o esporte transforma perdedores em vencedores!  Esse é o poder do esporte. Faz a pessoa acreditar, que, nossos sonhos a gente é quem constrói. Parabéns Rafaela Silva do Brasil!** Medalha de ouro no Judô, nas Olimpíadas do Rio de Janeiro, Brasil 2016.']",120,80,120,120,160,600
44,""" e não sou eu uma mulher?""","['Ao afirmar em sua celebre canção,""o tempo não para"", o poeta Cazuza, faz de certo modo analgias entre o futuro e o passado. De fato ele estava certo,pois a necessidade de mulheres provarem o seu sexo biológico não é um problema atual .Desde a época medieval, mulheres tinham que provar a sua feminilidade, até no modo de se vestirem. Esse impasse ainda persiste,seja devido a falta de visibilidade feminina, proveniente de padrões arcaicos e machistas, seja pela falta de ação dos estados diante da problemática.', 'Em primeiro plano, é importante ressaltar que,de acordo com a socióloga Simone de Beauvoir ""ninguém nasce mulher,torna-se mulher"".Diante dessa afirmação é completamente desnecessário, que mulheres precisem passar por situações de constrangimento e até mesmo abusos, para provarem sua sexualidade. Além disso o grupo de mulheres, não se restringem apenas ao sexo biológico,como é o caso de mulheres trans do grupo LGBTQI+ .', 'Ademais,ainda é fulcral salientar que ao longo de séculos, os padrões impostos pela sociedade,para que mulheres se encaixasse, contribuiu de um modo negativo e equivocado, para situações como essa. O discurso""e não sou eu uma mulher?"" De Sojourner Truth,em uma convenção dos direitos das mulheres,por exemplo,mostrava a crítica,  justamente a esses padrões e como as mulheres sempre foram vistas como o sexo frágil,além de questionar o porquê de homens não precisarem provar a sua sexualidade.', 'Portanto, é mister que este revés seja solucionado. Para isso é fundamental que as mídias ,por entermédio de campanhas enganadoras,motivem, mulheres a lutarem por seus direitos, assim como o movimento que foi criado "" deixa ela correr"".Também é importante que ONGs e Estados,  forneçam apoio, além da extinção de regras, onde mulheres precisem passar por contrangimento com o seu corpo,tudo com um único propósito,a igualdade dos gêneros.']",120,160,160,200,160,800
73,Um preconceito que persiste,"['O preconceito racial contra pessoas negras no Brasil, é resultado de um passado histórico marcado, entre outras coisas, pelo darwinismo social de Gobineau (o qual buscava o ""branqueamento"" dos brasileiros, alegando que a raça branca era superior às outras) e pela escravidão negreira a qual durou 3 séculos. Tais fatos ainda estão enraízados ou disfarçados na sociedade brasileira, pois são muitos os desafios encontrados por mulheres e homens negros para cessar os preconceitos.', 'Segundo o filósofo Jean-Jacques Rousseau, o homem nasceu livre e por toda a parte vive acorrentado ; tal ideia, deste pensador,  reflete a situação das pessoas negras no Brasil, já que mesmo depois de libertas da escravidão em 1888, ainda hoje enfrentam as barreiras de viver em uma sociedade que as acorrentam através do preconceito.', 'Estima-se que, a cada 100 vítimas de homicídios no Brasil, aproximadamente 70 % delas são negras. O que demonstra o racismo persistente no âmbito social , além disso, são os bullyings raciais nas escolas, as desigualdades de escolaridade e empregabilidade entre negros e brancos, etc.', 'Com base no que foi exposto, é necessário, portanto, que o Ministério da Educação (MEC) promulgue campanhas nas escolas que conscientizem todos a respeito do quanto o racismo impede o bem estar da sociedade . Ademais, devem ser criados e colocados em prática programas sociais de apoio às vítimas de racismo para que possam denunciar as agressões e exigir da justiça civil seus direitos legais. Aos poucos, o passado de um país desigual será substituído por um hoje melhor.']",120,120,80,120,120,560
57,Acesso cinematográfico,"['Charles Chaplin no filme ""tempos modernos"" ilustrou a importância do cinema através do senso crítico relacionado ao fordismo(produção em série),pois a acessibilidade sendo um marco para o ser humano com informações sobre os problemas da revolução industrial do século XX,por tanto, a indisponibilidade cinematográfica deve ser avaliada em causais, de consequências e medida possível', 'Primeiramente,sendo que indivíduos de baixa renda, com menos recursos financeiros,que moram em regiões distanciadas,porque os lugares que foram construidos os cinemas, nas cidades grandes,situando-se longínquos e os ingressos são caros,os mais simples estão desprestigiados e desprovidos sem acesso aos cinemas, não conseguem assistir filmes clássicos no interior do Brasil,precisamente na região nordeste. Isso com mais características de uma etnia, que infelizmente estão inacessíveis de um bom longa metragem. Há também impasses culturais que com o avanços tecnológicos têm sido agravados,por isso, acarretando muitos impossibilitados de instalações tecnológicas, que são difíceis de chegar sinais da rede nas periferias.', 'Em segundo lugar,pessoas que sem a democratização de um roteiro adequado se tornam ""refém"" da precariedade cultural,cinematográfica e informativa, de modo que, à população que necessita de amparo através de um acervo cultural, gerando em desconhecimento midiático. Provocando carências de suas necessidades básicas de ciência para o seu viver. Não sendo aceito o descaso através de reações mais hostis, por um povo que a exclusão social que está visível,favorecendo as classes sociais mais abastadas de um modo mais operante,os nobres em patamar centralizado.', 'Compete aos empresários construtores de cinemas efetuar mais investimentos,por meio de construções cinematográficas,abaixando o valor dos ingressos em áreas interioranas com o objetivo de angariar cidadãos interativos e informados que a sociedade verá os resultados na justiça social sendo acessível,ou seja,a democracia nos cinemas.']",120,80,40,80,40,360
45,Injustiças Por Causa do Abuso de Poder,"['Pelo histórico brasileiro, é evidente o abuso de poder entre os beneficiários de cargos importantes do governo federal, como exemplo os polêmicos casos de corrupção submetidos aos representantes do poder executivo, desse modo usando a autoridade para interesses pessoais. Ademais, devido as diferenças de classes sociais, muitas situações de discriminação e violência policial é constante no Brasil, onde os mais prejudicados pela opressão são na maioria os pobres, assim evidenciando o autoritarismo desnecessário.', 'Geralmente a falta de profissionalismo entre os considerados superiores na gestão governamental brasileira, é em usar o cargo de liderança para cometer crimes como o da corrupção, com isso diversos presidentes e governadores já foram investigados pela polícia federal cometendo abusos de poder, como exemplo Dilma Rouself, Michel Temer, etc . Consequentemente os prejudicados por isso é o povo que os elegeu democraticamente, onde o dinheiro usado por interesses maliciosos e egoístas,  poderia ter sido gasto em projetos para o estado. Além disso, o atual presidente Jair Messias Bolsonaro conseguiu colocar o filho Eduardo Bolsonado no cargo de embaixador dos Estados Unidos, nisso abrindo reflexões e debates a esta situação, pois essa atitude do presidente é vista como nepotismo, assim mostra claramente o tamanho do poder que o cargo de chefe de estado pode fazer.', 'Apesar disso, o nível de desigualdade social no Brasil ainda é alta, e devido a descriminação de classes baixas, muitos policiais abusam de seu poder e tratam os mais pobres com agressões e violência, porém os indivíduos de classe alta e média na maioria dos casos não recebem o mesmo tratamento que os pobres, levando a crer a desarmonia entre as classes sociais, onde a justificativa da violência policial é a pobreza e cor de pele . Um acontecimento que abalou o mundo em 2020, foi a morte de Jorge Floyd por um policial branco nos Estados Unido, em que mostrava nitidamente a atitude covarde de abuso policial.', 'Em virtude dos fatos mencionados, tanto no Brasil como em outros paises, não se deve existir o abuso de poder das instituições governamentais e entre os considerados de classe alta, pois além de atrair infelicidades e injustiças sociais, o modo de vida em sociedade é afetado, já que os escândalos de autoritarismo geram revoltas populares e assim os oprimidos podem entrar em conflito aos que os oprimem. Desse modo, todos seres humanos devem entender que igualdade, lealdade e respeito faz parte do cotidiano e só assim para uma qualidade de vida constante.']",120,120,120,120,120,600
71,UMA DOENÇA SILENCIOSA,"['Em 2017 o Jogo ""Baleia Azul"" - 50 desafios diários, que iniciam com simples ordens como escrever códigos secretos nas redes sociais, e vão até ao último, o suicídio do jogador - tornou-se um fenômeno nas redes sociais e resultou na morte de inúmeros jovens em todo o mundo. No Brasil, a taxa de suicídio entre os jovens vem crescendo a cada dia por motivos distintos e precisa ser controlada.', 'Um dos culpados pelo aumento dessa taxa é a mídia, que estimula através de músicas, filmes e seriados a morte prematura dos jovens. Um exemplo disso é a série de enorme sucesso  13 reasons Why, transmitida pela Netflix, que narra a história de Hannah, uma garota que após passar por inúmeros problemas, como estupro e bullying, começa a questionar o sentido de existir e começa a planejar sua própria morte. A revista Exame publicou uma pesquisa que associou a série ao aumento de casos de suicídio, principalmente de jovens, em todo o mundo.', 'Além disso, a depressão, conhecida como ""a doença do século XXI"", vem crescendo entre os jovens por diversos fatores como traumas, pressão familiar, auto-estima baixa, bullying, ansiedade, entre outros. Segundo a Organização Mundial de Saúde (OMS), até 2020 a depressão vai ser a doença mais incapacitante do mundo. A depressão é uma doença silenciosa e mascarada, onde o indivíduo não aparenta tristeza a todo o momento. É o caso do ator e humorista Robin Williams, conhecido por diversos papéis cômicos, que cometeu suicídio em 2014.', 'É necessário, portanto, medidas para evitar o suicídio entre os jovens. A prevenção é uma das principais formas de combate ao suicídio e pode ser realizada através de palestras de auto-ajuda nas escolas problematizando o bullying e os diversos tipos de assédios; a capacitação dos professores para lidar com os seus alunos e encorajá-los; cartilhas e documentários criados por psicólogos e distribuídos gratuitamente pelo governo aos pais com conselhos sobre a necessidade de controle do que o seu filho está vendo ou lendo, e também a respeito da pressão familiar que ele pode estar sofrendo, entre outros;  que e programas criados pelo governo que fortaleçam a saúde mental do jovem como a implementação de psicólogos nas escolas, além de reforçar programas já existentes como o Setembro Amarelo, o mês dedicado ao combate do suicídio.']",120,160,120,160,120,680
60,Reforma da previdência para a sociedade idosa,"['Desde o início do século XVI, com a chegada oficial da colonização portuguesa ao Brasil, cultiva-se a ideia de que nossos recursos naturais são infinitos . Frente a atual crise econômica em todo o território nacional, nota-se que não é verdade. A reforma da previdência é um problema, pois afeta diretamente a classe idosa na saúde, não apenas isso como também tem-se como prova a mortalidade entre homens e mulheres.', 'A medida que o corpo envelhece torna-se frágil, surgem diversos problemas de saúde, como fraqueza, enfado, dores nas costas, entre outros que dificultam a mão de obra no mercado de trabalho. Segundo Clement Atllee a democracia não é apenas a lei da maioria, mas a lei da maioria respeitando o direito das minorias . Se por um lado melhora a economia do país, por outro se torna um grande obstáculo para a minoria idosa.', 'Somado a isso pode-se destacar também a taxa de mortalidade, pois o índice de morte entre homens é maior que entre mulheres. Isso reduz o número de homens idoso acima da idade estabelecida (de 65) pela reforma da previdência. De acordo com a socióloga Emile Durkhein, a sociedade pode ser comparada a um ""corpo biológico"" por ser, assim como esse, composta por partes que interagem entre si . Desse modo, nota-se um déficit na conexão dos fatos. Se poucos homens conseguem adquirir uma boa aposentadoria não deveria ser essa a preocupação nos cortes de gastos no Brasil.', 'Dessa forma, portanto, o governo deve agir coeso com a realidade atual vivenciada no país, reduzindo a idade de direito aposentadoria por meio de uma votação entre deputados federais e senadores para definição de nova idade de aposentamento visando melhoria para o cidadão brasileiro.']",120,120,120,120,80,560
41,Fatores para o péssimo desempenho dos colégios públicos,"['Apesar dos ótimos resultados dos colégios militares em todo o Brasil, no Enem, é um equivoco acreditar que os valores militares favorecem a educação. Existe varios fatores que somam o ensino, e a ausência destes são às causas do péssimo desempenho dos alunos dos demais colégios públicos. Os colégios militares vem apresentando melhores resultados do que outras instituições de ensino público. O fato se faz afirmar que os diferentes valores empregados nessas repartições favorece o ensino. Uma diferença importante dos colégios militares são sua estrutura. A falta de estrutura nos demais colégios, causa a pouca exigência do aluno, e dificulta às funções do professor e dos demais trabalhadores da instituição, subtraindo assim os bons resultados das escolas públicas. Toda instituição de ensino tem suas regras que exigem disciplina, ordem e senso de autoridade do aluno, e a base estrutural está totalmente ligada a esse exercício . O deficit do ambiente escolar público compõe os fatores que causam o péssimo desempenho dessas repartições. Fica claro que a resposta para uma melhor educação de qualidade não está só na maneira exclusiva de cada instituição de ensino, mas também está na estrutura dos colégios. Isso se constata tanto nos colégios militares, quanto nos colégios privados, detentores de boas estruturas.']",120,120,80,120,80,520
44,Injustiça contra as mulheres,"['Em princípio, a ciência caracteriza a testosterona como um hormônio com um desenvolvimento altamente progressivo. Com uma maior evidência em homens, a testosterona também é encontrada em mulheres, porém em quantidades menores. Sendo um fator que no decorrer dos anos ainda é muito debatido pelas pessoas, principalmente em competições onde ambos competem, algumas mulheres acabam sendo alvo de intolerâncias e injustiças por algum acaso, produzirem uma maior quantidade de testosterona, ultrapassando o limite exigido.', 'De acordo com situações já apresentadas e vivenciadas por algumas mulheres, a sociedade ainda vê como algo surreal, tendo em vista que isso pode ser levado a ser considerado como algo normal . Em certas ocasiões há um tipo de dificuldade em aceitar, trazendo à tona protestos que podem gerar grandes conflitos, como nos tempos históricos, os quais onde vários conflitos foram originados através de revoltas contra decisões e atitudes inaceitáveis.', 'Outros fatores a abordar, são as iniciativas tomadas, sobretudo quando essas iniciativas acabam trazendo um tipo de constrangimento para as pessoas, como a solicitação de exames além dos necessitados e a descriminação sofrida diante algumas atletas, a qual tanto serve para demonstrar que permanece uma falta de confiança no potencial feminino, quanto serve para mostrar que ainda existe uma grande desigualdade entre homens e mulheres estipulada pela sociedade.', 'Em síntese, uma mulher não precisa provar que é mulher por apresentar um desenvolvimento avançado no organismo. Esse é mais um tabu imposto pela sociedade que deve ser cortado, para não trazer consequências futuras. E cabe as entidades esportivas  procurarem métodos e medicamentos autorizados que possam estabilizar o desenvolvimento da testosterona no organismo de atletas femininas, proporcionando a chance de poderem participar de competições.']",200,160,120,200,160,840
43,AAAA - Cultura do cancelamento.,"['São Tomás de Aquino defendeu que todas as pessoas precisam ser tratadas igualmente, com a mesma importância. Porém, a cultura do cancelamento vai de encontro ao ponto de vista do filósofo, uma vez que,  as pessoas são vítimas de ódio por erros ou visões diferentes. Dessa forma, é possível pontuar que não só a intolerância, mas as doenças mentais estão diretamente ligados essa temática.', 'Primeiramente, é válido lembrar da ausência de respeito com a opinião do próximo como entrave dessa situação. De acordo com a Declaração Universal dos Direitos Humanos, a liberdade de expressão é direito de todos. Apesar disso, parte dos cidadãos não acatam essa lei, visto que atacam pessoas que têm opiniões contrárias e/ou divergentes. Logo, cada vez mais indivíduos não se posicionam diante de certos assuntos devido ao receio do “cancelamento”.', 'Outrossim, como destaque, algumas enfermidades podem vir à tona através de situações problemáticas como essa. De acordo com a OMS (Organização Mundial da Saúde), o aumento de doenças como ansiedade e depressão estão relacionadas ao uso de redes sociais. À vista disso, nota-se que a cultura do cancelamento está diretamente ligada às redes sociais e internet. Consequentemente, o indivíduo que sofre os ataques pode não aguentar e desenvolver problemas de saúde mental.', 'Em suma, medidas devem ser tomadas para que haja mudança. Cabe ao Poder Legislativo dos países que vivem nessa realidade, criar e reformular leis de crimes cibernéticos, punições como: pagamento de tratamento psicológico à vítima do cancelamento; além de palestras em escolas públicas e privadas, para que haja consciência de aceitação de pensamentos divergentes. Somente assim, a sociedade ficará cada vez mais próxima do mundo igualitário e respeitoso falado por Tomás de Aquino.']",200,160,120,200,160,840
40,A beleza vale tudo isso?,"['Hoje em dia a busca pelo padrão de beleza perfeito vem levando muitos homens e mulheres para as mesas cirúrgicas ou até mesmo injetando e passando substancias químicas no corpo. A ditadura da ""beleza perfeita"" esta dentro da sociedade a muitos anos, e vem se consolidando ate hoje, essa ditadura atinge principalmente as pessoas que acreditam que para serem aceitas na sociedade e serem felizes tem que estar dentro dos padrões. A mídia é a principal fonte que se propaga essa ditadura, pois a mesma criar a ilusão alienadora que só homens e mulheres de corpos esculturais, cabelos lisos ou ondulados e de pele perfeita se enquadram no que chamamos de beleza. Essa busca inassinalável faz com ser o ser humano seja capaz de passar por cima da sua saúde, só para ter o ""corpo perfeito"". Os procedimentos cirúrgicos como: lipoaspiração,  próteses de silicones; a injeção de substancias químicas no músculo como o hidrogel; substancias química para alisar os cabelos como o formol vem sendo banalizado cada dia que passa, as pessoas vem esquecem o risco que estão pondo sua saúde, pois a vontade de serem aceitas fala mais alto, mas as vez acabam pagando um preço muito alto; pois em muitos casos as pessoas que faziam uso desses procedimentos adquiriram alguma doença, complicações e outras foram a óbito.Portanto, visando o bem estar da sociedade a mídia deveria quebrar esses padrão, colocando modelos com beleza diferentes da atuais para fazer as propaganda e o governa e população dar atenção os protesto contra o padrão atual, pois eles mostram a verdadeira realidade.']",120,120,160,160,80,640
90,Dificuldades encontradas por transexuais na sociedade brasileira.,"['""Brasil é o país que mais mata pessoas transexuais"" ""Assassinatos de travestis e transexuais crescem 70% em 2020 "", essas são algumas notícias relacionadas a transgêneros no Brasil, onde mostram a decadência e a perseguição aos LGBTs homens e mulheres mortos por motivos de ódio, etnia sexual ou pela sua aparência, no entanto o número de pessoas que se assumem transexuais é cada vez maior e esses indivíduos vem lutando contra a transfobia deixando-os então em uma espécie de bolha, uma proteção, entre sua orientação sexual e o preconceito da sociedade.', 'Primeiramente vale realçar que a transfobia é um crime de ódio, que em muitos casos está relacionado má formação no desenvolvimento das crianças em suas infâncias, que crescem com a ideia de discriminação e racismo já que a sociedade ao seu redor as impõe esse pensamento de divisão por diferenças étnicas.', 'Por consequência, se desenvolve uma nova geração racista e preconceituosa, mas esse problema é muito mais antigo já que transexuais eram submetidos a testes bizarros como: amputações torturas e mortes , dentro de centro de concentrações durante a segunda Guerra Mundial por serem considerados sujos, inferiores e uma ofensa.', 'Portanto, medidas são necessárias para resolver o impasse através do Poder Legislativo que tem o dever de criar e melhorar as eis como a Lei de nº 122 que propõe a criminalização dos preconceitos motivados pela orientação sexual e identidade de gênero demais, é indispensável propostas de intervenção e projetos contra a transfobia em escolas e nas ruas conscientizando as pessoas que os LGBTs tem direito de escolher e acima de tudo eles tem o direito de viver ,estourando assim a bolha de proteção imposta pela sociedade.']",160,120,120,160,120,680
81,Religião vinculada ao eurocentrismo,"['Pode-se perceber nitidamente que  ao analisar o tema referente à intolerância religiosa no Brasil  vê-se que a discriminação e o desrespeito às crenças individuais estão se tornando mais rotineiros. Segundo a Constituição Cidadã, todos os indivíduos devem ser tratados e respeitados de igual forma, entretanto, é fato saber que nem sempre a teoria está em consonância com a prática .', 'Dessa forma, por conta de um  contexto histórico do Brasil, os adeptos das religiões de matriz africana constituem as principais vítimas. De fato, a liberdade de expressão é um dos princípios fundamentais no Estado Democrático de Direito, no entanto, é perceptível observar que os índices de casos de pessoas que usam e abusam desse direito para criticar de forma a denegrir as manifestações culturais e religiosas de outro povo aumentou  vertiginosamente ao longo dos anos. Nesse sentindo, no que tange os  direitos de cada cidadão brasileiro, é assegurado  pela Carta Magna de 1988 os fundamentos de isonomia e equidade, nos quais todos os membros da sociedade são tratados sem diferença em um âmbito social, político, econômico e cultural.', 'Contudo, mesmo com tais premissas, a sociedade ainda continua altamente arraigadas  à conceitos pejorativos, especialmente relacionados às  religiões afro-brasileiras.  à ', 'Torna-se evidente, portanto, que medidas são necessárias para resolver o impasse. Segundo Immanuel Kant, ""o ser humano é aquilo que a educação faz dele"". Sendo assim, se faz  necessário que o Ministério da Educação, juntamente com os meios de comunicação, crie campanhas midiáticas que ressaltem o respeito e a liberdade de crença religiosa. Por fim, o MEC poderia instituir palestras ministradas por professores e psicólogos aos alunos, a fim de desconstruir ideologias preconceituosas relacionadas a  determinada crença.']",120,120,120,120,160,640
117,(Sem título 035),"['A vida é um direito inalienável de todo cidadão, reconhecido pela Constituição brasileira. Com o desenvolvimento da medicina, houve a erradicação de muitas doenças e         existe         a possibilidade de postergar a vida. No entanto, muito se discute acerca da instituição da eutanásia no Brasil, uma prática irracional e que fere os princípios humanos.', 'O homem tem um prazo de vida delimitado: nasce, cresce e morre, logicamente, ele não viverá para sempre. Porém, o surgimento de doenças degenerativas e os infelizes acidentes catastróficos, por exemplo, levam parentes, amigos e a própria pessoa a não querer mais conviver com tanto sofrimento e decidir por eliminar a vida mais rapidamente. Traços de insensatez, pois a imprevisibilidade e o inesperado ocorrem na vida de todo ser humano e é preciso aprender a lidar com ele.', 'A eutanásia nunca será a melhor escolha, pois a sensação de perda para quem convive com a pessoa será constante, o sentimento de ter desistido de um ente querido será expressivo. Além disso, para as pessoas que têm alguma crença, sempre há a possibilidade de regeneração,         conforme         dizia         Drummond que         ""há duas maneiras de ver a vida: uma é não acreditando em milagres, outra é que todas as coisas são um milagre.""', 'A banalização da morte não é viável, porque impede que o destino termine da forma que deveria terminar e torna o homem                 ""senhor do tempo"".                Já que se pode                 ""lutar""                por mais um dia de vida, que assim o seja, pelo menos para tirar o                 ""peso da consciência""                de acreditar que algo positivo possa acontecer, ou até mesmo um milagre, para quem acredita.']",160,160,160,160,200,840
74,Misoginia em cenário brasileiro,"['É indubitável que a luta de mulheres por seus direitos e interesses não pode ser caracterizada como uma novidade. Em uma sociedade repleta de valores patriarcais , a misoginia representa um problema de grande escala. Por conseguinte, debates contemporâneos demonstram a utopia da igualdade de gêneros, e a realidade violenta e discriminatória em que a figura feminina está inserida.', 'Simone de Beauvoir afirmava que os homens estereotipam as mulheres para manter o patriarcado, infelizmente tal citação ainda se aplica em dias atuais, já que a objetificação do corpo feminino é diariamente propagada. A misoginia promove muitos debates, a desigualdade salarial, a atuação da mulher na política, e em seu auge o feminicídio . Sendo este definido como a expressão fatal do cenário violento em que vive a mulher brasileira.', 'Em 2015 o Mapa da Violência apontou que entre 1980 e 2013, 106.093 pessoas morreram por sua condição de ser mulher. Neste mesmo ano entrou em vigor a lei que prevê a proteção de mulheres contra tais crimes hediondos e a violência contra o gênero. Embora medidas tenham sido tomadas é nítida a necessidade de uma atuação assídua perante o tema, já que os números não representam apenas estatísticas e sim vidas.', 'É inadmissível que a vida de brasileiras se resuma a obras como “Geni e o Zepelim” , é necessário que diante ataques físicos e psíquicos contra mulheres, haja uma severa atuação da sociedade como um todo. Cabe ao Governo assegurar a atuação das leis,  e juntamente a mídia e escolas  disseminar movimentos que promovam a igualdade de gêneros, para assim, eliminar visões patriarcais. Sendo assim, a nação não será convidada a discutir questões retóricas.']",160,120,120,160,120,680
85,Projeto de iniciativa popular,"['A constituição de 1988, reservou a população brasileira a capacidade de propor novas leis. A participação direta do povo é de suma importância para o processo democrático do país, Mas para um projeto primeiramente, chegar ao Congresso é preciso ter alguns requesitos antes de ser aprovado. Atualmente apenas 4 projetos de incentivo social se tornaram leis:  lei Daniella Perez,  combate a compra de votos,fundação nacional de habitação de interesse social,e a mais recente, lei da ficha limpa.', 'O transporte público é um ponto em que a maioria dos cidadãos insiste para o melhoramento. Vivemos em um país onde uma grande parte da população depende desses coletivos para inúmeras coisas, inclusive, para o trabalho. O transporte de qualidade é uma falta para os brasileiros nos dias atuais.', 'A necessidade, muitas vezes, leva a população a utilizar os transportes públicos em situações de desconforto como a superlotação, que é um grande perigo, pois existem casos de pessoas que já caíram de ônibus em movimento por ficaram grudados na porta, por falta de espaço. A falta de cinto de seguranças , que também colocam a vida dos passageiros em risco.', 'Situações como estas, de incômodo e insatisfação por algo que persiste, mas que pode ser aprimorado é um ponto a ser levado em consideração para a criação de um projeto de incentivo popular que visa atender milhões de brasileiros, que passam por viagens longas, caras e desconfortáveis.', 'As soluções para amenizar esse problema, seriam: ônibus maiores com a capacidade máxima permitida de passageiros, para evitar amontoações, mais ônibus circulando para atender toda a população e todos os seus horários corretos, redução do tempo de viagem e obrigatoriamente cintos de segurança em todos os coletivos. Isso reduziria esse caos por quais muitos brasileiros passam. Como pagamos vários impostos e passagens caras, temos direito a um bom transporte público.']",120,160,160,120,200,760
83,A importância da prática de esportes,"['O esporte está cada vez mais presente no nosso dia-a-dia, e traz ótimos benefícios para o corpo e a mente, já que pode ser realizado em locais ao ar livre e em contato com a natureza.', 'Além da vida saudável, a prática esportiva pode ajudar em diversos fatores, entre eles estão características cada vez mais solicitadas pelo mercado de trabalho, como disciplina, inteligência emocional, responsabilidade, perfil de liderança, trabalho em equipe, etc.', 'As habilidade de raciocínio que o esporte nos concede também pode ser uma ferramenta poderosa para a aprendizagem. Crianças e jovens que praticam esporte, espontâneamente passam a ter um comportamento diferenciado em sala de aula, com mais foco, capacidade de compreender situações, linguagens e estratégias.', 'No futebol, voleibol e basquete, por exemplo, aprendemos a importância do trabalho em equipe, do controle emocional, da perseverança e da socialização. Sendo essas, habilidades socioemotivas são essenciais não só para o sucesso escolar, mas também para a vida.', 'Apesar de ser de suma importância, o esporte não alcança a todos no Brasil. É preciso que haja um planejamento para que todos sejam alcançados, - crianças, jovens, pessoas de baixa renda e deficientes físicos- .', 'Visando isso, as ONGS e empresas, em parceria, podem fortalecer as ações sociais de inclusão no esporte. A educação de base precisa ser reestruturada para que as crianças tenham, desde sempre, acesso à prática esportiva. O governo pode ajudar com infraestrutura para a realização de campeonatos nas cidades.', 'Dessa forma, todos poderão conhecer as inúmeras atribuições que a vida esportiva pode nos trazer, e consequentemente adiquirir uma vida mais saudável. .']",120,160,200,200,200,880
88,Mal enraizado,"['Na antiguidade, a falta de conhecimento levava as pessoas a acreditarem que as doenças mentais eram causadas por manifestações de entidades malignas. Entretanto, mesmo depois de começarem a serem tratadas como enfermidades fisiológicas, a insuficiência de informação, o preconceito social retrógrado, e a negligência estatal em relação as doenças mentais fazem com que elas ainda sejam vistas como futilidades. Sendo assim medidas devem ser pensadas para amenizar essa questão na sociedade brasileira.', 'De início, é importante ressaltar que o estigma relacionado às enfermidades psíquicas provem da aceitação de um conceito errôneo pré-formado que se sucede de outro problema: a desinformação. Hannah Arendt – filósofa contemporânea – desenvolveu o conceito de Banalidade do Mal, segundo o qual a crueldade está enraizada no mundo. Nesse viés, o fenômeno denunciado por Arendt, se mostra presente na sociedade brasileira na forma de um dos mais antigos e graves exemplos da crueldade do homem: o preconceito (existente por causa da quantidade insuficiente de informação), que prejudica o crescente número de pessoas psicologicamente instáveis. Assim, enquanto a escassez informativa prevalecer, o Brasil será obrigado a continuar com um dos maiores obstáculos para ter uma população mentalmente saudável: o preconceito.', 'Ademais, de acordo com uma pesquisa realizada em 2017 pela Organização Mundial da Saúde (OMS), existem aproximadamente 12 milhões de depressivos no Brasil. Tais dados divulgados pela OMS, evidenciam o quão falho e precário é o sistema de saúde brasileiro, e a negligência governamental em relação ao atendimento da população mentalmente doente. Sendo assim, é necessário que providencias sejam tomadas para reduzir os estigmas relacionados às doenças psíquicas.', 'Portando, é importante que o governo federal por meio das redes sociais e instituições de ensino, inicie a abordagem de assuntos relacionados aos transtornos psicológicos mostrando que eles não são “frescura” ou “falta de Deus”, a fim de distribuir conhecimento real sobre o assunto. Além disso, é necessário que o governo disponibilize atendimento psicológico adequado ao povo, integrando mais psicólogos ao sistema de saúde e às escolas públicas. Quem sabe assim, talvez os estigmas sejam arrancados pela raiz de vez e o conceito de Banalidade do Mal deixe de ser realidade no Brasil.']",160,160,160,200,160,840
46,A questão da privatização do saneamento básico no Brasil,"['A privatização do saneamento básico é um tema colocado em pauta na hodierna conjuntura social, e que detém grande importância. Tal afirmação é corroborada pelo fato de que a presença desse tipo de saneamento é fundamental à manutenção da qualidade de vida dos brasileiros. Diante disso, em decorrência do hodierno quadro social, privatizar o saneamento básico pode ser uma ameaça ao seu acesso no aís, já não abastoso  por parte da população.', 'A priori, salienta-se que, de acordo com dado do levantamento feito pelo Sistema Nacional de Informações sobre Saneamento (SNIS), somente 46% do esgoto no Brasil passa por tratamento. Isso indica que a área sanitarista, ainda com o investimento do Estado, sofre, presentemente, com a precariedade de abrangência de sua efetivação, conforme a análise do que foi sobredito.', 'A posteriori, é nitidificado que não é pequena a parcela de cidadãos que fica à mercê da diligência governamental no que diz respeito ao saneamento que é básico, aliás . Nesse viés, o conceito de Aristóteles,  de ""dar desigualmente aos desiguais"", não é aplicado, na íntegra.', 'Nesse sentido, é válido ressaltar que a falta de saneamento básico pode afetar diversos âmbitos da vida de um indivíduo, dentre eles, sua saúde, por exemplo. Dessarte, em um aís que apresenta, infelizmente, um histórico marcado pela ganância humana, a privatização do saneamento básico pode representar o favorecimento da elite.', 'Mediante ao exposto, urge que sejam avaliados, por parte de autoridades estatais, os já pouco evidentes benefícios de se privatizar o saneamento básico. Frente a isso, com o fito de propiciar, mesmo que minimamente, melhoria em relação à realidade vivenciada por muitos brasileiros, torna-se mister que a decisão da privatização supracitada seja pesada criteriosamente. Assim, ainda que em pequena escala, o conceito de Aristóteles, juntamente a mais ações eficazes de caráter sanitarista básico, seriam colocados em prática.']",160,120,120,160,120,680
113,A virgindade explorada,"['A virgindade não é uma mercadoria e não deve ser vendida como se vende um peixe numa feira, ou um carro num leilão, pois quem procede desse jeito contribui para uma completa banalização do ato sexual,                 favorece a prostituição                e, além disso, deixa de lado os valores morais que norteiam nossa sociedade.', 'Algumas pessoas                tratam o sexo como algo vulgar e consideram irrelevante a intimidade entre os casais, transformando suas vidas sexuais num verdadeiro ""reality show"",         onde         o que vale realmente é a fama.', 'Quando alguém leiloa sua própria virgindade, expõe o corpo à venda e entrega por ""alguns trocados""                 o que tem de mais precioso                . E passa a ser considerado como um objeto sexual e não um ser humano.', 'Ainda convém lembrar que sentimentos como: amor, respeito, amizade, cumplicidade, lealdade e carinho não são observados nesse tipo de situação, fazendo com que a promiscuidade reja o ato sexual,                 tornando-o cada vez mais depravado e imoral.', 'Portanto, não é correto leiloar a virgindade, porque                 tal atitude deteriora e suja a imagem da mulher, que é um ser magnífico, dotado de várias qualidades. E as mulheres não merecem ser achocalhadas dessa forma com tamanho desrespeito.']",160,160,160,200,0,680
95,Além das terras,"['Convém lembrar, que a data 19 de abril é conhecida como o dia do indio,uma homenagem aos primeiros habitantes do Brasil. Essa data é comemorada em todo Brasil e por todos os brasileiros,sendo conscientizada nas escolas,pois este dia é relevante para a história nacional e cultural do Brasil. Apesar disso, muitos indígenas estão lutando e clamando por seus direitos, desde a proposta do marco temporal, que põem em risco e vulnerabilidade muitas famílias,uma cultura histórica e o meio-ambiente.', 'Ademais,em 5 de outubro de 1988,a Constituição federal reconheceu aos índios o direito às terras que originalmente e tradicionalmente ocupavam e a União tinha a obrigação de demarcar,proteger e fazer respeitar esses direitos referentes s terras; entretanto  recentemente o debate em relação ao marco temporal tem posto em ameaça esses direitos territoriais. O marco temporal é defendido por grandes setores da sociedade,ainda mais por aqueles que são de exploração agricólas,e possui a tese de que os índios só possuem direitos aos territórios que ocupavam até a promulgação da constituição em 1988.', 'Percebe-se na verdade,que isso vai além dos direitos indígenas e afeta toda sociedade brasileira,pois também existe a exploração ambiental em virtude da ambição humana. Esses grandes setores desejam arrecadar mais economicamente e para isso é necessário mais matérias-primas,é necessário explorar e desmatar mais florestas, para manter suas linhas de produções. E toda essa exploração ambiental impacta negativamente no nosso cotidiano com a poluição do ar,a chuva ácida,a degradação costeira e marinha,o efeito estufa e assim por diante. Embora afete também a sociedade ,muitos ao invés de se unir aos indígenas nessa mobilização,na verdade os atacam:como na mobilização pacífica que eles foram recebidos com bombas pelos PM ,agridem ou nem dão o valor que eles possuem e nem se importam . Apesar desse povo possuir uma data que é comemorada por muitos,eles na realidade são esquecidos pela sociedade brasileira.', 'Mediante o exposto deve-se respeitar e assegurar os direitos que os indígenas possuem,pois o art.6°diz o seguinte: “São direitos sociais educação, saúde, alimentação, o trabalho, segurança, o lazer, moradia..."" e criar uma mediação pacífica com a bancada ruralista, conscientizar a sociedade sobre o verdadeiro significado da data 19 de abril, criar palestras e eventos que interaja o jovem com o cotidiano do índio para respeitar e compreender a diferença cultural.']",120,160,120,160,120,680
81,Futuro seres mais pensantes.,"['Por conta da colonização brasileira, migrantes e imigrantes, temos uma população com pensamento diversificado, mas o fato de outra pessoa pensar diferente não significa que ela esteja errada. Vivemos em um mundo onde nossa cor, gênero ou religião definem nossa ""imagem social"". Mas  afinal, o que seria o certo? Somos diferentes e isso inova o mundo. O fato dos fiéis de religião afro-brasileira serem as principais vitimas de descriminação,  é alarmante,  por carregaram uma de nossas culturas, considerando do nosso povo ter sido cristianizado. Um dos grandes fatores que influenciam na intolerância religiosa é falta de respeito com o próximo, que é passada de geração para geração. Somos livres para definir nossa crença, então  não devemos impor nossa religião aos outros. Uma medida que pode ser tomada no intuito de combater este  tipo de crime,  é educar e mostrar ao nosso povo que toda forma de crença é válida,  e  caso não concorde com os ensinamentos de outra religião, o que se deve fazer é respeitar. Sendo assim, pode-se concluir que esta  medida deverá ser tomada por nossos governantes, através  de propagandas, para conscientização da população, e em matérias do ensino fundamental e médio, para assim colhermos no futuro, seres mais pensantes.']",120,80,120,120,120,560
85,Um instrumento na vida política do cidadão,"['Um instrumento na vida política do cidadão', 'Ao Analisar o tema vê-se que, a Lei de Iniciativa Popular é um importante instrumento na vida política dos cidadãos. Onde eles podem atuar publicamente na criação das normas que os regem e, assim permitindo a qualquer um propor mudanças no funcionamento da estrutura política.', 'A democracia brasileira possui um sistema representativo, onde os cidadãos votam para que sejam representados nos poderes legislativo e Executivo, no entanto, este modelo não é absoluto.', 'Contudo, o problema está caminhando lentamente para solução. Pois, esses projetos não podem ser apreciados pelo Congresso Nacional se não tiver adesão de no mínimo 1% do eleitorado, além da adesão de 0,3% do eleitorado de pelo menos cinco estados da federação, ou seja é um processo que exige paciência.', 'Portanto, medidas são necessárias para resolver o impasse. O Congresso Nacional deve dar carta branca a à população e saber ouvir e atender as necessidades de todos, Pois , a Constituição de 1988 prevê a participação direta da população, fazendo com que todos tenham direitos de impor propor leis de acordo com as necessidades da população, Sendo assim, um País de igualdade social e deixando com que o povo tenha liberdade de expressão. Como citou o grande filósofo Aristóteles: “A base da sociedade é a justiça”, os cidadãos devem ter a liberdade de impor por eles mesmos, cobrando seus direitos, Pois é dever da Política nacional deixar com que os próprios eleitores tenham suas ideias apresentadas, Entre tudo medidas devem ser tomadas, para que o Brasil seja um País onde o povo tem  vós e participação.']",120,80,120,160,160,640
56,,"['Segundo o filósofo Georg Hegel o Estado deve proteger seus ""filhos"", assim cada indivíduo merece o respeito e os direitos que lhe é propriamente dado perante a lei. Entretanto, nos dias em questão esse pensamento se torna quase, até mesmo, inexistente para a situação carcerária vista no Brasil com total falta de suporte.', 'Corriqueiramente é noticiado em reportagens prisões com a sua lotação máxima, moradias insalubres para a sobrevivência e falta de recursos primários. Reforço necessário do ideal já visto na idade média: a marginalização de detentos aprisionados em pequenas ""jaulas"", sem total higiene, alimentação completamente restrita, aonde tais esperavam ser aplicadas suas penas que iam de chicoteamento à morte na guilhotina. Entretanto, nessa época era muito normal cenas como essas serem vistas visando que não tinham a mesma forma de justiça que hoje em dia.', 'No Art. 5º na Constituição da República Federativa do Brasil é relatado: ""Todos somos iguais perante a lei, ninguém será submetido a tratamento desumano."", sem quaisquer dúvida afirmando então que essas pessoas no estado de detentos merecem visibilidade no campo humano, tendo a necessidade urgente de auxílio básico enquanto cumprem suas dividas.', 'Diante disso, a intervenção se faz por meio da ONU (Organização das Nações Unidas) junto com o Departamento Penitenciário Nacional (DEPEN), em função de inspecionar presídios  afim de ajustar esses problemas com segurança, saneamento básico etc. Palestras também são bastantes importantes para conseguir educar e redirecionar esses prisioneiros, para que do lado de fora eles consigam continuar a luta pela sua sobrevivência.']",120,120,120,120,120,600
58,A conscientização da preservação da Amazônia,"['A floresta amazônica é famosa pela sua biodiversidade. Ela ocupa cerca de 600 milhões de hectares, é atravessada por milhares de rios , abriga inúmeras espécies de animais e sua vegetação é rica, densa e perene. Hoje em dia infelizmente esse cenário mudou, pois com os vários desmatamentos ela se transformou em uma área destinada à urbanização, extrativismo animal, mineral e vegetal, expansão do agronegócio e atividades ilegais que envolve queimadas propositais. É um cenário preocupante para o mundo, porque a amazônia é responsável pelo equilíbrio ambiental e acabando com esse recurso natural, obviamente todos irão sofrer diretamente as consequências.', 'O mundo inteiro necessita do meio ambiente para sobreviver, e não só para sobreviver, mas para ter bem-estar, de um modo geral. O ar, a água, a alimentação, tudo vêm da natureza e a relação de interdependência é muito grande entre tudo o que existe. Não adianta alavancar a economia se não cuidam daquilo que é essencial para a vida, o meio ambiente! É fundamental preservá-lo para continuar recebendo tudo aquilo que ele oferece de melhor para o planeta.', 'O desmatamento e as queimadas comprometem toda a biodiversidade da área. Espécies da fauna perdem seu habitat e espécies da flora podem entrar para a lista de ameaças à extinção e assim causar um enorme desequilíbrio ambiental, além de comprometer também o clima, que tem sofrido mudanças sentidas em todas as partes do mundo e tem causado inúmeros danos aos ecossistemas e a saúde humana, como exemplo disso é São Paulo que foi resultado de um fenômeno ótico criado pelo encontro de particulados das queimadas de certas partes da amazônia com uma frente fria.', 'Segundo dados do Instituto Nacional de Pesquisas Espaciais (INPE) divulgado esse ano, apontam que o desmatamento aumentou em 278% no mês de julho comparado a julho do ano passado, e o número de focos de queimadas, entre janeiro e agosto de 2019, cresceu 84% em relação ao mesmo período de 2018. Uma triste realidade devido ao fato de ser dada maior importância as questões econômicas e não as questões ambientais.', 'Conclui-se que é necessário que todos se conscientizem da importância de preservar a amazônia. Atitudes como economizar água e energia, reciclar o lixo, não jogar lixo nas ruas , além da ajuda dos governantes em ter ações mais efetivas como fiscalização e controle para evitar os desmatamentos e as queimadas ilegais são tarefas diárias e que ajudam a ter um ambiente melhor e saudável.']",120,120,120,120,80,560
52,Gravidez na adolescência,"['A gravidez na adolescência se trata de uma questão de saúde pública, sendo um assunto que causa muita discussão e preocupaçâo dentro da sociedade.', 'Segundo a Organização undial de Saúde , a gravidez é considerada precoce netre os 10 e os 19 anos, com o passar dos anos este problema tem se tornado maior, envolvendo questões como infraestrutura, cultura, religião, pobreza, entre outros . A fundação abrinq revelou que quase 30% das mães adolescentes estudaram menos de sete anos, portanto, em países subdesenvolvidos  este percentual é maior, mostrando que a falta de informação acompanhada de condições precárias é um fato agravante, trazendo prejuízos a vida da adolescente, interrompendo sua vida estudantil e a forçando se tornar uma adulta muito jovem .', 'Ainda de acordo com a ONU , no Brasil a taxa é de 62 adolescentes grávidas para cada grupo de mil jovens do sexo feminino na faixa etária entre 15 e 19 anos. O índice é maior que a taxa mundial, que corresponde a 44 adolescentes grávidas para cada mil jovens, certamente este dado é assustador e mostra a necessidade de melhorias dentro do país  fornecendo uma melhor qualidade de vida.', 'Portanto, conclui-se que uma boa solução para este problema seria o investimento do governo em saúde pública , maiores informações e oportunidades a papulação feminina desta faixa etária e uma atenção há formação destas adolescentes pois,  uma boa formação educacional traz inúmeros benefícios como conciência sobre o assunto.']",120,120,80,120,80,520
54,Saúde em primeiro lugar,"['Em meados do século XX ocorreu a revolta da vacina na cidade do Rio de Janeiro, as pessoas se opuseram à imunização, isso tudo se deu por falta de conhecimento . Atualmente o Brasil enfrenta problemas com a vacina cuja causa é a mesma de cem anos atrás: falta de informações atrelada a notícias falsas.', 'Evidência-se que, a falta de informações na atualidade é muito grande. De acordo com Karl Popper, ""A verdadeira ignorância não é ausência de conhecimento, mas o fato de se recusar adquiri -lo. É notório como as pessoas não procuram saber sobre os benefícios que a vacina traz, achando que as doenças já foram controladas, o que acarreta ainda mais a problemática, ficando expostas aos vírus . Assim hão de ser analisados tais fatores a fim de liquidá-los.', 'Em segundo plano, é importante destacar que o número exarcebado de “Fake News” nas redes sociais é grande, com isso, muitas pessoas deixam de vacinar. Segundo Ralph Wall Emerson,  “A maior riqueza é a saúde”.Entretanto, a população deixa-se levar por tantas notícias falsas que esquecem de cuidar do seu bem maior, que é a saúde. Desse modo, compreende-se que a vacinação é de extrema importância na sociedade, e o fluxo de informações falsas às prejudicam.', 'Conclui-se portanto, que medidas devem ser tomadas para acabar com os impasses. A organização Mundial De Saúde(OMS), deve promover palestras e campanhas nas escolas e redes sociais , haja vista que o fluxo de informações falsas diminui o índice de vacinação, a fim de sinalizar a importância da imunização para todos.']",120,160,120,120,80,600
94,Autismo,"['O autismo, atualmente denominado de Transtorno d Espectro Autista (TEA), foi descoberto na década de 1940, sendo na época considerado um tipo de síndrome. Desde então, com a realização de vários estudos, o autismo vem sendo caracterizado com uma condição psicomental que compromete a vida nomal de uma pessoa. Nesse parâmetro, segundo dados coletados em 2016 pelo Centro de preservação de doenças dos Estados Unidos, uma em cada 54 crianças de 8 anos tem autismo. Essa realidade, especialmente no Brasil tem suscitado várias preocupações dentre elas o desafio de garantir a inclusão dos auitistas em uma sociedade imbuída de barreiras socioestruturais.', 'Em primeiro lugar, observa-se no aspecto social que o desconhecimento sobre o autismo tende a estigmatizar os sujeitos que apresentam esse transtorno. Culturalmente, a maioria das pessoas associa o TEA a doenças neurológicas graves. Tal concepção pode condicionar o isolamento desse indivíduo, pois parte-se do pressuposto que essa suposta gravidade os incapacita de socializarem com os demais. No entanto, pesquisas têm mostrado que o autismo apresenta vários níveis de intensidade que podem se manifestar ora no âmbito da linguagem da criança, ora no aspecto comportamental, não sendo necessariamente uma condição que a torne insociavel. Logo, a ausência de conhecimento sobre as peculiaridades do TEA pode dificultar a sua inclusão nos diversos espaços sociais.', 'Ademais, deve-se considerar o fator estrutural envolvido no mecanismo de inserção do autista na comunidade, pois a sua inadequao ou mesmo inexistência pode prejudicar esse processo de inclusão. Essa questão vem sendo observada, principalmente na esfera educacional em que várias dificuldades são encontradas, como as levantadas pelo estudo realizado, em 2018, por pesquisadores da Universidade federal de Pelotas com 19 professoras da rede municipal de Pelotas que apontaram a falta de conhecimento de meios pedagógicos adequados para promover a aprendizagem desses alunos, bem como a forma apropriada de avaliá-los no decorrer do processo educacional.', 'Sendo assim, faz-se necessário ações que combatam essas barreiras impostas inclusão dos autistas. Para tanto, o Ministério da educação deve desenvolver uma parceria com o Ministério da saúde e com as universidades públicas para criarem um programa de formação que oriente e auxiliem os professores quanto a forma de incluir esses alunos na sala de aula, preservandolhes o seu direito educação e uma rede de socialização para interagirem com outros sujeitos. Paralelamente, o Ministério da saúde deve realizar uma campanha de divulgação maciva sobre autismo com o objetivo de levar conhecimento para a população e, assim, sensibilizá-la em relação ao respeito e aceitação desses indivíduos em seu meio.']",160,160,120,200,160,800
82,Perigo da automedicação,"['Por proporcionar um bem estar  imediato    vários medicamentos passaram a ser utilizados sem prescrição medica,  tal atitude tem demonstrado ser bastante prejudicial tanto para a saúde do individuo como da população de modo geral.', 'Em razão da larga utilização de medicamentos sem acompanhamento medico , vários tipos de doenças, sobretudo bacterianas, passaram a ser combatidas com maior dificuldade,  ]  isto ocorre devido ao tratamento iniciado de maneira incorreta ou não concluído, fazendo com que esses microrganismos  passem a ter resistência a certos medicamentos.', 'Já outros medicamentos    quando utilizados de maneira incorreta   acabam por oculta  doenças graves   levando o individuo a um autodiagnostico  errado de sua real situação, causando em alguns casos a morte.', 'A utilização de medicamentos sem acompanhamento medico  e  muito prejudicial para a sociedade como um todo pois e através  do uso incorreto de remédios  que podem surgir novos organismos de difícil combate.']",120,120,120,120,120,600
63,,"['De acordo com Mahatma gandhi  "" A natureza pode suprir todas as necessidades do homem, menos a sua ganância.""Desde a evolução industrial  o homem intensificou a exploração dos recursos naturais. Seja pelo solo, vento, rio, etc, sempre visando a produção de energia, lucro e a própria satisfação. Essa exploração intensiva resulta em impactos ambientais muitas vezes irreversíveis. Entretanto, existem formas de reduzir e até mesmo evitar tais impactos.', 'Casos de problemas ambientais estão presentes em mais de 90% dos municípios brasileiros, segundo dados divulgados pelo Instituto Brasileiro de Geografia e Estatística (IBGE). O caso ocorrido em Mariana foi um dos de maior repercussão, devido ao rompimento de uma barragem o que gerou impactos socieconômicos e ambientais . Recentemente outra barragem se rompeu em Brumadinho, os dois casos pertencem a mesma corporativa. O problema seria a falta de fiscalização ou a ineficiência na aplicação do código penal? mbos são empecilhos para a prevenção dos impactos ambientais gerados.', 'A falta de fiscalização foi o pivô responsável pela tragedia ocorrida em Mariana, afirma a associação nacional dos peritos criminais (APCE). Em matéria publicada na BBC News Brasil especialistas alertam que a legislação ambiental é boa, mas a fiscalização falha e a punição lenta leva a novas tragedias como a de Brumadinho.', 'Tendo em vista os problemas apresentados  as soluções plausíveis devem surgir do governo, criando um sistema nacional de informação sobre as barragens através de dados disponibilizados pelas impressas, junto a melhores fiscalizações evitando que mais impactos ambientais sejam causados por essas grandes corporações.']",120,160,120,120,120,640
125,Maconha,"['Muito         têm         se falado         na         questão de legalizar ou não a maconha. Muitos defendem e outros são         contra, sobre a         legalização da considerada ""droga leve"", que teria                 várias finalidades                ,         exemplos de uso próprio e para fins médicos         . A legalização só trará problemas para a sociedade.', 'Realmente, muito se          sabem de          benefícios do uso da maconha, que foi constatada sua eficiência de cura total ou parcial de várias doenças, sendo esse o coro feito por médicos a respeito que seja liberada. Mas não podemos esquecer que no caso da legalização a população já usuária só se beneficiaria, tendo em vista que não será mais proibido o consumo e consequentemente o uso aumentaria em grande proporção e ocasionaria um fluxo enorme de ""maconheiros"" nas cidades, colocando em perigo os não usuários, devido que o usuário só          trás          medo para o restante da população.                  Portanto, a lei de legalização da maconha não deve ser aprovada, visando o combate ao tráfico já existente. E que os já usuários podem ter oportunidade de largar esse vício, já que não é fácil, tendo em vista os problemas que a maconha oferece.']",0,80,0,0,0,80
103,(Sem título 062),"['É notório que todos                 os jovens passam por problemas na adolescência                , o que é natural, pois é o período em que questionam tudo o que acontece à sua volta. Sendo o método mais simples, porém não o correto,                 a automedicação permite aliviar essas conturbações.', 'De certo modo, as relações sociais, a convivência familiar, a preocupação em ser aceito, são pontos importantes e necessários na vida de um indivíduo, principalmente para seu equilíbrio psicológico.                 O índice desse problema no Brasil está elevado, mas não o faz a sede dessa prática, pode-se citar como o país da automedicação          o          Estados Unidos, com mais da metade dos jovens envolvidos em conflitos sociais, as doenças psicológicas também favorecem o aumento da mesma, uma parcela dos jovens drogam-se para eliminar o estresse do dia-a-dia, pela pressão de amigos ou por diversão.', 'Portanto,                 deve-se conscientizar                a população de que medicamentos não são a forma adequada de solucionar problemas, que existem consequências em ingerir um produto,         cujo         o corpo não está necessitando,                 e de encaminhar                os indivíduos à um centro especializado, onde         possa         receber o tratamento.']",80,0,80,0,80,240
44,"""Let her run""","['Segundo a associação Internacional de federações de atletismo(IAAF), uma atleta, seja ela trans ou não, deve possuir seu nível de testosterona inferior a cinco nanomols por litro de sangue. Contudo, o grande crescimento no ramo do atletismo trouxe diversas atletas com uma quantidade de testosterona maior que a tolerável pela IAAF. Nesse sentido, a IAAF vem aplicando em suas atletas os exames de forma rígida para detectar o nível de testosterona presente no sangue. Sob tal ótica, esse cenário desrespeita princípios importantes da vida social dessas atletas.', 'Em primeiro lugar é importante destacar que,  uma mulher produz testosterona de forma natural. Devido à alguma alteração genética, as mesmas podem vir a produzir testosterona de forma acelerada, ultrapassando os limites aceitos até pelo próprio organismo. Porém esse problema pode ser contido com o uso regular de medicamentos apropriados.', 'Em segundo lugar, vale salientar que muitas vezes essas mulheres não possuem conhecimento sobre seus altos níveis de testosterona em seus organismos, uma vez que as mesmas não tenham se apropriado de meios desonestos para aumentar esse hormônio e garantir a história em jogos.', 'Depreende-se portanto que uma medida seja tomada para mitigar esse impasse. O governo , por meio de seus representantes, deve realizar campanhas sociais que conscientize o público feminino sobre como controlar seus altos níveis de testosterona no sangue, a fim de extinguir esses conflitos sociais. Espera-se com isso que esse problema seja de uma vez por todas extinto.']",160,160,120,200,160,800
47,educação a distância e exclusão digital,"['Segundo Nelson Mandela”a educação é a arma mais poderosa pela qual se pode mudar a mundo”. Atualmente, com o isolamento social causado pela pandemia do coronavírus os alunos que não possuem acesso internet estão sendo prejudicados, aumentando, portanto, a desigualdade de acesso  educação no Brasil. Sendo assim, é necessário encontrar meios de resolver essa problemática, a fim de garantir um sistema educacional justo e igualitário.', 'O ensino a distância das escolas públicas é,na maioria das vezes, incompleto e incoerente com o ano escolar, em contrapartida ao ensino particular que dispõe de muito mais recursos, aumentando ainda mais os privilégios de alunos de instituições particulares de ensino, principalmente em relação á queles que não possuem acesso internet e outros meios de aprendizagem externos.', 'A saúde mental dos jovens e adolescentes também é um ponto a ser considerado. A dificuldade de aprender os conteúdos e manter uma rotina de estudos é muito maior fora das escolas. Além disso, a escola é o maior meio de socialização de crianças, jovens e adolescentes . O sedentarismo e o acesso exagerado a internet também devem ser considerados como obstáculos à educação distância.', 'Portanto, o governo e o ministério da educação  devem criar projetos sociais, como cotas e bolsas de estudos para alunos que não possuem acesso internet, além de intensificar os projetos sociais feitos para alunos de escola pública. Tendo como objetivo diminuir as desigualdades educacionais existentes no Brasil.']",160,120,120,120,120,640
76,Machismo que subestima até no mercado de trabalho,"['Muito se fala acerca da igualdade entre homens e mulheres. O feminismo é um tema já conhecido para muitas pessoas, amplamente comentado na internet, entretanto, ainda pouco alcançado para muitas mulheres.', 'Sabe-se que homens e mulheres nunca obtiveram igualdade entre si, já que pessoas do gênero feminino sempre foram vistas como inferiores, frágeis destinadas a cuidar de sua famílias e realizar tarefas domésticas. Esta situação permaneceu assim por muito tempo, no Brasil. Porém, as mulheres foram ganhando mais espaço na mídia, mercado de trabalho e até mesmo na política.', 'Com o passar dos anos, algumas coisas mudaram, mas infelizmente muito ainda precisa ser modificado, como o fato das mulheres estudarem mais que os homens e ainda assim, ocuparem os cargos menos desejados, ou muitas vezes, no mesmo cargo, não obterem o mesmo salário. Algo que ocorre no Brasil e não apresenta perspectiva de melhora é a falta de equidade de gênero. É necessário que medidas governamentais sejam tomadas, como leis impedindo que empresas que não promovam a equidade de gênero permaneçam invictas.', 'O preconceito e o machismo ainda são os maiores obstáculos a serem enfrentados pelas mulheres, seja no mercado de trabalho ou mesmo dentro de casa, onde a mulher exerce ao mesmo tempo a tarefa de dona de dona de casa e profissional. E como um ciclo vicioso, o machismo passa de geração para geração, impedindo que a igualdade seja conquistada.']",160,120,120,160,80,640
76,Equidade de gênero,"['Por muitas décadas a desigualdade de gênero esteve presente no cotidiano, de muitas mulher que sempre ficaram prejudicadas por conta de terem sido tituladas como ´´ sexo frágil´´.', 'Apesar de que de tempos pra cá, as mulheres vem cada vez mais conquistando seu espaço no mercado de trabalho e na sociedade. Ocupando a frente de empresas,  grandes negócios  e até mesmo nos campos e,  em produções agrícolas.', 'Tendo mais escolaridade de que muitos homens e diplomas renomados , mesmo assim recebem salários inferiores ao do sexo oposto e não chegam a altura do diploma e capacidade de muitas .', 'Uma grande ajuda e protetora dos direitos das mulheres são as feministas, que estão sempre lutando e protestando a favor dos direitos das mulheres, para que a igualdade seja presente.', 'Não se deve julgar uma pessoa pela gênero, e sim por sua capacidade e competência. Um grande desafio para o Brasil e o mundo e cada a dia que passa e vencido por muitas mulheres, que não aceitam serem consideradas e discriminadas baseado no seu gênero.']",120,80,80,80,80,440
49,O PAPEL DOS INFLUENCIADORES DIGITAIS,"['Conforme Umberto Eco, as redes sociais dão a voz a uma legião de imbecis. Eram calados, mas agora eles têm o mesmo direito à palavra de um Prêmio Nobel. Eco tem uma visão completamente oposta. Para ele, a internet permite que pessoas sem um devido saber fale o que quiser, sem a devida comprovação. Posto isso, a sociedade contemporânea moderna vive uma era de informações , em que todos os cidadãos consomem diversos conteúdos  principalmente os dos influenciadores digitais , que tem como incentivo influenciar outras pessoas, seja no estilo de vida ou consumo de grandes marcas . Mais pode ser um grave problema , principalmente os mais jovens. Com isso o governo junto a sociedade poderiam se posicionar diante dos problemas acerca disso.', 'A priori, destaca-se a grande relevância desses criadores de conteúdo, quando adicionam um valor a marcas, e seu reconhecimento pelo público pode até mudar os padrões de consumo de tal grupo , que os seguem, nas redes sociais. Com o sucesso e o alto número de seguidores, os influencers comandam campanhas publicitárias, muitos estão expandindo suas contas no Instagram aumentando também seu poder de influência no meio digital e garantindo a permanência no concorrido mercado publicitário . Exemplo disso, são as irmãs Kardashian, que possuem um alcance de mais de 150 milhões de pessoas no Instagram. Por isso, essas celebridades virtuais são instrumentos de propaganda para diversas marcas. Enfim, os blogueiros estão sendo cada vez mais utilizados por grandes empresas, ganham produtos e serviços gratuitamente e dissertam sobre os benefícios que terá aqueles que adquirirem. São certamente gigantescos e promovedores do capitalismo, e de vendas online.', 'Ademais, esta é uma nova profissão que tem contribuído para o consumismo exacerbado e a insatisfação pessoal de muitas pessoas. Sendo exibido constantemente um modelo de corpo, relacionamentos e vida decepcionando e idealizando  coisas diferentes da realidade dos seguidores, causando insatisfações e por diversas vezes muitos se endividam , passam por procedimentos arriscados para se tornarem e se sentirem mais próximos do indivíduo que admiram, além de se tornarem cada vez mais dependentes do uso de aparelhos eletrônicos para sempre estar ligados aos perfis dos preponderantes.', 'Portanto, é necessário que os influenciadores digitais se conscientizem sobre o poder de influência que possuem, e utilize de maneira responsável e benéfica. Com isto, marcas patrocinadoras criariam conteúdos mais saudáveis e que ajudariam de alguma forma os seguidores, assim medidas seriam  tomadas. É responsabilidade do Governo junto ao CONAR(Conselho Nacional de Autorregulamentação Publicitária), formular leis para regulamentar a publicidade no âmbito virtual , a fim de diminuir as propagandas que de alguma forma sejam prejudiciais a quem os assista. Além disso, devem avaliar todo conteúdo postado evitando problemas aos usuários das plataformas digitais, e usem como forma de trabalho a fim de terem uma ética modelo a ser obedecida.', 'Ana Beatriz']",160,160,120,160,120,720
125,(Sem título 064),"['Nos dias de          hoje         a maconha é um assunto muito falado                 entre                os jovens,                 onde                esta         ""droga""         virou modinha                 entre         eles, muitos         aderem ao vício para se incluir         a         determinado grupo, outros só por diversão. O tema levanta diversos debates em relação a         legaliza-la         ou não,         pois         como         sabemos         a         ""erva""         pode ser utilizada tanto para fim         medicinais         como para saciar         um         vício de um dependente. Para diversas         pessoas         se         legalizada         a maconha                 será aderida na sociedade como mais uma forma de maquiagem do governo                , pois assim dizendo,         legaliza-la         seria o mesmo que tratar os dependentes como caso de saúde pública e não caso de         polícia, já         para outros a maconha                 é comparada ao          cigarro          por exemplo,                  não faz nenhum mal. Por fim, deveríamos instruir a sociedade para que independente da escolha feita de legalizar ou não a droga já saberíamos o que fazer.']",120,120,80,80,0,400
92,O preconceito amarelo no atual cenário brasileiro,"['Na série de televisão brasileira “Malhação: viva a diferença”, a personagem de origem japonesa, Tina, sofre do preconceito amarelo. Termos como “japa” são constantemente usados para se referir à personagem. Em consonância com a realidade de Tina, está a de muitos indivíduos nascidos ou descendentes de asiáticos, que sofrem desse preconceito. Nesse sentido, cabe ainda ressaltar que, durante a pandemia de covid-19, houve o aumento dessa ação discriminatória, visto que, com o aparecimento inicial do vírus na China, juntamente com a propagação de notícias falsas, muitos indivíduos passaram a associar o surgimento do vírus com a população asiática. Decorrente a isso, nota-se o agravamento do preconceito amarelo na sociedade brasileira. Isso ocorre, seja pelo engajamento de notícias falsas, seja pelas atitudes intolerantes de grande parte da população . Dessa maneira, é imperioso que essa chaga social seja resolvida, a fim de que haja mais respeito entre os indivíduos e que esse preconceito seja extinto.', 'Nessa perspectiva, acerca do preconceito amarelo, nota-se que, as informações deturpadas influenciaram as ações discriminatórias durante a pandemia da Covid-19. Com isso, constata-se inúmeros crimes contra a honra, tais como injúria e difamação, que foram cometidos contra a população asiática em meio às redes sociais, ao se relacionar a origem do vírus com os indivíduos vítimas do preconceito amarelo. Desse modo, é clar a oportunidade que essas notícias falsas podem criar ao influenciar comportamentos preconceituosos contra a população asiática.', 'Paralelamente, a esse fato, nota-se também as atitudes pautadas na ignorância de parte da população, sejam por meio de apelidos pejorativos, atitudes de violência verbal ou física. Retomando o exemplo da personagem Tina, considerando o âmbito não fictício, a atriz Ana Hikari,  trouxe tona variadas atitudes discriminatórias que sofreu, especialmente no cenário atual. A atriz descreveu as ações de preconceito amarelo a qual foi submetida, sendo chamada de ""vírus"" e de ""japa"". Logo, é visível a presença do preconceito amarelo na sociedade brasileira.', 'Portanto, medidas são necessárias para resolver o impasse do preconceito amarelo no Brasil, a fim de que se impeça a exclusão e as ações pejorativas, e haja mais respeito e igualdade entre os indivíduos. Para isso, compete ao Ministério da Justiça e Segurança pública, juntamente com o Ministério da Cidadania, promover políticas públicas de inclusão da população amarela , além de garantir o direito à igualdade e ao respeito, seja através de punições ou multas aos infratores. Assim, o preconceito amarelo poderá ser combatido, e finalmente,  esse cenário discriminatório não será a realidade de muitos indivíduos, tal como a atriz Ana Hikari e sua personagem, Tina.']",160,160,160,200,200,880
91,Os impactos do negacionismo científico na sociedade,"['O negacionismo científico hoje  é algo muito presente na sociedade, a maioria das pessoas acham que se ignorarem os problemas eles sumirão. Mais não é tão simples assim, as consequências são diversas como se pode notar no cenário atual do nosso país . Essa rejeição da realidade causa nas pessoas uma falsa sensação de estabilidade ou até mesmo de que não existe nenhum problema.', 'O negacionsmo científico pode comprometer o futuro do Brasil, como por exemplo o desprezo e o desinteresse científico sobre os efeitos destruidores que a epidemia está causando no mundo a fora, gerando inúmeras mortes todos os dias. Mais o que fazer quando uma doença tão séria vira motivo de deboche para o então presidente e sendo negligenciada pelo governo ?', 'Infelizmente o negacionismo vem ganhando cada vez mais espaço na sociedade e quase não se vive os fatos, mas por qual motivo as pessoas insistem em negar a ciência ? A resposta não é tão difícil. Para que se entenda as explicações científicas requer um conhecimento mais detalhado, com mais pontos a serem entendidos, porém as pessoas preferem acreditar nas fake news que veem nas redes sociais.', 'Existem diversas situações em que o nagacionismo científico está presente em nossa sociedade, mais esperamos um dia que o país viva de fatos.']",160,120,120,120,0,520
66,,"['""Geração Z"" é um termo sociólogo para intitular as pessoas que nasceram nos anos de 1988 a 2010. Tal expressão está ligada com o avanço da tecnologia na modernidade. Contudo, apesar dos grandes benefícios que o mundo tecnológico propiciou, a internet trouxe problemáticas como a manipulação do comportamento de seus usuários, necessitando, então, de ações para resolver o impasse.', 'Inicialmente, cabe ressaltar o fato de que muitos indivíduos carregam uma falsa ideia de liberdade. Nesse sentido, eles acham que possuem total controle de suas escolhas ao navegarem na internet. Tal percepção está totalmente errada, visto que nos grandes sistemas de computação ocorre uma filtragem dos dados do aparelho que, em seguida, é personalizada de acordo com as preferências de cada pessoa.', 'Além disso, é notório que o conforto que a internet trouxe fez com que as pessoas não se sintam mais na obrigação de verificar o conteúdo que elas acessam. Nessa perspectiva, é ainda mais provável que ocorra uma certa alienação que afetará o pensamento e, consequentemente, o comportamento de seus usuários. Logo, enquanto a sociedade não reconhecer que o meio tecnológico possui desafios, a globalização será obrigada a viver com um grande problema: a manipulação.', 'Urge, portanto, que o Governo Federal crie políticas públicas para revisar os sistemas de computador e de celular  a fim de que esses sejam incapazes de alterar, de alguma forma, o comportamento de seus usuários. Ademais, cabe às escolas criarem palestras sobre o tema ""Os limites da internet na construção da sociedade""  mostrando e alertando a manipulação que pode ocorrer no âmbito das redes. Com essas medidas, a tecnologia continuará em alta na contemporaneidade, porém, agora, sem os problemas referentes à manipulação.']",160,160,120,120,120,680
78,Reforma não só no ensino médio mas também nas escolas,"['É notório que a reforma do ensino médio no Brasil traz divergências de opiniões, principalmente em movimentos sociais e entidades ligadas à educação (. Dentre tantos fatores, relevantes destacam-se:aspectos favoráveis e contrários para a melhoria da qualidade de ensino do país .', 'Sabe-se que á ) reforma do ensino médio vem para favorecer , . Segundo índice de desenvolvimento da educação básica (IDEB) 1,7 milhão dos jovens de 15 a 24 anos nem estuda, nem trabalha e o desempenho em português e matemática e menor hoje do que em décadas atrás.', 'Tantas vezes, mau remunerados, nem um pouco incentivados e escolas com poucas estruturas para poder o estudante ter uma educação de qualidade. De acordo com Immanuel Kant filosofo, o ser humano e aquilo que a educação faz dele .', 'Portanto, medidas são necessárias para resolver o impasse. Diante disso, antes mesmo de se propor uma reforma de tamanha grandeza, o ministério da educação (MEC) juntamente com a receita federal do Brasil (RFB), movimentos sociais e professores da categoria, discutir mais a respeito da reforma, por melhorias nas escolas, que muitas não tem se quer estrutura para poder suporta carga integral, o (RFB) que faz o recolhimento de tributos, implementar uma porcentagem de imposto recolhidos da população, usar em estruturas para escolas e implementação de tecnologia de qualidade, já que a carga horaria vai ser aumentada gradualmente no ensino, para que não fique um dia-a-dia  desgastante para o professor e o aluno e por último reajuste de piso.']",80,120,120,80,80,480
44,A mulher da atualidade,"['As mulheres da atualidade do nosso século 21 , são muito guerreiras . A um tempo atrás mulheres eram proibidas de fazer muitas coisas,de ter certos tipos de trabalhos até mesmo não podiam participar da política .', 'Com o passar do tempo essas mulheres foram quebrando barreiras ,hoje elas pode trabalhar ,participar da política,existem até algumas delas que são chefe de família. Mas o principal desejo das mulheres que viveram no passado , era de ter a própria liberdade .', 'Na atualidade todas elas tem por lei seus direito. Hoje elas podem dizer valeu a pena lutar pelos nossos diretos .']",120,80,80,80,0,360
45,"Abuso, não!","['De acordo com Aristóteles, ""A base da sociedade é a justiça"". Entretanto, o contexto do Brasil do século XXI contraria-o, uma vez que o abuso de autoridade prejudica a população e demonstra-se como uma questão de injustiça, assim, desestrutura a base da sociedade brasileira . Sob esta perspectiva, cabe avaliar os fatores que favorecem este quadro como a insuficiência legislativa e a irresponsabilidade de autoridades.', 'Em primeiro plano, é imprescindível ressaltar que a falta da severa atuação das leis colabora para a permanência do problema. Segundo o filósofo John Locke, as leis se fizeram para os homens e não para as leis. Sob esta ótica, percebe-se que ao criar uma lei é preciso que ela seja planejada para melhorar a vida das pessoas em sua aplicação. No entanto, na questão do abuso de poder a legislação não tem sido suficiente quando algumas autoridades praticam atos ilegais e não são punidas por possuírem cargos importantes ou por serem autoridades. Conforme publicado no portal da UOL, um guarda civil foi humilhado por um desembargador quando desempenhava sua atividade, sendo essa uma autoridade que já possuía em sua ficha mais de 40 procedimentos de apuração disciplinar, demonstrando que as punições não têm sido efetivas, uma vez que o problema persiste.', 'Ademais, a irresponsabilidade é outro fator que dificulta a resolução da problemática. Em conformidade com Sartre, importante pensador, cabe ao ser humano escolher seu modo de agir, pois este seria livre e responsável. No entanto, percebe-se a irresponsabilidade de algumas autoridades quando estas atuam fora de sua competência ou quando praticam atos visando seus próprios interesses e não o bem estar da sociedade, que por vezes depositou a confiança nestas. Desse modo, é preciso reverter este cenário que contraria o interesse público.', 'Portanto, medidas devem ser tomadas para resolver o abuso de autoridades no poder. Para isso, o Ministério da Justiça deve promover a efetivação das leis, para que esta seja aplicada a todos os indivíduos, sem nenhuma distinção, por meio de punições severas aos transgressores, a fim de restringir tal atuações e defender os interesses da sociedade. Nesta ação seria importante incluir que os envolvidos praticassem serviços voluntários em ONGs . Somente assim, será possível buscar a justiça defendida pelo filósofo Aristóteles.']",200,200,160,200,160,920
64,,"['Muito se discute sobre a falta de informação entre os jovens em relação ao sexo, o que está a se tornar algo bastante comum em nossa  sociedade moderna . Os altos riscos de doenças sexualmente transmissíveis  e a gravidez indesejada está cada vez maior. Portanto, é importante a educação sexual nas escolas e em casa, pois, é através das informações transmitidas aos filhos e alunos que os dados recorrentes, apresentados na sociedade, baixa.', 'Em um mundo tecnológico, os jovens e adolescentes, em busca de informação, buscam conhecimentos, às vezes, de forma errada nas redes sociais ou amigos próximos, enquanto podiam buscar estas devidas informações com seus familiares . No entanto, a internet pode fornecer fontes erradas ou não confiáveis, o que acaba transmitindo assuntos inadequados para cada fase do desenvolvimento do jovem.', 'O ensino da sexualidade na escola esclarece a importância de se preservar ao entregar o seu corpo a alguém, visando assim, ajudar jovens e adolescentes a serem cuidadosos com o próprio corpo. Por outro lado, é dever dos pais informar seus filhos sobre o sexo, para evitar, assim, devidos problemas inconvenientes.', 'Tendo em vista os argumentos apresentados, é possível concluir que, o Estado e os outros meios de educação, devem apresentar sociedade jovem sobre os devidos meios de se preservarem e cuidarem de seus próprios corpos, para que assim, venhamos  ter saúde, podendo assim, levar uma sociedade saudável.']",120,120,80,120,80,520
87,A erotização infantil,"['É de conhecimento geral que a erotização infantil é uma ação que atualmente está se tornando bem comum no Brasil, com as crianças entrando cada vez mais em contato com o mundo adulto, e assim acabam ""querendo"" se tornar um adulto gradativamente cedo, de forma física ou mental.', 'As crianças por serem seres que ainda estão aprendendo enquanto crescem, podem acabar entrando no mundo erótico cedo. Sem o devido cuidado com os meios em que a criança pode encontrar as informações eróticas, como imagens ou texto, elas podem acabar se interessando no assunto e se não forem repreendidos pelos familiares desde cedo, pode acabar se tornando algo comum para o menor a ponto de mexer com o seu psicológico . Crescendo desta forma a criança pode não ter uma base de senso comum e ter um comportamento precoce quanto a suas relações com outras pessoas, o que é um perigo, para ela uma brincadeira como ""casinha"" já não seria algo tão infantil e alguém poderia acabar se aproveitando disso , como por exemplo outras crianças no mesmo estado e até mesmo adultos com mentes maliciosas. Se a criança crescer assim, ela poderá ter muitos problema psicológicos quando maior, como por exemplo desenvolver a depressão.', 'Concluindo, da pra perceber que crianças são seres frágeis e com mente geralmente fraca, dependendo do ambiente em que cresceu ela pode correr grande risco de ir para o mau caminho. É necessário sempre prestar bastante atenção nas crianças para que a erotização seja impedida, tanto em casa quanto na escola e na rua.']",160,120,120,120,120,640
33,Artes e educação física,"['As disciplinas de artes e educação física são, de certa forma, fundamentais para a formação de um indivíduo, seja para ajudar a desenvolver senso crítico sobre um determinado assunto, ou para despertar certo interesse dos alunos sobre o esporte.', 'A disciplina de artes, assim como outras, não pode ser desvalorizada somente por não haver interesse por parte dos alunos e do governo. É através dela que conhecemos um mundo que nos ajuda a entender um pouco mais sobre como surgiu diversos tipos de cultura, artes e expressões.', 'Já quanto à disciplina de educação física, como seria possível a descoberta de novos talentos no esporte, senão por meio da própria disciplina? É na escola onde, garotos e garotas carentes, tem a oportunidade de praticar aquilo que realmente gostam de fazer, e mostrar seus potenciais em diversas modalidades do esporte.', 'Artes e educação física são, portanto, importantes para o currículo dos adolescentes do ensino médio. O governo não pode simplesmente extinguir essas duas disciplinas, sem antes fazer uma profunda reflexão sobre o quão importante são essas matérias para os alunos que estão cursando o ensino médio.']",120,120,80,120,80,520
86,I.D.U.D.R.S.N.S.M.,"['Durante a exibição da novela ""Chiquititas"",produzido no canal televisivo SBT,é retratado em um de seus episódios como o uso exagerado das redes sociais impacta negativamente no comportamento das crianças, haja vista que as personagens não estavam nem praticando exercícios físicos e nem comendo regularmente. Não distante da televisão, a questão das redes sociais também traz consequências à população brasileira, uma vez que a sociedade do século XXI, encontra-se ""presa virtualmente"" ao uso excessivo da internet. Logo,é imperioso notar que uma das causas da questão é a formação familiar,que tem como consequência um prejuízo imenso à saúde mental das famílias.', 'Inicialmente, vale salientar que a construção familiar em relação à conjuntura abordada é um de seus agravantes. Nesse sentido,Karl Marx, notório filósofo, afirma que a desvalorização do mundo humano aumenta em proporção direta com a valorização do mundo das coisas. Sob essa perspectiva, torna-se evidente que o pensamento do filósofo está conectado ao que está sendo vivenciado no país, já que o mundo virtual,infelizmente,na modernidade,é mais venerado que as relações afetivas de uma família,sendo essa valorização ocasionada pela falta de atenção por parte dos pais em relação ao tempo que os filhos estão conectados virtualmente.', 'Consequentemente,ocorre um prejuízo na saúde mental tanto dos filhos quantos dos país,que usam a internet massivamente em detrimento do coletivo familiar. Nesse sentido,o conceito de Indústria Cultural,oriundo da Escola de Frankfurt,descreve que a produção de mercadorias está baseada em estereótipos socialmente construídos. Sob tal olhar,constata-se de maneira nítida que a mídia ao promover comportamentos idealizados em suas redes  acaba afetando a população,tendo em vista que o indivíduo procura-se inserir nesse cenário ideal,o que,no entanto,pode ser difícil de ser almejado,gerando transtornos psicológicos no ser humano, Sendo assim, uma forma de amenizar o óbice é imprescindível.', 'Diante do supracitado,urge que o governo federal  deve criar um documentário que relate sobre as consequências do assunto,por meio da opinião de especialistas,como por exemplo, psicólogos e médicos, com o fito de esclarecer para as pessoas a relevância que a saúde mental tem em suas vidas,o que,possivelmente,gerará uma melhora nos hábitos da população acerca das redes sociais. Dessa forma,a sociedade poderá progredir.']",160,200,160,200,160,880
13,Com o poder nas mãos,"['Após as eleições presidenciais de 2018, ficou claro que as políticas de segurança públicas seriam intensificadas. E seguindo nesta linha, uma das políticas mais importantes é a flexibilização do porte de armas de fogo.', 'Anos atrás, passamos por um referendo popular no qual optamos pelo direito de comercializar armas de fogo. Mas, o estatuto do desarmamento, dificultava ou quase que impossibilitava ao cidadão de ter a posse de tal bem em casa ou em seu comércio, tirando assim sua oportunidade de defesa.', 'Vivenciamos, em 2018, um processo eleitoral muito conturbado mas democrático e legítimo. E foi dada assim,  a chance de todos os brasileiros escutar e analisar as propostas dos diversos candidatos. Uma destas propostas, justamente do candidato eleito, era facilitar o acesso da população as armas, seguindo alguns critérios estabelecidos como treinamento e teste psicológico.', 'A flexibilização do porte de arma foi uma vitória, tanto do novo governo quanto da população de bem deste país. Agora cabe a ambos preservar este direito alcançado e legitimá-lo com ações e políticas sobre as questões dos riscos e responsabilidades.']",120,80,120,80,80,480
15,Causas e soluções relacionadas a  epidemia alimentar.,"['Ao se propor uma reflexão sobre o índice crescente de sobrepeso e obesidade na escala de doenças atuais, verifica-se a necessidade de conter esse crescimento. Nesse sentido , é necessário analisar as causas e as soluções a fim de se combater essa epidemia .', 'É preciso avaliar, primeiramente, que a obesidade é uma doença causada não apenas pelo excesso de alimentos consumidos, mas também, por questões hormonais e psicológicas envolvidas . Atualmente, no mundo capitalista, onde o acesso a alimentos industrializados é mais rápido e de fácil aquisição, adultos e crianças se tornam vítimas da obesidade e sobrepeso pelo consumo constante desses alimentos de alto níveis calóricos e prejudiciais à saúde. Além disso, o estresse e alterações hormonais de difícil diagnóstico são exemplos da compulsividade alimentar que geram o sobrepeso e, através dele, problemas de saúde e aceitação diante da população, principalmente pelos padrões de beleza preconizados nas mídias.', 'Outro ponto que merece destaque são as soluções para se combater essa epidemia. É preciso uma reeducação alimentar em escolas e ambiente familiar com o intuito de expor a necessidade de uma alimentação mais saudável. Ter um acompanhamento psicológico é essencial na inclusão do tratamento aos obesos, além de priorizar consultas médicas que visem diagnosticar e solucionar alterações hormonais através de campanhas educativas e inserção de programas governamentais vinculados tanto na preservação quanto na recuperação desses pacientes.', 'Verifica-se, portanto, que o sobrepeso e a obesidade são questões de saúde pública e merecem atenção dos governantes. Afinal, obter hábitos alimentares corretos resultam em uma vida mais saudável e assim diminuem os custos com doenças secundárias como a hipertensão, diabetes tipo II, esteatose hepática dentre']",160,160,160,160,120,760
146,Banalização da indignação racial,"['No final do         dia em casa         ao ligarmos a TV, acessarmos a internet ou escutarmos o         rádio         deparamo-nos com reportagens e situações         que tornaram-se cotidianas relacionadas ao racismo         . Seja em uma partida de futebol do campeonato Europeu, no atendimento de uma pessoa ""mal vestida"" em um restaurante, na exclusão social de um aluno em sua classe... diversas são as situações de racismo.                 Até quando vamos encarar isso como uma ferida social que merece cuidados?', 'Se procurar em um dicionário a palavra         racismo         provavelmente encontrará que racismo é a convicção sobre a superioridade de determinadas raças, com base em diferentes motivações. Ou seja, todos         nos         estamos sujeitos ao racismo. Ferida que pulsa desde                 as dominações de impérios                ,         a qual         os inimigos eram feitos escravos do vencedor, tornando-se um modo de impor o poder sobre os devastados; arrastou-se pela colonização do Brasil com os índios, no continente         Africano         com os negros,                 na segregação de negros, judeus e homossexuais na segunda guerra com o nazismo                , entre outros eventos.                 O próprio ser humano usa-o como instrumento de imposição de sua suposta superioridade que devasta várias          geração          mudando apenas os seus supostos motivos de imposição.', 'O Estado brasileiro possui várias ferramentas que ajudam a coibir esse tipo de crime. A Constituição Federal traz em seu art. 5° que todas pessoas são iguais perante a lei,         ampliando         os direitos fundamentais a todos, indistintamente. O Código Penal brasileiro em seu art. 139° diz que quem difama alguém imputando-lhe fato ofensivo à sua reputação, honra objetiva, está sujeito a sanção penal e o art. 140° fala que quem injuriar alguém ofendendo-lhe a dignidade ou decoro, honra subjetiva, responderá a ação penal. A lei n° 7716/89 define os crimes resultantes de preconceito de raça ou de cor com suas respectivas penas. Tudo isso foi criado para favorecer um Estado social igualitário, penalizando quem usa o preconceito para se impor diante dos outros.', 'Infelizmente em nossa sociedade evoluída, ainda presenciamos, como         expectadores         ou vítimas, cenas de exclusão e depreciação de outras pessoas. Talvez uma falta de interesse público, na cobrança da lei, ou a banalização do tema racismo na sociedade         tem contribuído         para sua perpetuação. Não bastar indignar-se com a reportagem ou a notícia de um ocorrido sobre o racismo, falta o dever de agir em nosso dia a dia diante de situações como essas usando as ferramentas que o         estado         disponibiliza para seu combate.']",160,200,160,160,200,880
93,Parto humanizado,"['O nascimento é um acontecimento singular da vida; um momento em que ocorre a aproximação de uma mãe e de seu recém-nascido através do compartilhamento de emoções afetivas entre ambos. Isto posto, compele fazer-se um questionamento: a priorização de um método de parto em que essas interações ocorram - em detrimento a outros métodos menos humanizados -, não é uma questão de saúde pública?', 'Quando analisa-se nacionalmente esta questão, observa-se que o Brasil está longe de ser o exemplo ideal com relação implementação deste método à saúde pública. Dados demonstram que há falta de unidades especializadas neste tipo de procedimento, bem como há falta de interesse do Poder Público de introdução destas mesmas ao Sistema Único de Saúde.', 'O baixo envolvimento das autoridades políticas e sanitárias neste tema demonstra, para além disto, um desatino social entre as atribuições do Poder Público e os direitos individuais da mulher, resultando no desestímulo do aperfeiçoamento e da implementação deste método.', 'É mister enfatizar, portanto, que mais do que nunca faz-se necessária a participação popular na requisição e na cobrança da implementação bem como no aperfeiçoamento deste método pelo Poder Público, haja vista que esta é uma questão pública, que embasada em diversos apontamentos técnico-científicos, demonstram ser benéfica a sua implementação em procedência à saúde da mulher. De igual modo, compete a este, o Poder Público, visar e empenhar suas ações nas necessidades requeridas pela sociedade, tal como delimitado essencialmente em suas atribuições basilares. Por fim, a incrementação deste método resultará, sem sombra de dúvidas, no aprimoramento da saúde pública no Brasil, bem como, para fins sociais, no aprimoramento dos direitos individuais da mulher.']",160,120,120,160,120,680
46,Acesso ao saneamento básico,"['A Constituição Federal de 1988 assegura a todos os indivíduos o acesso ao saneamento básico. No entanto, na prática, tal garantia é deturpada, visto que esse direito, indispensável para a saúde da população, é precário em zonas rurais e periféricas. Assim, uma possível privatização do saneamento básico restringirá ainda mais a saúde no Brasil. Isso ocorre devido a má distribuição de renda e a negligência governamental.', 'Em primeira análise, a desigualdade de renda corrobora para a elitizacão do acesso ao saneamento. Segundo a ONU , o Brasil está em segundo lugar em concentração de renda nas mãos de poucos . Visto isso, fica claro que privatizar tal serviço agravará a desigualdade social e o tornará ainda mais restrito, uma vez que, nas mãos de empresas privadas, os impostos crescerão cada vez mais e a população carente não terá condições de arcar com as despesas.', 'Além disso, é irrefutável o descaso governamental na resolução do problema. De acordo com o SNIS 2017 (Sistema Nacional de Informações sobre Saneamento), o Brasil tem 48% da população sem coleta de esgoto, esse dado mostra como a gestão brasileira é ineficaz na democratização de serviços essenciais. Mas privatizar não solucionará o problema do povo, apenas beneficiará a geração de lucro, e sacrificar a saúde a qualquer outra vantagem é o maior erro do homem , assim como afirmava Arthur Schopenhauer.', 'Entende-se, portanto, a necessidade em democratizar o saneamento básico. Para tanto, o Estado , através do Ministério da Saúde, deve expandir o alcance dos serviços de esgoto, de água, de coleta de lixo e limpeza pública para zonas rurais e periféricas com o auxílio da prefeitura de cada região, onde os prefeitos devem fornecer um relatório sobre a atual situação para que possa ser analisada e redirecionar as verbas governamentais para a resolução do problema a fim de popularizar o acesso ao saneamento básico. Assim, a população verá o direito constitucional como uma realidade próxima.']",160,200,160,200,160,880
50,a preocupação de todos,"['Nos últimos dias o mundo vem enfrentando  um problema seríssimo contra a Covid-19 mais conhecida como novo coronavírus, oriunda da hina, gerado a partir de uma mutação laboratorial.; no qual o mesmo  trouxe também uma serie de problemas a ser enfrentados por todos.  Por exemplo a crise econômica mundial, onde gerou inúmeros desempregos pelo mundo.', 'Cientistas e especialistas vêm tentando  achar a solução para eliminar o vírus o mais rápido possível, pois, de acordo com Ministério da Saúde foi ceifado aproximadamente um milhão de vidas no planeta. Deixando assim a população cada vez mais espantadas com a pandemia. O mundo todo inclusive profissionais da saúde preocupa-se com a doença, uma vez que,  o tratamento ideal para combater a mesma  não foi encontrado. Mas, a ciência e a tecnologia não desiste de tentar encontrar o recurso terapêutico para arrematar a Covid-19.', 'O governos de todos os países tem adotado e imposto medidas de prevenção para a população, uma das tais medidas é a quarentena, ou seja, o isolamento social. O mesmo também tem destinado fundos para o combate a doença.', 'Sobretudo, a ciência tem desenvolvido um papel importante para todos, pois, a cura de milhares de doenças que existem no planeta foram descobertos pela mesma ; ou seja; ela possui um imensa importância para a sociedade no geral. Por exemplo, a própria, juntamente com a tecnologia descobriu que a cloroquina o remédio da malária serviria para ajudar a combater a pandemia . Depois de diversos experimentos a mesma observou que o remédio que trata a AIDS seria mais eficaz do que a cloroquina.', ""Sendo assim, pode-se dizer que todas as coisas precisam ser baseadas na ciência, ou seja, no conhecimento. segundo Isaac Asimov ''o aspecto mais triste da vida de hoje é que a ciência ganha em conhecimento mais rapidamente que a sociedade em sabedoria''.""]",120,120,80,120,0,440
89,Um choque de realidade,"['Vivemos em uma situação pela qual nos obriga a repensarmos nossas atitudes e valores diante da sociedade. Interrompermos nossas rotinas corridas, diminuindo a velocidade pela qual levávamos nossas vidas, é algo que exige muita postura e maturidade diante de uma nova realidade complicada . A pandemia originada pelo avanço do coronavírus, hoje denominado como C-19, foi o termo principal que nos mostrou o quão pequenos somos e como não temos controle sobre nada, incluindo o nosso amanhã.', 'Em meio a uma sociedade capitalista, onde se é mais bem valorizado o ""ter""(dinheiro) em comparação ao ""ser"", vivemos um grande desafio quando se trata de pararmos todas nossas atividades para darmos prioridade à nossa saúde e de todos em nossa volta. O Covid que atingiu uma escala mundial significativa de diagnósticos e mortes, nos exige a compreensão de sua fácil transmissão através de gotículas despejadas que são absorvidas no corpo por meio do toque das mãos em um objeto ou local infectado sendo transmitido nos olhos, nariz ou boca.', 'O coronavírus foi prejudicial sim para a economia global, a medida tomada que corresponde ao isolamento social e a paralisação de empresas industriais, de meio de transporte, de organização de eventos, lojas, pequenos e próprios negócios foram diretamente atingidos. Onde no Brasil por exemplo, gerou ainda mais o desemprego e também dificuldades para aqueles que lutavam todos os dias para pôr alimento na mesa de sua família.', 'Com isso, ainda há aqueles que acreditam ser uma grande farsa criada pela mídia por conta desta doença não trazer um rótulo, ou seja, ela pode variar seus sintomas e complicações independente da faixa etária e saúde da pessoa. E justamente por isso que devemos dar mais importância às formas de prevenção sobre a contaminação deste vírus. Pois a situação já se encontra em emergência. Resultando em falta de UTI , esgotamento físico e psicológico aos agentes da saúde que se encontram tendo muitas vezes de selecionar vidas, e principalmente para que haja a diminuição nos números de morte de pessoas pelas quais têm sua jornada interrompida pela dor e tristeza de uma situação assim.', 'Por meio dos fatos mencionados é visto que sim, precisamos urgentemente começar a darmos valor vida, através de toda forma de prevenção, incluindo o uso de máscara, álcool em gel e principalmente o isolamento social. Três coisas que mesmo por sua simplicidade, devem ser levadas mais a sério, pois são elas quem irão garantir um futuro reencontro com direito a muitos abraços com aqueles que tanto amamos e queremos ver acima de tudo, muito bem.']",160,120,120,160,80,640
108,Sim ao consumo consciente,"['A base do atual sistema econômico mundial é o consumo e, para isso,         desenvolve-e os         meios de se vender um produto, seja com o marketing excessivo ou com facilidades garantidas pelo governo.', 'É evidente que o papel da mídia em influenciar o consumidor é o mais impactante, porém, o ambiente familiar e a falta de informação também são fatores que contribuem diretamente na formação de um perfil psicológico voltado para as compras.', 'Embora sejam comumente destacados os pontos negativos do                 consumo exagerado, é necessário enfatizar que essa atividade é a principal responsável pelo aquecimento do mercado interno brasileiro                e principal motivo do aumento da qualidade de vida e desenvolvimento econômico do país.', 'Sendo assim, seria necessário                 implantar um projeto de educação financeira que          atue juntamente com psicólogos         a fim de                 formar cidadãos que aqueçam o comércio para manter suas necessidades e qualidade de vida.']",160,120,80,120,120,600
118,Experiências com animais justificam a violência nas manifestações?,"['Os atos de protesto no mês passado, contra a utilização de animais em pesquisas, despertaram diversas opiniões entre a população de quase todo o país. Isso, pelo fato de grande parte não concordar com o                 uso dos cães nas pesquisas do instituto                e ainda pelos atos de vandalismo que, mais uma         vez         foram feitos pela atuação dos black         blocks         infiltrados na manifestação que inicialmente seria pacífica.', 'Primeiramente, vejamos que os animais que foram retirados do         instituto, não         apresentavam sinais de maus tratos físicos, como         justificam         os ativistas. Foi possível perceber         esta questão         já que todo o ato da retirada dos bichos foi filmado. Em contrapartida, após dois dias do         fato         , alguns animais “resgatados” foram encontrados abandonados nas ruas da cidade de         SP         . Os pesquisadores não cometiam nenhum crime, já que no Brasil é permitido o uso de espécies de animais para pesquisas.', 'Vemos ainda         que, novamente o tumulto e a depredação,         mancharam a imagem do protesto que de início foi pacífico e que, além disso, deixaram pessoas feriadas e outros até foram detidos. Tudo isso porque os grupo dos black         blocks         se infiltraram         aos         manifestantes e cometeram estes atos de violência sem necessidade.', 'Sendo assim, é necessário que antes de                 realizar o protesto analise-se o seu real motivo para          que, os          atos não sejam banalizados                . Os manifestantes deveriam saber, antes de invadir propriedades particulares, que existem nas         ruas, muitos         animais,                cães e gatos, abandonados que         sofrem, sem         alimento e sem água. Seria mais                 viável                se a manifestação fosse em prol         destes         .']",120,120,80,80,0,400
89,A CRISE,"['De acordo com Aristóteles ""A base da sociedade é a justiça"". Entretanto, o contexto do Brasil do século XXI contrária-o, uma vez que a crise econômica do isolamento demonstra-se questão de injustiça, o que desestrutura a base da sociedade brasileira. Nesse contexto, torna-se evidente como causas a falta de investimentos, bem como o desemprego.', 'Em primeiro plano, é preciso atentar-se para a falta de investimentos, presente na questão. De acordo com o Antropólogo Montogazza ""A ciência é o melhor instrumento para medir nossa ignorância"". Como demonstra essa perspectiva, a pesquisa científica é essencial para diagnosticar problemas chegar em seus detalhes como o caso da vacinação contra o Covid-19. Assim como há uma boa base de investimentos em ciência, no que se refere o problema, dificulta-se sua erradicação.', 'Além disso, outra dificuldade enfrentada é a questão do desemprego. No entanto, sem infraestrutura não há como atuar na questão da falta de emprego, que encontra-se de força escassez . Assim, a priorização do dinheiro em outros setores, a não ser na vacinação dos autônomos, que situa-se como forte empecilho já intervenção do problema.', 'Logo, medidas estratégicas deverão ser tomadas para alterar este cenário. É fundamental, que o residente, juntamente com a Organização Mundial da Saúde e Instituto Butantan, reveja o plano de vacinação, priorizando não os idosos, mas sim os comerciantes que precisam ganhar o seu sustento. Deve-se passar ainda, a orientação, para que os idosos permaneçam em suas casas, já que grande parte dos mesmo são aposentados. Desta forma, Brasil sairá desta crise econômica.']",160,120,120,160,120,680
43,Lixamento virtual,"['O ator hollywoodiano Johnny Depp sofreu uma série de ataques nas redes sociais devido a acusações de agressão física feitas pela sua ex-esposa Amber Heard. De petições para a exclusão do ator em vindouros papéis no cinema a desvalorização de seus personagens e sua filmografia, o astro se viu “cancelado” dentro das mídias de entretenimento. No entanto, com o decorrer do caso na justiça, alguns fatos deturpados foram esclarecidos e um debate começou a surgir na internet sobre como a agressividade inerente à natureza humana e a crescente visibilidade de pessoas má intencionadas compõe os males dessa prática.', 'Em um primeiro ponto, é necessário enfatizar o senso de justiça violento intrínseco ao caráter humano. Para o filósofo Luiz Felipe Pondé, os internautas, com o argumento de criar um ambiente totalmente purista, transpassam para a atualidade cenários análogos aos da idade média no qual comumente eram feitos lixamentos de indivíduos para que fosse sanado um critério deturpado de justiça, inviabilizando dessa maneira o acusado de amadurecer e contemplar novas interpretações de determinadas pautas.', 'Nesse sentido, um dos maiores contribuintes para o aumento dessa problemática tem sido a crescente visibilidade de pessoas mal-intencionadas nas redes sociais. É perceptível que independente da influência de dado indivíduo gerador de determinada discussão, o engajamento advindo dos seus argumentos, sendo saudáveis ou não, pode acabar viralizando e polarizando um conjunto de ideias que tendem a conceber certas atitudes como negativas ou até mesmo imperdoáveis. À vista disso, aumenta-se a frequência com que rotulações são feitas figuras públicas, visando diminuir seu local de fala, seu trabalho ou até mesmo sua pessoa, como foi o caso de Johnny Depp.', 'Portanto, medidas devem ser tomadas no que diz respeito essa problemática. Assim sendo, cabe às redes sociais como Facebook, Instagram e principalmente Twitter, por ser o canal preponderante no que concerne o aumento da visibilidade de determinadas “ações de cancelamento”, desenvolverem novas ferramentas de denúncia através de seus dados meios de comunicação que visem policiar de maneira efetiva e específica, mobilizações feitas no intuito de acarretar malefícios à vida pessoal ou carreira pública de dado indivíduo. Dessa forma, seria possível mitigar os atos e campanhas de caráter nocivo nas redes sociais.']",200,160,160,200,200,920
89,Por que nem todos ficam em casa?,"['A peste negra foi uma pandemia que assolou a população européia no século XIV, contudo nos dias atuais o que vem assolando a população mundial é a pandemia da Covid19, onde a recomendação dada por especialistas é o isolamento social. Entretanto, uma parcela da sociedade não aplica tal orientação devido às pessoas terem a necessidade de trabalhar fora para o seu sustento e por conseguinte não terem condições de trabalharem em casa.', 'É relevante abordar primeiramente que a maioria dos indivíduos necessitam trabalhar para viverem dignamente. Por este motivo e entre outros, que o isolamento social é algo inacessível para alguns e consequentemente praticado por poucos.', 'Outrossim, o acesso à internet e aparelhos tecnológicos ainda é restrito ao povo. Sob a ótica da desigualdade social destaca-se o livro ""Os Miseráveis"" de Vitor Hugo, onde narra a história de pessoas passando fome nas ruas da França. Fora da ficção, esta é uma problemática enfrentada pelo Brasil, não apenas no quesito da fome mas também no que se refere a oportunidade de alguns poderem estudar e trabalhar em casa, e outros não.', 'T em vista o que foi discutido é necessário que o governo federal  preste assistência aos mais necessitados por meio do investimento e aumento do auxílio emergencial que será dado todos aqueles sem acesso à internet e aos que possuem a renda de um salário mínimo ou inferior. Tais medidas serão feitas com a finalidade de proporcionar a oportunidade de todos cumprirem o isolamento social.']",160,120,80,160,160,680
54,,"['A vacinação é a melhor forma de prevenir uma doença, e sem ela a população está ficando ainda mais suscetível, tanto a novas doenças quanto aquelas que já foram erradicadas e voltaram a aparecer. Isso acontece devido a falta de conscientização da população e de investimento na sua produção.', 'Em princípio, a atual população brasileira está descrente na real utilidade das vacinas, sobretudo daquelas feitas para previnir mazelas que já foram erradicadas. Logo, deixam de se vacinar, por falta de informação. Tal descreça, pode se comparar com a revolta da vacina de 1904, onde o povo se revoltou com as vacinações não justificadas.', 'Todavia, os grandes cortes feitos na saúde não é novidade, tanto que novos cientistas buscam vagas em faculdades do exterior. Com isso, a produção de vacinas também caíu, deixando as mães muito preocupadas com o bemestar do seu filho.', 'Sendo assim, para armeniar esse imbróglio se faz necessário que o governo invista na saúde de modo que toda população tenha acesso e direito a vacinação. Além de propor campanhas de vacinação por meio da internet e televisão, alertando a população do perigo causado devido  ausência da vacinação. Enquanto isso não acontece mais pessoas continuarão adoentado.']",120,120,80,120,80,520
51,A educação na construção da sociedade ideal,"['""Educai as crianças e não será preciso punir os homens"" - Pitágoras.', 'Em virtude do cenário atual, analfabetismo funcional é quando pessoas alfabetizadas apresentam dificuldades ao interpretar textos simples, ou mesmo não conseguem resolver equações matemáticas consideradas nível fácil.', 'Evidentemente, o assunto tratado é mais problemático do que imaginasse. Analise inicialmente que apenas 8% da população é capaz de entender e se expressar corretamente. Vários motivos podem contribuir para esta porcentagem, como, ausência de campanhas ao incentivo à leitura; ensino básico de baixa qualidade, dentre outros.', 'Ademais, o governo também está relacionado às causas deste analfabetismo, ressaltando, seu descaso na educação e a falta de políticas públicas para esta melhoria focando em cursos e oficinas.', 'Retomando o que disse Pitágoras, é preciso considerar os projetos educacionais para solucionar este problema, e não precisar punir os homens. Ações voltadas ao bem da comunidade tem potencial de transformação da realidade, gerando ganhos para todos os envolvidos.']",120,120,80,120,80,520
93,,"['No Brasil, acontece mais cesáreas que o normal. Na série de filmes:  ""O Renascimento do Parto"", mães relatam suas experiências com o parto. Contam que, os médicos não atendem a seus pedidos (muitas queriam parto normal); a equipe que realiza o procedimento a tratam de forma grosseira e impaciente, e que ficaram insatisfeitas com a maneira de que o parto foi realizado.', 'Na cesariana, muitas coisas ocorrem que as gestantes não gostariam de passar , como: o bebê é levado para longe da mãe sem o primeiro contato, são cortadas e suturadas, tudo isso sem ser da sua vontade. Por conta disso, o movimento do parto humanizado surgiu. As mulheres buscam por mais respeito, seja em qualquer tipo de parto.', 'Portanto, medidas devem ser tomadas para resolver essa questão. O Ministério da Saúde, juntamente com o governo federal,  deve promover o movimento do parto humanizado .  por meio de um projeto de lei, entregue à Câmara dos deputados . A equipe de médicos deve realizar a cesárea quando realmente for necessário, respeitando a gestante. Consequentemente, deve haver a construção de casas de parto e a contratação de obstetrizes. Com essa medida, espera-se partos mais humanos e mães satisfeitas.']",160,120,120,160,160,720
48,Carência no setor de saúde publica,"['Conforme 0 art.6 da Constituição Federal, é dever do estado garantir o acesso saúde e executar medidas públicas para o bem-estar de todo cidadão brasileiro. Nesse viés, percebe-se a importância de programas para saúde pública, como o SUS , na vida da sociedade. No entanto, existem desafios no atendimento e financiamento desse sistema que prejudicam seu funcionamento correto.', 'Mormente, é visível que as dificuldades no atendimento pelo SUS agravam a carência da saúde pública. Em vista disso, na Idade Média  com o aparecimento da Peste Negra, a saúde entrou em colapso e os hospitais não tinham condições de atender a população . Nesse contexto, os problemas no atendimento persistem na atualidade, porem com novas formas. Logo, alguns dos hospitais públicos não possuem uma boa infraestrutura, o que acarreta em um ambiente que não está preparado para receber os pacientes e torna-se superlotado, além, da demora em conseguir o entendimento , que pode resultar em um agravamento do estado de saúde do indivíduo, o que deixa a população desamparada e carente de um dos seus direitos.', 'Ademais, existem outros fatores que intensificam esse problema, como a falta de investimentos na área . Nesse cenário, segundo as ideias de Marx “A economia é a base da sociedade”. Diante disso, o financiamento do sus e os demais investimentos nas áreas de saúde, são essenciais para que se possa atender corretamente a população. Dessa forma, como o sistema de saúde pública brasileiro não é corretamente financiado, a população sofre com a falta de medicamentos, profissionais e até mesmo espaço, o que passa a ser um desafio para o seu pelo funcionamento.', 'Portanto, é necessário que medidas sejam tomadas. Desse modo, o Poder Executivo deve investir na saúde pública brasileira, por meio do Ministério da Educação, o qual deve fiscalizar e garantir que as verbas que são mandadas para o melhoramento desse setor, sejam de fato aplicadas em infraestrutura e necessidades dos locais de atendimento saúde, como remédios, profissionais e utensílios médicos, a fim de garantir que programas como o SUS tenham sua importância reconhecida e consiga chegar a toda a população. Para que assim seja minimizado alguns dos desafios enfrentados pela saúde pública brasileira.']",160,160,160,160,120,760
87,A percistência da erotização infantil na sociedade atual.,"['É notório  na sociedade contemporânea brasileira  o crescimento da cultura da erotização infantil. Crianças veem a cada dia mais a necessidade de expor seus corpos e crescer antes do tempo, o que acaba por atrair a atenção de pessoas mal-intencionadas que erotizam esses jovens. Isso é impulsionado  em grande parte, pela exposição causada pela internet e pela falta de orientação proveniente dos pais ou responsáveis. Sendo assim, essas questões se tornam agravantes para a problemática.', 'Sob esse viés, é válido ressaltar que a modernidade trouxe consigo avanços tecnológicos inegalvemente benéficos para a convivência social, todavia, há também a presença de malefícios tais como a exposição precoce de crianças em redes sociais e programas televisivos diversos. Um exemplo atual se trata da cantora Melody  de 13 anos, que se tornou famosa nas midias por conta da sexualização de seu corpo por pedófilos  mesmo se tratando de uma pré-adolescente. Dessa forma, vê-se que essas práticas estão tragicamente se tornando cada vez mais constante nos dias atuais.', 'Consequentemente, a carência de orientação esperada pelos responsáveis contribuí fortemente para esse cenário. Segundo o Estatuto da Criança e do Adolescente (ECA), ""É dever da família e da sociedade garantir o bem estar, segurança e o direito à dignidade às crianças"", entretanto muitas da vezes esse dever não é respeitado, o que acaba por promover cada vez mais a persistência do imbróglio.', 'Portanto, medidas devem ser tomadas para reverter essa adversidade. Nesse sentido, é mister que o Ministério da Justiça  juntamente à Secretaria Nacional dos Direitos da Criança e do Adolescente   promovam a proteção desses individuos através do reforçamento das leis de proteção as crianças, além da divulgação de campanhas informativas contra esse impasse através das mídias  com a finalidade de incentivar aos pais e responsáveis a inteirar-se sobre o assunto e orientar a seus filhos para que assim a cultura da erotização infantil possa deixar de ser algo pertinentente na sociedade hodierna.']",160,160,160,200,160,840
19,Redes sociais e a manipulação política,"['A internet é um meio de comunicação quase indispensável atualmente. E neste vasto mundo da informação temos as redes sociais, locais de conversas e notícias em que as pessoas estão mais conectadas e atualizadas sobre o que se passa pelo mundo. Essas redes podem ajudar ou prejudicar a sociedade em que vivemos, principalmente nos períodos de eleições, com a manipulação do eleitorado.', 'Entre os benefícios dessas redes na área política, destaca-se a Primavera Árabe, uma onda revolucionária de protestos e manifestações ocorrida no Oriente Médio e que ficou conhecida mundialmente. Essa estrutura online foi essencial para a comunicação das pessoas, com o fim da organização e das manifestações para depor os governos ditatoriais.', 'Em termo prejudicial , encontram-se os chamados fake news, notícias falsas por meio das redes online que buscam como um dos principais alvos manipularem as pessoas e a opinião pública. Em um estudo feito pela Universidade de Oxford, do Reino Unido, demonstra que a disseminação dessas notícias falsas já atingiu 48 países nos últimos 12 meses, incluindo o Brasil. Essas notícias são provocadas em sua maioria por perfis falsos e por grupos organizados que tentam difamar e denegrir a imagem dos opositores.', 'Portanto, destaca-se a importância de, antes de divulgar qualquer notícia, verificar se a mesma é verdadeira, buscar sempre acessar sites e páginas confiáveis e denunciando as que forem difamadoras e fidedignas.']",160,120,120,120,120,640
15,O que engorda mata,"['Hambúgueres, Milk-Shakes, Pizzas e Batatas-Fritas. Será surpreendente à qualquer um que retroceder na história até o período incipiente do processo de sedentarização a visão da vala abissal que segrega os nossos ancestrais caçadores-coletores de seus descendentes sobreviventes desta geração. Inesperadamente, mais na questão tecnológica do que na questão cultural. Digo isso pois a toda análise realizada por um atento espectador das eras caberá o fato de que o ser humano sempre buscou novas soluções com o fim de apresentar-se resiliente às adversidades de seu ambiente. É fruto dessa constante necessidade inata do homem o sedentarismo. Se a divergência tecnológica nos afasta de nossas remotas bases na árvore genealógica, o dado nutricional logra êxito em aproximar-nos deles, pois os mesmos alimentos que serviam a um mesmo fim não sofreram substituição ao atravessarem esses longos séculos. Apenas os consumimos de diferente maneira, bem menos saudável.', 'A obesidade afeta cerca de 40% da população adulta mundial e as ramificações desse alarmante dado estatístico também atingem a esfera infantil, que já esta conta com cerca de 20% de crianças acima do peso. Ao contrário do tabagismo e do alcoolismo, que revelam a seus combatentes apenas um tipo de barreira, a obesidade descobre vários fatores que demandam igual atenção e cuidado para que se possa atingi-lô e mitiga-lô . Outra dificuldade é a influência constante das publicidades de alimentos industrializados que encontrou fôlego com a globalização e cujos produtos anunciados estão expostos nas prateleiras em muito maior quantidade do que aqueles considerados verdadeiramente saudáveis. Os ricos capitalistas donos de tais indústrias mostraram-se, previsivelmente, indolentes quanto a esse fato e as conquistas das atuais medidas contra a obesidade se mostraram impotentes para estabelecer o equilíbrio entre o que oferecido pela mídia e o que se deveria consumir.', 'É trivial que a educação é um importante fator que influencia na formação do indivíduo, já que, para citarmos Kant, ""O homem não é nada além daquilo que a educação faz dele"". Portanto, a educação nutricional deveria estar presente em todas as escolas, para que se estabeleça a consciência da necessidade de uma alimentação saudável nos futuros cidadãos brasileiros e os do resto do mundo.']",160,120,120,120,120,640
83,O esporte é um aliado a educação*,"['Podemos dizer que o esporte é um tipo de suporte educativo, pois nele aprendemos a ter disciplina, ter uma boa relação social e ainda ganhamos saúde e mais disposição para realizarmos nossas obrigações diárias.', 'Uma criança que cresce dentro do esporte, sem dúvidas ela se tornará um cidadão de bem, que sabe respeitar e cumprir seu dever dentro da sociedade, pois ela foi instruída para obedecer normas, dialogar e sempre respeitar o próximo. Por isso d a importância dos projetos educativos que existem ou deveriam existir nas cidades e, principalmente, nas periferias, onde os jovens ficam propensos a ilusão do dinheiro fácil que o tráfico sugere.', 'Noticiários mostram a realidade de ter uma vida sedentária, a obesidade, o stress, doenças cardíacas, todas elas são causadas pela falta de atividade física e uma má alimentação. Para diminuir esses riscos, o aconselhável é aderir a uma alimentação saudável, associada a uma atividade, seja um esporte ou caminhada sendo praticados continuamente, pode se adquirir um bom funcionamento do corpo e da mente.', 'Portanto, podemos perceber claramente os benefícios que a prática esportiva pode trazer tanto para o corpo, quanto para o convívio social de um ser humano. O problema é que muitos, já estão acostumados a uma vida sedentária e nada fazem para mudar isso, o que é bastante preocupante,  por isso d a importância de expor e incentivar nossos jovens a buscarem uma vida saudável para diminuir as chances de, futuramente, ser um prisioneiro do seu próprio corpo.']",160,160,160,160,200,840
73,,"['A abolição da escravidão no Ocidente foi determinada menos por uma inspiração de ideais humanistas do que por uma necessidade que as nações recém-industrializadas tinham de um mercado consumidor mais amplo. Nesse contexto, o fim do regime escravocrata livrou os negros da submissão aos brancos, sem, em contrapartida, propiciar a inserção social dessa população, o que implicou em sua marginalização. Assim, em decorrência dessa exclusão histórica, os afrodescendentes brasileiros da atualidade têm um duplo desafio: de um lado, fugir dos estigmas sociais impostos à sua raça e, de outro lado, afrontar o preconceito racial velado existente na sociedade brasileira.', 'De uma parte, embora o Estatuto da Igualdade Racial exista desde 2010, dados recentes da ONU (Organização das Nações Unidas) afirmam que a cada 23 minutos um jovem negro é morto no Brasil. Tal fato evidencia um dos obstáculos na vida de uma pessoa afrodescendente - a violência - que vitimiza sobretudo membros dessa etnia. Esse problema se agrava ainda mais quando a força policial estatal é uma das causadoras das agressões infligidas contra essa população , segundo militantes do movimento negro.', 'De outra parte, o preconceito étnico implícito na sociedade brasileira é outra mazela com a qual pessoas negras se deparam. Esse tipo de racismo não se manifesta de forma agressiva ou violenta , como na injúria racial, mas pode ser verificado em várias situações cotidianas, desde o fato de que a maioria dos serviços braçais é executada por negros até constatação de que os professores afrodescendentes de uma instituição como a USP (Universidade de São Paulo) representam apenas 0,09% do corpo docente.', 'Fica evidente, portanto, que os afrobrasileiros enfrentam ao mesmo tempo a desigualdade social e o racismo velado. Para amenizar esse problema, é imprescindível que o Estado Brasileiro amplie o número de vagas universitárias destinadas a membros da população negra, visto que esse grupo já corresponde a 55% da população brasileira, de acordo com o IBGE (Instituto Brasileiro de Geografia e Estatística). Assim, aumentará o número de afrodescendentes nas universidades, garantindo-lhes a igualdade material prevista na Constituinte de 1988.']",160,160,120,160,160,760
143,Trote,"['O trote atualmente          vem se evoluindo para          crime, pois ele é praticado com o objetivo de humilhar os mais fracos, tem sido praticado por quem já sofreu tal ação, além disso algumas pessoas consideram normal o que vem acontecendo com muita frequência com os jovens em nossa sociedade.                  Hoje em          dia          é normal ouvirmos falar de trote em faculdades          onde          os alvos são os calouros, que na maioria das vezes são humilhados e maltratados, é uma forma de          demostra a          superioridade, mas isso vem se intensificando, já que não se trata somente de um ritual de passagem, mas sim de um ato de humilhação, podendo até mesmos agredir os direitos dos cidadãos.                  As pessoas que sofrem                   bullying          tem          uma certa tendência          à          fazer o mesmo com          outras, com          o trote não é diferente, pois os que sofrem hoje          faram          o mesmo no futuro, é como a lei da ação e reação. Se as autoridades não entrarem em ação agora, nunca acabaremos com esse com esse ciclo                  vingança que afeta nossa sociedade.', 'Apesar de tudo que sabemos sobre o trote,         à ainda         certa parte da população que defende está prática, alegando que é algo normal e que esteve                 presente desde as primeiras civilizações                . Não compreendem que a         saciedade         mudou e evoluiu, tanto que hoje vivemos numa democracia, onde o cidadão tem direitos e deveres que devem ser respeitados.', 'Sendo assim,                 vemos que o trote tem se tornado um crime                , que acontece às escondidas. Para mudarmos         está         situação será preciso fazer campanhas                 conscientizando a população                , e também criar leis que proíbam os maus tratos         à         calouros,                 só assim contribuiremos para uma sociedade melhor.']",120,120,80,80,80,480
91,Efeitos do negacionismo cientifico na conjuntura brasileira,"['No filme “O menino que descobriu o vento” é apresentado como William, estudante de uma aldeia que passava por um período de seca, tem suas idéias, baseadas em leituras científicas para salvar as colheitas, negadas e mesmo substituídas por alternativas baseadas em suposições da população. Fora da ficção, os efeitos do negacionismo cientifico se apresentam similarmente na contemporaneidade brasileira. Sendo este perpetuado principalmente nas áreas onde o acesso educação de qualidade é mínimo e é desencorajado pela ineficiência governamental na disseminação e aplicação da ciência no país.', 'Em primeiro plano, é imprescindível destacar a vitalidade da comunicação durante o compartilhamento dessa ciência. Semelhante ao conflito presente, tivemos, em 1904, a Revolta da Vacina, evento este marcado pela ira do povo para com a medida obrigatória de vacinação. Conquanto, ao analisar o contexto histórico, se torna compreensível, em vista que o governo vigente jamais se importou em explicar a importância da vacinação e direcionava sua economia para as metrópoles , que a população tendesse, como na atualidade, a acreditar em fontes não disseminadas pelo governo e os meios de saúde, devido falta de acessibilidade de forma clara.', 'Ademais, é incontrovertível o impacto do papel passivo do Estado na garantia da prevalência dos meios científicos sobre os demais. Na Constituição federal de 1988 é declarado como dever estatal a asseguração de medidas para acesso e distribuição, de forma igualitária, aos serviços envolvendo a saúde, a área mais afetada pelo negacionismo. Contudo, em vista do aumento do apoio a este movimento radical e a diminuição no número de brasileiros que procuram a vacinação e os tratamentos medicinais, é conclusivo que o governo fez a quebra com o proferido na conjuntura, ajudando indiretamente na prolongação do quadro alarmante.', 'Portanto, em vista do supracitado, é mister que o Estado reconheça sua influência na problemática, devido falta de investimentos e promoção ao acesso área cientifica, e trabalhe com o Ministério da Saúde na criação de um projeto governamental que vise, por meio da instalação de instituições educacionais públicas e divulgação midiática, o compartilhamento de informações e resolução de dúvidas da população sobre os meios científicos com a ocorrência de palestras e debates abertos feitos por profissionais da área da saúde e a apresentação de dados que comprovem a veracidade da ciência. Destarte, ocasionando, por meio da ampla disseminação clara do conhecimento comprovado, uma significativa diminuição do movimento negacionista e garantindo que idéias fundamentadas, como as de William, se tornem a voz da nação.']",160,160,160,200,160,840
77,A vida na sociedade,"['esse tema é bem delicado de falar, pois envolve um série de elementos que podem dar origem a homofobia por exemplo ; pode começar com uma certa ignorância com pessoas que portam determinada vestimenta e questionam sem saber as causas da qual teve suas origens. Esse ato pode desencadear um processo que futuramente podem levar até uma violência verbal e física violando os direitos humanos da pessoa . As pessoas podem ter uma reflexão sobre o tema e deixar o preconceito de lado e pensar de uma forma mais racional, para buscar como auxiliar essa pessoa a viver em sociedade com maior valorização de si mesma e auto-confiança. Muitas pessoas quando ouvem a palavra gay, homosexual, bissexual ou travesti querem sair do assunto pois tem dificuldade de reconhecer que é um indivíduo da sociedade normal como ele , tem suas dificuldade , responsabilidade e atividades.']",80,40,0,0,0,120
35,Ensino ou doutrinação?,"['No dicionário da língua portuguesa, ensinar significa transmitir experiências, repassar ensinamentos, instruir alguém. Enquanto doutrinar expressa-se como transmitir à um indivíduo alguma crença ou atitude particular, com o objetivo de que não aceite uma opinião diferente. Mas então , qual o problema de um professor doutrinar os seus alunos?', 'Principalmente na fase de pré-adolescente, o jovem ainda não tem a opinião formada, é fortemente e facilmente influenciado por outros.  Com isso, se o professor começar a impor a sua opinião em sala de aula, os pensamentos dos mais jovens serão interferidos e a opinião do aluno será comprometida. Como o projeto de lei Escola Sem Partido espera, a doutrinação política na sala de aula será o fim.', 'Porém, não são todos os professores que fazem doutrinação e não são todos os alunos que são influenciados com facilidade. Cada aluno chega à escola com a sua história, religião, cultura e aprendizados familiares. O que não é permitido acontecer é o professor impor apenas a sua visão, ele deve mostrar ao aluno todas as opiniões possíveis de determinado assunto. Por meio de filmes, livros, notícias e diferentes opiniões, o jovem começa a ter o seu próprio ponto de vista. Não há mal em o educador expressar a sua opinião para os alunos, desde que não prejudique ou constranja os alunos.', 'Em relação á política, é evidente que cada um tem uma opinião diferente comparando com outros. Várias pessoas julgam determinados partidos e governos com críticas negativas ou positivas e há muitos professores entre esses indivíduos. O orientador consegue demonstrar a sua crença, demonstrando novas ideias ao lecionando sem que faça propagandas de partidos e sem induzir o aluno à ir em protestos ou atos públicos.', 'Existe uma assimetria entre professor e estudante, mas não significa que o aluno absorva exatamente tudo o quê o docente diz. Cabe ao governo aprovar a lei Escola sem Partido, para deixar pais e orientadores informados sobre o quê pode ou não falar em sala de aula. Campanhas em revistas, jornais e redes sociais solicitando a interrupção da doutrinação em classe e algumas passeatas fariam com que o problema se minimizasse, deixando as pessoas cientes que não se deve doutrinar. Também cabe aos pais aconselharem sobre as crenças políticas ou religiosas, e, assim, a criança será menos influenciada por opiniões diferentes.']",120,120,120,120,120,600
64,,"['Mitos, tabus, valores morais, conservadorismo, influência religiosa, falta de leis adequadas, entre outras causas, dão forma à forte resistência que impede a implantação de políticas públicas que permitam a todos, desde a infância, acesso a uma educação sexual de qualidade. Disto resultam graves consequências, como a gravidez na adolescência e o alto índice de transmissão de doenças sexualmente transmissíveis .', 'Segundo levantamento do Ipea, do ano de 2017, uma em cada cinco crianças no Brasil é filha de mãe adolescente. Como resultado, este responde pela 7ª maior taxa de gravidez precoce entre os países Sul-americanos. Dessa forma, atribui-se essa realidade, principalmente, a falta de legislação adequada, fruto de sucessivos governos e parlamentos desconectos dos anseios do povo por aqueles representado . Em oposição a esse descaso há bons exemplos de gestão pública eficiente. Entre esses, o da Alemanha, cuja legislação obriga as escolas terem em seus currículos disciplinas ligadas ao ensino sobre sexualidade e as famílias, por sua vez, tem que matricular as crianças nas instituições de ensino, podendo os pais ou responsáveis até ser punidos com prisão em caso de desobediência. Consequentemente, esse país tem números baixíssimos de casos de gravidez entre as adolescentes e de transmissões de doenças por relações sexuais.', 'Além desse problema, a falta de educação específica dentro das escolas eleva os números de transmissão de doenças sexualmente transmissíveis entre adolescentes e adultos, pois lhes faltam informações sobre sexualidade. Vergonhosamente, O   Brasil é um exemplo claro dessa triste realidade . Com destaque no cenário mundial como um dos países mais corruptos, sucessivas gestões públicas ineficientes, além da classe política desmoralizada, responde por quase metade dos novos casos de infecções por HIV no continente latino-americano.', 'Em suma, ações simples e baratas podem ser implementadas. Uma alternativa é utilizar o celular, com enfoque nas redes sociais, como meio de facilitar a interação do professor com o aluno, dentro das escolas, disponibilizando os conteúdos educativos sobre sexualidade para que sejam debatidos dentro da sala de aula.']",120,120,120,120,80,560
51,Um vilão em nossa nação,"['Analfabetismo funcional consiste na incapacidade de compreender textos e realizar cálculos simples apesar de entender letras e números. Numa época de visíveis avanços na área da educação, este ainda se faz presente. Este estorvo trás como sua principal consequência um forte impacto na produtividade nacional , além de ser o reflexo de um sistema de ensino deficiente.', 'Mesmo que os índices de analfabetismo estejam diminuindo, o número de pessoas com dificuldade na interpretação de um simples texto apenas aumenta . Segundo o Inaf , três em cada dez pessoas de 15 a 64 anos são consideradas analfabetas funcionais. Esse dado mostra o abandono que a educação brasileira sofre ano após ano.', 'Uma grave consequência deste problema é a repercussão na produtividade  do país. De acordo com o professor doutor Issao Minami, o baixo índice de escolaridade e a má qualidade do ensino impossibilitam as pessoas de aperfeiçoares as técnicas de escrita e leitura. Este fato trás a tona circunstâncias que trabalhadores com analfabetismo funcional passam todos os dias, como por exemplo, não conseguir ler um manual de instruções de uma máquina.', 'Logo, é preciso diminuir os índices de analfabetismo funcional no Brasil. Com um maior investimento no sistema público de educação, tal como a reestruturação do ensino básico, afim de evitar que este número cresça. A partir destas ações, a perca anual de trabalhadores produtivos e qualificados será consideravelmente reduzida.']",160,160,120,120,120,680
43,**,"['O advento da internet e das mídias sociais ainda é uma tecnologia recente que revolucionou a comunicação no mundo contemporâneo, entretanto junto a isso surgiu também a chamada ""Cultura do cancelamento"", que consiste em uma represália virtual pessoas que tenham dito ou agido de maneira indevida segundo os internautas, mas a adoção dessa conduta intolerante causa impactos negativos para os alvos desses ataques, essa postura e impulsionada pela sensação de impunidade no meio digital e por uma sociedade não conscientizada sobre o uso das mídias sociais.', 'Primeiramente, deve-se considerar que as redes sociais modificaram a maneira de se comunicar e interagir socialmente, tornando mais fácil o acesso e a divulgação de informações, mas essa facilidade gera um sentimento de inobservância no meio digital como se a internet fosse um mundo parte da realidade onde as ações não terão consequências, o que favorece os ataques aos ""cancelados"", entretanto essas agressões causam danos morais, psicológicos, patrimoniais e até físico em alguns casos.', 'Além disso a sociedade não foi educada para o uso da internet o que contribui para o problema, visto que as pessoas usam as mídias sociais para praticar uma violência mascarada de busca por justiça, revelando uma postura intolerante e imediatista não aberta ao diálogo, sendo assim de acordo com os dizeres do filósofo alemão Friedrich Schiller "" A violência é sempre terrível, mesmo quando a causa é justa. Sendo assim é necessário que a sociedade reflita e combata a cultura do cancelamento.', 'Portanto em vista do exposto, faz-se necessário que, o governo por meio do Ministério da Cidadania promova campanhas de educação digital fazendo uso das principais mídias sociais, formando assim uma sociedade mais cônscia em relação ao uso das tecnologias. Além disso é necessário que o Ministério da Justiça junto as principais plataformas digitais regulamentem leis mais incisivas, que responsabilizem os usuários que promovam agressão no meio digital, tornado assim o ambiente virtual mais seguro e justo com regras a serem seguidas por todos.']",160,160,160,200,200,880
90,Revolta de Stonewall e seu legado,"['A Revolta de Stonewall é uns dos primeiros registros do início da luta de pessoas LGBTQIA+ . O movimento foi liderado por Marsha P. Johnson, uma travesti negra naqual representa uma das classes que mais sofrem com o preconceito estampado. De maneira análoga a isso, se analisa que lutas passadas foram responsáveis para encontrar nessa atual realidade, mas que ainda não se vê parâmetro justo para julgar a verdade em que pessoas transexuais vivem neste momento. Nesse prisma, destacam-se dois aspectos importantes , o prejulgamento oriundo de todos os lados, desde de dentro da própria residência ambientes públicos, e os problemas psicológicos gerados a quem se identifica com o gênero oposto.', 'Primeiro é indubitável questionar a terrível realidade em que eles vivem, sofrendo desde ameaças, violências físicas. Assim sendo que, somente o primeiro semestre deste ano, 89 pessoas transgênero foram assassinadas no Brasil. Provando desta maneira, como o preconceito não é mais algo relacionado fala, mas em algo físico e que oferece risco integridade pessoal.', 'Outrossim, é notório os problemas psicológicos recorrentes às pessoas transgêneros, sejam eles gerados pela transfobia ou a dificuldade da sua aceitação. Dessa forma, segundo a Declaração Universal dos Direitos Humanos, ""Todos os seres humanos nascem livres e iguais em dignidade"", demonstra a necessidade de combater este crime, já que todos nascem iguais perante a lei e necessitam do respeito mútuo. Sendo assim, a luta contra a transfobia é fundamental visto que a realidade desses cidadãos são complicadas desde o momento em que se identificaram como tal.', 'Portanto medidas são necessárias para resolver esse,  impasse. Por conseguinte, cabe ao Ministério da Educação fazer projetos por meio das escolas brasileiras em que tenham a finalidade de levar conhecimento às crianças e adolescentes a diversidade apresentada no país e como cada indivíduo deve ser respeitado com suas diferenças. Ademais empresas de grande alcance e publicidade, devem buscar trazer em seu time pessoas trangêneros, através, ou de propagandas ou em suas empresas, abrindo oportunidades de empregos, para que se possa inserir cada vez mais essas pessoas no mercado de trabalho. Somente assim, o legado de Marsha P. Johnson poderá ser valorizado.']",160,200,160,160,160,840
44,O limite da exceção,"['Todas as instituições, sejam elas públicas, privadas, religiosas, seculares ou qualquer livre associação de pessoas, para alcançar suas finalidades, tendem a estabelecer critérios e diretórios para limitar qualquer excesso dos funcionários ou membros associados. O uso desses recursos é uma prática tão antiga quanto a lei, e leva em consideração as contingências dos interesses humanos. Neste âmbito, dadas as limitações de critérios e protocolos, até onde a exceção deve depor a regra?', 'O caso da atleta sul-africana Caster Semenya, que foi banida em 2019 por apresentar níveis de testosterona elevados, é um exemplo. Sua disposição biológica atípica, embora inata, sugere para alguns que é um caso excepcional que não merece o crivo de um tribunal para avaliar suas competências e que a decisão de a banir foi descriminação. No entanto, há um limite tênue entre discriminação e critério. Critérios em competições costumam ser uma média prudente do cenário geral. No caso de competições atléticas, os critérios são formulados com base em evidencias cientificas especificas do desempenho corporal humano, e não em preconceitos pessoais ou intuições.', 'A própria Federação Internacional do Atletismo já havia constatado que mulheres com níveis de testosterona de mais de cinco nanomol por litro de sangue têm uma vantagem significativa no desempenho. Isto sugere, portanto, e por se só, o estabelecimento de um limite razoável para competições femininas, com base no desempenho médio das mulheres, independente de cor, raça ou preferencias sexuais. Logo, a decisão da instituição de banir a atleta Semenya,  não foi baseada numa régua para medir feminilidade, mas em critérios que levam em conta o desempenho corporal feminino.', 'Diante disso, fica claro, portanto, a necessidade de conscientização madura sobre os critérios esportivos dissociados de paixões pessoais, especialmente diante de um quadro cada vez mais politizado, como é das competições femininas, que podem levar a longo prazo a conflitos e perda de credibilidade das instituições que regulam os esportes. Também é necessária uma reflexão séria sobre os perigos do detrimento de regras com base em visões políticas, identitárias ou preconceituosas. Só assim haverá uma promoção e reconhecimento justo das competências individuais dos atletas, sem a intervenção de visões pessoais ou ideológicas.']",200,160,160,120,160,800
77,Respeito,"['O debate sobre a homofobia é contemporâneo, já sua antropologia é secular. Todos falam em escolhas ou opção sexual, mas esquecem de que ninguém escolhe ser gay, homem ou mulher, se nasce assim. E por que tanta complicação com esse tema? Por que simplesmente não aceitar a pessoa como ela é? Que crime comete uma pessoa por amar outra do mesmo sexo? Amar é um crime? Quem disse? Se um casal heterossexual pode ser feliz para sempre! Por que um casal de homossexual não? Viram? São muitas perguntas, mas quem tem as respostas?', 'As estáticas são trágicas, o Brasil é o país que mais mata homossexual no mundo. Não é possível que a sociedade brasileira aceite essa realidade cruel como se normal fosse. Porque não é! A homofobia não passa do mais puro preconceito, e deve ser combatido diariamente por todos. O melhor lugar para aprender e debater sobre esse assunto é na escola. É muito importante que as crianças aprendam a respeitarem as diferenças humanas. Assim saberão que o respeito é a melhor forma de amar o outro.', 'Se aceitar como se é,  não é crime, pecado, aberração, doença ou loucura! É um ato de coragem. Uma família é composta de duas pessoas que se amam, se respeitam, se admiram e querem compartilhar a vida juntos. Crime é ser homofóbico, preconceituoso, racista e assassino.', 'A homofobia é um crime, e como todo crime deve ser punido e combatido. O respeito é o único caminho seguro que pode transformar essa realidade contemporânea e trazer paz aos gêneros. O aspecto extremamente dinâmico do mundo atual manifesta-se em todos os setores da vida. A prática do respeito com o ser, deve ser a mudança significativa da humanidade. Respeitar e ser respeitado é o que todo mundo carece.']",120,120,120,120,120,600
83,Atividades,"['A prática de esportes, principalmente na fase da infância, é essencial, pois trás um estilo de vida mais saudável e formação de valores e deveres, na característica  social. O desenvolvimento esportivo fornece também ensinamentos como: companheirismo e trabalho em equipe, entre outros.', 'Na década dos anos 90 era muito comum ver crianças brincando de correr, bicicleta, futebol e vôlei etc, (;) com a tecnologia do ano 2000 as mesmas veem se tornando sedentárias e, consequentemente, doentes: obesidades e depressão são uma delas .', 'Conforme uma entrevista dada por Sellmer* ao Estadão, ele afirma que é necessário praticar esportes na fase infantil, pois é o momento de desenvolvimento motor, melhorando a articulação e o condicionamento físico.', 'Há que se observar que o esporte vai além, servindo de ferramenta de inclusão social, as crianças e jovens de baixa renda, têm o mesmo como plataforma de aberturas de portas e criação de oportunidades para um melhor futuro. Além disso, indivíduos com deficiência física podem encontrar no esporte um enorme espaço de socialização e autoestima.', 'De acordo com a UNESCO, o esporte deve trazer uma maior comunhão entre nações e entre as pessoas, juntamente com a competição saudável, devendo ter solidariedade e a fraternidade, envolvendo respeito mútuo e o entendimento, e o respeito total pela integridade e pela dignidade dos seres humanos,', 'Logo, o esporte não tem preconceito, rico ou pobre, negro, branco. Assim se tem exemplos concretos de que a realização de esportes gera mais oportunidades. As pessoas deveriam fazer dele seu hábito comum.']",120,160,160,200,200,840
23,Rótulos mas  elaborados,"['Muito se tem falado sobre a comercialização e produção dos OGMs (Organismos geneticamente modificados , ou simplesmente alimentos transgênicos, termo ainda não definido pela lei da Biossegurança de 2005, mas nem todos sabemos que ambos são processos geneticamente diferentes, Conforme assegura o processo proposto por Charles Darwin e Alfred Wallace, os OGMs poderiam existir de forma natural, já os transgênicos cuja derivado de um processo onde se cria um organismo transgênico (o transgêne) em hipótese alguma ocorreria de forma natural, embora a forma natural levaria muito mas tempo, para o nosso consumo seria menos agressivo.', 'Trazendo para a realidade do nosso pais a aprovação dessa lei implicara na alteração das embalagens usadas para comercializar esses produtos, a inibição da sigla informando que o alimentos se derivou de forma transgênica fara que o consumidor mas uma vez seja enganado, e desprovido de informações importantes para a nossa saúde, embora não são muitos as pessoas que se dão o trabalho de antes de comprar um produto, dediquem um minuto do seu tempo para ler quais as composições daquele respectivo produto , mas levando em conta dos poucos que fazem ao contrario , essa lei negara essa informação muito importante.', 'Embora saibamos que existam muitos erros na qualidade da alimentação da humanidade, às vezes pela falta de conhecimento, tanto na fabricação quanto na derivação dos alimentos, não se deve ser negado a informação bem clara e precisa da composição dos alimentos, não apenas produtos transgênicos, mas a sua composição num todo, introduzir um rotulo mas elaborado e bem descritivo cessaria essa grande repercussão a respeito da desvalorização dos nossos produtos no ato da exportação, acabando assim com os rumores que a nossa economia poderia sofrer altos riscos, sem as exportações.']",0,0,0,0,0,0
85,Cidadania além do ato de votar,"['Está contido na Constituição Federal que todo poder emana do povo  que pode exercê-lo escolhendo representantes , através do voto, ou por meio da participação direta. Na própria Constituição há um instrumento que torna possível a participação direta do cidadão , a lei de iniciativa popular , que infelizmente é pouco conhecida pela maior parte dos brasileiros e encontra empecilhos na ordem legislativa para se efetivarem .', 'No Brasil , é adotado o sistema democrático representativo , em que o voto dos cidadãos é fundamental . Sem dúvida, o ato de votar é inegavelmente importante, mas , infelizmente é visto pela maior parte das pessoas como a única oportunidade de participação na vida pública ou a única forma de ter sua voz ouvida e tratada com (a) devida importância . Apesar de ser importante , o voto não é a única via de acesso para o cidadão exercer seu papel no corpo social do Estado . Infelizmente no país a desinformação política é um fato concreto ; a população desconhece a amplitude do processo democrático .', 'Mas , o desconhecimento dos cidadãos à respeito de seu papel num estado democrático não é o único problema que impede uma participação popular mais ativa . Desde d a formulação da lei de iniciativa popular , apenas quatro projeto de leis efetivaram-se e se tornaram leis de fato . A lei da ficha limpa , por exemplo , demorou dez anos para ser aprovada , devido a burocratização . Com certeza , um número bem pequeno , que se deve ao processo lento e burocrático no âmbito legislativo .', 'É perceptível observar que  a população brasileira está aprendendo tardiamente a participar do processo democrático e político . Há cada vez mais interesse das pessoas por seus direitos e é significativa a mobilização das mesmas por seus direitos e anseios . Mas , esse processo ainda pode ser considerado lento . Outras medidas precisam ser elaboradas para que a participação das pessoas no processo democrático de direito aumente cada vez mais .', 'Dito isso , é necessária a criação de uma lei que torne o processo de participação direta  menos lento , menos burocrático em todos os seus aspectos , sejam eles jurídicos ou legislativos . Os projetos de leis indicados pela população precisam ter mais prioridade no Congresso , algo a ser incluso também nessa lei . É importante também a criação de uma disciplina nas escolas de nível fundamental e médio que discuta sobre o processo democrático , formação das leis e seus valores e princípios constitucionais, direitos e deveres do cidadão , para que esses  estudantes possam se tornar adultos cientes de seu papel na sociedade . Cabe à mídia informar mais a população à respeito da lei de iniciativa popular e de todos os mecanismos que tornem o cidadão mais atuante na democracia .']",160,200,200,160,200,920
78,A organização do ensino médio,"['Percebe-se que a reforma do ensino médio é um tema que causa opiniões contraditórias, e é notável que o Brasil necessita-se de uma, mas não uma inesperada, sendo assim, a reforma não é uma solução para a educação no país.', 'O Brasil precisa de uma reforma na educação, mas não uma que exclui as opiniões da população e  principalmente  dos professores e alunos, que sabem os defeitos e onde melhorar o ensino. Vale ressaltar que que o projeto já foi colocado como medida provisória para não depender das convicções do povo e também para a aceleração do andamento, sem precisar de muitas autorizações de setores do governo.', '   ', 'Além disso, com o aumento da carga horária,  e as escolas em ensino integral, será um obstaculo  para alunos que querem e precisam entrar no mercado de trabalho, como jovens aprendizes ou estagiários, que iram [irão ter que decidir entre trabalhar ou estudar, porque em pleno século vinte e um muitas famílias estão em condições econômicas precárias.', 'Portanto, medidas são necessárias para resolver esse problema,  cabe a  população e os  professores reagirem e organizarem manifestações pacificas contra a reforma do ensino médio e também o ministério da educação realizar uma pesquisa online  , no qual  alunos e seus mestre  possam dar sugestões e opiniões onde é preciso reorganizar o ensino.']",120,120,120,120,120,600
82,Com saúde não se brinca,"['A automedicação tornou se  uma solução mais fácil para aliviar sintomas de imediato, mas é uma pratica  que deve se combater , pois esta implica em um  alto risco a  saúde do individuo, pois este não possui conhecimento medico ,  e nem como os medicamentos agirão em seu organismo,  este  são desenvolvidos para curar, controlar, diagnosticar ou prevenir doenças , porem , se utilizados de forma abusiva ou inapropriada, podem trazer graves consequências.', 'A maioria da população não conhece os efeitos dos remédios  antes de ingeri-los, e a combinação de duas ou mais substancias ,  pode anular o afeito da outra ou até mesmo causar reações adversas, o aumento dos batimentos cardíacos, alergia,dependência, entre outros.', 'Além disso  podem esconder determinados sintomas  dificultando o diagnósticos de doença,  os microrganismo  acabam criando resistência aos medicamentos ,o que compromete a eficácia dos tratamentos.', 'O uso de qualquer medicamento,  deve ser acompanhado por um profissional da saúde, pois só este possui o conhecimento necessário para o uso dessas substancias , de forma que faça bem a saúde da pessoa e não o contrario .  Na maioria das situações em que se pratica a automedicação, é para solucionar casos de dores, gripes, diarreias,, entre outros,  nesses  casos  leves e  autolimitados, O  farmacêutico é um profissional da saúde que pode auxiliar o individuo, Mas em nenhuma hipótese se deve dispensar o diagnostico medico  antes de ingerir qualquer medicamento.', 'Ao se automedicar  é como se o individuo estivesse brincando com própria vida, podendo levar a  morte, dessa forma  deve se  incentivar a população o uso racional de medicamentos com prescrição medica, e isso deve começar desde de cedo, conscientizando crianças e jovens sobre os risco que desta pratica, lhes mostrando  que com saúde não se brinca.']",80,120,120,120,120,560
56,A situação atual dentro dos presídios no Brasil,"['Os prisioneiros no Brasil são vistos com maus olhos perante a sociedade onde dizem: ""lugar de bandido é na cadeia"" . Os presídios atualmente são super lotados com pequenos espaços, ali são abrigados homens que cometeram crimes como assassinato, furtos, ou foram pegos possuindo drogas.', 'A cadeia é um lugar triste onde os presos passam a maior parte da vida dentro de grades sem ver o mundo externo. Quando saem de lá e vivem a experiência de ter passado anos no cárcere,  não querem voltar para esse lugar tão horrível e não cometem os crimes que cometia antes, quando tem a oportunidade de ter saído com vida.', 'Todavia, nas prisões entram celulares, tablets com acesso internet para que sirva de comunicação entre o mundo do crime. Cadeias com pouco espaço e super lotadas, causando rebeliões entre os presos e os que estão soltos assaltam ônibus, lojas, bancos etc. em respostas ao mundo do crime', 'Portanto, para acabar com as rebeldias dos presos deveriam implantar mais trabalhos nas cadeias e não colocar tantos presos no mesmo lugar. Com isto acabariam com tanta violência nos próprios presídios, segurança máxima ao entrar visitas, para que não entre celulares ou nenhum objeto que comprometa o preso.']",120,80,80,120,80,480
13,Mais armas menos violência?,"['Em outubro de 2005, houve no Brasil um referendo a respeito da proibição do comércio de armas de fogo e munições no país. Os brasileiros votaram contra a proposta. Nesse contexto, em virtude do aumento da violência e atendendo ao pedido de uma parcela da população, o Presidente assinou o decreto que facilita a posse de armas para população brasileira. Todavia, a medida gera opiniões divergentes e coloca em xeque a sua efetividade.', 'Com o intuito de cumprir uma promessa da sua campanha eleitoral, em 2018, o Presidente Jair Bolsonaro assinou o Decreto que flexibiliza e torna os critérios mais objetivos para a posse de armas de fogo no Brasil. Para apoiadores da medida, o armamento da população a torna mais segura. Outro ponto levantado e que o acesso facilitado às armas servirá de desestímulo aos criminosos. Além disso, o estatuto do desarmamento não cumpriu a sua função, haja vista que os números de homicídios por armas no país aumenta ano a ano. O número de mortes está entre os mais altos do mundo.', 'Em contrapartida, para aqueles que discordam dessa posição, argumentam que se mais pessoas tiverem armas, a possibilidade de conflitos aumente e até mesmo a polícia estará mais vulnerável. De acordo com as pesquisas realizadas pelas universidades USP, PUC Rio, FGV, a taxa de homicídios nas cidades está atrelada com a disponibilidade de armas. Para as ONGs é função do Estado, e não do cidadão comum, lidar com a segurança e a criminalidade. Nesse sentido, mais armas não é garantia de menos violência.', 'Segundo um estudo publicado pela universidade de Harvard, países que têm mais armas tendem a ter menos crimes. Ainda, de acordo com o mesmo estudo, ao longo dos últimos 20 anos, as vendas de armas aumentaram nos Estados Unidos, contudo os homicídios relacionados a armas de fogo diminuíram em 39%.', 'Desse modo, embora ao a flexibilização do acesso à posse de armas de fogo traga a sensação de mais segurança para a população, tal medida não deve ser tratada de forma isolada. Faz se necessário que líderes governamentais associem a nova legislação com políticas públicas mais eficientes voltadas para a diminuição da violência.']",120,160,120,120,120,640
55,,"[""Data-se a descoberta do Brasil em 1500, quando Pedro Álvares Cabral chegou região Norte do país . Mas o que muitos não levam em consideração é o fato de que desde muito tempo antes as terras brasileiras já eram habitadas por pessoas um tanto quanto diferentes daqueles ''colonizadores'' que chegavam..."", ""Essas pessoas receberam, e recebem até hoje, a denominação de ''índios'', o que acaba sendo muito abrangente e faz com que as diferentes tribos percam sua singularidade. Cada uma possui características e costumes próprios, o que faz com que elas se tornam únicas e ricas em diversidades. Atualmente há cerca de 215 grupos indígenas distintos, e no começo esse numero era muito maior . Infelizmente, doenças trazidas da Europa e das quais os indígenas não tinham conhecimentos, como gripe, dizimaram boa parte de sua população. Outro fator que levou muitos morte foi os confrontos com os brancos devido a disputas por terras."", 'Atualmente  há um processo para que determinado território passe a ser de propriedade dos índios, que consiste em: estudos da área realizados pela Funai (Fundação Nacional do Índio); acontece uma delimitação que chega ao Ministério da Justiça via Diário Oficial; após ser autorizada ocorre a demarcação e a terra passa a ser de uso somente dos indígenas; verifica-se a existência de benfeitorias por parte de antigos donos para possível ressarcimento financeiro; a residência realiza a homologação; ocupantes não indígenas são retirados com eventuais indenizações; a regularização e demarcação oficial em cartório acontece; e finalmente a Funai pode interditar a área para que seus habitantes permaneçam seguros e isolados.', 'É de suma importância que esse processo seja agilizado o máximo possível, já que é um trâmite que muitas vezes arrasta-se por anos, e enquanto isso, a fauna e flora são atacadas por exploradores. É dever do Poder Público implantar leis mais rígidas de proteção essas reservas e fiscalizar seu cumprimento para que mais nenhuma cultura se perca.']",120,120,80,80,40,440
29,Corrupção à 1988,"['Medidas desumanas foram tomadas na retirada de usuários de drogas na chamada “Cracolândia”  alguns bairros da cidade de São Paulo. A internação dos dependentes químicos é necessária para que os mesmos se recuperem e saíam do ambiente hostil em que habitam. Entretando o internamento não deve ser compulsório pois além de desrespeitar a Constituição brasileira de 1988, a qual assegura os direitos dos cidadãos e a igualdade , impõe a um indivíduo que não consegue responder pelo seu livre arbítrio um tratamento não requerido pelo mesmo .', 'O deslocamento dos utentes de crack da “Cracolândia” forçadamente não deve ser atuada , deve ser planejada com o intuito de recuperação voluntária, pela atitude de cada indivíduo em procurar assistência dessa forma obedecendo os direitos humanos.', 'Por conseguinte trabalhos que motivem a recuperação dos usuários, possibilitando então a vontade do internamento por conta própria, e através de profissionais especializados na área de reabilitação que possam estar presentes nos bairros onde a crack foi implantado.']",80,80,80,0,0,240
5,Defensivos agrícolas,"['Defensivos agrícolas: uma expressão branda diante de um problema impactante', 'O Brasil passou, na década de 70, pela revolução verde que inseriu o uso de compostos químicos nas plantações para garantir um bom desempenho do agronegócio. Como consequência, tais produtos começaram a ser utilizados em larga escala, sem a preocupação com os efeitos que essa conduta pode acarretar sobre a à saúde humana e o ao meio ambiente. Nesse contexto, fica claro que a ideia de substituir o nome ""agrotóxico"" por ""defensivo agrícola"" serve apenas para mascarar um problema de cunho sócio ambiental socioambiental.', 'À A princípio, cabe destacar que a ideia de proibir o uso do termo agrotóxico advém da do PL 6299 (PL = projeto de lei), elaborada pelo senador Blairo Maggi. Acerca disso, convém mencionar que tal PL prioriza mais os interesses do capital privado do que o bem-estar coletivo. Em outras palavras, o objetivo da referida proposta é flexibilizar o uso desses componentes nocivos à saúde humana - capazes de, segundo o Ministério da Saúde, provocar cânceres e até más formações nos fetos, em benefício dos latifundiários inseridos no do agronegócio. Com base nisso, essa esse PL desrespeita um o direito de ter uma saúde de qualidade garantido pela constituição Constituição, e por conseguinte, a sua execução sanção torna-se contestável.', 'Outrossim, é válido ressaltar também que, a que a mudança no nome para defensivo agrícola tenta descontruir a imagem negativa vinda do termo agrotóxico e, assim, favorecer o agronegócio ao deixar a população na ignorância, procurando dissolver movimentos de resistência que são contra o uso indiscriminado de tais fitossanitários. Acerca disso, convém mencionar que os seus efeitos desses produtos não afetam só saúde humana, mas ao meio ambiente mas também o meio ambiente, à medida que contaminam o solo, a água e favorecem a extinção da fauna. Evidencia-se, assim, que o uso intensivo dos agrotóxicos não pode ser permitido, pois é prejudicial tanto do ponto de vista social como ambiental.', 'Cabe, portanto, ao Ministério Ambiente aos ministérios do Meio Ambiente e da Saúde promover debates sobre os impactos dos agrotóxicos na esfera ambiental e na saúde humana, no intuito de aumentar a pressão sob o congresso Congresso para que seja coibido coibida a flexibilização do seu uso. Somado a isso, o governo federal poderia ceder lotes de terras que não estão cumprindo sua função social e ajudar com subsídios as famílias camponesas, de modo que a agricultura familiar voltada à produção orgânica fosse estimulada. Resta saber se os governantes vão priorizar os interesses da população em geral ou apenas àqueles voltados aos aspectos econômicos.']",160,160,120,160,160,760
92,preconceito social,"['Perigo amarelo (tambem conhecido como terror asiático e espectro amarelo) é uma metáfora racista que descreve os asiáticos orientais como um perigo e uma ameaça psicocultural do mundo oriental, o medo do perigo amarelo era mais racial do que nacional, um medo derivado não da preocupação de uma fonte especifica de perigo ou de qualquer pais ou povo.', 'Como uma forma de xenofobia esse termo foi usado varias vezes por sociólogos e imperadores no final do século XIX,  sociólogo russo Jacques Novikow cunhou o termo no ensaio ""Le Péril Jaune"" (1897); mais tarde, o imperador Guilherme II da Alemanha (r. 1888–1918) usou este termo a fim de incentivar uma invasão por parte da Europa para conquistar e colonizar a hina, esses são apenas dois exemplos de como esse termo foi e ainda é usado de forma extremamente agressiva. a atualidade existem casos graves de preconceito amarelo que são minimizados, isso porque a sociedade foi dividida entre pretos e brancos excluindo assim as pessoas amarelas de forma com que elas fossem incluídas ao grupo de pessoas brancas.', 'É importante que a escola leve a diversidade cultural para dentro da sala de aula e converse com os alunos sobre a justiça racial,  tambem de extrema importância que as pessoas tenham acesso a essas informações em casa  e para que isso aconteça é responsabilidade do ministério da educação estabelecer meios de acesso para que todos possam receber esse tipo de informação, e não só isso mais é necessário que a secretaria nacional de segurança publica estabeleça meios de comunicação e apoio para as pessoas que sofrem preconceito , esses casos devem ser tratados com seriedade e trazer resultados assim as vitimas não terão medo de denunciar pois terão a total certeza que a justiça será feita.']",160,120,80,120,120,600
78,Brasil para estrangeiro ver,"['Desde a idealização do Brasil, quando esse ainda era uma colônia portuguesa, a influência de nações estrangeiras no país foi e ainda é notável . Atualmente, essa tendência ainda se mantém e a proposta de reformulação do ensino médio tem como base a experiência de terras estrangeiras. Apesar de que o sistema educacional que o país tupiniquim quer adotar faz uma diferença positiva em outros países , há de se destacar que a atual situação educacional brasileira não consegue manter nem as estruturas mínimas necessárias para estar em concordância com uma futura reforma.', 'Para exemplificar, alguns dados. Segundoc matéria publicada no site Portal Brasil, passa de um milhão o número de jovens de 17 anos que, em termos normais, deveriam estar concluindo o ensino médio, mas estão fora da escola . Seguindo a análise dos dados da juventude verde e amarela, cerca de 1,7 milhão de jovens nem comparecem à escola e nem ao mercado de trabalho. Essas informações ajudam a compreender que antes de uma reforma, o nosso país deve priorizar ao menos o comparecimento e o investimento mínimos necessários para a educação nacional.', 'Uma forma de tentar corrigir o atual problema seria a criação, por parte do setor executivo Federal, de ministérios da educação subalternos nas cinco regiões do Brasil. Dessa forma, o encargo das melhorias na educação atual brasileira não ficaria apenas sob responsabilidade do atual Ministério da Educação, que é único. A parte financeira para se manter tal projeto seria advinda do atual plano de reforma, ou seja, ao invés de ir para a reforma, o dinheiro irá ser direcionado para a melhoria do atual sistema educacional, que já perdeu as contas e a noção concreta dos problemas que possui.', 'Partindo de tal proposta de conserto, surge uma ideia central: não há possibilidade mínima de se reformar algo sem ter as estruturas básicas garantidas, basicamente, a renovação se torna inválida se alguns defeitos graves forem conservados . Com base na discussão até aqui construída e com um olhar para o futuro, o Brasil necessita se livrar dos grilhões que o mantém preso a outros países e, eliminando de vez os problemas da educação atual, mostrar para o exterior a grande educação de um país que foi subjugado desde sua época de colônia .']",120,120,120,120,120,600
82,Hábito Controverso,"['É um hábito da sociedade, ao se deparar com anormalidades em relação a sua saúde, buscar a automedicação, sem o diagnóstico de um profissional da saúde. Mesmo comum, tal ato gera diversos questionamentos quanto a sua adoção.', 'O cenário da saúde pública e privada tem sido um dos principais fatores contribuintes para a difusão e manutenção desse hábito, considerando os tempos de espera e a precariedade dos serviços, aliados aos altos custos de consultas e tratamentos, quando a busca é por hospitais privados.', 'Dessa forma, tem-se têm-se / há] dois lados conflitantes: a saturação do sistema de saúde e os riscos que a automedicação pode trazer, como intoxicação e o agravamento do quadro de saúde devido a reações alérgicas e combinações indevidas de remédios.', 'É notório e bastante discutido que a automedicação poderia ajudar a desaforgar o sistema de saúde. No entanto, julgar que certos casos podem ser tratados com a  automedicação pode ser bastante arriscado e problemático, uma vez que a minimização de sintomas pode não significar a cura e há grande probabilidade de diagnósticos errôneos, sucedidos por tratamentos não apropriados.', 'Não se deve, portanto, admitir a automedicação, mas   sim    exigir um sistema de saúde que atenda a demanda, a começar pelo atendimento médico em farmácias, facilitando o acesso do público, além de ter como meta a criação de hospitais e postos de saúde com atendimento proporcional à  zonas  que serão instalados, seja pelo governo ou a  iniciativa privada. Espera-se que assim os problemas quanto a saúde comecem a diminuir e a automedicação torne-se um hábito obsoleto.']",120,120,160,160,160,720
62,A falta moral e ética nas redes sociais.,"['As redes sociais possibilita a ligação de varias pessoas virtualmente, tendo entre isso acesso a vários tipos de conteúdos e opiniões discursivas. No entanto  se tratando dessa diversificação, a um certo confrontamento na exposição de ideias.', 'Nos conflitos se tratam ideologias e manifestações de pontos de vista particular, fazendo com que indivíduos não reflitam sobre as questões abordadas e acabe compartilhando o preconceito e discriminação, podendo afetar a pessoa a quem se dirige e até causar,  certa forma abusiva ou limitação . Estas abordagens se direciona principalmente em culturas, religiões ou tradições diferentes. Tendo at conteúdos que levam a influência de praticar o racismo, xingamentos, dentre outros. "" Temos de combater, ou seja, colocando as diferenças de lado. Se perguntando por que tantas pessoas se sentem tentadas pelas mensagens extremas de Intolerância contra o outro."" completou António Guterres, ONU.', 'Segundo o psicanalista Contardo Calligaris, doutor em psicologia clínica, faz uma observação,  "" Deveríamos ter limites claros ao que é o campo da liberdade de expressão que é intocável, e o momento em que aquilo se torna uma ameaça.""', 'Sem dúvida diante das afirmações, resulta a ideia que quando as pessoas são atacadas, por suas etnias toda a sociedade é diminuída , ou seja, é necessário que todos tenham consciência do grave risco que a exposição de ódio causa.', 'Tema de tal forma pode sr atribuído em propagandas, discursos ou comoções, junto a partidos e sistemas de organizações, fazendo o indivíduo pensar e analisar todo o contexto.']",120,120,80,80,80,480
93,Os verdadeiros protagonistas de um parto,"['O nascimento de um filho é uma das experiências mais inexplicável e encantadora da vida de uma mulher. Mas, por que então, muitas delas não tem bons relatos e se frustraram com tal momento ? Seria possível mudarmos essa situação? Claramente que sim, através do parto humanizado, que alis, é inteiramente uma questão de saúde pública.', 'Primeiramente, sem dúvida que, um parto com menos intervenções médicas e cirúrgicas, teremos menos partos com risco de complicações e infecções. Diminuindo o número de internações prolongadas e os casos de violência obstétrica , o que resultaria em leitos e profissionais com disponibilidade para receber e atender mais pacientes, evitando também longos períodos de espera por um atendimento.', 'Além disso, a humanização dos partos torna o momento mais acolhedor, passando uma segurança maior para a gestante, vendo ela que o bemestar, a vida dela e do bebê é o mais importante. Claramente que este seja um dos motivos pelo aumento relevante da procura pelo parto mais humano, entretanto, infelizmente, existe poucos hospitais e maternidades com estrutura para esse tipo de atendimento.', 'Certamente que o parto humanizado é uma questão de saúde pública. Como explicado por Juliana do Carmo, enfermeira obstétrica, recém-eleita co-vereadora, em Belo Horizonte (MG), para o Mandato da Coletiva, não há o interesse por parte dos gestores da saúde em criar estes tipos de serviços, cabe sociedade e os representantes a frente do apoio pela humanização dos partos buscarem parcerias e apoio financeiros para manter e ampliar as casas de parto, recorrerem autoridades superiores a gestão de saúde para exigir e receberem o que precisam para que todas as mulheres que desejam tenham acesso ao parto humanizado.']",160,120,120,160,120,680
28,O poder do povo,"['As manifestações públicas se mostraram um fator decisivo ao longo da história do Brasil e do mundo, uma vez que representam o poder que o povo tem dentro da política . Entretanto, devido aos intermináveis escândalos envolvendo país, os protestos passaram a diminuir, em quantidade e intensidade, o que tem piorado cada vez mais a situação política e econômica brasileira.', 'Um exemplo desse fator é a Revolução Francesa. O povo não estava satisfeito com a monarquia absolutista que governava e, por isso, mesmo sendo de uma forma violenta e drástica, lutou para alcançar uma nação mais justa, transformando-a em república, sendo que até hoje esse sistema prevalece . Casos assim também ocorreram no Brasil, como no período da Ditadura Militar , no qual, apesar do conceito de liberdade de expressão não ser algo permitido , muitos eram os que iam às ruas para protestar contra o governo e lutar por um país melhor, o que gerou resultados na época.', 'Nos últimos tempos, desde que os esquemas de corrupção foram revelados ao público, um certo sentimento nacionalista surgiu entre o povo, como foi possível perceber através das manifestações que assolaram todo o território brasileiro. Entretanto, cada vez mais corruptos foram sendo revelados, e esse fator acabou levando muitos a perderem sua fé no país e/ou em sua reestruturação econômica. Em outras palavras, a quantidade de escândalos políticos levou a população a um estado de apatia, no qual o “tanto faz” passa a ser uma expressão dominante.', 'Portanto, percebe-se que a população tem um papel fundamental no desenvolvimento da política e economia do seu país. Ela tem o controle dos eventos que ocorrem, mesmo que isso seja exercido de forma indireta. Dito isso, cabe aos que não se deixaram abater a promoção de manifestações públicas, que reunirão todos que querem ver uma mudança nos atuais parâmetros que o Brasil tem seguido e, dessa forma, mudar a nação para a melhor.']",160,200,120,160,200,840
96,Joias perdidas em silêncio,"['""Ideologia"", ""O tempo não         pára         "" e ""Exagerado"" são algumas das músicas que eternizaram o cantor brasileiro Cazuza. Outros artistas como Renato Russo e Freddie Mercury também são ídolos até hoje. O que eles possuem em comum? O fato de terem adquirido a Aids, uma doença viral que atinge 600 mil pessoas no         Brasil. Esta         vem sendo esquecida nos últimos anos devido à mídia, aos próprios jovens e ao governo.', 'Os meios de comunicação         em         massa, em especial a televisão, são responsáveis por         esta         situação quando não a abordam de maneira satisfatória. Percebe-se, nesse caso, o pouco espaço dedicado à discussão do tema, visto que muitas vezes o sexo gratuito, banal e despreocupado recebe destaque em programas, em detrimento da relação segura e respeitosa, com o uso de camisinha.', 'Além da                 passividade exercida                pela mídia, está claro que os próprios jovens não se preocupam com a possibilidade de adquirirem a patologia. Com                 essa concepção                , estes não utilizam os preservativos, visto como um falta de confiança para com o parceiro e não realizam os exames que concedem um diagnóstico preciso. Muitos desses indivíduos possuem as informações necessárias para o entendimento da doença, contudo pensam se tratar de algo distante de sua realidade.', 'Bem         como a juventude, o governo também tem dado pouca relevância ao assunto, mesmo que alguns programas já estejam em vigor. Indubitavelmente,                 este                possui                 uma grande influência                , que deveria ser utilizada para a melhoria das taxas ainda elevadas de aidéticos brasileiros. Com isso, as despesas relacionadas à saúde diminuiriam e possibilitariam o redirecionamento do capital remanescente a outros setores. Ganha a sociedade, ganha o Estado.', 'Portanto, é evidente a negligência e conivência de diversos setores sociais com relação ao combate ao vírus. Convém ressaltar a importância da união do público e do privado no investimento em novas pesquisas de tratamentos e nas políticas direcionadas à divulgação e orientação de adolescentes nas escolas. Desse modo, todos seriam poupados da perda de seus ídolos. Cazuza, Renato Russo e Freddie Mercury que o digam.']",160,200,200,200,200,960
83,Um direito humano,"['A prática de esporte sempre foi entendida por órgãos mundiais, como por exemplo a Unesco, como direito humano inalienável, sendo considerada sempre da forma mais universal (e) democratica possivel. Em outras palavras, o direito a pratica de exercício fisico é um direito que deveria ser igual para todos, mas porque deveria? Porque nossa constituição prevê qualidade de vida para todos. Mesmo em uma sociedade desenvolvida, com inúmeros projetos de incentivo enfatizando a qualidade de vida de pessoas que praticam esporte, ainda é nótorio verificar que uma boa parcela da sociedade não tem acessoas práticas de exercícios físicos.', 'Mesmo sendo comprovado que a prática esportiva deste cedo em criança  promove laços de fraternidade, espírito em equipe e boa convivência, ainda é pouco divulgados em nossa sociedade os beneficios desenvolvidos derivados do esporte. Um estudo publicado pela Unesco confirma que adultos que tiveram acessoa pratica de exercícios físicos deste infância, na sua totalidade, são pessoas que contém um nível de qualidade de vida superior a pessoas que nõa tiveram essa oportunidade. São pessoas mais sociáveis e, na maioria das vezes, pessoas com um grande equilíbrio emocional.', 'A prática esportiva significa muito além de uma boa aparência fisicavai muito além de um corpo esbelto. Sendo aplicado Sde forma coerente, possibilita n a formação do caratér de um indivíduo possibilitando o mesmo conhecer atitudes nobres, como exemplo a honestidade, a confiança e, além disso, o respeito pelo próximo.']",80,120,160,120,200,680
89,Tempos difíceis,"['O Brasil,  já estava vivendo problemas políticos e econômicos antes da pandemia. A pandemia só agravou mais a situação do país. O isolamento social e as medidas de segurança sempre foram criticadas por parte do governo, tornando assim muito difícil que a população aderisse os métodos de proteção. A crise econômica também foi um grande contribuinte para o baixo índice de isolamento, pois as pessoas estavam passando necessidades.', 'Os impactos econômicos já estão sendo sentidos no mundo todo. Vários economistas do mundo já estão dizendo que os impactos do corona vírus  já se aproximam da crise de 2008. Os governos na tentativa de auxiliar e diminuir o número de pessoas na rua, conceberam um auxílio emergencial, que dava um quantia para grupos selecionados. Cada país estipulou um valor diferente. Por exemplo, o Brasil ajudou com 600 e 1200 reais.', 'Com as novas variantes do corona vírus o isolamento social ficou bem mais importante, pois o número de casos e mortes por dia estão descontrolados. Hospitais de todo o país estão com sua capacidade no 100%. Esse ano está acontecendo ao contrário, a taxa de pessoas em casa está menor que ano passado. É o reflexo do término do auxílio.', 'Para aumentar a taxa de isolamento é necessário novos decretos mais rígidos do governo, a volta do auxílio emergencial e mais fiscalização em pontos de aglomerações. O auxílio vai dar um estímulo na economia e ajudar as famílias. A compra de vacinas também é fundamental para que muitas vidas sejam salvas. Dessa forma o vírus vai ser vencido e a economia vai voltar a crescer.']",160,120,120,120,120,640
49,...,"['Os influenciadores digitais ou digital influencers tem a capacidade de influenciar outras pessoas a tomarem decisões seja estilo de vida ou consumo. Eles usam as redes sociais para publicar conteúdo relevante para seu público. Alguns exemplos são: Jovem Nerd, Felipe Castanhari, Erico Rocha, eles vivem a base da internet. A relevância dos influencers esta crescendo  tanto nos últimos anos, que a pessoa mais relevante da internet de 2017 foi o Whindersson Nunes e estão mais ativos principalmente nesse contexto atual de isolamento social.', 'Da mesma forma que eles são uma inspiração seja na vida profissional, na saúde ou nos relacionamentos, eles também impõem um padrão principalmente as influencers mulheres. Vale a pena ganhar dinheiro com palestras, parcerias, anúncios e no fim do dia não sentir melhora? Vale a pena assistir os vídeos e depois sentir tristeza ao ver que eles tem uma vida “perfeita”? Não, não vale. Ninguém deveria ser dependente da internet para viver apesar de facilitar muito.', 'Entretanto os influencers também são motivadores por exemplo a youtuber e influencer do Instagram, Nah Cardoso  que constantemente compartilha com o público os seus pensamentos, anseios e sua vida, e também a Manu Gavassi que recentemente participou do BBB e representa muito o empoderamento feminino.', 'Portanto, alguns influenciadores deveriam se precaver com o conteúdo que postam e pensar se aquilo realmente vai edificar alguém, postar mais mensagens motivacionais para que incentive a melhora de vida das pessoas']",120,120,80,160,80,560
108,Desenvolvimento Consciente,"['De país         sub-desenvolvido         para em desenvolvimento, de 3º mundo para emergente. O Brasil deu um salto para o que podemos chamar de progresso.                 Tudo aconteceu muito rápido e agora consequências começam a surgir, um exemplo é o consumo impulsivo.', 'Está          cada vez mais          jovem          os usuários de celulares e smartphones, o que antes só se comprava aos 20, virou presente de aniversário aos 8.                Nem que seja apenas para fins recreativos. Isso acontece pois muitos         pais         para justificar a sua         ausência compensa em         ""presentes"", alimentando assim um futuro consumista inconsequente.', 'Se não invertermos a situação, mais cartões de créditos irão ""estourar"", mais cheques especiais serão emitidos e o país poderá entrar em crise financeira,                assim como os E.U.A         e         Europa. E como quase tudo, as medidas mais notáveis de prevenção         tem que ser tomadas de pequeno, ensinando         que nem sempre querer         não é         poder,         mais sim necessario.', 'O consumo administrado corretamente eleva o país perante o mundo. Porém se usado erroneamente o afunda em         dividas         .         O futuro para um Brasil melhor         depende de nossas atitudes.']",120,160,120,120,120,640
87,A infância como um bem social,"['A Constituição federal de 1988 garante como direito social a proteção à infância. No entanto, tal garantia é deturpada, haja vista a cultura da erotização infantil, que tem se tornado cada vez mais comum na sociedade hodierna. Esse problema advém, sobretudo, da negligência governamental e da educação lacunar.', 'Em primeira análise, o descaso do governo é responsável pelo problema. A esse respeito, segundo o filósofo Thomas Hobbes, o Estado é responsável por garantir o bem-estar da população, o que não ocorre no Brasil. Como resultado da omissão das autoridades, a sexualização precoce não encontra barreiras efetivas e, por consequência disso, se expande de maneira quase incontrolável.', 'Ademais, o ensino fraco oferecido no país é outra causa do impasse. Para o filósofo Kant, o ser humano é resultado da educação que teve. Dessa forma, o ensino pode também ser responsabilizado pelos problemas sociais, inclusive pela erotização de crianças, pois, com a ausência da educação sexual nas escolas, o público infanto-juvenil muitas vezes não consegue distinguir o que é adequado para sua idade do que viola sua infância, o que dificulta a resolução da mazela.', 'Portanto, uma intervenção faz-se necessária. Cabe, então, ao Ministério da Educação- responsável pelo sistema educacional brasileiro- criar uma campanha destinada ao combate a ""adultizacão"" de crianças. Essa campanha deve ser feita nas escolas nacionais e deve conter palestras e teatros de fácil entendimento para o público infantil, a fim de que as crianças entendam a importância da preservação da infância. Além disso, o governo deve fortalecer a fiscalização sobre a sexualização precoce em prol do bem-estar social. Assim, poderá se consolidar um país melhor.']",200,200,120,200,200,920
54,,"['A decadência das vacinações no Brasil levanta o receio, por parte do sistema de saúde, de um possível retorno de doenças graves, podendo dar início à endemias e até mesmo epidemias. Com o aumento da proliferação de vírus, por acarretamento da poluição, descaso com saneamento básico e outros fatores, a população se torna mais vulnerável a adquirir problemas de saúde, que podem ser evitados através da aplicação de vacinas.', 'A preocupação do governo brasileiro com campanhas vacinais tem um histórico antigo que pode ser observado no início da década de vinte , quando Oswaldo Cruz foi encarregado da criação de vacinas obrigatórias que erradicassem febre amarela , varíola e peste bubônica,  no intuito de melhorar a situação da saúde pública. A reação negativa de parte dos cidadãos, nos dias atuais, pode se refletir nos acontecimentos da época, onde milhares de pessoas foram contra a obrigatoriedade vacinal, por não terem a conscientização de importância da mesma.', 'Como consequência do enfraquecimento das campanhas de vacinação, além do aumento de enfermidade nacional, há a questão de mal estar social por parte das camadas mais pobres, que são as mais prejudicadas em todo o cenário. Pessoas de menos valia financeira se tornam mais suscetíveis à falta de informação e acesso ao atendimento médico necessário, além da exposição à condições precárias de saneamento, o que implica na maior dificuldade das mesmas, em relação à outras que não sofrem com um país desigual e hierarquizado.', 'Sendo assim, é clara a importância do aumento de postos de saúde e consultas médicas gratuitas , com a distribuição de vacinas oferecidas pelo Sistema Único de Saúde e a propagação de informações necessárias pelas escolas e pontos de mídia que possam fazer entender o tamanho da necessidade das vacinação para a população brasileira.']",120,120,120,120,80,560
91,isabela,"['O negacionismo científico crescente no século XXI atinge as diversas camadas na ciência, como a rejeição ao modelo do globo comprovado a séculos pelos terraplanistas , negação atual da veracidade da vacinação. Nesse contexto, tal problemática acompanha efeitos nocivos para toda coletividade. Isto posto cabe analisar a ascensão das fake news, bem como a má formação educacional das futuras crianças - como consequências dessa negação.', 'Em primeiro plano, notabiliza-se o crescimento da disseminação de notícias falsas. Dessa forma, em exemplificação, durante a pandemia de COVID-19 diversas frentes contra o desenvolvimento das vacinas surgiram. Essas negavam a sua atuação e, por conseguinte, abriam-se espaços para o engajamento e disseminação de medicamentos e receitas sem eficácia comprovada nas diversas redes sociais. Assim, tais fake news fomentam um trabalho contraproducente à erradicação do vírus.', 'Outrossim, futuras sequelas educacionais são perceptíveis dentro dessa discussão. Segundo o naturalista Lamark e o filósofo Kant, a educação o meio são fatores determinantes na formação humana. Em paralelo, jovens e crianças inseridas na atual realidade na qual a internet está mais rápida e presente, a influência desta transborda ao meio. Sob esse ângulo, torna-se descomplicado o recebimento da desinformação advinda de fontes negacionistas, o que proporciona convergência entre informações educacionais construtivas e destrutivas - propiciando lacunas educacionais nesses jovens.', 'Em suma, tendo exposto a questões que englobam os efeitos do negacionismo científico - interferências são necessárias. Desse modo, é vital a ação do Ministério da Educação na implementação de aulas, na grade curricular dos estudantes de ensino fundamental e médio, com profissionais qualificados entre professores, agentes federais de crimes cibernéticos e especialistas, sobre as fake news na esfera científica dentro da internet . Nesses encontros, o debate deve se estender às aulas de ciências naturais como conteúdo interdiciplinar - com o fito de elucidar os  jovens e crianças sobre a veracidade dos conteúdos circulados nas redes em contrapartida aos apresentados nas escolas.']",160,160,120,200,160,800
56,A situção caótica dos presídios,"['Parafraseando o artigo 5º da Declaração Universal dos Direitos do Homem, a tortura e desumanidade são intoleráveis, portanto, atingem a integridade física e mental do indivíduo. Entretanto, no que tange as condições do sistema carcerário no Brasil, percebe-se não somente a violação aos Direitos Humanos, como também as constantes rivalidades entre facções criminosas devido a busca por ""autoridade"" nos presídios ou pelo comando no tráfico, que acarretam muitas vezes em massacres. Logo, é relevante analisar as causas e consequências desse problema.', 'Primeiramente, cabe pontuar que,  a superlotação das celas, a falta de projetos educacionais e as punições brandas são algumas das causas que geram o cenário caótico das unidades prisionais do país. Isso ocorre porque o próprio Estado torna-se ineficaz ao internalizar métodos para combater o crime organizado, muito menos melhorar as condições insalubres ao qual os presos são submetidos tais como alimentação e higiene. Sendo assim, além da negligência, há também a falta de rigorosidade na legislação brasileira, uma vez que a justiça diminui a sentença ou concede liberdade provisória, mostrando a ineficiência na aplicação das punições, deixando a sociedade cada vez mais indignada e ameaçada.', 'Além disso, o investimento em cursos profissionalizantes à presidiários podem ajudar não somente na qualificação do indivíduo, como também no processo de reintegração social, pois teriam uma nova chance para seguir uma vida digna e honesta, sem voltar para a marginalidade, mas, existem questões burocráticas que dificultam para essas mudanças como por exemplo, o envio de verbas para promover os projetos. Dessa forma, deve-se-à compreender que todos podem mudar e ser bons cidadãos, desde que cumpram as condutas corretas.', 'Portanto, o artigo 5º mencionado inicialmente, mostra que não é através da intolerância que o Brasil ganhará progressos, e sim, estabelecendo pequenas atitudes que corroboram para diminuir a violência dentro dos presídios. O Estado precisa buscar soluções cabíveis, tanto para reforçar a segurança nas cadeias, quanto na educação profissional, através de palestras feitas por psicólogos e reforço nas leis, evitando impunidades. Somente assim, será notável e ao mesmo tempo, teremos  o respeito e dignidade de todos.']",120,160,120,160,120,680
81,,"['Ao analisar os noticiários no dia-a-dia  ?  vê-se  inúmeros casos de preconceito entre religiões, seja no Brasil ? ou  no mundo. Quem não se lembra dos ataques a um jornal francês por publicarem uma charge sobre o islamismo . Ou uma jovem q foi apedrejada no Rio de Janeiro por ir a  escola com roupas típicas do candomblé? Os casos são muitos. Mas como inibir ou de fato extinguir esse mal tão enraizado nas sociedades se quando questionados todos dizem ser tolerantes e sem preconceito?', 'Em primeiro lugar, é importante dizer que leis já foram feitas e vêm surtindo efeitos positivos na sociedade. No entanto, como toda lei, não foi o bastante para acabar de vez com as intolerâncias. Fato compreensível, uma vez que este  problema está no Brasil desde antes dele se chamar Brasil. Nossa nação foi criada em preceitos de Portugal, que já chegou se impondo superior e obrigando os índios, que já tinham suas próprias crenças, a se converterem ao catolicismo, ? o mesmo aconteceu com os escravos posteriormente. Porém ? o tempo passou, Lutero fundou o evangelismo, que hoje se subdivide em outras categorias, que mesmo crendo no mesmo deus, não se entendem ou se respeitam, o que chega a ser controverso, pois o livros  guia das religiões com mais devotos no Brasil e no mundo, a bíblia, prega o respeito e o amor ao próximo acima de tudo. E se engana quem pensa que a intolerância religiosa se restringe a religiosos, ateus e agnósticos sofrem o mesmo ou mais, ? por não seguirem aquilo que dizem ser sagrado.', 'Sendo assim, há solução paras  essa triste realidade? Tem de haver ? e o primeiro passo seria o aprimoramento das leis já existentes ? além de uma parceria entre governo, escolas, ongs , famílias e sociedade em geral para incitar o respeito e a empatia ao outro. A disciplina ‘Ensino Religioso’ é de grande utilidade, sendo válido expandi-la para todas as series  da fase escolar. É de grande valia também o acompanhamento a domicilio , uma vez que a aprendizagem começa em casa. ? Pois a única maneira de se lutar contra a intolerância de qualquer tipo é a partir do conhecimento ? respeito e educação.']",120,160,160,120,160,720
92,Preconceito amarelo - Um problema na sociedade,"['""Construímos muitos muros e poucas pontes"". Essa frase tão marcante  que o teólogo e cientista inglês Isaac Newton disse, pode ser facilmente aplicada ao comportamento da sociedade diante do preconceito com asiáticos, principalmente chineses, já que esse imbróglio é visto diariamente por conta da construções de barreiras sociais e a escassez de medidas públicas para a sua erracadicação . Assim, fica evidente que esse cenário traz a conclusão,  que precisamos combater esse tipo de racismo, que ficou mais presente ainda,  na pandemia do novo coronavírus. Desse modo, atuam agravando o quadro da situação não só o Poder Judiciário como também o Ministério da Educação.', 'Acima de tudo, o teórico político conceituado, Edmund Burke disse uma vez que toda lei tem apenas dois fundamentos: equidade e a utilidade. Após isso, fica evidente a necessidade de ambos princípios para que possamos viver em união em nossa sociedade, mas por conta do preconceito com os de descendência de povos oriundos da Ásia, não vemos isso no nosso cotidiano. Com certeza, se o Poder Judiciário cumprisse com sua obrigação, de zelar pelos direitos das pessoas e resolver os possíveis problemas entre elas, não veríamos tantos casos de preconceito amarelo.', 'Imediatamente lembramos da frase  do famoso filósofo alemão, Immanuel Kant que dizia: ""O ser humano é aquilo que a educação faz dele"". A educação tem uma extrema importância, na vida e na formação do indivíduo, se o governo investisse mais no Ministério da Educação, para que possa criar medidas socioeducativas no ambiente escolar, ensinando sobre a importância de não aceitar o preconceito amarelo, nem praticar, além de promover palestras com o conselho sobre o assunto, com responsáveis, pais e até mesmo os estudantes.', 'É necessário, dessa forma, que atitudes sejam tomadas para resolução do contratempo. É fundamental, portanto que o Poder Judiciário e o Ministério da Educação, cumpram  com seus respectivos deveres na sociedade, por meio de medidas socioeducativas e públicas, para que a população tenha seus direitos assegurados e saiba mais sobre o assunto. Sem dúvida, se não praticarmos esse tipo de racismo e entendermos que todos tem lugar na nossa pátria, conseguiremos ter equidade e utilidade, que Edmund Burke tanto disse.']",160,160,120,160,160,760
44,Crise hormonal no desporte,"['O mundo dos esportes é pautado pela competição. Vence o mais concentrado, o mais técnico ou mais veloz. Nesse último campo, porém, crê-se existirem desafios que podem torná-lo desvantajoso para uns e hiper vantajoso para outros. Cabe pontuar, portanto, como se comporta tal teoria no que tange competidoras femininas e o impacto disso em suas carreiras.', 'No universo do atletismo, a mulher deve apresentar em seu sangue quantidade de testosterona inferior a 5 nmol/L. Essa exigência ignora completamente quaisquer outras comprovações de seu sexo, além de possíveis alterações hormonais inatas. A solução apresentada é um inibidor hormonal que ""normalize"" essa taxa dando a mulher o direito de ser considerada assim.', 'A recusa de prosseguir com esse tratamento pode significar o fim de suas carreiras, já que a Confederação Internacional entende isso como uma vantagem competitiva, um dopping não intencional. Essa medida, entretanto, expõe mulheres à situações vexatórias por colocar em dúvida desnecessária seu sexo biológico indiscutível e esse sim, devidamente comprovado, fazendo-as passar por exaustivos exames e tratamentos invasivos.', 'É de extrema importância, portanto, reajuste na legislação desportiva e cumprimento visando a regularização de tais competidoras levando em conta seus fatores genéticos e, comprovado o não uso de anabolizantes, permitirem sua participação plena no esporte.  É inconcebível depois de tantas lutas por direitos reconhecidos, a necessidade de se provar ser mulher.']",160,160,120,120,120,680
55,,"['A chegada dos portugueses em 1500 na América resultou no conhecido Descobrimento do Brasil, porém essa parte do continente não necessitava de descobrimento  uma vez que por toda a sua extensão já habitavam milhares de indígenas, cujo a importância era extrema tanto nos cuidados da flora e fauna, quanto na criação de uma certa base cultural, originada por eles . A chegada de tais colonizadores resultou em extermínio e desvalorização completa do conhecido índio, porém os eventos antes conhecidos como parte do passado se repetem, mesmo que de maneira amenizada e menos violenta, no presente.', 'Convém ressaltar que o desmatamento desenfreado que busca suprir a necessidade da ocupação urbana ou rural é um dos maiores fatores que colaboram com tal busca constante dos indígenas por seus direitos e valorização, sua sobrevivência é colocada a segundo prazo e o interesse da população que se sobressaí em números é rapidamente suprido, mesmo com tais consequências .', 'Sendo assim o que lhes resta é a batalha contra um povo que não os ouve e os considera atrasados, já que é comum por exemplo o pensamento de que o indígena deveria se adaptar á cidade e não ao contrário, assim como os costumes, crenças e culturas das tribos, que além  não possuírem nenhuma importância podem ser simplesmente esquecidos e substituídos por todos os valores hoje conhecidos.', 'Contudo, com órgãos do governo que visem a garantia de tais áreas destinadas e assegurem sua propriedade a essas pessoas o problema pode ser contido, assim também como o papel da escola através de discussões e estudos evidenciando o papel da sociedade indígena na construção da nação que conhecemos  hoje, para que haja uma mudança de pensamento e quebra de preconceitos.']",120,120,120,120,120,600
133,O Estado é caracterizado pela sua população,"['Percebemos no mundo contemporâneo dois modelos de Estado: o liberal e o         hierarquizado  , o         primeiro tem como         grande protagonista         os Estados Unidos e                 fez uma grande estátua como marco desde processo que nomeou como Estátua da          Liberdade  , e o         segundo tem como exemplo o         Brasil         onde a                 sociedade se diferencia pelo “status” social                .', 'O modelo de Estado         liberal         que teve como precursor os         norte americanos         antes de sua independência já         apresentavam         uma cultura liberal, mas a coletividade se destacava naquela nação, pois todos os cidadãos         tem         os mesmos direitos e deveres não importando sua etnia, cultura ou classe social.', 'Nos Estados com características hierarquizadas, com temos por exemplo o Brasil, desde sua busca pela         independência         o individualismo, os favores, se destacam, seja pela cultura do         beija mão         ou por coroar alguns indivíduos que se destacaram em algum esporte (Pelé é rei), ou programas de televisão (         Xuxa         a rainha dos baixinhos).', 'Antropólogos como Roberto Kant de         Lima, fez         um estudo         onde          comprovou                o modelo de Estado dos Estados Unidos e do         Brasil, com isso         associou-se o primeiro         pais         como tendo um modelo que se assemelha a uma figura de formato de um paralelepípedo, onde a base da figura é igual ao topo e com isso os direitos e privilégios são iguais para todos os         cidadãos, já no         segundo modelo tem o formato geométrico de uma pirâmide, onde a base é maior que o topo, sendo assim indivíduos         desta         sociedade “brigam” por interesses particularizados e temos uma sociedade desigual.', 'Podemos concluir que o Estado não precisa controlar sua população e sim cada cidadão se conscientize em fazer o melhor, sem tirar vantagens, pois assim iremos melhorar a vida da coletividade e precisamos apenas de um governo que nos represente nas esferas internacionais pensando sempre na coletividade.']",160,120,80,120,120,600
56,Da Situação à Solução,"['Nos últimos anos dobrou a população carcerária no Brasil, sendo o terceiro país com mais presos  ultrapassando o limite nas penitenciárias, ocorrendo então a superlotação com mais de 840 mil presos.', 'De acordo com a Lei de Execução Penal a assistência ao preso é dever do estado, para prevenir o crime e orientar o retorno à convivência em sociedade. Diante o Levantamento Nacional de Informações Penitenciárias (INFOPEN) mais da metade da população são jovens de 18 a 29 anos, os dados revelam que 95% dos presos são homens e 5% mulheres e 89% não tem Educação Básica completa. Contudo no país as taxas mais elevadas de acordo com a população,  seria no Mato Grosso do Sul e no Acre. Com a superlotação ocorre então sérios problemas, além de crimes, brigas, doenças transmitidas, torna-se um ambiente de difícil convivência, ocasionando várias mortes e com tudo isso familiares dos penitenciários também sofrem por um familiar que está preso, por várias vezes esse não ter direitos e ainda em alguns casos passar por situações completamente desumanas.', 'Conforme essa situação uma das saídas seria o estado ofertar serviços, ações, dando oportunidades aos presidiários de voltar à sociedade e a convivência. Outra saída seria uma educação nas penitenciárias abrangendo mais saberes sociais, envolvendo a esperança, ética, com conversas no coletivo, com tudo isso estaria ajudando o próximo a voltar à vida.']",120,120,80,120,80,520
47,Ensino a distância,"['Surgido da necessidade de eliminação das barreiras físicas entre professores e alunos e de uma demanda cada vez maior pela educação, o ensino a distância não é uma novidade trazida pelo segundo milênio. No final do século XIX já era possível realizar cursos por correspondência ofertados pelas Universidades de Chicago e Oxford. Em território brasileiro, o famoso Telecurso 2000 foi criado com a proposta de fornecer educação fundamental e técnica por meio da mídia televisiva e conseguiu atingir um grande número de pessoas que viam nessa oportunidade um recurso educacional barato e viável.', 'Nos dias de hoje, o desenvolvimento do campo da comunicação tem influência direta sobre a qualidade e disseminação dos serviços de EAD. Nesta perspectiva, o acesso à internet faz-se imprescindível para a garantia de um ensino pleno, estimulante e que favoreça o desenvolvimento de autonomia didática. Levando-se em consideração as afirmações anteriores , pode-se identificar a inclusão digital como a principal dificuldade enfrentada pelo EAD no Brasil, tendo em vista as significativas taxas de desigualdade social e o alto percentual de lares sem estrutura tecnológica para mediar o aprendizado. Para além disso, o ensino a distância ainda carrega estigmas que revelam a existência de uma desconfiança relativa a efetividade desta modalidade de ensino, contudo,  tal receio só se justifica quando o ambiente físico e psicológico não é adequado para tanto.', 'A pandemia em decorrência das infecções por COVID-19 neste ano  mostrou com mais clareza algumas arestas desta modalidade de ensino e permitiu reflexões acerca da viabilidade da estrutura em substituição ao ensino convencional. Dentre estas, incluem-se os seguintes questionamentos: como, em um curto período de tempo, capacitar os professores que ainda encontram dificuldades no manejo das ferramentas de interação digital e garantir que os estudantes de baixo poder aquisitivo tenham acesso ao material necessário para realização do ensino remoto?', 'Diante deste cenário entende-se como fundamental o fortalecimento de políticas públicas de inclusão digital por meio da prestação de auxílio financeiro para contratação de pacotes de internet e compra de equipamentos pelas famílias carentes. Adicionalmente, o desenvolvimento de plataformas responsivas que funcionem bem no formato mobile é relevante  já que torna opcional a utilização de eletrônicos caros como os computadores e notebooks. Sugere-se ainda a valorização da interação nos sistemas de aulas virtuais por meio da criação de fóruns e bate-papos de modo a fortalecer interações sociais e resgatar o papel, antes exclusivo do ambiente escolar, de formar cidadãos.']",160,160,120,160,120,720
75,combata o trafico não o porte,"['Foi liberado o porte de armas de fogo no Brasil. É um assunto polêmico devido as fatalidades que estão acontecendo no mundo e  principalmente no rio de aneiro. É melhor com ou sem o porte?', 'A realidade é que se não houver o porte para o cidadão comum  aqueles que são corruptos vão continuar possuindo armas. Um exemplo disso é o porte de armas altamente perigosas como as de uso exclusivo da foras armadas e que está nas mãos de traficantes. Um dia desses um indivduo mal intencionado entrou na escola dos estados unidos e só parou de matar porque outro individuo estava com uma arma segundo a folha de São Paulo.', 'É preciso o porte, porque bandidos não vão deixar de usar armas com porte ou sem. O cidadão com o porte está mais seguro e além disso qualquer bandido vai pensar mais de duas vezes antes de qualquer atitude. Há dados que sem o porte de armas morre mais gente aqui no Brasil  com destaque para o rio de janeiro do que em paises que estão em guerra como a síria segundo a revista Veja.', 'É claro também que algumas medidas de segurança tem que continuar sendo feitas como o combate ao tráfico de armas que vem do Paraguai e Venezuela. É necessário o apoio integral do ministro da defesa Raul Jungmann nessa questão. O combate não deve ser ao porte legal, mas ao tráfico ilegal de armas de uso Exclusivo das foras armadas.']",120,80,120,120,120,560
98,"O cruel jogo da ""trash-food"" no Brasil imediatista","['A população obesa no Brasil vem crescendo consideravelmente nos últimos anos. Isso se deve à proliferação                das redes de “fast-food”, cujo carro chefe é um combinado de sanduíche, batata frita e refrigerante         , pelo país.         O fato de o índice estar mais alto entre crianças e jovens reflete o poder da propaganda sobre eles. Mas as crianças não podem carregar sozinhas a culpa pelo que ingerem                a grande maioria delas não sabe o risco e os males futuros desse tipo de alimentação.', 'Toda criança começa a construir sua personalidade muito cedo, começa a escolher o que vai vestir, onde quer passear, que amigos vai fazer e também o que vai comer, por isso é importante o exemplo dos pais na vida deles. Os pequenos demonstram grande admiração pelos parentes próximos e tendem a imitar o que esses fazem. Se os pais forçam os filhos a se alimentarem corretamente em casa, mas sempre os levam para lanchar em redes de ""fast-food"", o ensino nunca será eficaz. As crianças se vêem num mundo em que tudo acontece muito rápido e deve-se aproveitar ao máximo toda e qualquer experiência, logo, na hora de comer, querem algo que         os         satisfaça, seja gostoso, agrade ao seu grupo de amigos e não tome muito tempo para que elas se divirtam depois.', 'Como as crianças acreditam nos encantos da propaganda das                 ""trash-foods""                , o governo pode contribuir adotando leis sobre o horário em que                 elas                serão exibidas, de modo que os alvos sejam apenas adolescentes e adultos, já que apresentam certo conhecimento sobre o prejuízo de se alimentar mal e não se deixam influenciar tanto pelo marketing. Além disso, cabe à família mostrar para as crianças que comidas saudáveis podem ser gostosas e atrativas visualmente, como as                 ""junk-food"",                basta que o prato seja montado de forma adequada e envolva a criança no preparo, fazendo da alimentação algo divertido e prazeroso para pais e filhos.', 'Portanto, podemos concluir que o segredo para combater a obesidade no Brasil é o equilíbrio. Proibir o consumo de comidas inadequadas ou deixar que os jovens escolham livremente o que vão comer não são opções sensatas. A família deve mostrar a eles que                 uma alimentação saudável é importante para a saúde e para a auto-estima e não os priva do convívio social,                e que a ingestão de comidas mais gordurosas e calóricas algumas vezes é perfeitamente aceitável.']",160,120,120,120,160,680
21,Greve dos caminhoneiros?,"['Dependentes quase que exclusivamente do transporte rodoviário de cargas, o Brasil encontra-se em estado de alerta; caminhoneiros de todo país, através de um movimento reivindicatório, conseguiram “parar o país”. Entretanto, como mostra a pesquisa Datafolha, 87% da população brasileira apoia o movimento grevista. Será que apenas o preço do óleo diesel e outras reivindicações como o fim do pagamento de pedágio por eixo suspenso de caminhão fez com que 87% da população brasileira apoiasse o movimento?', 'O Brasil é o país com a maior carga tributária do mundo. Todo mês são arrecadados milhões e milhões de impostos. E, como se não bastasse, o preço do óleo diesel oscilava quase que diariamente. Aumentos sucessivos no preço desse combustível e a consequente falta de planejamento em virtude dos preços a serem cobrados nos fretes fizeram com que os caminhoneiros reivindicassem . O resultado foi a falta de combustíveis nos postos, a falta de alimentos nos supermercados, colégios e universidades paradas, isso sem falar do comércio.', 'Mesmo com tudo isso, o apoio popular foi muito forte. As reivindicações não são apenas por preços mais baixos de combustíveis e melhores condições de trabalho, mas pelo grande quadro de corrupção instaurado na cúpula do sistema político brasileiro. Enquanto o povo assiste a aumentos sucessivos de impostos, políticos corruptos são mostrados pelas mídias sociais com malas de dinheiro desviadas dos cofres públicos, fazendo pagamentos de propina e, em virtude ao foro privilegiado, retardando as investigações e a própria eficácia da justiça.', 'A insatisfação da população é com a corrupção. Hoje, os verdadeiros representantes do povo são os caminhoneiros.']",160,160,160,120,80,680
75,Legítima defesa,"['Legítima defesa', 'A teoria de Darwin nos traz o conceito de que quem se adapta vive melhor, visto que vivemos em um país com altos índices de criminalidade,  é plausível que haja o livre porte de armas para a população. Dessa maneira são um retrocesso as leis que desarmam a sociedade, pois no mundo contemporâneo há déficit de policiais e de segurança.', 'De um lado a carência de forças de segurança gera maior violência , principalmente nas capitais Brasileiras . Como foi noticiado recentemente pela mídia o caso do senhor conhecido como “Marechal”, de 70 anos que foi assassinado por traficantes após ajudar um policial, então é notável que a quantidade de agentes não supre a necessidade da população . Dessa forma é de suma importância que indivíduos possuam armas para sua legitima defesa e, assim, diminuam os números de mortes violentas.', 'De outro lado a falta de segurança é um empecilho no direito de ir e vir da sociedade. O economista e escritor do livro “Preconceito contra as armas”, John Lott defende a ideia de que,  quanto mais permissão para o porte de arma, mais difícil para um criminoso atacar uma vítima. Desse modo além da segurança o fato das armas possuírem registros é imprescindível para a solução de crimes, aumentando ainda mais a segurança da população.', 'Pode-se perceber, portanto, é um avanço para o país o livre porte de armas de grande importância seja reestabelecida na sociedade a segurança e os índices de mortes violentas diminuam. Precisa-se o governo implante medidas como possuir ficha limpa, oferecer treinamento e realizar testes psicológicos rígidos em indivíduos desejem o porte. Também se faz necessário se fiscalize os estabelecimentos irão comercializar as armas para as medidas protetoras sejam seguidas e a população tenha segurança.']",120,120,120,120,120,600
108,Consumismo,"['Ao sentar no sofá, para         assistir sua         novela depois de um dia cansativo de trabalho, no caso dos adultos, ou até mesmo quando se está assistindo aos seus desenhos animados preferidos, no caso das crianças,         somos          bombardeados                a toda hora pela mídia,         nos incentivando         a consumir. Em épocas comemorativas, isso se torna cada vez mais constante, sem falar nas facilidades impostas pelas lojas,                 sempre dando aquela facilitada na hora da compra.                Embora sejamos seres pensantes, somos facilmente         influenciáveis         por aquelas propagandas bem boladas que apresentam os mais diversos artifícios para nos convencer. Essas propagandas são vistas nos mais diversos meios de comunicação. Outdoors, televisão, rádio, revista, jornais, em ônibus –                 sim, você pode não perceber                , mas até o transporte público é utilizado para vender alguma coisa - enfim, por onde olharmos existe alguma armadilha tentadora de promoção.', 'Outro problema é que as mais diversas faixas etárias são atingidas por essa                 “bomba influenciadora”                . Hoje já é comum se ver uma criança escolhendo o                 que                vai vestir, o                 que                vai comer, o                 que                quer comprar. Baseadas no                 que                veem na televisão durante os intervalos do desenho animado, elas se deparam as táticas utilizadas pelas marcas famosas infantis,                 que                são próprias para esse público e acabam influenciando os pais,                 que na maioria das vezes escutam sempre                a opinião dos pequenos na hora das compras.', 'As datas comemorativas são os dias em que o consumismo é mais evidente. As lojas oferecem longos prazos de pagamento,                 suaves parcelas em várias vezes                , grandes descontos promocionais, fazendo com que o consumidor se ludibrie, aja no impulso e compre mais do que pode, fique endividado e atrapalhe o orçamento familiar.', 'Sociedade consumista é de fato o que estamos nos tornando, seja criança, jovem ou adulto, não devemos comprar mais do que necessário, temos que deixar de nos iludir e cair na tentação de comprar mais e mais. Fazer um planejamento dos gastos         mensais, é         uma boa solução,                 colocando tudo no papel, vendo o que sobra e destinando                para comprar aquilo que                 você                tanto quer, claro, usando outros truques para economizar, como: fazer pesquisa de         preço,         pagar à vista,         que         geralmente as lojas oferecem         descontos.']",120,160,120,160,160,720
110,A procura da humanização,"['Infelizmente a cada dia nos deparamos com notícias que nos deixam cada vez mais         assustados, estamos         entrando em um período em que esses acontecimentos estão virando rotina. O ser humano já não tem noção do que é o certo ou o errado. Segundo                 as leis da          bíblia         ,                 deveremos                amar o próximo como         a si mesmo         , e isso não vem ocorrendo ultimamente,                 as leis                não estão sendo seguidas para o bem comum da sociedade.', 'Dentre essas         noticias         que não gostaríamos de receber, existe uma que         vem sido trazida         com         muito mais         frequência, que deixamos de prestar a devida atenção ao caso.                 Ressaltamos agora, que é, o estupro de mulheres, pois são inúmeros abusos contra este sexo frágil.                Apesar de estarem conquistando sua colocação na sociedade, cuidando de lares, sendo chefes de família e exercendo cargos que jamais foram ocupados antes,         a mulher não está         recebendo         seu         devido respeito,         ainda sim         sendo vistas         como, um objeto de domínio para os         homens,         colocando         seus desejos em primeiro plano e não         dando         a devida importância aos desejos e decisões do sexo         oposto, se         a mulher conversa bem, é graciosa,         se vesti         bem, isso não é visto como um desejo de realização         própria, e sim de         tentativa de         conquista,a         mulher não passa toda a parte do seu tempo querendo seduzir os homens, muitos                estão querendo justificar o ato do abuso         sexual         alegando que a mulher está o todo tempo praticando a         sedução, este         ato monstruoso não pode ser justificado         desta forma,difícil         é encontrar uma justificação plausível         á este         comportamento.', 'Contudo não devemos fechar os olhos e tampar os ouvidos para o que está         á         um palmo do nosso         nariz, devemos         nos unir e                 tentar eliminar as estatísticas. Não é na vestimenta, e nem no perfil doce de uma mulher,que devemos condenar, e sim na alma do ser humano e no caráter de um homem.']",80,80,80,120,80,440
21,Greve,"['A greve dos caminhoneiros deu início devido o aumento de gasolina no Brasil. É notório que esse assunto trás divergências de opinião, pois a ação dos caminhoneiros trouxe consequências a população brasileira.', 'Com o aumento do imposto da gasolina, houve se revolta por parte da população que deu início a greve, que de fato os caminhoneiros são os que mais sofrem com a situação. A greve paralisou o Brasil, bloqueado as principais rodovias e ocasionando no desabastecimento dos comércio levando a falta de remédios, alimentos e combustível nos estabelecimentos .', 'É importante relatar que essa greve fez se necessária para mostrar, os preços abusivos que os brasileiros pagam de impostos. Porém o Brasil não pode parar, devido a inúmeros transtornos que é deixado a Boa parte da população, como indivíduos doentes precisando de remédios, famílias que necessitam do alimento e o direito do cidadão de ir e vir.', 'Portanto, devido aos fatos a primeira coisa a se fazer é que o poder público estabeleça uma queda nos impostos, e que também diminua a carga de trabalho dos caminhoneiros, pois eles são de extrema importância para o Brasil e são os que mais saiem prejudicados com preços abusivos.']",80,80,0,80,0,240
56,situaçao carcerario do Brasil,"['notório que o sistema carcerário brasileiro vem enfrentando ao longo dos anos um grande almento no número de dententos, atualmente o Brasil ocupa o 4ºlugar de pais com maior numero de detentos.', 'As superlotações, os envolvimentos de presos em organizações criminosas e a falha de pessoal, são os principais problemas enfrentados pelas penitenciárias brasileiras. Outro fator que estamos acostumados a ver nos noticiários é a questão das rebeliões em presídios, sempre com resultados lastimáveis de sentenciados que são mortos por seus próprios companheiros, funcionários e familiares de detentos transformados em reféns, resgates e fugas audaciosas e espetaculares realizadas por criminosos, e por fim,  a incapacidade das autoridades em face de organizações de criminosos, cada vez mais presente nos estados brasileiros.', 'Alguns episodios que aconteceram em 2017 denotam a crise nos presidios brasileiros, no dia 1º de janeiro pelo menos 60 presos que cumpriam pena em manaus foram mortos durante uma rebelião, na mesma semana houve um tumulto em uma penitenciaria em roraima onde 33 presos foram mortos.', 'Para uma possivel reverso desse caso cabe incluir questoes tais como a educaçao basica, a grande maioria dos detentos no tiveram melhores oportunidades ao longo de suas vidas, principalmente o ensino para um futuro melhor.', 'O ser humano é aquilo que a educaçao faz dele.']",120,80,80,120,80,480
45,Redação do K.E de Lima,"['O abuso de autoridade presente em quase toda história do Brasil, sendo esse um problema jurídico e social. O abuso de autoridade precisa urgentemente ser erradicado, pois além de no âmbito jurídico ser um ato criminoso e que mancha o nome da instituição a qual o portador de certa autoridade pratica o abuso.', 'No âmbito social o ato de abuso de autoridade gera inúmeros problemas, tais como uma população a polícia ou até mesmo um policial que não cumpre com seu dever , por ter que para isso agir contra um superior hierárquico ou alguém de grau superior nas esferas jurídicas ou governamentais, além de haver casos onde o abuso ocorre de forma indireta, quando amigos ou parentes destas pessoas com certa autoridade usam o nome destas pessoas ou pedem certos favores e estes aceitam que usem seu nome e ou concedem o favor destruindo assim a democracia e minando a autonomia das autoridades de menor escala.', 'Uma medida já adotada é a lei de abuso de autoridade sancionada pelo presidente Jair Bolsonaro, porém essa lei é usada na maioria das vezes em casos que ganham alguma repercussão e para que ela seja melhor aplicada, algumas medidas precisam ser implementadas como a aplicação de penas mais severas, além de criação de comissões internas permanentes em toas as esferas dos poderes e a criação de um portal utilizados por todos eles onde qualquer pessoa que se sinta abusada possa gerar uma denúncia que seja de acesso público no portal e que o processo dessa denúncia seja também de domínio público para que assim toda a população tenha como fiscalizar . Outro ponto que deve se adotar são denúncias anônimas e geradas por terceiros, tendo em mente que em muitos casos o abusado tem medo de represálias como no caso de moradores de periferias e funcionários públicos por diferentes motivos. Por esses motivos a adoção dessas medidas trará autonomia necessária e assim haverá democracia.']",120,120,120,120,80,560
47,"Educação a distância no Brasil, uma discussão social","['A educação é base fundamental na formação pessoal, social e profissional do indivíduo.  E, é por meio dessa prorrogativa pela qual muitos indivíduos brasileiros construirão opiniões próprias e, principalmente sua identidade social na sociedade. Dessa forma, hoje o ensino ganhou variabilidade, ou seja, conhecimento não ficou apenas em salas de aulas, mas expandiu-se para plataformas digitais, online e proporcionou a educação à distância (EAD). No entanto, embora seja moderno, não é universal, pois esbarra na desigualdade social do país e na geografia brasileira, cuja cobertura de internet não abrange as regiões interioranas de forma qualitativa.', 'Nesse contexto, infere-se a questão do ensino a distância na realidade social do Brasil. Posto isto, mais que atribuir modernidade educacional em ambientes virtuais e professores onlines, a resolução inicial deve primar pela qualificação das políticas públicas para depois igualar educação digital qualitativa. Sendo assim, num país problematizado por desigualdades sociais, tais como: distribuição de renda concentrada pela elite , desemprego e dados da Pesquisa Nacional por Amostra de Domicílios – PNAD  a qual mostra um público elitista com maior acesso à internet. Assim, os desafios em quantificar de maneira democrática e universal o ensino EAD permanece apenas nos filmes de ficções do cineasta Steven Spielberg.', 'Por conseguinte, falta ressaltar uma dualidade, de um lado a educação via internet busca espaço de outro há o impasse geográfico brasileiro, no qual em muitas regiões a cobertura de acesso é remota e, às vezes, inexistente; seja pela falta da iniciativa do poder governamental municipal, seja pelo inerte interesse do empresariado em investir nessas regiões . Por isso, o Brasil precisa adequar-se, modernizar não apenas os campos de plantação e rebanho dentro do gronegócio, mas evoluir seus pequenos municípios e, assim, permitir cidades rurais evoluídas ao futuro do conhecimento à distância.', 'Com base nessas considerações, percebe-se os desafios enfrentados para difundir a educação a distância no Brasil. Então, é necessário perfectibilizar resultados. Cabe ao Ministério da Infraestrutura e da Integração nacional formar parceria e buscar estudar as regiões brasileiras mais prejudicadas pelo acesso à internet. Logo, por intermédio de uma Medida Provisória – MP a estruturação possível de cabeamentos e provedores de internet devem ser instalados nesses lugares. Tal iniciativa permite proporcionar investimentos e, consequentemente, trazer outras realidades digitais de educação. Além de melhorar mais um pouco a desigualdade e construir um país justo.']",160,200,160,200,160,880
68,,"['O dia 2 de setembro de 2017 marcou a história do Brasil com o grande desastre ocorrido no Museu Nacional, localizado no Rio de Janeiro. A perda do maior monumento histórico brasileiro e seus diversos acervos, reflete o descaso do poder público frente a tais instituições e ressalta a necessidade da valorização do patrimônio histórico remanescente.', 'As diretrizes curriculares da educação nacional indicam que os espaços não formais de educação devem ser usados como ferramenta de ensino. Portanto, espaços como museus, herbários, memoriais, entre outros, poderiam ser mais explorados pelas escolas, uma vez que são fonte de conhecimentos e experiências que muitas vezes, não podem ser obtidas com o mesmo impacto em sala de aula.', 'Diante do exposto, é preciso reconhecer também, que o patrimônio histórico é, entre outros aspectos, a materialização da cultura e identidade de um povo ou nação. Um grande exemplo disso é o próprio Museu Nacional que foi o palácio da família real portuguesa durante o período Imperial, ou as igrejas em Ouro Preto e Salvador, cobertas por representações religiosas banhadas à ouro. Esses patrimônios histórico-culturais contam o enredo do Brasil.', 'Infere-se assim que os patrimônios históricos devem ser mais valorizados e reconhecidos. O ministério da Educação  deve buscar investimentos para manutenção desses, junto ao ministro da Economia, promovendo um mutirão de reforma dessas instituições. Outra opção seria a integralização dos centros históricos à universidades e centros de pesquisa que promovam campanhas e exposições para que a população visite, doando fundos direcionados a proteção do patrimônio.']",120,120,80,120,120,560
89,As dificuldades da conscientização do isolamento social em uma crise na economia e na saúde,"['No filme sul-coreano “The Flu” é mostrado um cenário fictício de contaminação em massa devido a uma mutação do vírus Influenza. Ao longo da trama, mesmo com o alerta de necessidade de medidas de prevenção por parte de profissionais da área da saúde, os cidadãos ignoram as recomendações, causando uma epidemia dizimadora. Paralelamente, o brasil contemporâneo se vê enfrentando os mesmos empasses acerca da conscientização do isolamento social, devido à falta de apoio das instituições e a falta de consciência coletiva da população.', 'Em primeiro plano, é imprescindível o papel das organizações sociais na conscientização dos habitantes. Na Revolta da Vacina, em 1904, surgiram locais periféricos de péssimas condições sanitárias, devido as reformas no centro do Rio de Janeiro, as favelas. Nesse contexto, foi aplicado a obrigatoriedade da vacina de prevenção à varíola, ignorando as demais dificuldades da população. Similarmente, nos tempos atuais, vemos a negligência governamental por meio da falta de apoio financeiro nas medidas de isolamento, contribuindo para a postura dos brasileiros que, similarmente aos antigos cariocas, não reconhecem as necessidades de seguir as medidas governamentais, dado as suas condições.', 'Ademais, a falta de solidariedade também exerce sua parcela de falta de responsabilidade. É afirmado pelo sociólogo Émile Durkheim a importância da consciência coletiva, esta que envolve a tomada de decisões pensando no melhor para o coletivo, pois a sociedade é o resultado das escolhas do grupo. Aplicada essa filosofia na atualidade, é perceptível como, devido a aqueles que optam por ignorar as medidas de prevenção, o país como um todo se afeta negativamente pela contaminação, apresentando a necessidade de normas que promovam com mais eficiência o melhor para o coletivo.', 'Portanto, a partir da problemática supracitada, é mister que o Estado reconheça à ineficácia das medidas atuais na conscientização do isolamento social e trabalhe na criação de um projeto de lei, a ser enviado à câmara dos deputados, propondo medidas mais rígidas, como a aplicação de multas em caso de frequentação de locais públicos por motivos diferentes de trabalho e necessidades básicas, visando uma maior efetividade na prevenção a contaminação. Sendo complementar a criação de um projeto governamental com a função de bancar parcelas de consumos de necessidades básicas da população carente – como alimentação, energia elétrica e água – minimizando os impactos da crise econômica, transformando o cenário atual de adversidade em algo presente apenas em obras cinematográficas.']",160,160,160,200,160,840
83,Observa o passado de olho no presente,"['Com origem na Grécia e mais de 300(?) anos de existência as olimpíadas ainda permanecem vivas, acontecendo em várias partes do globo. Neste ano foi a vez do Brasil sediar este espetáculo . Apesar de sabermos que é mais que um simples show,oque realmente podemos aprender de benefício nesta e nas anteriores?', 'As suas primeiras aparições na história serviram para substituir as guerras, demostrando a força das nações através de competições de provas de força e de agilidade.  Demonstrando que possuímos a capacidade de encontrar meios de chegar a paz. Situações observadas na própria televisão onde vemos representantes de seus países cumprimentando seus oponentes para uma disputa amigável.', 'Não temos benefícios apenas politícos, continuando . Valores étnicos ,companheirismo,respeito,jogo limpo e questões sobre saúde vêm atrelado para os atletas. Sendo um ponto importante (é) não ser necessário querer seguir carreira para desfrutar de qualquer esporte. Qualquer cidadão pode iniciar uma atividade esportiva.', 'Sendo nossos país o escolhido para ser realizada este evento, nossa nação terá mais chances de se erguer e de demonstrar ao mundo que estamos caminhando para frente, como tantos países fizeram. O interesses pelo esporte crescera pela população, novos esportistas podem surgir. Com isso teremos um maior aumento de pessoas com valores positivos e mais saudades onde Ongs podem facilitar essas oportunidades para pessoas mais carentes. De fato podemos aprender muito com o esporte, observando o que já foi realizado e oque está sendo feito.']",120,160,120,160,200,760
100,Dualidade,"['""Quando alguém lhe oferece um presente e você não o aceita, de quem continua sendo o presente? - De quem lhe ofereceu"". Este é um dito de um sábio chinês que podemos utilizar para referenciar situações ocorridas no conturbado trânsito brasileiro.', 'Dados estatísticos publicados no ano vigente, no estado de São Paulo,         mostra         -nos que a indenização pelo DPVAT (Danos Pessoais Causados por Veículos Automotores em Vias Terrestres) aumentou 36% em relação a 2010, principalmente indenização por óbito.', 'Isto         demonstra como a violência se instalou nas vias públicas. Os motoristas/motociclistas estão estressados por diversos fatores: muitas horas de trabalho, dívidas, problemas pessoais que só aumentam sua impaciência diante do trânsito que não flui, engarramentos enormes, poluição sonora e atmosférica e xingamentos proferidos por todos os lados.', 'É         cada vez mais         frequente         brigas entre os próprios motoristas e entre estes e os pedestres por situações banais que poderiam ser                 resolvidas no diálogo com um sincero pedido de desculpas.', 'Falta educação e paciência. A violência no trânsito deve ser avaliada pelo prisma psicológico:                 o aumento da adrenalina, déficit de atenção e principalmente a falta de gentileza.', 'As autoescolas deveriam não somente ensinar o CTB (Código de Trânsito Brasileiro), mas também e essencialmente a ética, assim motoristas não fariam de seu carro uma arma e haveria menos acidentes fatais.', 'Por todo o exposto,                 a humanidade precisa voltar a ser mais humana e menos insensível, valorizando sua vida e a de quem está ao seu lado, seja por um breve segundo ou por longa data                .']",200,160,160,120,120,760
72,,"['O uso de notícias falsas vem sendo cada vez mais utilizado para promover conflitos e beneficiar os que as pronunciam . Com a chegada das eleições essa quantidade de notícias  chamadas “fake news”, acabam aumentando devido à grande repercussão que trazem.', 'A utilização em massa dessas informações falsas é capaz até mesmo de causar guerras, como é o caso de Kuwait  que estava em um conflito com o Iraque, no qual a filha de um representante do país em um congresso, realizado nos Estados Unidos, deu um depoimento falso em que esta se pronunciou como voluntária de um hospital localizado em Kuwait e afirmou que soldados iraquianos entravam no hospital e retiravam bebês prematuros de incubadoras e os deixavam no chão para levar as incubadoras. O depoimento da garota teve tanta repercussão que ocasionou a votação favorável à guerra  e só depois da notícia ter se alastrado em todas as mídias uma companhia de investigação descobriu que a notícia era falsa.', 'As eleições realizadas em 2016 nos Estados Unidos causaram polêmica e muitos boatos, alguns jornais afirmam que Donald Trump tenha supostamente contratado pessoas para auxiliar em sua campanha, como é o caso do Facebook, que teve maior repercussão com suas notícias falsas que jornais como “New York Times” com suas notícias verdadeiras . E isso pode, de alguma forma, ter feito com que pessoas se sentissem influenciadas para mudar o seu voto.', 'Uma maneira de tentar amenizar o problema das “fake news” seriam mais sites como o StopFake, criado pela ucraniana Olga Yurkova , no qual busca mostrar as notícias falsas que são publicadas diariamente na Ucrânia. A criação de sites voltados a essa causa são de grande importância principalmente no atual cenário de eleições  fazendo assim com que as pessoas comecem a ter mais cuidado e atenção com o que recebem, buscando a fonte da informação e não sendo alvo de mentiras.']",120,160,120,160,120,680
58,Desastres ambientais,"['José de Alencar e outros autores do romance indianista nos fizeram conhecer e', 'entender a relação do índio com a natureza: subsistência, exploração saudável', 'e freada, cooperação. Esse modo de se utilizar da fauna e da flora, no entanto,', 'não é o mais prevalecente no mundo, já que o homem, desde muito antes', 'de essas histórias serem contadas, tm para si duas únicas palavras-chave:', 'desenvolvimento e lucro. A fim de satisfazer essas necessidades inventadas,', 'viemos  explorando, desenfreada e irresponsavelmente, a natureza, sem', 'pensar que – um dia – a humanidade pode ser engolida por essas ações, como', 'recentes acontecimentos vêm sugerindo.', 'Primeiramente, é preciso compreender de que maneira ocorre a exploração', 'de bens naturais. Viemos retirando do meio ambiente muito mais do que', 'necessitamos, muito mais do que o imprescindível para a vida, isso porque nosso modo de viver está intimamente associado ao que é supérfluo. Se necessitamos, por exemplo, de certa quantidade de madeira para a construção de utensílios básicos, encontramos uma maneira de inventar algo de que', 'não precisamos verdadeiramente e acabamos extraindo muito mais do que a', 'quantidade inicial. Essa é, então, uma exploração totalmente irresponsável.', 'Nada disso, porém, seria tão prejudicial se tivéssemos consciência e o mínimo', 'de preocupação com a prevenção de desastres. Falta-nos entender que a', 'natureza não é totalmente autorrenovável e que, mesmo se fosse, ela não teria', 'uma força de regeneração diretamente proporcional à nossa capacidade de', 'degradação. Precisamos extrair menos, de forma consciente, para ajudar esse', 'processo natural e agir ativamente para reparar os danos que fazemos. Além', 'disso, é necessário que tenhamos discernimento e que sejamos consequentes', 'ao nos utilizarmos do meio ambiente, para que verdadeiras tragédias, como o', 'recente rompimento de uma barragem da mineradora Samarco, em Mariana,', 'Minas Gerais, não voltem a acontecer. Isso é possível com um planejamento de prevenção.', 'Fica evidente, portanto, que o jeito com que conduzimos as coisas até agora', 'precisa ser mudado. Já que o caminho mais certo – o de mudar nosso modo de', 'vida e, por consequência, de consumo – é, também, o mais árduo e demorado,', 'deveríamos, pelo menos, nos preocupar com a extração consciente e com', 'preparo contra desastres. Para isso, instituições internacionais, como a ONU,', 'deveriam, juntamente a organizações como a União Europeia e os BRICS,', 'pensar em políticas públicas de regulamentação sobre a utilização dos recursos', 'naturais, além de desenvolver medidas punitivas aplicáveis a empresas ou', 'Estados responsáveis por acidentes. A responsabilidade é a palavra-chave que,', 'de fato, devemos seguir.']",120,160,80,120,80,560
52,A ADOLESCÊNCIA E A GRAVIDEZ.,"['Gravidez precoce, um problema? Na maioria das vezes a resposta é sim. A gravidez caminha lado a lado na adolescência, não por falta de informações, que nos rodeia no século XXI e sim por falta de prevenção, e de certa forma, diga-se de passagem, falta de preocupação.', 'Os riscos de um sexo sem prevenção,  vão além de uma gravidez indesejada, estão expostos à inúmeras doenças sexualmente transmissíveis. A gravidez precoce têm sido vista com mais frequência . Oferecendo riscos para a própria saúde, lembramos quê; na grande maioria das vezes o corpo ainda não está bem estruturado para receber outro ser, podendo acarretar os riscos de hipertensão e até a pré diabetes.', 'Quanto mais nós, jovens, nos manifestarmos, passarmos informações e abrindo os olhos dos colegas ao lado, teremos jovens preparados. Para quem sabe, um dia, estruturado e formado, possa gerar outra vida.']",120,80,40,80,0,320
56,Uma Nova Consciência,"['Enquanto houver gente tirando proveito diante da miséria humana, a situação dos cárceres do Brasil jamais será revertida. Os presídios se tornaram verdadeiras universidades do crime. O sistema é brutal, indigno e falido. O país gasta anualmente 20 bilhões de reais para manter o sistema de degradação humana. Essa é a verdade. Super lotação, infraestrutura inexistente, alimentação precária e o pior   as facções criminosas extorquindo suas aprisionadas vidas. Do jeito que esta esse sistema fracassado de ressocialização não tem solução. Esses prisioneiros são feras feridas,  no corpo, na alma e no coração.', 'Como melhorar um sistema injusto onde a força da injustiça é aceita como normal? Onde você é ensinado a acreditar que não vale nada e que não presta para nada? Tem que haver uma mudança de valores urgente, tem que acreditar. Não pode tratar essas pessoas como lixo. É dever desses estabelecimentos resgatar a dignidade humana dos que cometeram erros, e não,  condená-los a uma pena eterna. Já é visto que esse atual sistema é caro, ineficaz e sem retorno. Então, por que insistem nele? Por que o exército com toda sua disciplina não toma conta desse setor? A prisão deve ser um lugar de recomeço, com dias produtivos, o preso deve ter oficio e recreação.', 'Quando um homem é preso, sua família é condenada junto. Os pais e os filhos desses condenados são os que mais sofrem. Não existe projeto de reabilitação para que esse apenado volte para a sociedade com uma vida transformada e produtiva. Ninguém dar uma chance para que a transformação aconteça. Ninguém pergunta, qual o seu objetivo de vida agora? Quando ver o antecedente criminal dispensa, pois para a atual sociedade brasileira, uma vez bandido, bandido até morrer. Entrou no sistema, não sai nunca mais. Até quando a sociedade brasileira aceitará viver presa mesmo que em cárcere de luxo? Enquanto o poder político negligência suas obrigações de educar, proteger e cuidar de seu povo. O tratamento desumano é um convite para a angustia. Quais são os valores desses detentos? O que eles querem da vida? Quais valores e objetivos de vida estão sendo construídos em favor da sonhada liberdade? Eles sabem o que querem da vida? E o que não querem? Se senti sozinho tropeçando em seu caminho. À procura de abrigo, uma ajuda, um lugar um amigo.', 'O governo é o guardião legal desses homens, não deve negligenciar seu dever de promover a transformação desses seres humanos. A sociedade não pode viver refém progressivamente das barbareis dos cárceres brasileiro. O futuro do Brasil está preso. Eles estão presos nas grades e a sociedade está presa ao medo. É justo? Só a dignidade humana poderá libertar a todos. Não se pode seguir com é essa história triste. É preciso uma nova história onde todos terão justiça e igualdade e o futuro será livre sem medo e sem laços. Não se pode mudar a história. Mas se pode fazer outra, com cada um fazendo sua parte com uma nova consciência. Todos têm o direito natural a vida. E esse direito foi dado por Deus.']",120,80,40,120,40,400
54,,"['A vacina é um grande avanço tecnológico. A mesma é responsável por criar uma proteção no sistema imunológico, assim diminuindo a incidência de vários tipos de doenças e dando uma qualidade de vida melhor para as pessoas. Mesmo assim, muita gente afirma que as vacinas não são importantes, é possível analisar isso nos aspectos: porque existem pessoas antivacinas e o perigo que isso pode gerar.', 'Uma vez que começou a repercutir que muitas pessoas estavam acusando os imunizantes de provocar efeitos colaterais graves  e até transtornos como o do autismo, muitos pais começaram a não vacinarem os seus filhos. Além disso, por causa da eficácia das vacinas, não se ouvia mais falar em doenças como poliomielite rubéola, fazendo com que muitos achem que por não ser algo presente no momento, não causará problemas . Já dizia o filósofo Confúcio: Se queres prever o futuro, estuda o passado.  Então, vendo como era a sociedade anos atrás, antes do desenvolvimento das vacinas, pode-se observar o estado crítico que essas pessoas viviam.', 'Logo, haverá muitas consequências caso o número de pessoas que não forem vacinadas aumente, pois irá voltar a circular epidemias de doenças que já estavam erradicadas, deixando sequelas e causando até a morte. A taxa de mortalidade infantil vinha caindo nos últimos anos, pela primeira vez, desde 1990, essa estatística voltou a crescer, gerando preocupação.', 'Portanto, medidas são necessárias para resolver o impasse. O ministério da saúde poderá desenvolver campanhas de conscientização em postos de saúde e escolas, com palestras, principalmente para pais e mulheres grávidas, para que obtenha conhecimento sobre a importância de vacinarem seus filhos desde os seus nascimentos para que cresçam saudáveis, com menos chance de desenvolverem doenças.']",120,120,80,120,80,520
89,,"['Atualmente o que mais se fala, tanto pelas redes sociais quanto pelas mídias televisivas, é a disseminação da Covid-19. As medidas de prevenção ordenadas pela ONU e a OMS são simples: higienização das mãos, uso de máscara, álcool em gel e isolamento social. Algo fácil de se cumprir, não fosse pelo pensamento conflitante imposto por vários governadores de escolher entre a saúde ou o sustento da família.', 'Embora o setor econômico global tenha sofrido o duro impacto da pandemia, tal pensamento deve ser desconsiderado, pois a rejeição das medidas restritivas reflete diretamente no número de mortes por contaminação, que já ultrapassa a marca dos milhões em escala global. Os efeitos do isolamento na economia são inevitáveis, principalmente em um país como o Brasil, onde a desigualdade social é explícita.', 'É evidente que as classes média-baixas têm sofrido mais durante esse período tanto pela falta de uma renda de emergência quanto pela falta de investimento do próprio governo nas unidades de saúde, um problema de raízes antigas.', 'A maneira mais efetiva de tranquilizar a população e mantê-la dentro das casas continuar com o programa de renda básica, que no Brasil foi denominado Auxílio Emergencial. O valor deverá suprir as necessidades mais básicas dos moradores para que possa alcançar um número maior de famílias.']",160,160,120,160,120,720
72,Verdades que salvam,"['Na era em que vivemos  o número cada vez maior de informações que temos  acesso, não deixa dúvidas de que a tecnologia trouxe vários benefícios para o nosso cotidiano, porém, a qualidade duvidosa de algumas dessas informações, gera vários transtornos. Iso porque, a quantidade de notícias falsas espalhadas, as chamadas fake news, que objetivam muitas vezes prejudicar e enganar pessoas  tornam-se frequentes no nosso  dia a dia.', 'Em um ano de eleições presidenciais, como é no Brasil no ano de 2018, é preciso ter muita cautela ao receber e repassar tais informações falsas à diante. A busca por eleitores, a competição e rivalidade entre candidatos e principalmente seus apoiadores, pode causar grandes prejuízos, e manchar a esta da democracia.', 'Nas eleições de 2016 nos Estados Unidos, vários veículos de mídia credenciaram a vitória de Donald Trump às chamadas fake news. O caos ocorrido em uma eleição muito disputada foi bastante questionado e gerando um grande desconforto no país, alguns, até acreditavam que as notícias falsas e os boatos, levariam a queda da maior potência econômica mundial.', 'Assim, é inquestionável e necessário o uso de tecnologias digitais e internet nos dia atuais, porém, a cautela no uso dessas mídias é indispensável, para que boatos não tenham tanto poder para causar tantos danos. É preciso a criação de leis específicas para a punição e responsabilização dos autores das fake news, com o pagamento de multas, esclarecimento ao público sobre as inverdades escritas. É inaceitável as palavras falsas e mentiras vencerem e destruírem o futuro  de uma nação.']",120,120,120,120,120,600
106,Relação homem-animal,"['Constantemente é noticiado ou presenciado o tratamento a animais em dois extremos: sendo tratados melhores que seres humanos ou agredidos e         traficados, mas         onde estaria a formar correta de tratamento? Provavelmente no equilíbrio.', 'É verdade que todo tipo de vida deve ser respeitado, porém quando o mundo do ?pet?                 torna-se fundamental e comum preterir familiares, atividades físicas, pagar contas e outros aspectos cotidianos para proporcionar um melhor tratamento apenas ao animal, enquadra-se como uma atividade ilógica, pois a vida pessoal e social é afetada.', 'Esse pensamento não estaria pautado na ideia         deles         não merecerem um cuidado cordial,         portanto  estaria em harmonizar         com o bom senso. Pessoas estão passando fome e frio         e ao         transformar animais em ""gente"" é agredir         moralmente e eticamente os valores e o valor         de uma vida humana.', 'Tendo em vista tais exageros, muitas vezes com prejuízo financeiro e psicológico ao dono, o animal sofre igualmente, pois sua natureza é afetada com joias, roupas, ""chapinhas"", pinturas, entre outros acessórios         quem além         satisfazer seu proprietário, incomodam e         pode         vir a causar traumas ao bicho de estimação.', 'Possivelmente todas as atitudes equilibradas relacionados a essa questão não acabem com o desrespeito         com o         ""homem""         e ao         animal,         contudo, valorize qualquer constituição ou manifestações         em que ambos estejam presentes.']",120,160,120,80,120,600
107,Brechas da Impunidade,"['Um dos problemas constantes na sociedade é os elevados índices envolvendo os                 jovens                no crime. É nessa         fase         que se observa uma natural rebeldia, porém, quando exercida sem limites, ocasiona consequências negativas. Tal constatação evidencia a necessidade de mudanças na educação familiar, a redução da maioridade penal, além da criação de programas voltados para os                 jovens.', 'De acordo com a legislação brasileira, são penalmente inimputáveis os menores de dezoito anos. Devido a         este         fato, os                 jovens                passam a ser         explorado         por maiores, que         o         utilizam na linha de frente do crime. Com isso, a redução da maioridade penal seria eficiente no combate         deste ato. Pois         os                 jovens                estariam sujeitos a serem presos assim como os adultos. Assim, o temor coibiria os                 jovens                de praticarem atos ilícitos.', 'A estrutura familiar também é de extrema importância. Os países com menor índice de         criminalidade, tem         um alto índice de cultura, educação e planejamento familiar. Proporcionar uma educação de qualidade aos                 jovens                ajuda no afastamento do menor no crime.', 'O contato do                 governo         para com         os                 jovens                é essencial. O                 governo                poderia criar programas voltados para os                 jovens                nas escolas, com atividades extracurriculares em período integral. Assim, o                 governo                ofereceria alternativas que         reduzem         a exposição do                 jovem                no ambiente de criminalidade, possibilitando         o          jovem                não         só de         estudar, mas também         de fazer o         que gosta, como praticar esportes.', 'Portanto, tanto no âmbito familiar quanto no governamental,         se deve         atribuir a devida importância aos nossos         jovens. Assim, proporcionar         uma melhor qualidade de vida a todos.']",160,200,120,160,200,840
87,Educação sexual x sexualização,"['Durante a Idade Média os corpos infantis eram retratados nos quadros como adultos em miniatura, pois naquela época a infância era pouco valorizada e vista apenas, como uma passagem do nascimento para a vida adulta. Atualmente, há diversos estudos referentes ao mundo infantil. Com isso, as crianças possuem a liberdade de serem quem são e aproveitarem essa fase de maneira lúdica e curiosa. Por outro lado, essa mesma liberdade tem trazido conflitos e despertado a sexualidade precoce delas, o que pode causar um aceleramento para a vida adulta e desencadear transtornos psicológicos no futuro. Além disso, com a exposição em rede, consequentemente pode abrir espaços para pedófilos.', 'Contudo, as crianças devem ser orientadas a evitarem a exposição excessiva nas redes sociais, pois através da aceleração de informações proporcionadas pela tecnologia, muitos pedófilos tem se aproveitado disso para cometer seus crimes . Sendo assim, os pais devem acompanhar os filhos em suas comunicações em redes para a proteção da infância. No entanto, referente a sexualidade infantil, é de suma importância a família tratar esses assuntos para o desenvolvimento e educação sexual, o que pode evitar possíveis abusos sexuais e até mesmo assédios no mundo virtual.', 'Por outro lado, muitos pais involuntariamente acabam envolvendo as crianças demais nesse ambiente de sexualização dos corpos, eles não ensinam a educação sexual e sim, a erotização infantil por meio de conteúdos de filmes, novelas e músicas, e até mesmo cenas do dia a dia, a infância vai sendo tomada por essa sexualidade adulta, através de palavras, gestos, danças e atitudes inapropriadas para a idade delas . Isso pode levar a adultização e desencadear sérios problemas no que se refere a vida sexual precoce, e até mesmo a gravidez na adolescência.', 'Portanto, no que tange a educação sexual, as escolas devem proporcionar orientações por meio de reuniões de pais, alertando-os sobre os possíveis problemas gerados para seus filhos em relação a interferência de incentivo a sexualidade adulta na sexualidade infantil. No mais, as instituições de ensino deverão desenvolver junto ao seu corpo docentes, atividades elaboradas para trabalhar assuntos atuais sobre a sexualização infantil, por meio da educação sexual.']",160,160,160,200,160,840
54,,"['Atualmente está em evidencia assuntos sobre os movimentos antivacina, e que a consequência dos mesmos, segundo especialistas, pode resultar na volta de doenças consideradas erradicadas no Brasil há 20 anos – segundo dados na BBC news –. Considerando a gravidade desse assunto, é importante debater e apresentar soluções viáveis para combater à volta dessas doenças.', 'Em primeiro plano, consideramos, a importância e a eficácia das vacinas para a defesa do corpo humano,  contra bactérias e agentes infecciosos,  causadores de doenças consideravelmente graves (sarampo, poliomielite, rubéola) . A vacina constitui em inserir no organismo humano micrioorganismos inativados da doença, protegendo o corpo humano, agindo como agente defensor quando necessário .', 'Além disso, notamos, que, o possível retorno dessas doenças pode resultar em uma epidemia em alta escala no Brasil, por serem doenças consideradas de fácil contagio. Segundo dados obtidos pela BBC, o sarampo – doença altamente contagiosa -, é a doença evitável por vacina, que mais causa mortes no mundo. Ademais, é importante observar as consequências da poliomielite nas crianças, quando não vacinadas, pode apresentar atrofia muscular, paralisia de uma das pernas, etc.', 'Portanto, é de fácil entendimento a importância das campanhas de vacinação no atual contexto brasileiro, evitando aumento em taxas de mortalidade, problemas secundários como aumento de paciente em filas de hospitais, e problemas econômicos na área da saúde. Através de planos de conscientização por meios de comunicação eficazes, as campanhas de vacinas se tornariam mais notáveis e assim mais pessoas estariam protegidas evitando uma possível crise no país.']",120,120,80,120,80,520
65,A educação para a violência,"['Hodiernamente , situações como o envolvimento e utilização de jovens com idade inferior à 18 anos, tendo como base assaltos à mão armada ocorrentes em todos os alquilais do país apresenta-se como a proteção exorbitante de diversas atitudes incompetentes desde o início do convívio social do indivíduo se argumenta , que por seu turno salienta para o desmoronamento dos valores sociais de igualdade e fraternidade, valorizados em diversos ideais mobilizados na história.', 'A priori, estabelece-se uma conjuntura erroneamente protecionista ao observar a ausência de uma correção dos atos inicialmente cometidos pelos indivíduos posteriormente cometidos em ações ilegais por jovens. A carência de atitudes corretivas contribui exclusivamente para a geração de uma linha de raciocínio em prática de reações delinquentes. Em caráter abusivo, os jovens analisam uma certa valorização positiva em teor egocêntrico, influindo a perfilhar constantemente reações deste nível, adquirindo um conhecimento malicioso, quando passa a enxergar como uma fonte de desenvolvimento pessoal a criminalidade, afligindo com contextualização póstuma de direitos que lhe poderiam ser atribuídos, desconstitucionalizando a formação de um ideal educacional positivo, sobrevindo a abranger uma devotada ascensão de estatísticas criminais em múltiplos alquilais e posições, em destaque e exemplo o envolvimento de jovens no tráfico de drogas e armas, como se percepciona corriqueiramente nas comunidades de baixa classe social do município do Rio de Janeiro.', 'Posteriormente, consoante a confirmação do filósofo Jean-Paul Sartre, de que “A violência, seja qual for a maneira como ela se manifesta, é sempre uma derrota”, relata exacerbadamente o caos gerenciado em um convívio de um indivíduo em uma sociedade. acarretando circunstâncias como a elevação de dados criminais e incentivando uma imagem de pânico na população, influenciando primordialmente no modo como se visualiza o comportamento social relacionando-se nas atitudes adotadas primordialmente para uma tentativa de se eliminar a ficha da criminalidade, entretanto construindo um preconceito deplorável para com os valores da igualdade social , ademais a fraternidade pressentida conforme a pontuação visualizada pelo descaso apontado na injustiça cometida por indivíduos que não receberam anteriormente uma educação suficientemente convicta de práticas ilegais e também a liberdade, principal contexto ameaçado excepcionalmente pelas avaliações de violência cometidas pelos sujeitos.', 'Perante os elementos supracitados, corrobora-se a instalação de aparelhos de comunicação e interação social com a adoção de uma moderna e rígida plataforma educacional, valorizando tópicos de ensino de valimentos como o respeito, a igualdade, além de combater as plataformas de construção de desigualdades, permitindo transmitir a origem de uma comunidade harmônica e livre. Outrossim, salienta a determinação de políticas públicas para o combate essencial e eficiente dos diversos conflitos de violência, agrupando os indivíduos em um processo de reconstrução educacional, permitindo a recuperação de intrepidezes, construindo uma oportunidade de ampliar as vantagens do convívio social. Seguindo esses conceitos, permite-se derrotar de forma abrupta a violência e suas indolências, edificando uma comunicação social segura e livre.']",120,160,120,120,120,640
143,O ritual de aceitação escolar,"['O trote universitário é uma tradição entre veteranos e calouros do mundo inteiro, e tem sido aceita entre os alunos por conta                 da promoção social dentro do ciclo social                no qual o estudante irá conviver durante anos de sua vida.', 'Com o passar dos anos, inúmeros estilos de                 “brincadeiras”         vem         sido         criadas         .                 Temas solidários                , que envolvem doações de sangue ou de comida não         perecível         são aceitos e até         influenciados         pelas instituições, porém,                 alunos que estão cursando a                  mais tempo tendem a aplicar suas ações mais radicais para os novos colegas.                É a partir         deste         ponto que o trote e a criminalidade se encontram.']",120,120,120,120,0,480
47,Dificuldades na Educação durante Pandemia,"['Em virtude do cenário atual no nosso pais, pessoas tm buscado como alternativa este tipo de ensino para suprir as necessidades cotidianas, é comum que com a agitação do cotidiano e com a dificuldade de frequentar o ensino tradicional em sala de aula e o ensino físico como um todo , as pessoas buscam ensino por meio da internet inclusive em canais no YouTube e por cursos online, mas mesmo com essa questão e com esse tipo de ensino acontecendo com tanta frequência ainda temos alguns desafios relacionados ao ensino a distancia .', 'Apesar de no Brasil hoje, as pessoas tenham acesso muito maior a tecnologia ainda temos situações que os indivíduos não conseguem adquirir determinados bens tecnológicos fundamentais para que eles possam usufruir, por exemplo da educação a distância, é comum que as pessoas de classes sociais mais baixas não tenham por exemplo computadores de qualidade ou até mesmo smartphones para navegar na internet e usufruir de grande parte desses serviços.', 'Além disso a internet como um todo no pais ainda é muito escasso , as regiões mais desenvolvidas já oferecem internet de qualidade a praticamente todos os indivíduos , mas ainda temos situações e locais no Brasil que as pessoas não conseguem ter acesso internet que faz com que nesses casos seja praticamente inviável.', 'Portanto, é importante que haja um preço exequível, para que todos os indivíduos independentes da classe social possam ter um fácil acesso à internet e que as prefeituras municipais possam disponibilizar um ambiente como se fosse uma lan house, para que essas pessoas que não tenham aparelhos digitais acessem a internet deste ambiente.']",120,160,120,160,120,680
49,O papel dos influenciadores digitais,"['Com o avanço da internet, nos dias atuais os influenciadores digitais tem grande influência na publicidade do seu negócio. É por meio dos influenciadores digitais que se utiliza a ferramenta do marketing digital.', 'O marketing digital é o meio de promover produtos ou marcas por meio de mídias digitais. É uma das principais maneiras que as empresas tem para se comunicar com o público. É um meio de divulgação que alcança grandes resultados, por isso a importância do marketing digital. O digital influencer tem um grande número de seguidores nas redes sociais, e tem grande influência sobre seus milhares de seguidores. Sendo assim, o influenciador fazendo uma boa propaganda de sua marca, consegue convencer o seu público também consumir aquele produto, já que os seguidores confiam e se expiração no modo de vida do influenciador que ele segue.  O brasileiro passa em média 9 horas e 15 minutos online todos os dias, então a profissão de digital influencer é muito importante é essencial para se ter grandes lucros e obter clientes no seu negócio.']",120,120,80,80,0,400
49,O papel dos influenciadores digitais,"['Atualmente no Brasil podemos citar centenas de influenciadores que estão presentes em nosso  dia a dia, entre eles, Whindersson Nunes. Reconhecido tanto nacionalmente como internacionalmente, o mesmo se destaca por seus vários shows humorísticos e por seu canal no Youtube. Além disso, Whindersson, como vários outros, vem trazendo  risos e manias aos que o segue diariamente pela rede digital.', 'Os influenciadores digitais têm como objetivo vender e propagar uma imagem, que tanto pode ser a receita de um suco “fitness” ou a venda de uma marca de batom pela qual trabalha ou usa. Todos os dias milhões de pessoas acordam pela manhã e são pegas pelos ""stories” de atores, modelos ou até desconhecidos com boas frases de efeito. Como um exemplo disso, podemos citar o livro Extraordinário, de R. J. Palácio. No qual conta a história de August, um encantador menino que possuía deformidades no rosto e sofria bullying por ser diferente, porém, invés de reclamar via as coisas de uma maneira diferente . Nesse sentido, esta obra influencia na pratica da gentileza com o outro, reafirmando que todo ser é especial e diferente.', 'Entretanto, também é possível perceber que muitos influenciadores usam seus seguidores para estereotipar atitudes, roupas de marcas e um modelo de corpo perfeito. Além disso, apresentam opiniões e pontos de vista sobre determinados assuntos que influenciam e as vezes manipulam a cabeça de milhões de jovens e adultos, fazendo com que os mesmos  assumam comportamentos e personalidades de seus “famosos”.', 'Portanto, é necessário lançar e promover campanhas que façam com que as pessoas percebam que os maiores influenciadores precisam ser nós mesmos , uma vez que,  cada pessoa é diferente de outra. Tendo isso em vista, deve haver panfletos nas ruas, lojas e escolas para que a sociedade em geral se redescubra como influenciador próprio e adquira sendo crítico.']",160,120,120,160,80,640
29,A internação compulsória de dependentes do crack,"['É de conhecimento geral, que no', 'Torna-se importante observar, que essa iniciativa é uma forma de descerticular o tráfico e acabar com a criminalidade nas grandes cidades. Salienta-se, que todo cidadão tem o direito à saúde, dessa forma , o número de dependentes químicos diminuirá.', 'Pode-se mencionar, por exemplo, que para esses usuários voltar a ter o seu organismo sem o efeito da droga, é necessário o acompanhamento de psicólogos, médicos como também de medicamentos, para que assim, aconteça a reabilitação de quem deseja a restauração.', 'Levando em consideração, os fatos mencionados. Cabe, ao governo do estado de São Paulo criar cada vez mais clínicas de regeneração aos usuários. Com adoção de atendimento, especializados nessas adversidades, como também aumentar a fiscalização do tráfico de drogas na cracolândia. Dessa forma, será possível reduzir o número dessa absessão e chegar a uma sociedade menos problemática.']",80,0,0,0,80,160
69,Agrotóxico e a conscientização,"['Os agrotóxicos começaram se intensificado no final da segunda guerra mundial , conhecido como a evolução verde, é usado para controlar insetos, doenças, ou plantas daninhas que causam danos às plantações e tem ganhado bastante visibilidade na sociedade, s urbanistas defendem a necessidade de usar para a maior produtividade da agricultura, já os especialistas e ambientalistas são contra o uso  pois trazem riscos à saúde e ao meio ambiente.', 'O Brasil é o maior consumidor, segundo o site g1 (globo.com)  e com o maior risco, tanto para os trabalhadores da agricultura e para os consumidores  podendo causar doenças gravíssimas, como problemas neurológicos, mentais, câncer de diversos tipos entre outros . No meio ambiente também tem seus prejuízos podem diminuir a biodiversidade do solo, ocasionar acidez, desencadear a morte de vários tipos de plantas.', 'Sendo assim, diante de todos problemas causados pelo agrotóxico é fundamental que haja novas maneiras e fiscalização para que diminua os riscos para os seres vivos, e que de alguma forma seja palestras, campanhas na televisão, conscientizando a população na importância de lavar os alimentos assim diminuindo a concentração inserido do agrotóxico.']",120,80,120,120,80,520
125,Maconha,"['A maconha          e          uma droga assim como qualquer outra,         porem         ela         e         mais                 ""fraca""                que as         outras         como                crack,                cocaína, etc. O uso         continuo          da droga                pode trazer a dependência                 e que                muitos consideram a como porta de entrada para outras                 drogas         ilícitas         o que         podem vim         a                 agravar o estado físico e mental do usuário                . E quando a pessoa passa a se tornar dependente da         droga  à         família sofre os prejuízos junto com         ele         já que                 ele                pode chegar em casa sobre efeitos da                 droga                e agredir algum familiar para conseguir mais dinheiro para comprar                 a erva                .', 'Outra parte agravante                é o         trafico         da maconha,         que         com o grande         numero         de usuários, se torna um grande perigo para sociedade, uma vez que os traficantes irão ter mais dinheiro para comprar armas,         na qual pode ser usada         para                assassinato de inocentes e roubos. O         trafico         gera uma         violência de grande escala         tanto por parte dos         traficantes         quanto         pelos         dependentes da         droga         já que muitas vezes o usuário não tem dinheiro para comprar         que         opta por roubar, se prostituir e         ate         se for preciso matar.', 'É preciso investir no combate ao trafico                para reduzir a entrada e                produção da droga no         pais         , e                investigações rigorosas         para assim cada vez mais         prender traficantes                 que são um dos grandes responsáveis pela venda ilegal da droga, com penas mais severas para os traficantes,                e também para os usuários que se envolverem em algum tipo de delito sobre efeito da droga,                 mas cabe a                  sociedade se conscientizar dos malefícios que a maconha pode trazer sendo uma ?droga leve?          mais          que pode lhe levar para um mundo                  onde alguns conseguem voltar, e poucos se recuperar.']",80,80,80,80,80,400
56,Presídios Brasileiros,"['O Brasil têm aproximadamente 622 mil presos atualmente  é o sistema possui menos de 400 mil vagas, com isso gerando um dos principais problemas carcerário a super lotação, outro ponto e a reincidência dos presos no país.', 'Quando falamos em sistema carcerário a primeira coisa que vem a nossa  mente e a super lotação, o Brasil têm a 4° maior população carcerária do mundo, e segundo o ministério da justiça o país tem 622 mil detentos, mas apenas 371 mil vagas gerando um desequilíbrio em relação ao número de detentos e o de vagas, segundo uma pesquisa realizada pela BBC a cada mês, penitenciárias de todo o país recebem 3 mil novos presos.', 'Outro ponto importante é a reincidência um problema global  mas no Brasil têm dimensões muito maiores, 70% dos que deixam a prisão acabam comentando crimes novamente.', 'Esses são alguns do vários exemplos que podemos citar , a super lotação tem duas saídas: a construção de novas penitenciárias ou o investimento no ramo como o da educação para diminuir a população carcerária levando em consideração que a maior parte dos presos não tiveram acesso a uma educação de qualidade, a reincidência poderia ser evitada se fossem adotados novos métodos de reintegração social baseado na teoria da aprendizagem social .']",120,120,80,120,80,520
45,Sou1000Do,"['“Pouca saúde e muita saúva, os males do Brasil são”. O excerto de “Macunaíma”, livro de Mário de Andrade, criticava as mazelas brasileiras em vários setores. Embora de 1928, a obra continua atual, pois ela contextualiza o abuso de autoridade ainda recorrente no país, o qual fere a isonomia constitucional . Assim, é legítimo afirmar que a omissão do poder judiciário e o tímido protagonismo social corroboram os ataques de agentes públicos contra a esfera privada, fenômeno que sedimenta o desequilíbrio democrático.', 'A priori, constata-se que o abuso de autoridade é engendrado pela negligência da justiça, a qual detém legitimidade para apurar e punir essa distopia. Porém, a recorrência dos excessos autoritários expõe a ineficiência judiciária para mudar esse quadro. Fato exemplificado pelo indiciamento proferido pelo procurador federal Wellington Divino de Oliveira contra o jornalista Glenn Greenwald, acusado, sem investigação prévia, de “hackear” a operação “Lava Jato”. Logo, a displicência do judiciário é uma falta grave, posto que revela o descompromisso do poder público face ao abuso de autoridade e ao caráter democrático de instituições como o Ministério Público Federal.', 'Outrossim, é indiscutível que o débil protagonismo social está no cerne da continuidade dos abusos, já que a falta de engajamento civil dificulta a solução dessa problemática. Sob esse viés, o sociólogo Roberto DaMatta afirma que o “jeitinho brasileiro” possui um lado negativo, por meio do qual os indivíduos ignoram leis para conseguirem, de modo duvidoso, benefícios para si. Portanto, dado que a cidadania confere direitos, ela também cobra deveres e, por conseguinte, uma robusta participação societária para contornar o abuso de autoridade e ampliar a isonomia entre os cidadãos.', 'Destarte, cabe ao poder judiciário e à sociedade civil organizada rechaçarem qualquer forma de abuso de autoridade, uma vez que ela macula a igualdade entre todos os brasileiros. Dito isso, a Secretaria Federal de Tecnologia da Informação deve desenvolver um aplicativo gratuito, por meio do qual os cidadãos vão delatar, anonimamente, os excessos de servidores do Estado. Ademais, a plataforma digital contará com um algoritmo seguro que proteja a identidade dos denunciantes. Desse modo, a interlocução entre as esferas estatal e privada terá menos ruídos, garantindo a investigação e a punição severa daqueles que cometem abuso de poder e reiteram a presença de saúvas nas repartições públicas brasileiras, conforme escreveu Mário de Andrade.']",160,200,160,200,200,920
94,,"['A série “The Good Doctor” conta a história de Shaun Murphy, um jovem médico com espectro autista, o qual frequentemente lida com situações preconceituosas, devido a sua condição psíquica anormal. Fora das telas, a realidade brasileira não se difere do enredo ficcional, visto que indivíduos com esse transtorno psicossocial sofrem situações semelhantes e são minimamente incluídos na sociedade. Assim, aprofundam esse quadro tanto a falta de informações, como também a carência de investimentos para auxiliarem no tratamento e inclusão dessas pessoas.', 'Nesse contexto, vale ressaltar que a falta de informações sobre o autismo é um dos fatores que agravam essa problemática na sociedade. Indivíduos autistas possuem dificuldades de comunicação e de interação em diversos níveis, acabando por ser complexo estabelecer uma relação com eles, e dessa maneira, sem o conhecimento adequado diversas pessoas tendem a menosprezar esse grupo de sujeitos diferenciados . Logo, segundo o filósofo Immanuel Kant, o homem é fruto da educação que ele recebe, o entanto, à medida que a população brasileira tem desconhecimento de como tratar alguém com esse transtorno psíquico, a negligência que ocorre com esses cidadãos é recorrente.', 'Ademais, a carência de investimentos por parte do governo no tratamento de autistas  mostra-se como mais um dos fatores que acentua a falta de inclusão desses sujeitos. A Constituição Cidadã de 1988 garante à saúde como um direito inerente todo cidadão, porém, aqueles que possuem autismo não conseguem ter acesso tratamentos essenciais para o bem-estar deles, devido ao sistema de saúde ser precário com uma escassez de recursos por parte do Estado e da baixa remuneração e valorização dos profissionais especializados no tratamento de indivíduos com esse transtorno psicológico. Dessa forma, percebe-se que medidas necessitam de serem aplicadas, com o propósito de garantir os direitos e a inclusão de pessoas com esse transtorno.', 'Infere-se, portanto, que ações sejam tomadas com o intuito de assegurar a inclusão de pessoas autistas na sociedade brasileira. Para isso, cabe ao Ministério da Saúde, órgão responsável por gerenciar a saúde pública no país, investir na contratação de profissionais especializados no tratamento de pessoas com esse condicionamento mental, para garantir o bem-estar deles e, além disso, deve, através de palestras realizadas em eventos presenciais e on-line, informar população maneiras de se relacionar e ajudar a incluir socialmente cidadãos com essa condição neurológica. Desse modo, em um futuro próximo, a maioria daqueles que possuem autismo vão ser devidamente auxiliados e incluídos na sociedade como consta na Carta Magna.']",160,160,120,200,160,800
72,,"['Com os avanços tecnológicos, o uso indevido das informações para obterem o resultado positivo para si é cada vez maior, as fake news como ficou popularmente conhecida, as noticias falsas,  são utilizadas para fins próprios, causando danos, com conteúdo noticiosos falsos e criar uma percepção equivocada ou mudar um pesamento coletivo.', 'O"" poder"" que as mídias exercem sobre o ouvinte, leitor e seu telespectador, é usado por diversas vezes de forma inadequada ,disseminando informações falsas ,em muitos casos o leitor é incapaz de avaliar e reagir as duas importantes alavancas da proliferação das noticias .A primeira o grau em que a noticia (falsa) se baseia nos fatos, a segunda define a intenção imediata ,o nível de desinformação e potencialmente de distorção que o burlador da noticia pretende produzir .Vivemos expostos a um enorme volume de dados e informações em diversos formatos a todo minuto,  nas eleições , diversas fake news surgem, com o intuito de levar o eleitor a acreditar e ficar em favor deles,  através de gráficos, reportagens via internet ,redes sociais ,jornais ou qualquer outro meio de informações com teor sensacionalista .', 'Em sociedades baseadas na troca de informações e na comunicação sustentada por tecnologia de ponta que se alto replicam e formatam todos os setores da vida econômica ,politica ,na educação e cultura os interesses estratégicos estão vinculados as possibilidades tecnologicamente facilitadas, de"" tornar comum ""o conteúdo vinculado ou seja de difundi-lo a universo amplo de pessoas, tornando cada vez mais fácil espalhar desinformação na rede .', 'Contudo, devemos  começar a combater as fake news em varias esferas, na escola defendendo a importância de uma boa alfabetização midiática e informacional, procurar fontes confiáveis em diferentes áreas do aspecto ideológico, politico e cultural para perceber nuances e obter visão mais ampla do que realmente est acontecendo, não lê somente o titulo da matéria, verificar o autor, fazer pesquisas em sites conhecidos, tomar cuidado com o sensacionalismo, pois, quem aprende a consumir informações criticamente, aprende a pensar criticamente .', 'Portado ,tomar cuidado com as fontes pesquisadas, com as noticias, observar a sua veracidade é um ponto chave para que as fake news em tempos eleitorais ou no cotidiano sejam combatidas, pois o cidadão que tem conhecido do que fala e compartilha, não é enganado por nem uma informação falsa .']",120,120,120,120,120,600
89,redação 1,"['Comenta-se com frequência a respeito do isolamento social e do seu impacto na sociedade como um todo. Segundo a Constituição federal de 1988, no seu artigo 196, é dever do Estado garantir o acesso à saúde, bem como é responsável pelas medidas públicas para zelar pelo bem-estar físico de todos os cidadãos brasileiros. Todavia, com o aumento dos casos e a realidade escancarada, há quem duvide da eficiência do distanciamento.', 'Ao analisar algumas metrópoles verifica-se que há a fixação das medidas protectivas, bem como consequência do burlamento das mesmas, a implantação de multas e possíveis restrições. Observamos também, a ineficiência caso não haja uma abordagem segura e uma escolta em prol da limitação da transmissão.', 'Em consequência do descaso de alguns municípios, é incrementado um isolamento ainda mais persuasivo e rigoroso, como é destacado na pesquisa feita pela Universidade Estadual de Campinas (UNICAMP). Outro factor existente é a falta de empatia gerada pelos inúmeros grupos sociais, grandes causadores de aglomeração e proliferação em massa do vírus.', 'Em virtude dos fatos mencionados, é necessário levar em conta que sem restrições mais severas, essa guerra se tornará impossível e sem eficiência. Tendo em vista esses pontos, seria imprescindível a utilização de canais para ter uma melhor rede de informação e o monitoramento constante e eficiência para a melhoria, de pelo menos, 50% dos casos.']",160,120,120,160,120,680
70,Prevenção.,"['De acordo com dados do mistério da saúde, só em 2005 o números de casos de HIV passaram de 16,2% para 33,1% em um grupo de 100 mil habitantes entre as idades de 20 a 24 anos e isso é um avanço mesmo com informações necessárias sobre os cuidados.', 'A doença Sexualmente transmissíveis ela ainda e um tabu para sociedade brasileira , ainda que existe meios e informações mas pouca gente sabe da importância de alto se proteger já que a doença por sua vez pode levar at  morte . Entretanto o vírus pode ser combatido e o paciente protegido desse mal e sem essa informação muitos são os acometidos pela doença a fazerem coisas erradas e se vingar de seu parceiro ou parceira e sim precisa ser orientada e divulgada para o mundo que tem tratamento e pode ser evitado.', 'Claramente tem que ser um assunto falado nas escolas , mídias e em quaisquer convívio social sobre a proteção e os cuidados para não adquirir . A faixa etária de adolescentes e jovens são mais comum por motivo de estarem aventureiros sobre a jornada de responsabilidade e os casos se torna maiores nessas idades , ma pesquisa feita pela Folha de São Paulo mostra que a maior parte da população juvenil não tem informações claras como usar uma camisinhas  e que isso tem se deixado a essa geração ficar na casa do esquecimento e esse numero de casos cada vez aumentando. Existe um preconceito muito grande para quem já adquiriu a doença nem o próprio contaminado não gosta de expor sobre o assunto , mais ainda assim precisa ser acabado e se sentirem protegidos sobre os seus problemas e o fator principal vem dentro de casa  , o mesmo precisa se sentir acolhido e seguro sobre os problemas que enfrentarão.', 'Visando que alm dos pais apoiarem já o filho acometido pelo vírus precisa ser orientados os pais que não tiveram seus filhos pela doença mas apoiar as medidas governamentais que precisar da o suporte para serem ensinados nas escolas e na rede de atenção primaria de estar e deixar as escolas e sociedade cientes e presentes sobre os risco e proteção . Cada vez que um jovem de 15 anos for na unidade básica de saúde se vacinar com a vacina de 15 anos Dpat ser orientados pelos pais e os adolescentes sobre essa doença ainda que a vacina não tem nada a ver já que ainda assim é um meio de orientar e sair com planfetos de informação para jornada adulta que esta por vim. E a prevenção alem de tudo tem que ser da sociedade em si e sempre visando na qualidade de vida']",120,120,120,120,120,600
9,A privatização e o aumento da desigualdade,"['Em 1808 o acesso ao ensino superior no Brasil era restrito apenas a homens pertencentes a famílias de alto poder aquisitivo. Quase dois séculos depois, essa restrição persiste, embora de forma mais sutil. Por este fato isso, a privatização das universidades apenas contribuiria com a desigualdade.', 'Ingressar em uma instituição pública de ensino superior é o desejo de grande parte da população, todavia, não é uma tarefa simples, a começar pelo fato de que os vestibulares têm um nível de cobrança que não condiz com o conteúdo programático da maioria das escolas de ensino básico.', 'Tal fenômeno ocorre porque o investimento no ensino superior é maior em comparação ao nível básico. Famílias que possuem renda elevada podem custear escolas especializadas em preparar os estudantes para os vestibulares de alto nível, e isso deixa em desvantagem alunos de rede pública que várias vezes não possuem professores nas escolas.', 'Maiores investimentos no setor básico de ensino poderiam mudar drasticamente a história da educação no Brasil. Tendo em vista que, culturalmente, ingressar em uma universidade pública é mais fácil quando se tem maior quantidade de dinheiro, a privatização tornaria mais penoso o processo de graduação para a população de baixa renda, o que consequentemente aumentaria as taxas de desemprego no país.']",160,80,80,0,0,320
72,Direito a informação,"['Fake news são notícias falsas que circulam na Internet. Graças a criação das redes sociais como o facebook, por exemplo, a velocidade de compartilhamento de posts ofensivos ou falsos cresceu.', 'Em primeiro lugar, elas se espalham rapidamente pelas redes sociais. Geralmente, são compartilhadas por pessoas com ideias parecidas, assim incitando rumores falsos ou deformando notícias verdadeiras . Além disso, fake news,  podem interferir na política de um país, como foi o caso dos Estados Unidos, nas eleições para presidente que ocorreram em 2017. Em que boatos, hoje considerados falsos, levaram a vitória do atual presidente, Trump.', 'Ademas, devido a velocidade de compartilhamento presente na internet atual, torna-se extremamente difícil de ser identificada e excluida. Porém, outro fator que vem  impossibilitado o problema de ser combatido é a falta de informações sobre o assunto, já que a população não tem conhecimento para identificar e diferenciar as fake news de notícias verdadeiras.', 'Logo, por serem causadoras de rumores e espalharem falsidades, as fake news devem ser combatidas. A Polícia Federal deve ser rigorosa, punindo quem divulga ou compartilha falsas notícias, estando cientes de que ela não são verdadeiras. E a população deve investigar minuciosamente a fonte das notícias espalhadas, procurando em outros meios sua veracidade e evitar compartilhar notícias que não se mostrem verídicas.']",120,120,120,120,120,600
64,"Educação sexual, e a sua importância para crianças e adolescentes.","['Relativo educação sexual na escola é possível destacar tanto aspectos positivos quanto negativos. Se por um lado,  ensina as crianças a amar, se relacionar e a se defender contra abusos; por outro lado pode fazer com que crianças que vivem sob uma educação patriarcal passem por maus tratos.', 'Inicialmente, a educação sexual ensina crianças e adolescentes a respeitar o sexo oposto desmistificando as habilidades mediante o sexo seja ele feminino ou masculino, os prepara para identificar e se defender de abusos e assédio, os instruindo de que não se pode tocar nem ser tocado sem consentimento, a praticar sexo com responsabilidade e proteção para evitar doenças e gravidez. Segundo o portal EXTRA  um estudo feito pela Associação Americana de Psicologia (APA) identificou que a educação sexual ajuda a diminuir a incidência de doenças e gravidez e comportamentos abusivos entre os jovens.', 'No entanto, nem todas as famílias compreendem essa disciplina, demonizando-a, acreditando que as crianças vão começaram a falar sobre sexo em vez de brincar e que os adolescentes vão acabar se tornando pais muito jovens por conta do acesso a esse tipo de informação, proibindo os filhos de participar das aulas, agredindo fisicamente e moralmente ao serem questionados sobre o tema, criando uma barreira entre os alunos e a educação sexual. É inadmissível que em pleno século XXI com todo acesso a informações os pais sejam vassalos da ignorância e não permitam que seus filhos tenham acesso a informações que lhes garantam educação tão importante quanto educação básica.', 'A educação sexual é, portanto, de suma importância para crianças e adolescentes e sua formação, e para isso o Estado, precisa intervir com campanhas televisionadas mostrando aos pais a importância da educação sexual nessa fase e a importância da escola  e para tal feito dando a eles também essa responsabilidade, pois essa função não cabe somente s escolas, mas também aos pais. Desse modo, se faz necessári reuniões com os pais e professores, para que sejam analisados, explorados e estudados os temas abordados tanto no âmbito escolar quanto no âmbito familiar.']",120,160,120,120,120,640
32,Constituição Bilateral,"['A Constituição Federal brasileira é o livro de leis que contém os direitos e deveres de cada indivíduo dentro deste país. Ela foi redigida com base em princípios de liberdade e igualdade, com poderes de proteger o cidadão contra injustiças que prejudicam a sua rotina diária.', 'Um dos fundamentos que esse conjunto de leis defende é o da liberdade de expressão, que fornece a base para a democracia. Outro, é o da privacidade, que preserva o individualismo e a intimidade . Em alguns casos, tais decretos se contrariam .', 'Momentos como este geram controvérsias e discussões, sem haver na verdade, um lado incorreto, pois ambos se baseiam na Constituição. Nestes julgamentos, deve se colocar na balança as consequências e impactos de cada passo em defender um ou outro.', 'Podemos citar a polêmica recente da primeira-dama Marcela , que proibiu a publicação de reportagens sobre áudios gravados de uma de suas conversas. Neste caso foi dado ênfase ao direito de privacidade, entretanto, por trás de uma violação à sua intimidade, pode haver crimes muito maiores, como a corrupção.', 'O julgamento deve acontecer levando em conta muito mais do que apenas a infração em si. Para eliminar dúvidas dessa natureza, vertentes de cada um desses tópicos deveriam ser feitas pelo Legislativo, especificando quando um ou outro deve ser utilizado, mas lógico, sempre mantendo a liberdade individual intacta.']",120,160,120,120,80,600
74,,"['Foram varias as conquistas que as mulheres brasileiras conseguiram ao longo do processo evolutivo do país. Direito de trabalhar, frequentar escolas e direito ao voto. Entretanto, as conquistas estão em constante acontecimento e ainda faltam muitas vitorias no quesito referente ao feminicídio. Apesar das questões relacionadas ao crime contra a mulher serem bastante discutido, a adoção de uma cultura patriarcal e a impunidade refletem numa sensação de insegurança que vão de encontro com as lutas femininas para uma vida mais digna.', 'a formação da sociedade brasileira foi feita sob a cultura agraria . a relação entre o patriarcalismo e o feminicídio é que nessa cultura o homem fica incumbido da função do sustento familiar enquanto a mulher passa a ser mero coadjuvante na estrutura social . o impacto advindo dessa característica é que ela é qualificada com um ser inferior o que reflete em uma sensação de posso do homem que busca nesse entrave desculpas para justificar a agressão contra a mulher', 'Essa agressão ganha desfecho desumano  uma vez que as medidas punitivas não fazem efeito no Brasil. m dos fatores que favorecem o feminicídio é a vergonha e impunidade. Muitos dos crimes acontecem na própria casa com o marido agredindo a esposa, isso gera uma sensação vexatória perante a mulher em denunciar criminoso marido que continua com as agressões pelo sentimento de opressão contra a mulher. Contudo, quando buscam auxilio na justiça são muitas vezes desiludidas pela impunidade . A deficiência da policia  para fiscalizar as ações de medidas restritivas de distancia entre o acusado e a dificuldade  cumprir mandado de prisão favorecem a pratica de agressão e o sentimento de insegurança.', 'Fica evidente, portanto, que apesar das conquistas das mulheres brasileiras ao longo dos séculos  muito há de ser conquistado no quesito feminicídio. Com o intuito de continuar as conquistas femininas  elas devem buscar por meio do seu direito cívico eleger mulheres para o executivo com propostas de leis voltadas para elas  a fim de melhorar sua relação na sociedade além de parar com preconceito e denunciar qualquer homem que agredi-las e essas medidas devem ir ao encontro de punições mais efetivas e austera para quem cometer o crime de feminicídio. O que irá contribuir para uma sociedade mais segura.']",80,120,120,120,80,520
110,"""Não mereço ser atacada""","['É de conhecimento         geral, que  nos dias de hoje         [hoje,] a mulher         têm         se mostrado         cada vez mais atuante na sociedade         , mas ainda falta                 entre nós                tolerância e respeito a elas.', 'As mulheres         hoje         buscam         cada vez mais seu espaço na sociedade         , já         deixou         [deixaram] de ser apenas         “rainha         do lar” e         hoje         ocupam, por exemplo, o         cargo do poder executivo         do nosso país,                 como é o caso da                Dilma Rousseff. No entanto, recentemente, o IPEA (Instituto de Pesquisa Econômica Aplicada) divulgou uma pesquisa onde mostrou que a maioria dos brasileiros concordaram que                 a vítima                era responsável pela violência que sofria.', 'Não obstante, é indiscutível um ato de violência contra um ser, muito menos pela sua vestimenta, como mostra parte da pesquisa, sendo assim, a praia um local onde mulheres usam          biquines          e homens retiram a camisa, seria um local onde aconteceriam mais violências.', 'Dado o exposto, percebemos que ainda temos uma cultura atrasada. Diante disso,         se faz necessário         leis mais eficientes, para que as mulheres sintam-se mais protegidas e consigam         cada vez mais seu espaço na sociedade         .']",80,80,0,80,80,320
93,Parto humanizado e seus benefícios,"['Por volta dos anos 2000, o movimento do parto humanizado apresentou um aumento neste período no Brasil, com o intuito de diminuir o crescimento de cesáreas e intervenções médicas nos partos no Sistema Único de Saúde.', 'Tendo em conta que essa prática esta sendo escolhida pelas gestantes pelo fato de ter o primeiro contato com o bebê o mais rápido possível, pois será um momento único . Muitos hospitais já utilizam essa técnica, segundo obstetras o parto tem que ser em local seguro para não ocorrer nenhuma complicação, porque a mãe e o bebê necessitam de atendimento médico imediato.', 'Algumas mulheres preferem o parto humanizado em sua residência, mas os médicos garantem que para a segurança da mesma e do seu bebê que o correto seria em um hospital.', 'Em face do cenário atual seria necessário abrir mais casas de parto no Sistema Único de Saúde ou ampliar as mesmas, para atender todos os casos, porque atualmente são poucas casas funcionando em todo o território nacional e isso acaba sendo um descaso total com as gestantes.']",160,120,80,120,40,520
10,Vencer ou ser?,"['Vencer é algo que desde cedo somos instruídos a realizar. A fim de analisarmos o que é mais importante para vencer na vida, é necessário entender que existem duas vertentes: aquela que de fato é importante para cada um e a que é necessária para tal triunfo.', 'Muitos são os princípios e valores do homem, sendo homem. Sendo assim, para muitos, o sucesso pode estar associado à religião (através da salvação e/ou vida eterna), bem como à a realizações pessoais, a exemplo da família e amigos. Tal veracidade afirmação pode ser confirmado confirmada numa simples conversa em um grupo alternativo. Porém, as prioridades citadas podem nem sempre ser bem vistas bem-vistas ao olhar geral do meio social em que vivemos.', 'Em livros e revistas são citados como ""vencedores"" aqueles que ocupam grandes cargos, se graduam cedo, ou adquirem vagas em importantes instituições, para instituições. Para se confirmar o que digo: sabemos quem é Einstein, Aristóteles, foram Einstein e Aristóteles, mas não sabemos quem foi o primeiro homem a reunir um grupo de amigos, e isso não é errante errado, muito pelo contrário, é imperioso para o desenvolver e crescer de uma nação. Sendo assim, somos pressionados a ocupar grandes cargos e vagas para só depois fazermos o que seja de nossa escolha. Por isso existem pessoas frustradas que só buscam a ""vitória"" e esquecem o ""viver"".', 'Então, o que pode ser feito para que alcancemos a nossa realização pessoal e profissional? Que busquemos o que nos faz bem, a religião em que cremos, os valores que admiramos e julgamos necessários, e profissionalmente necessários e, profissionalmente, os cargos que sejam de nosso querer, sem nunca deixar de lado aquilo que precisamos dominar para saber como as coisas funcionam e foram criadas, e até mesmo entender quem somos.']",160,160,120,160,120,720
89,Como conscientizar a população acerca do isolamento social em meio a crise economica,"['Alguns estudos de universidades dos EUA, relatam que, o isolamento social, fez muita eficácia nos meses de março a junho de 2020.No entanto,o grande problema é a crise economica em todo o mundo,que só tende a crescer mais. Nessa perspectiva esse desafio deve ser superado de imediato.', 'Visto que, muitas empresas sofreram com a pandemia de isolamento. Para não irem à falência, despediram muitos de seus funcionários. Nas empresas de turismo,a perda de emprego atingiu marca de 1 milhão de desempregados,nesse setor. Além de outros setores econômicos.', 'Ademais,as condições precárias do modo de vida dessas pessoas, são os piores. Deixam suas casas, para irem morar nas ruas,por não conseguirem pagar contas de casa. De acordo com os dados do IBGE ,107 mil pessoas deixaram suas casas, por falta de condições.', 'É evidente que, o isolamento trouxe uma grande taxa de falta de desempregados. Essas pessoas, devem procurar novos meios de vida, algo que chame atenção de outras pessoas,mas sempre tendo em vista o isolamento social. Espera-se que se promova maior taxas de empregados em todo país.']",120,120,120,160,120,640
91,Andressa- xxx,"['No período da Antiguidade, podemos ver o surgimento do conhecimento científico e suas contribuições para a melhoria do padrão de vida das pessoas na sociedade. De forma análoga a isso, podemos perceber que atualmente ocorre um grande negacionismo científico no meio em que vivemos. Nesse contexto, há a configuração de um problema causado pela negação da importância da ciência, podendo interferir na qualidade de vida da população.', 'Em primeiro plano, evidencia- se, que a negação da importância do saber científico é um grande problema. Segundo Louis Pasteur, os benefícios da ciência não são para os cientistas, e sim para a humanidade. Porém, muitas pessoas acabam descredibilizando tal conhecimento, acreditando em crenças populares, teorias da conspiração, ou, apenas negligenciando a ciência, tendo em vista que ela é muito importante para diversos eixos sociais, como a educação, a saúde, a economia, dentre outras áreas e que os efeitos do negacionismo científico podem prejudicar toda uma população.', 'Além disso, é notório que esse problema interfere na qualidade de vida das pessoas. O artigo 1 da Constituição federal prevê como um fundamento a cidadania, que inclui o direito uma boa qualidade de vida. Logo, essa implicação acaba ferindo um pressuposto básico da sociedade e pode acarretar no surgimento de outros problemas, como a diminuição da expectativa de vida, a disseminação e o surgimento de novas doenças, a falta de saneamento básico e etc.', 'Portanto, conclui-se que, há a necessidade de medidas que venham conter os efeitos do negacionismo científico na sociedade. Consequentemente, cabe ao governo criar programas e leis, que visem investir na ciência, por meio do Ministério Público Federal, a fim de que haja uma melhoria no padrão de vida da população. Somente assim, nós poderemos fazer jus a importância da ciência na sociedade e suas contribuições ao longo da história.']",160,160,160,200,160,840
22,Restrição no foro privilegiado,"['O foro privilegiado é um benefício concedido para políticos ou quem ocupa determinados cargos públicos. Essas pessoas não são julgadas pela justiça comum, demonstrando uma sensação de impunidade.', 'Alguns defendem o foro privilegiado, pois consideram que a justiça comum não tem possibilidade de realizar julgamentos de uma pessoa com alto cargo e muita influência política, com total imparcialidade. Por exemplo, se um juiz de uma determinada cidade tivesse que julgar o governador do estado , seria enorme a pressão política exercida sobre o magistrado.', 'Por outro lado, há quem defenda a manutenção do foro, não no formato atual, mas reduzindo o número de cargos e agentes públicos beneficiados. No entanto, no modelo virgente , percebe-se uma certa impunidade, pois alguns casos demoram tanto para serem julgados que chegam a prescrever.', 'Por tanto , a sensação de impunidade aumenta cada vez mais em nosso país. Algumas formas de amenizar essa situação, além da redução de pessoas com foro privilegiado, é a celeridade no andamento dos processos, para evitar prescrição, maior rigor na aplicabilidade e execução das penas. Com isso, passaria, efetivamente, a valer a máxima que a justiça é para todos.']",160,120,120,120,120,640
44,O lugar da mulher em meio a sociedade,"['Desde os primórdios a figura da mulher é associada ao mundo doméstico, no qual ela fica responsável pela educação dos filhos e pela dinâmica da casa. Felizmente, ao longo da história houve mulheres que romperam com este estereótipo e buscavam se mobilizar contra essa realidade. Mesmo com todo este movimento a mulher ainda tem encontrado dificuldades para se afirmar na sociedade como mulher, devido a questões de ordem cultural e estrutural.', 'Em primeiro lugar a afirmação da mulher tem se deparado com diversos desafios, dentre eles a ideia construída sobre seu papel. Essa construção segue toda uma ideologia patriarcal que sempre subestimou a capacidade do sexo feminino, a exemplo, do ocorrido com a atleta sul-africana, que teve seu desempenho atrelado a um hormônio . A questão mostra-se paradoxa, quando procura igualar a atleta a outros corredores masculinos, devido produção hormonal e não a sua capacidade e habilidade como atleta. Logo, é possível perceber como o aspecto cultural pode tensionar o lugar da mulher na sociedade a partir de um vies patriarcal.', 'Além disso, a conjuntura atual oferece muitos obstáculos para garantir a inserção da mulher nos segmentos existentes. Nesse parâmetro, nota-se uma baixa representatividade da figura feminina em locais de deliberação, como no meio político e nas corporações, os quais são majoritariamente ocupados por homens. Desse modo, observa-se a concentração das decisões em mãos masculinas e, consequentemente, o detrimento do protagonismo da mulher. Portanto, a falta de acesso a instâncias de deliberações pode prejudicar a ascensão feminina.', 'Sendo assim, para que a mulher ocupe o devido espaço em meio a sociedade faz-se necessário ações de conscientização e fomento. Logo, desde a terna idade as crianças devem ser educadas no sentido de que homens e mulheres devem ter as mesmas oportunidades e direitos. Para tanto, o Ministério da Educação deve inserir essa temática na grade curricular das escolas, como um tema transversal. Concomitantemente, o governo federal deve fomentar a inserção da mulher em órgãos deliberativos do próprio governo, através de processos seletivos simplificados, com o objetivo de diminuir a diferença entre homens e mulheres no exercício desses cargos, bem como estender essa iniciativa para o setor privado, de maneira que as empresas que igualarem a ocupação das vagas entre homens e mulheres possam ter  redução de encargos fiscais.']",160,160,120,200,200,840
54,,"['Durante o início do século XX, a cidade do Rio de Janeiro passou por uma intensa reforma sanitária  liderada pelo então diretor de saúde pública, Dr. Oswaldo Cruz. Dentre suas medidas, se destacou a imposição da vacinação obrigatória para o povo da cidade, com o intuito de prevenir doenças como a varíola e a febre amarela. O projeto do doutor foi um sucesso e a vacinação se tornou cada vez mais comum no Brasil, sendo responsável até pela erradicação de diversas doenças. Já no início do século XXI, entretanto, as coisas saíram do rumo, visto que diversas doenças erradicadas no país voltaram a ser diagnosticadas. Sendo assim, cabe analisarmos esse problema e buscar uma maneira de contorná-lo.', 'Primordialmente, é necessário enfatizar a importância da vacinação, de tal maneira que é prevista por lei como sendo obrigatória na infância, pelo Estatuto da Criança e do Adolescente. Todavia, segundo dados fornecidos pela Organização Mundial da Saúde, o índice de vacinação no país vem só diminuindo. A aplicação da vacina tríplice viral, por exemplo, reduziu em 15% em um período de três anos. Assim sendo, notamos que existe um desafio e que soluções devem ser tomadas.', 'Além disso, cabe ressaltar o papel da falta de informação e até mesmo a negação da mesma, na geração do problema. O visionário norte-americano Martin Luther King,  dizia que nada é mais perigoso que a ignorância sincera e a estupidez consciente. Atualmente, o que se vê no Brasil é justamente isso, uma vez que o povo sabe da questão da vacinação, mas não a atribui sua devida importância, o que facilita no retorno de doenças extintas.', 'Com base no que foi exposto acima, podemos concluir, portanto,  que há motivos para que novos surtos de doenças obsoletas ocorram no país e que soluções cabíveis são urgentes. Diante disso, cabe ao Ministério da Justiça a missão de endurecer as leis de obrigatoriedade de vacinação, exigindo o cartão de vacina do cidadão nas mais variadas situações, como na procura de um empregou ou na bilheteria de um show, para que a prática de ser vacinar se torne comum novamente. Desse modo, podemos manter um controle de doenças estável no país valorizando a importância da vacinação.']",120,160,80,120,80,560
69,,"['A Revolução Verde foi responsável pelas transformações tecnológicas no campo visando alcançar uma maior produtividade. Nesse contexto de evolução, agrotóxicos foram introduzidos para equilibrar os danos causados pelas pragas e aumentar o rendimento. Entretanto, os produtos estão sendo usados de forma excessiva causando problemas de níveis preocupantes. Nesse sentido convém analisarmos as principais causas, consequências e possível solução para esse impasse.', 'Primeiramente cabe pontuar que a falta de capacitação dos agricultores é um dos fatores que agravam a problemática. Isso porque na fome por dinheiro grandes produtores ou até mesmo de pequeno porte usam de maneira errônea os agroquímicos para o lucro ser maior. Segundo dados da OMS  o Brasil é o maior consumidor de agrotóxicos do mundo, tal pesquisa só comprova que são necessárias mudanças urgentes.', 'Em segunda análise vale destacar que a fauna, flora e saúde humana são as mais afetadas pelos pesticidas. Comprova-se isso pelo desaparecimento das abelhas, de acordo com Marina Lacôrte especialista do Greenpeace em agricultura e alimentação, a população do inseto na Europa declinou em 37%. Além disso, a ingestão de alimentos com alta concentração de agrotóxicos causam no homem lesões nos rins, cânceres, problemas no sistema nervoso e em casos mais graves chegando ao óbito do paciente.', 'Portanto, medidas são necessárias para resolver o impasse. É imprescindível que os agricultores aprendam a maneira correta de aplicar os agroquímicos e sejam conscientizados dos males trazidos pelos produtos, a fim de que o uso do mesmo seja reduzido . Isso pode ser realizado através de cursos profissionalizantes criados pelo Ministério da Agricultura em parceria com a ANVISA , sendo garantido de forma gratuita para os produtores rurais e aplicado por um profissional experiente na área, com o intuito de que a educação seja uma forma de combater a problemática. Além disso, é importante que a população investigue o que está consumindo optando por alimentos orgânicos e agroecológicos, com esse hábito é garantida uma vida saudável e livre de defensivos agrícolas na alimentação. Dessa forma, o Brasil poderia superar o uso exacerbado de agrotóxicos.']",120,160,120,160,120,680
111,Deve ou não haver maior controle sobre o consumo do álcool?,"['O álcool consumido em excesso, principalmente por jovens, é um dos principais                 causadores de morte nos últimos anos. A combinação: álcool + direção, como podemos ver nos jornais, não          combinam         de forma alguma. Muitos acidentes de trânsito estão relacionados a casos de         embriaguês         ao volante. Outro fato preocupante também está relacionado ao consumo de álcool nos         estádios         que gera a violência entre as torcidas rivais.         Ainda mais que com a copa do mundo         chegando, além de preocupante, esse assunto também já está se tornando polêmico.', 'Com a          lei de proibição da venda de bebidas nos estádios, com o objetivo de evitar os conflitos entre as torcidas durante o evento, já          vêm          gerando vários debates                e opiniões entre a própria sociedade. Agora, também podemos relatar a lei seca que proíbe o condutor de algum veículo automotor de consumir bebida alcoólica antes de dirigir. Esta medida é excelente, no início gerou muita discussão, mas aos poucos foi                 tomando forma                e a grande maioria aderiu. Essa última citada, já evitou bastantes acidentes com vítimas e serve de exemplo a ser seguido pelas pessoas que irão aos estádios durante a Copa.', 'Com a criação de mais leis e de mais projetos de conscientização para o controle do álcool na sociedade, as estatísticas poderão cair cada vez mais em relação às vítimas fatais que o álcool         nos proporciona         .']",80,120,120,120,80,520
89,Vidas em risco e egoísmo presente,"[""Quando analisamos filmes que retratam realidade de abandono do mundo pelo ser humano, imediatamente o ''Por que?'' urge em nossos pensamentos; por que a população deixaria chegar a esse ponto?! Bem exemplificado no filme de animação, da Walt Disney, ''Wall-e'' cujo retrata o descaso da sociedade perante a destruição do Planeta, fugindo para viver em outro Globo em vez de cuidar da Terra. Em nossa realidade, lutamos contra uma pandemia e a discussão acerca do descaso com a saúde em prol do benefício próprio ficou alta em 2020. Neste sentido, a falta de conscientização popular e a desigualdade social se tornam predominantes nesse lamentável cenário."", ""Em primeiro plano, pode se analisar a indiferença da população com os cuidados e restrições em aglomerações, já que há um vírus chamado covid-19, do qual é transmitido por meio de pequenas gotículas do nariz ou da boca, onde essas gotículas residem em superfícies e objetos. O nível de contaminação se tornou alto e ocorreu urgência de isolamento imediato devido à grande massa contaminada e pelo número de óbitos. Apesar disso, a população começou a não respeitar os limites, exigidos pelo governo, frequentando lugares lotados, como: bares, casas de festas e eventos para mais de 10 pessoas e sem devida proteção. O site do G1, mostrou em 2021, que o país contabilizou mais de 200 mil mortos desde o início da pandemia. Nessa ótica, é notável a problemática onde não há empatia com o próximo além da crença ''não vai acontecer comigo''."", ""Além disso, surgiu uma crise econômica atrelada à chegada do vírus, da qual foi necessário fechamento do comércio e de lugares não essenciais para evitar aglomerações. A crise atingiu a todos, e a exigência de reabertura foi imposta, principalmente, pelos empresários e donos de estabelecimentos que não estavam lucrando com o ''lockdown''. Isso causou a morte de diversos funcionários, de diversas áreas, pois o patrão impôs que permaneceriam trabalhando. Uma pesquisa analisada pelo G1, apontou que funcionários de frigoríficos tem três vezes mais chance de contrair o vírus. Por meio desta análise, é percebido a desigualdade social, na qual os proprietários exigem que seus contratados corram riscos para não perder o lucro normalmente gerado."", 'Portanto, entende-se a necessidade de frear o aumento da contaminação e o direito a saúde todos os níveis econômicos Para tanto a prefeitura  em parceria com o governo estadual, devem enviar a segurança pública para as ruas a fim de manter as cidades sem aglomerações e conscientizar as pessoas divulgando todas as informações de óbitos e como os sintomas agem no contaminado; bem como a solução da desigualdade, implantar multas mais severas a estabelecimentos que não obedecerem as normas e limites de tempo de trabalho estipulados pelo Ministério da Saúde. Dessa forma, será possível cuidar de quem amamos e viver por mais tempo em nosso mundo.']",160,160,160,200,160,840
78,A reforma do ensino médio,"['Muito se tem discutido, recentemente, acerca da reforma do ensino médio, que consiste basicamente na flexibilização da grade curricular, permitindo ao estudante escolher uma área do conhecimento para aprofundar seus estudos. Afinal, a reforma do ensino médio seria a solução para a questão da educação no Brasil ?', 'Ao examinarem alguns fatores como  o desempenho dos alunos nas avaliação nacionais verifica-se a educação no país é péssima. Isso sem contar com os altos níveis de desistência. Alguns argumentam , com a reforma do ensino médio, esses índices diminuiriam, tendo em vista o aluno apenas estudaria as matérias de seu interesse,  ou de sua ""vocação"".', 'Por outro lado, a unificação das disciplinas em quatro grandes áreas faria com que o adolescente não tivesse uma visão completa acerca dos assuntos mais importantes de cada disciplina . Além disso, observa-se que o adolescente, em sua , muitas vezes ainda não é capaz de escolher qual profissão seguir, ou até mesmo discernir qual área mais lhe agrada, o que torna complicada a aplicação prática da reforma.', 'Em virtude dos fatos acima mencionados, percebe-se que a proposta de reforma do ensino médio é de fato precipitada, e além de não ser a solução , pode tornar a educação brasileira ainda mais precária.']",80,120,120,80,40,440
48,EM BUSCA DA MELHOR CONSOLIDAÇÃO DO SUS,"['A constituição federal de 1988 declarou saúde como direito de todo cidadão, assim para promulgar tal objetivo criou-se o SUS ( Sistema Único de Saúde) . Tendo em vista essa ferramenta, muito se tem discutido, atualmente, a respeito dos desafios e da importância da saúde pública no Brasil. Isso se motivou devido aos fatores econômicos, atrelado aos socioculturais que corrobora a sociedade em época de pandemia.', 'Em primeiro plano, é relevante abordar que muitos brasileiros dependem do SUS, uma vez que por meio desse benefício os cidadões tem acesso a medicamentos e exames gratuitos. Entretanto, muitas instituições de saúde carece de investimentos, várias vezes provocado pela ambição desmedida de alguns que desviam verbas; além de nos últimos anos ocorrerem cortes financeiros no ministério da saúde. Afinal, é amplamente divulgado nas mídias situações que corrobora à economia do setor público de saúde; por conseguinte provocando na demora em atendimentos, falta de equipamentos e medicamentos.', 'Além disso, observa-se na sociedade brasileira o previlégio em assistência médica, no qual determinados grupos ( minorias) são desacatados de seus direitos . Tal fato, é influenciado por alegorias que se prenderam no país desde o passado; prova disso está reflexo na vinda da família real ao Brasil em 1808, em que os mais pobres foram expulsos do centro da cidade do Rio de Janeiro, com o objetivo de criar um ambiente favorável as pessoas de alta patente. Ademais, outras problemas ainda estão em meio a sociedade, como a discriminação racial e homofobia, os quais, constantemente, são debatidos na atualidade. Assim, por conter esses paradigmas, muitas pessoas são desfavorecidas nos atendimentos pelo SUS.', 'Portanto, observa-se que a saúde pública gratuita é de fundamental importância para a população, porém ainda existem problemas que impedem na sua melhor efetivação. Assim, para explorar melhor o SUS, é necessário que o governo, por meio de verbas, fomente maiores investimentos na saúde, como são feitos no agronegócio. Outrossim, é preciso que o ministério da justiça, em parceria com o ministério da saúde, promova uma maior investigação, a qual puna as pessoas que estão desviando verbas, além de identificar os casos de desacatos de direitos, e, por meio da lei, puna-os severamente. Assim, o direito instituído na constituição de 1988 será melhor aproveitado.']",120,160,120,160,120,680
87,Crianças erotizadas,"['Produtos que são inifensivos como series, roupas e demais acessorios podem parecer que causam nehum transformação no comportamento da criança no mundo a sua volta, mas há sim uma grande influencia mesmo que seja pequena. Então apartir vê-se a configuração de um problema de contronos específicos que emerge devido a falta de debate e a educação lacunar.', 'Primerio, é preciso salientar que a falta de debate uma grande latente do problema . Segundo o filósofo Foucault, na sociedade pós-moderna temas são silenciados para que estruturas de poder sejam mantidas. Nesse ponto de vista pode-se enxergar uma grande influencia no que tangue a erotização infantial, já que marcas que lucram com esses produtos, não se importam como aquilo pode influenciar na vida sexual de uma criança . A bioeticista Daiane Priscila Simão-Silva afirma que a sexualição infantil pode ocorrer através de estimulos externos, como algo que está acessiveis a todo tempo a ela.', 'Em paralelo, outro causa para configuração do problema é a educação lacunar. De acordo com o filosofo Kant, é resultado da educação que teve . Sob essa tica, se há um problema social, há como base uma lacuna educacional. No que tangue a erotização infantil, verifica-se uma forte influencia dessa causa, uma vez que as escolas não tem comprido seu papel no sentido de previnir e reverte o problema, visto que naçao tem trazido esses conteudos para a sala de aula.', 'Portanto, uma intervencão faz-se necessária, Para isso é preciso que os governos estaduais com parceira com as escolas, promovam debates sobre a questão no ambiente escola e fora da escola,  Tais eventos podem ocorrer no periodo contraturno, contando a presença de pedagogos e professores. e dos pais das crianças. Além disso, esses eventos devem ser abertos à comunidade, afim de que mais pessoas pessoas compreendam o prejuizo que a erotização com crianlas é uma tangente a ser levada a sério. Assim, poder se configurar um Brasil melhor e até um mundo.']",120,160,120,160,160,720
49,INFLUÊNCIA PATOGÊNICA,"['Como dito por Humberto Eco, “ O drama da Internet é que ela levou o imbecil da aldeia ao portador da verdade.”, ou seja, a internet torna qualquer um capaz de persuadir, de influenciar, papel responsável pelo chamado influenciador digital. Porém, a persuasão pode ser de caráter maligno , levando o telespectador a acreditar em uma ideia incompatível com o momento político ou social em que realmente está vivendo . Portanto, as redes sociais devem controlar o conteúdo inserido por usuários e os próprios influenciadores se conscientizar de suas atitudes.', 'A priori, as redes sociais devem julgar rigorosamente o conteúdo o qual autorizam ser compartilhado, cientes de que o papel do influenciador digital deve ser positivo e não afete ninguém, diferente de atitudes irresponsáveis, como um vídeo de uma festa realizada em pleno período de isolamento social contra o coronavírus postado pela blogueira Gabriela Pugliesi, o qual gerou não apenas polêmica, mas também rescisão de contrato por parte de patrocinadores que ela tinha.', 'Ademais, o papel do chamado influenciador digital deve não ser apenas lucro ou prejudicar seu púbico através de falsas ideologias, mas sim a disseminação de boas práticas e boas culturas . Logo, com esse objetivo, aquilo que Theodor Adorno e Max Horkheimer denominaram como indústria cultural, o uso de cultura como objetivo de lucro, seria bem menos evidenciada na sociedade.', 'Destarte, é necessário que as plataformas de compartilhamento em parceria com universidades  forneçam cursos a usuários de rede com alto nível de influência digital, capazes de mudar opiniões do seu público . A plataforma cederia uma bolsa de estudos ao usuário que por sua vez frequentaria aulas presenciais sobre matérias de relações sociais na faculdade mais próxima, e ao final do curso, com aprovação do aluno, esse seria permitido a compartilhar conteúdo na mídia . Deste modo, o papel do influenciador digital, o “portador da verdade”, não seria realizado por um simples imbecil, como dito por Humberto Eco, mas por um sábio influenciador.']",160,160,120,160,120,720
92,O Falso Perigo Amarelo,"['Entre os séculos 19 e 20 alastrou-se a expressão ""perigo amarelo"" para indicar o suposto risco de povos do Leste Asiático invadirem o Ocidente. Atualmente,com a pandemia de coronavírus, o preconceito contra esses povos voltou tona. Nesse contexto,se vê que o preconceito amarelo é recorrente na sociedade e,por isso,em tese,é crucial combatê-lo para que ela seja verdadeiramente  igualitária.', 'Primeiro,é necessário saber quais mazelas esse preconceito traz. Um dos problemas é que,apesar dos amarelos estarem imigrando para o Brasil desde 1900,eles,mesmo os nascidos no Brasil,são vistos como estranhos e,por isso,muitos indivíduos acham que eles não deveriam ter os mesmos direitos que outros cidadãos brasileiros. Outro entrave é que a mídia,com frequência,ridiculariza seus traços físicos e estereotipa sua cultura,fazendo assim com que eles sofram xenofobia e racismo.', 'Em segundo plano,é importante saber porque essa mazela se perpetua. Ela persiste poque muitos brasileiros,por falta de instrução,ao pensar em amarelos,só conseguem levar em consideração seus traços físicos e,por eles serem diferentes dos ocidentais,não conseguem ver,mesmo os asiáticos nascidos no brasil,como iguais. Além disso,por não terem acesso à cultura asiática,muitos ficam presos as estereótipos que a mídia gera sobre amarelos e,por isso,grande parte da população acaba tirando conclusões erradas sobre amarelos e sua cultura. Por esses motivos, o governo deve difundir a verdadeira cultura asiática.', 'Portanto,o impasse deve ser resolvido. Então,o MEC (Ministério da Educação),por ser o responsável pela educação pública do Brasil,deve ,por meio da aula de ciências sociais,ensinar os estudantes a conhecerem os asiáticos além de sua aparência e os reconhecer como membros da sociedade brasileira para que,assim,os asiáticos não sofram mais ataques preconceituosos. O MEC,também,desmentirá,por meio de campanhas midiáticas,estereótipos sobre asiáticos,para que,não mais,a sociedade seja enganada por eles. Paralelamente, o Ministério da Cidadania,por meio da Secretaria Especial da Cultura,que é o órgão responsável por levar cultura aos brasileiros,promoverá eventos públicos sobre a verdadeira cultura asiática,para que a população,como um todo,entre em contato com ela. Assim,a sociedade, não mais, temerá,de forma infundada, o ""perigo amarelo"".']",160,160,120,160,160,760
89,Isolamento social em debate,"['A adoção do isolamento social tem sido a principal ferramenta defendida por especialistas sanitários no combate contra o covid-19. No entanto, uma parcela significativa da população entende que esta medida pode ocasionar uma quebradeira econômica no país. Nesse contexto, observar-se que a saúde e a economia vem sendo tratada de forma polatizada, totalmente, equidistante o que tem causado um grande desgaste no enfrentamento contra a doença. Tal questão pode estar sendo potencializada por fatores culturais, bem como por uma estrutura cambaleante.', 'Em primeiro lugar, a ascensão de uma sociedade sempre esteve associada a ideia de crescimento econômico. Embora, não haja nada de errado nisso, esse posicionamento se mostra conflitante,  quando o desenvolvimento de um país é pautato, preponderantemente, pela lei de mercado em detrimento do social. Esse parafoxo no atual contexto de pandemia é percebido pela dicotomia criada em relação às medidas sanitárias e o funcionamento de atividade não essenciais, como se a sobrecarga dos sistemas de saúde não viesse a impactar a esfera econômica. Portanto, essa concepção de saúde margem da economia tende a considerar o isolamento social como algo nefasto e não como um instrumento necessário para evitar maiores prejuízos sociais e, consequentemente, econômicos.', 'Ademais, quando se analisa o aspecto estrutural envolvido nas ações contra o coronavirus, nota-se que a existência de uma coordenação coesa em âmbito nacional pode mostrar-se efetiva contra os efeitos da doença. Entretanto, no caso brasileiro, observar-se uma coordenação tímida nesse sentido, a qual tem refletido, diretamente, no processo de imunização da população contra a covid-19, já que as aquisições tardias da vacina tem gerado um ambiente propício para a proliferação da doença, além do surgimento de novas cespas virais. Logo, a ausência de uma ação conjunta no combate ao vírus pode vir a causar um colapso no sistema público de saúde e acentuar as comorbidades econômicas já vigentes em nosso país.', 'Diante disso, urge a necessidade de iniciativas que possam amenizar os efeitos do covid-19 em nossa sociedade. Para tanto, os dirigentes públicos devem realizar campanhas publicitárias massivas sobre a importância do isolamento social para conter a disseminação da doença e, assim, evitar a sobrecarga das unidades de atendimento saúde. Paralelamente, o Ministério da saúde deve criar mecanismos que acelerem as aquisições das vacinas, bem como insumos para a produção de vacinas por Institutos brasileiros com know how na área, com o objetivo de imunizar, pelo menos, 70% da população.']",160,200,160,200,160,880
93,Novas práticas da medicina humanizada,"['O parto humanizado é caracterizado por respeitar a autonomia da gestante e oferecer o bom atendimento. Desse modo, deve-se avaliar o parto humanizado como questão de saúde pública. Ademais, cabe-se analisar os fatores do comportamento individualista presente na sociedade e a medicina humanizada aplicada no cotidiano. Assim, diante das barreiras para efetuar mais partos humanizados são necessárias medidas .', 'Nesse viés, as condutas superficiais individuais atuais fragilizam o andamento o parto humanizado, pois essas só visam o benefício individual. Outrossim, o filósofo Bauman descreve em sua teoria da “Modernidade Líquida” que os indivíduos líquidos apresentam relações frágeis que não buscam o bem-estar da maioria. Nesse contexto, esse conceito se faz presente quando o número de cesáreas sem necessidade aumenta e, primordialmente, é desrespeitado a autonomia da gestante visando o lucro e tempo médico. Em síntese, os atos líquidos dos atuais prejudicam a realização de partos humanizados, visto que superficializam e fragilizam as relações entre paciente e profissional de saúde.', ""Além disso, o conceito de medicina humanizada surgiu recentemente e visa diminuir barreiras entre médico e paciente. Do mesmo modo, na série “Grey's Anatomy” – disponível na Netflix – é discutido diversas vezes os benefícios em diminuir a distância entre profissionais e pacientes. Todavia, as relações sociais cotidianas barram as ações humanizadas no ambiente de hospitais e o parto humanizado, pois dificultam a conversa e respeito com a gestante . Em suma, a medicina humanizada ainda encontra dificuldades para se estabelecer no mundo real, diferentemente, do mundo ficcional."", 'Portanto, frente á problemática das barreiras para a realização dos partos humanizados, são necessárias medidas. Urge ao Ministério da Saúde – na sua função de assegurar a saúde aos brasileiros – promover a saúde e bem-estar das gestantes no Brasil . Desse modo, por meio de campanhas e palestras efetuadas através de profissionais especializados nos institutos de saúde, proporcionar o efeito de aumentar o espaço da medicina humanizada. Por conseguinte, diminuir os frutos das ações individualizadas e propiciar um bom atendimento.']",160,120,120,160,160,720
87,Infância abreviada,"['De acordo com o pensador e filósofo chinês Confcio: "" Não corrigir nossas falhas é o mesmo que cometer novos erros"" . Desse modo, é possível afirmar que enquanto a cultura da erotização infantil ainda estiver arraigada em nossa sociedade e sendo instigada pela mídia e os demais meios de comunicação, nossas crianças terão sua infância abreviada.', 'A sexualidade está presente em todas as fases de nossas vidas, inclusive na infância, onde através da curiosidade natural das crianças e com o diálogo dos pais,  se descobrem o que é e quem são. Porém essa descoberta se não abordada de modo correta, natural e saudável, leva a adultização infantil, a erotização e nos casos mais graves, abusos sexuais.', 'Indubitavelmente podemos observar essa cultura da erotização na normalidade errônea em ver crianças escutando e dançando determinados tipos de músicas que são destinadas a adultos, em roupas mais sensuais fabricadas e direcionadas ao público infantil, em filmes e séries onde a parte infantil é propositalmente abreviada  influenciando a criança a querer ""crescer"" fora do tempo. Os perigos da cultura da erotização infantil aumentam ainda mais quando o acesso internet é sem a supervisão dos pais, pois estão expostos a inúmeros conteúdos incompatíveis com a idade e de acordo com o IBGE aproximadamente 80% das crianças tem acesso internet no Brasil.', 'É imprescindível que os pais se informem e zelem pela infância de suas crianças, supervisionando a todo conteúdo que chegam a eles, que tenham diálogo claro e explicativo para que entendam o certo para cada fase da vida e que o governo faça campanha para combate, conscientização e fiscalização para erradicar a cultura da erotização infantil, como declarou o ativista Mahatma Ghandi: ""Temos que nos tornar a mudança que queremos ver"".']",160,160,120,120,160,720
62,As redes sociais e o ódio,"['Atualmente vivemos  em uma sociedade que o discurso d ódio este muito presente nas redes sociais, e ter virado rotina, principalmente por parte dos adolescentes e jovens.', 'Observamos que os discursos de agressões por meios das palavras em sites e nas redes sociais,  tem sido por motivo fútil por não gostar ou não concordar com as opiniões expostas.', 'Infelizmente com isso cresce o número de casos de violência,  e invasões nas redes sociais para a difamação do usuário da conta.', 'Observamos que se faz necessário interversões e um mecanismo de organização, para a conservação da privacidade e a propagação de informação nas escolas e outros meios de conscientização sobre o uso indevido das redes sociais.']",120,80,40,40,40,320
44,A ameaça da legitimidade da mulher,"['O esporte feminino vem ganhando destaque significativo nos últimos anos. Esse processo de evolução contínua provém de dietas funcionais e treinamento árduo. Entretanto, um caso específico de uma atleta desafia a Federação do esporte, visto que a mesma possui maiores níveis de testosterona, beneficiando-a com maiores quantidades de músculos e melhor rendimento esportivo. Outrossim, a mulher sempre seguiu corretamente a regulamentação para participar das modalidades, fazendo com que não houvesse motivos para ser desclassificada.', 'Segundo o médico Benjamin Levine, formado na Universidade Texas Southwestern, a testosterona constrói a musculatura corporal e eleva o número de glóbulos vermelhos no sangue, o que resulta no aumento da circulação do oxigênio e consequentemente a elevação da produção energética do corpo. No caso da competidora cujo nível de testosterona é muito elevado, os resultados são vistos dentro das pistas, já que a mesma se consagrou campeã olímpica nos 800 metros duas vezes consecutivas. Todavia, o mérito de suas conquistas não deve ser focado em seus hormônios em razão da mesma ter persistido e praticado o esporte de forma fatigante para obter seus resultados de forma justa e honrosa.', 'Indubitavelmente, os traços biológicos colaboram para a trajetória vitoriosa, em virtude de que proporciona constantemente a própria excelência esportiva. No entanto, a medida tomada pelo World Athletics de forçar as atletas com transtornos hormonais a ingerir medicamentos para diminuição da testosterona até se tornar “padrão” é falha.  Pois se faz presente como punição da naturalidade da mulher, criando um pressuposto de que indivíduos do sexo feminino são restritos de capacidade de superarem seus limites, formando um marco extremo da competência das mulheres, indo de encontro ao esporte que preza pela autossuperação e pela projeção de quebra de recordes incessantemente.', 'A partir do que foi atribuído, conclui-se que a participação da atleta é válida e justa. Contudo, a Federação Internacional de Atletismo deve revogar o mandato de medicação obrigatória às pessoas com transtornos no desenvolvimento sexual, permitir a participação da esportista em todos os eventos atléticos e apoiar todas as mulheres igualitariamente com equipamentos específicos e alojamentos adequados para que consigam superar os limites impostos, e deste modo, evidenciarem o legítimo poder das mulheres.']",200,160,160,160,160,840
93,Parto Humanizado e Sáude Feminina.,"['A saúde feminina sempre foi considerada um tópico tabu, não importa se estamos falando de menstruação, saúde mental ou saúde física em geral; Mulheres sempre tiveram que lutar por tudo, pela liberdade de expressão, pelo direito de votar e trabalhar, pelo direito de escolha e pelo direito de um tratamento decente. O parto humanizaqdo é um bom exemplo sobre como o sistema de saúde muitas vezes ignora a necessidade das mulheres, valorizando a opnião masculina, mesmo se estiver errada.', 'Uma em cada quatro mulheres sofre violência obstétrica durante o parto, fazem precedimentos desnecessários e invasivos sem o consentimento da paciente. Existe muita desinformção sobre o corpo feminino, resultado de médicos homens que decidiram assumir e teorizar ao invés de escutar as mulheres que eles tratavam, e isso acontece até hoje, médicos ignoram seus pacientes feminos e não respeitam suas opniões e preocupações.', 'A ideia de que uma mulher precisa sofrer durante o parto para poder ser uma ""mãe de verdade"" é uma ideia medieval e estúpida, pesquisas mostram que maiora dos casos de depressão pósparto acontecem por que a mulher sofreu algum tipo de violência duranto o processo, além disso essa ideia exclui a existência de mães adotivas e mães que não puderam ter parto normal por conta de problemas de saúde e riscos.', 'O fato de que temos que lutar pelo direito de parto humanizado é vergonhoso, pois parto humanizado devereia ser a norma e não a exceção. Dar luz é uma das coisas mais díficeis e mais bonitas que uma mulher pode fazer, e mesmo assim, em um momento tão especial e vulnerável, a mulher ainda não tem o direito de ter o controle, mesmo durante o nascimento do próprio filho, a mulher ainda é tratada como um ser que só exite para sofrer e seguir ordens.', 'Isso só mostra a falta de respeito que a nossa sociedade tem com as mulheres, m uma situação tão estressante e delicada, o mínimo que elas merecem é o direito de ter controle sobre como o parto vai acontecer, e fazer as próprias escolhas. Parto humazidao é uma quetão de saúde pública porque se trata de mulheres que ficam afastadas do trabalho, mulheres que ficam traumatizadas com a experiência, crianças que ficam sem mão por causa da depressão pós parto. O direito de tar um parto tranquilo e sguro é para todos. Então, sim, é questão de saúde pública.']",160,120,120,160,120,680
78,Reforma do Ensino Médio - uma solução ou um problema para a questão da educação no país?,"['No final do ano de 2016, no Brasil, tivemos uma nova proposta pelo governo A reformulação do Ensino médio. Diversos habitantes do país já ouviram falar, mas não sabem ter um posicionamento ou opinar sobre o assunto.', 'A reforma do ensino médio, ) reduz a duração de três anos para um ano e meio, aumenta a carga horária e tem como ideia retirar algumas matérias como artes, educação física, filosofia e sociologia do currículo mínimo obrigatório e deixar os alunos ou responsáveis escolherem o que o aluno irá estudar. O lado bom desta proposta é que o governo oferece ao aluno um curso técnico, mas, em contra partida, o aluno que ainda não decidiu sobre qual profissão seguir, vai ficar perdido e corre o risco de tomar uma decisão equivocada 9equívocada) sobre seu futuro profissional.', 'Existem vários colégios técnicos pelo Brasil e não é difícil entrar nem de encontra-los, basta estudar para fazer uma prova e em caso de aprovação o indivíduo fará um técnico com qualidade na unidade em que desejar. Para aumentar a carga horária, devemos ter dinheiro,para pagar as contas, alimentação dos alunos, aumentar o salário dos professores, e como sabemos, o país está em crise e não tem dinheiro para manter aquilo que tem, que dirá para botar em prática um projeto onde as chances de dar errado são imensas.', 'Não é ideal retirar disciplinas como artes, que estimula a sensibilidade dos alunos e educação física que incentiva a prática de esportes. Vale lembrar que é necessário exercitar o corpo e a mente para termos um melhor desempenho. Mas, no caso de sociologia e filosofia é um caso a se pensar, pois essas são as matérias que ""ensinam a pensar"", e se são matérias que ensinam a pensar,a grade delas não deveriam ser feitas por pessoas ligadas ao governo, para não ter influência sobre o pensamento dos alunos sobre diversos assuntos. A grade delas, deveriam ensinar realmente a pensar e não repercutir um discurso que foi""imposto"".', 'Grandes potências como a Inglaterra, França e Coreia do Sul adquiriram este  método de ensino e muitos dizem : ""se deu certo lá, vai dar certo aqui"" as a primeira coisa a se pensar é que não deve haver comparações entre nações, já que as realidades são completamente distintas .Não podemos comparar países desenvolvidos com um país subdesenvolvido. Um jovem que passa o dia inteiro em um colégio, não pode sair diretamente da instituição de ensino para trabalhar, pois, não adianta ter conhecimento teórico quando não se tem o conhecimento prático do dia a dia e conhecimento sobre o mundo. O governo, para influenciar na opinião dos jovens, pagou para um canal no youtube, para falar bem da respectiva reforma. Para começar, foi uma atitude bem apelativa. É uma forma de fazer os jovens concordarem sem ao menos saber direito sobre o que o assunto se trata. Para haver reformulação do ensino médio, tem que ter  um estudo a longo prazo, interesse do governo em melhorar a educação e dinheiro para investir. ""O ser humano é aquilo que a educação faz dele"", disse Kant.']",80,80,80,80,80,400
56,A solução para o sistema prisional brasileiro,"['Os presídios podem ser descritos de diversas formas, a depender da ideologia que ilumina este termo. Podem ser entendidos como lugar de punição, quando o Estado impõe a pena de morte ou o enclausuramento, como lugar de pagamento de débitos sociais, quando institui prazos máximos de pena e determina quanto tempo de prisão equivalem ao peso do crime cometido, ou como lugar de reflexão, mudança de conduta e redenção, como divagam e alardeiam muitos teóricos do direito e da política, que desenham no papel uma estrutura de primeiro mundo aos presídios de um país sem a organização necessária para tornar isso real.', 'Mas não importa por qual ideologia os presídios sejam descritos. A realidade destes é muito aquém do esperado para sua função sob qualquer uma das alternativas ideológicas. No Brasil, facções de presidiários comandam o crime dentro e foras das cadeias, presos saem antes de cumprirem suas penas, ou permanecem presos indefinidamente, e a mudança que ocorre na “psiquê” do preso é para intensificação da tendência ao crime, pelas condições desumanas que vivenciam, como a superlotação de celas, ambientes insalubres e parcas políticas sociais de profissionalização e reinclusão social .', 'Presos morrem todos os dias por falta de atendimento médico adequado, por violência de outros presos, por doenças adquiridas dentro do presídio. Presos aprendem a manter a própria vida através da violência, são destituídos de direitos humanos básicos, sendo acumulados em selas projetadas para receber menos da quinta parte dos presos que recebem.', 'As revoltas prisionais, as mortes de presidiários, a depredação e vandalismo dos prédios e equipamentos públicos, apenas refletem a ausência da justiça, a falta de definição sólida sobre os reais objetivos do sistema penitenciário brasileiro e das medidas necessárias para sua eficácia, oferecendo à injustiça o lugar de sua oponente e transformando as cadeias em nascedouros de sofrimentos tal qual os descritos no literário Inferno da “Divina Comédia” de Dante.', 'Para que essa realidade mude, e os detentos sejam tratados como humanos e não como números, é preciso a definição de qual seria a convicção do Estado sobre os objetivos da prisão, juntamente com a execução de ações para tornar essa convicção concreta na realidade das cadeias brasileiras, porque a falta de concretude nos objetivos de uma prisão,  torna mais complexa a extinção do caos que se tornou o sistema prisional brasileiro.']",120,160,120,160,120,680
44,O que é ser mulher?,"['“Não se nasce mulher, torna-se”, disse Simone de Beauvoir. Quando escreveu esta frase, Beauvoir não poderia saber o quanto ela reverberaria através das décadas e seria argumento de discussões em um momento que difere intensamente daquele em que ela o professou. Recentemente, tem-se debatido o que define uma mulher e um homem, e esta discussão atingiu o esporte quando uma atleta sul-africana foi impedida de competir por seus níveis hormonais de testosterona serem maiores que o permitido para uma mulher. Este caso é um entre vários que mostram a dificuldade dos atuais sistemas dicotômicos de abranger a diversidade.', 'O caso da atleta sul-africana traz à tona uma discussão muito maior e se assemelha a discussão do caso da jogadora de vôlei transsexual Tiffany Abreu, que causou controvérsia ao entrar em times femininos de vôlei. A polêmica se dá em função de Tiffany ter nascido no sexo masculino e, por ter começado tratamento hormonal para resignação de gênero depois da puberdade, teria vantagens em relação às outras atletas do sexo feminino. Embora as histórias das duas atletas sejam diferentes, elas escancaram a falta de preparo das atuais regras para essas exceções, e também para um mundo que está mudando. As duas mostram que a noção de gênero de mulher, dentro do esporte, está atrelada à níveis hormonais. Se ser mulher é ter níveis hormonais em um certo padrão, há muitas pessoas do sexo feminino no mundo que não se encaixariam nesta definição por uma gama de motivos, entre eles a menopausa.', 'Também há a grande questão de como organizar os novos formatos de gênero no mundo. Existem mais de 100 tipos de gênero diferentes, o que coloca em xeque a dicotomia homem e mulher com a qual dividimos a humanidade. Dentro do esporte, essa dicotomia evidentemente não é mais adequada, e tende a ser ainda mais inadequada no futuro, com o crescimento da notoriedade e a briga por espaço social de pessoas trans. Há a necessidade de novas regras e novos parâmetros que possam encaixar todos os seres humanos.', 'Em síntese, para que essa discussão seja abordada de forma justa, é necessário primeiramente que pensemos no que define ou não define uma mulher. Além disso, o atual sistema se mostra desatualizado e inapropriado para o cenário de diversidade que o ser humano possui. A fim de que este sistema seja mais justo, seriam necessárias novas regras, talvez um sistema baseado em níveis hormonais. Desta maneira, as duas atletas mencionadas não teriam que provar se se encaixam ou não em seus gêneros, mas que são aptas para a sua categoria esportiva.']",160,160,160,120,160,760
82,Remédios que podem curar ou matar,"['Muito se debate, nos dias de hoje, sobre o uso de medicamentos que as pessoas fazem por conta própria mesmo sabendo dos vários riscos que tal ato pode acarretar. O certo a se fazer seria procurar a assistência médica sempre que houver algum problema ou desconforto físico em que o indivíduo esteja sentindo, evitando assim qualquer risco de agravar a situação, mas, ? se a sociedade agisse dessa maneira ? ocorreria uma sobrecarga no sistema de saúde tanto pelo excesso de pacientes quanto a  falta de estrutura, principalmente, na atual situação da saúde brasileira.', 'Dentre  os inúmeros motivos que levaram a concluir que a automedicação pode ser prejudicial ? deve-se citar o caso dos antibióticos, que, se usados de forma incorreta ? é capaz  de não eliminar a infecção bacteriana corretamente ? deixando as bactérias mais resistentes no organismo da pessoa ? podendo se tornar  algo incurável ? levando à morte. Outro fator problemático é o uso excessivo de medicamentos  ? tornando-se um vício causando outros problemas de saúde sendo também fatal.', 'Já aconteceu vários casos de pessoas que se intoxicaram por ingerir anti-inflamatórios, analgésicos e antitérmicos. O uso indevido ligado a  falta de conhecimento sobre o remédio pode ocasionar uma falsa melhora na doença, escondendo temporariamente os sintomas, e no caso da utilização de outros medicamentos junto há o risco de um anular o efeito do outro.', 'Em vista dos argumentos mencionados, faz-se necessário que as farmácias apresentam uma maior rigidez na venda de remédios sem algum pedido médico. Também é importante que as escolas ensinem os riscos da automedicação para os alunos e que o governo invista em postos de saúde em várias regiões com a finalidade de atender casos mais simples.']",160,120,160,160,160,760
43,Novo nome para um problema antigo,"['Em 2006, Jack Doe fundou o “Twiter” com o objetivo de criar uma rede, na qual as pessoas pudessem se socializar. No entanto, o microblog assim como outras redes sociais  a exemplo de “Facebook"" e “ Instagram"" tiveram suas finalidades distorcidas, uma vez que essas foram transformadas em julgamento digital: cancelamento, como é conhecido. Nessa conjuntura, essa “cultura” prejudica as relações sociais, já que essa ação fragiliza a dignidade humana da pessoa cancelada e evidencia a maldade humana.', 'Sob uma primeira análise, o movimento #""metoo"" buscou denunciar o assédio e a exploração sexual. Entretanto, foi subvertida em cancelamento, nome novo para um velho problema: o discurso de ódio. Esse hábito criado na internet fragiliza a dignidade humana da vítima, pessoa julgada, pode ser considerado um tipo de violência, uma vez que o indivíduo julgado é difamado e atacado verbalmente nas redes, o que pode ocasionar grandes efeitos como a depressão, síndrome do pânico, por exemplo. Nesse sentido, percebe-se o grande problema a ser superado para a construção de uma sociedade mais empática.', 'Ademais, na obra “1984”  de George Owell, a população é convidada pelo Estado a passar dois minutos por dia diante da teletela para manifestar seu ódio, o que ficou conhecido na obra como “ 2 minutos de ódio”. Fora da ficção, infelizmente, a situação é ainda mais hostil, uma vez que os indivíduos passam horas por dia diante de seus “smartphones"" manifestando aversão a outras pessoas. Enquanto a maldade humana se mantiver, o Brasil será obrigado a conviver com uma das mais graves mazelas sociais: a hostilidade.', 'Dessa forma, é evidente que o problema é um grande obstáculo social e que precisa ser superado. Portanto, é necessário que o governo crie um projeto, que seja colocado em prática em todas as escolas do país, a ação poderá ser realizada por meio de parcerias público- privadas. O projeto poderia ser chamado de “Usuário consciente"" e teria como principal objetivo educar os usuários das redes sociais para que eles possam usá-las de maneira responsável e consciente, fazendo assim com que a proposta original delas seja realizada.']",160,160,160,200,160,840
83,,"['A prática de esporte é uma recomendação que todos os especialistas da área de saúde passam para as pessoas, e revelam que os benefícios são de grande plenitude, tanto na parte física como social.', 'A ONU, Organização das Nações Unidas, revelou que as pessoas praticam atividades esportivas, tendem a melhorar o condicionamento físico, como disposição no dia a dia, diminuição de chance de adquirir alguma doença ao longo da vida e também tornam pessoas interativas, sem preconceito, com um maior vínculo social. De modo que para os brasileiros torna-se a cada dia um avanço na redução de violência e de mortes ocasionadas pelo sedentarismo populacional.', 'Mas, as coisas não são fáceis, muitas cidades brasileiras não têm estrutura de qualidade para fornecimento de esportes. De fato não ser um problema só no Brasil, porém de grandes países também, como Canadá, que tem um elevado número de obesidade decorrente da falta de atividades físicas. Por isso, planejamentos esportivos estão sendo tomados, como ideia principal gerar uma melhoria de laser no meio social, de interatividade, a serem desenvolvidas principalmente nas favelas e periferias brasileiras, como tentativa de ofertar mais oportunidade nesses lugares.', 'Então, todas as pessoas devem incentivar as entidades governamentais para desenvolver em suas cidades locais para o fornecimento de atividades físicas, com boa estrutura e com profissionais qualificados para executar as mesmas.']",0,0,0,0,0,0
89,Um novo jeito de viver.,"['As pandemias são conhecidas como epidemias que se esparzem rapidamente por variados países e afetam uma grande quantidade de indivíduos. Deste modo, as pandemias geram consequências em nível micro e macro sistêmico determinando regras em mudanças de hábitos sociais, e mobilização de variadas naturezas. Assim de acordo com a Organização Mundial de Saúde (OMS), o surto da COVIDE-19 iniciou-se na China em dezembro de 2019, e desde então está se alastrando por diversos locais.', 'A princípio, no que se refere a aspectos sociais, o Ministério da Saúde lançou uma variedade de recomendações para sociedade a fim de informa-las quanto as relativas de transmissão, prevenção e procedimentos e caso de contagio da doença. Uma das principais consequências é o distanciamento social e o isolamento como medida de prevenção.', 'Em decorrência, decretos são lançados como medidas de prevenção ao contagio pelo novo coronavírus, nele inclui suspensão de aulas, determinação de horários de serviços essenciais e não essenciais e medidas especificas para que os serviços essenciais atendam a população.', 'Posteriormente, observam-se com o isolamento social como medidas protetivas, existem resultados negativos como como doenças psicológicas, estresses ocorridos devido perdas financeiras, momento de recessão econômica, pobreza e desemprego.', 'Logo, o distanciamento social é de grande valia, pois devido ao contagio de transmissão, diminuiria os números de contaminados, porém a população deve conscientizar e fazer sua parte, não precisa parar o mundo para controle de contaminação e sim ter o amadurecimento suficiente das pessoas sobre os cuidados respeito ao próximo e responsabilidade.']",160,160,120,160,120,720
46,Será possível ter um saneamento básico de qualidade sem privatização do serviço?,"['A questão do saneamento básico é um dos maiores problemas que sucede no Brasil. Diversas obras cinematográficas mostram claramente esse situação, como no filme “Saneamento Básico” que retrata a história de uma comunidade que batalha para conquistar o direito ao tratamento de esgoto e melhores condições de vida. Apesar de se tratar de uma ficção, sabemos que infelizmente essa situação ainda faz parte da realidade de uma grande parcela de brasileiros, principalmente quando se refere a camada social mais desfavorecida que inclui residentes de áreas mais afastadas e que não possui a mesma atenção e investimento por parte do Estado. Diante disso, temse discutido a possível privatização do saneamento básico.', 'Segundo dados de serviços de infraestrutura, 48% da população brasileira não possui coleta de esgoto, dado preocupante e que revela uma grave incapacidade do Estado de oferecer um saneamento básico de qualidade e que seja capaz de atingir todos os brasileiros, situação que acontece devido à grande extensão territorial do nosso país e a escassez de recursos do governo, que acarreta no aumento de doenças na população', 'Apesar do saneamento básico ser um direito assegurado pela constituição federal, e um dever do Estado garantir esse direito a todos os cidadãos brasileiros, isso não ocorre no Brasil, uma vez que uma grande parcela dos brasileiros não tem acesso a esse serviço. Com a privatização do saneamento básico o principal benefício seria um maior controle de qualidade na prestação do serviço, porém, por outro lado, isso encareceria o preço o que afetaria diretamente a população mais pobre e que não possui condições.', 'Levando em consideração esses aspectos, é possível notar um grande déficit na gestão tanto do governo como dos Estados de oferecer um saneamento básico de qualidade que consiga atingir toda a população brasileira, fazendo assim necessário a privatização do mesmo. Porém, é preciso levar em consideração a população mais carente. Pensando nisso, uma possível medida que poderia ser adotada pelo governo seria privatizar o saneamento básico somente em áreas urbanas “mais ricas”, ou seja, locais onde as pessoas possuem uma maior aquisição financeira e que podem pagar pelo serviço, assim o Estado diminuiria os gastos e poderia focar nas áreas mais afastadas e de população pobre, que não possuem condições para custear um serviço privado e que teriam esse benefício de qualidade entregue pelo governo. A questão da privatização do saneamento básico um assunto que exige uma análise minuciosa e que deve visar principalmente a camada social brasileira menos favorecida.']",160,160,120,120,120,680
142,Razão x coração,"['Nos dias de hoje                é normal                 chegar em adolescentes                e fazer a seguinte pergunta: “O que você quer ser                 quando crescer                ?” e consequentemente         ganhará         uma resposta como: “ Ainda não sei!” ou ainda “Estou em dúvidas!”. Isso é normal, pois muitos não sabem se seguem a         “razão ou o coração”,         dinheiro ou realização pessoal.', 'Estudos recentes afirmam que estudar faz as pessoas serem mais feliz, pois a educação         ajuda elas         a         desenvolverem          uma qualidade de vida como também a          terem          uma condição social melhor.', 'Há         também aqueles que abandonaram seus estudos e encontraram a “felicidade” e         tem         uma carreira profissional bem sucedida e são reconhecidos mundialmente. Um bom exemplo seria o de Mark Zuckerberg, criador de uma das redes sociais mais usadas recentemente, o Facebook;         onde  ele         largou Harvard para realizar um projeto social,         onde         está obtendo muito sucesso.', 'Em meio a muitas decisões e muitas dúvidas,                 pensar com a “razão e o coração” é a maneira mais apropriada para          que retorne          um futuro próspero e mais feliz.                Independentemente de qualquer profissão escolhida, as pessoas         tem         que levá-las a sério, pois qualquer trabalho bem feito resultará em sucesso e em uma carreira profissional bem sucedida.']",120,120,80,80,80,480
43,A Lei do Cancelamento,"['Na era Mesopotâmica, a Lei de Talião definia a sentença de acordo com o erro das pessoas, podendo resultar em decapitação, amputação de membros entre outras atrocidades. Hoje, a Lei de Talião converteu-se em cultura do cancelamento, tornando juízes pessoas comuns por detrás das telas. Isso, entretanto, incorre em degradação da saúde mental dos envolvidos além de afetar sua vida profissional e pessoal.', 'No que tange a saúde mental, o stress causado pelo cancelamento atinge ambas as partes envolvidas. A falta de comunicação leva extremos  como discursos de ódio e até mesmo linchamento virtual. De um lado, existe o furor e desejo ardente de fazer justiça, e do outro lado o medo constante de sofrer novos ataques, até mesmo físicos.', 'Já no âmbito profissional, o cancelamento gera uma série de prejuízos a curto, médio e longo prazo, haja vista que empresas e patrocinadores não desejam associar seu nome e marca aos cancelados . Um exemplo recente pode ser visto através da influenciadora Gabriela Pugliese que, após uma comemoração com amigos - em período de quarentena - por se recuperar da Covid-19, sofreu cancelamento, perdas contratuais e até mesmo desativou suas redes após ataques virtuais.', 'Dessa forma, faz-se crucial a conscientização da população por meio da mídia e das redes sociais acerca do diálogo como premissa , em vez de julgamentos precipitados. Também, cabe ao Estado intervir em situações criminais como racismo, homofobia e ameaças, para erradicar a sensação de impunidade que leva os internautas a praticarem sua própria justiça. É preciso menos olhos por olhos e mais olhos nos olhos']",200,160,120,120,160,760
43,A INTERNET DEVE SER UM AMBIENTE AGRADÁVEL,"['A cultura do cancelamento é uma forma incoerente de expor o equívoco cometido por algum digital influencer ou celebridade nas redes sociais. Dessa maneira, pode-se considerar uma problemática sobre esse fato: omo a cultura do cancelamento afeta a vida do cancelado e a convivência nas redes sociais? Com isso convém analisarmos essa problemática e responder a tese em questão.', 'Em primeiro plano, é importante argumentar que quando um digital influencer é cancelado em alguma rede social, como por exemplo o Instagram, sua vida financeira decaí. Isso acontece porque grande parte do patrimônio financeiro de um influencer advém de parcerias com grandes marcas, lojas, publicações pagas e indicações de produtos. Dessa forma, quando cancelado o influenciador perde parcerias e consequentemente dinheiro. Pode-se tomar como exemplo atual a digital influencer Gabriela Pugliesi que foi cancelada por quebrar a quarentena no auge da pandemia covid-19 . Quando esse fato ocorreu a moça rapidamente perdeu parcerias no Instagram e como consequência segundo uma pesquisa feita pela revista Forbes, Pugliesi teve um prejuízo de 3 milhões de reais. Por isso, é nocivo que esse problema ainda ocorra em nossa sociedade.', 'Em segundo plano, é importante mencionar que a cultura do cancelamento afeta a comunhão nas redes sociais, tornando-se mais tóxica. Isso acontece porque os canceladores acreditam ter a autoridade para fazer justiça através de insultos contra o cancelado. O que ocasiona um ambiente tecnológico prejudicial, pois, os internautas se sentem apreensivos a postar algo e serem vítimas de ofensas. Sendo assim, esse universo virtual se torna cada vez mais invasivo em relação as publicações alheias e é alarmante que isso ainda persista em nossa sociedade.', 'Considera-se, portanto, que para melhorar essas problemáticas é necessário que os internautas, modifiquem o cancelamento para uma denúncia virtual, por exemplo, caso algum famoso cometa uma falha a mesma deve ser evidenciada e criticada de maneira respeitosa, justa e livre de insultos para que não prejudique gravemente a vida do influencer. Logo, o objetivo a ser alcançado com essa proposta é que a denúncia virtual se torne uma sentença justa nas redes sociais, a fim de prevalecer a empatia alheia. Dessa forma, a internet pode-se tornar um ambiente mais agradável.']",200,160,160,200,160,880
55,A Força da Lei,"['O Brasil não foi descoberto no dia 22 de abril de 1500. Na verdade, ele foi invadido, orque quando as caravelas portuguesas, Nina, Pita e Santa Maria aportaram em Porto Seguro na Bahia, os invasores portugueses não encontraram uma terra vazia, eles encontraram uma civilização indígena, que logo, trataram de chamar de selvagens. Sem respeito, sem diálogo e sem cerimônia tentaram sem sucesso escravizar os legítimos donos da Terra. E se apossar do Brasil para sempre.', 'Em dezembro de 2016, o governo federal entregou ao Ministério da Justiça a Proposta de Regulamentação da Demarcação de Terras Indígenas que, se aprovada, altera radicalmente o processo de reconhecimento das terras tradicionais, além de paralisar por volta de 280 processos de demarcação que já estão em andamento.', 'A maior discussão gira em torno do decreto que muda o processo de desocupação de áreas onde haja presença de não índios. Pelas regras atuais, o governo propõe indenizações financeiras a donos de propriedades rurais, quando estes estão dentro de áreas que são reconhecidamente terras indígenas. O que o novo decreto prevê é que, agora, os índios sejam indenizados e não voltem mais para as terras.', 'O governo não levou em consideração ou dialogou com a FUNAI e os povos indígenas afetados para o desenvolvimento da proposta. Por isso, organizações da sociedade civil divulgaram uma nota de repúdio, pois acredita que o texto contraria a legislação vigente, a jurisprudência e impossibilita a resolução dos conflitos atuais. Se o governo pode fazer tudo o que quiser, passando por cima da minoria como um rolo compressor . Então, pra que a lei ? A força da lei deve ser maior,  que a lei da força.', 'De forma inédita, os indígenas passaram a ser protegidos por lei específica em 1973, por meio da Lei nº 6.001, que regula a situação jurídica dos índios ou silvícolas e das comunidades indígenas, com o propósito de preservar a sua cultura e integrá-los, progressiva e harmoniosamente, à comunhão nacional. No direito a lei não retroage, E quem é o governo para mudar as regras do direito?  A sociedade deve se solidarizar com os brasileiros indígenas para que esse absurdo não prospere. O Brasil precisa dessa população tão significativa para salvar nossas  florestas e rios. Os índios precisam de proteção e paz. Tem que respeitar sua cultura e seu modo simples de viver. Como falou o mestre Paulo Freire ( Patrono da educação brasileira) Não há saber mais ou saber menos. O que há é saberes diferentes.']",120,120,80,120,80,520
71,O problema do suicídio entre os jovens,"['O aumento do suicídio entre os jovens pode estar sendo uma consequência das mudanças recentes que a sociedade está passando. A vida moderna tem reduzido o tempo de qualidade que os pais têm com os filhos.', 'Nesse sentido, muitas pessoas, principalmente os jovens, têm cada vez mais reduzido o tempo de interação com o mundo real e se dedicado ao virtual, com a popularização das redes sociais, principalmente. Nesse meio, as pessoas não desenvolvem bem como resolver seus insucessos na vida. Um toque pode deletar o que desagrada.', 'Um outro fato é que a nova geração tem sido educada de forma mais liberal pelos pais. Os filhos têm menos convivência com a frustração, ouve-se pouco o não, levando muitos ao desenvolvimento inadequado da inteligência emocional. Dessa forma, quando os jovens são expostos às cobranças, tomadas de decisões que o mundo lhes impõe, não conseguem ter uma referência familiar ou no círculo de amizades em quem possam expor seus problemas e dificuldades de adaptação à vida adulta . Isso pode afetar negativamente a saúde mental e em alguns casos culminar no suicídio.', 'Portanto, para reduzir a incidência do suicídio entre os jovens é necessário uma ação do Estado, por meio de políticas públicas nas diversas áreas, e da sociedade para mudanças na forma de criação das crianças. Estas, convivendo com mais apoio familiar, aprendendo a conviver com a frustração desde cedo, se tornarão jovens mais confiantes e preparados para encarar os desafios que a vida adulta lhes reserva.']",120,120,120,120,120,600
95,,"['Promulgada pela ONU, em 1948, a Declaração Universal dos Direitos Humanos garante a todos os indivíduos o direito à vida, segurança e bem-estar social, entretanto no atual momento, há muitas divergências acerca da ocupação dos indígenas nas terras, além disso há muitos anos os índios são silenciados pela população e pelo governo, acarretando cada vez mais a pera do seu território de devido ao crescimento das áreas urbanas e da agropecuária. Diante disso, é necessário a discussão dessas questões a fim de garantir os direitos essenciais aos povos nativos', 'É importante destacar que há uma insuficiência legislativa, visto que não tem leis suficientes para cessar este problema, por isso os indígenas sofrem com uma falta de legislação para lutar pelos seus direitos de terra. Além disso, de acordo com o Amazônia Org, nos anos de 2019 e 2020, houve um crescimento de quase 90% das invasões às terras indígenas, isso acontece por não haver fiscalizações nas regiões limitadas á população indígena.', 'Ademais, este marco temporal só estaria favorecendo a expansão dos negócios ruralistas e dos latifundiários que iriam utilizar dessas terras apenas para agropecuária, colocando estes interesses econômicos acima do direito de viver do habitantes e afetando as práticas culturais das tribos que estão relacionadas com o ambiente natural. A carta de Pero Vaz de Caminha é um exemplo,  ela caracteriza o povo que sob os olhares dos europeus  precisava ser civilizado. Esse olhar continua até os dias de hoje na sociedade, pois os brasileiros ainda pensam como os portugueses ao considerar a cultura indígena como selvagem.', 'Desta forma, a delimitação de terras indígenas causa sérios problemas socioculturais nessas sociedades. Então, cabe ao Ministério dos direitos humanos, criar e aperfeiçoar leis para o controle dessas áreas. Junto polícia federal, para garantir a segurança das fronteiras com armas e equipamentos de vigilância, para a prisão efetiva de invasores. E que o Senado, através de parcerias com banqueiros, organizem fundos de verbas para garantia monetária do projeto, assim, conservando a sua riqueza cultural pondo fim a essa “guerra”.']",120,120,120,160,120,640
80,O combate contra o racismo no Brasil,"['O racismo no Brasil é um problema que deve ser combatido tanto pela sociedade como pelo governo. A herança histórica de escravidão, segregação racial e racismo, principalmente contra a população negra, deixa sequelas que são notadas até os dias atuais, evidenciando o fracasso da sociedade em alcançar uma democracia racial que colocasse o negro em condição indiferenciada aos demais.', 'Em primeiro lugar, vale ressaltar que o negro ainda é preso a novas formas de exploração que o impede  de ascender a uma condição melhor de vida. A marginalização e o preconceito refletem as  taxas de analfabetismo, de criminalidade e de mortalidade dos negros.', 'Em segundo lugar, vale lembrar que a lei brasileira define como crime atos de preconceito de raça ou de cor,  e até de religião. No entanto, são comuns casos de discriminação no dia a dia, como o caso da jornalista da Globo que recebeu mensagens de racismo nas redes sociais.', 'Sendo assim, é necessário que o governo atue em conjunto com a sociedade e com a iniciativa privada, seja promovendo ações afirmativas para corrigir desigualdades raciais presentes na sociedade, oferecendo igualdade de oportunidade e combatendo o preconceito e o racismo, seja punindo com maior rigor os crimes resultantes de discriminação.']",120,120,80,120,80,520
58,Floresta não será folclore,"['A partir século XVIII, com o advento da Revolução Industrial, um grande número de áreas florestais foi devastada no mundo visando ao estabelecimento de indústrias e habitações. O processo de urbanização, responsável pela atenuação dos territórios florestais, mostrou-se prejudicial à biosfera, sendo o recrudescimento de problemas ambientais um exemplo disso. A preservação da floresta amazônica, um dos biomas que contém mais biodiversidade no planeta, faz-se necessária não apenas por seu papel na contenção dessas problemáticas, como também por ser um habitat natural para diversas espécies animais.', 'O aumento da presença de gases intensificadores do efeito estufa na atmosfera, ocasionado por ações antrópicas, mostra-se uma das problemáticas da sociedade contemporânea, tendo em vista o aumento da temperatura global gerado por tal fenômeno. O dióxido de carbono (CO2), um desses gases, é consumido por plantas no processo de fotossíntese, o que exprime a importância da preservação dessas na redução de intempéries climáticas, como o aquecimento global. Logo, para que a temperatura do planeta permaneça estável e, por conseguinte, a biosfera tenha condições de subsistir, é necessário que ocorra a proteção da Amazônia.', 'Além disso, esse bioma é de extrema importância na manutenção do equilíbrio ecológico, uma vez que abriga grande diversidade de vida animal. Este conjunto, entretanto, é ameaçado quando a incidência de queimadas, como as ocorridas em agosto de 2019, aumenta na floresta, ocasionando a migração e morte de espécies nativas da região, as quais fomentam desequilíbrios ecológicos que, direta ou indiretamente, afetam a humanidade, uma vez que a cadeia alimentar detém relativa importância para a subsistência de alguns povos, como as populações ribeirinhas. Assim, é corroborada a tese da imprescindibilidade de preservação da Amazônia para a manutenção da estabilidade ecológica.', 'A floresta amazônica deve, assim, ser protegida. O reflorestamento de áreas devastadas dever ser providenciado por projetos do Ministério do Meio Ambiente, tendo em vista a importâncias dessas na atenuação de problemáticas ambientais. Estudos sobre o comportamento da cadeia alimentar da região, que analisem notificações de avistamento de animas fora de suas áreas de habitação, por exemplo, são necessários, visando verificação do impacto das ações antrópicas na região  e criação, com base em dados oriundos de tais pesquisas, de políticas  ambientais mais eficientes.']",120,120,80,120,120,560
6,A Caixa de Pandora Brasileira,"['O filme ""Avatar"" apresenta o planeta Pandora, local habitado pelos extraterrestres ""Na´Vis"", os quais mantêm uma relação harmoniosa com a Natureza. Entretanto, a chegada dos humanos à procura de metais preciosos nesse território perturba a paz dos nativos e ameaça o equilíbrio ambiental. Embora ficcional, esse panorama retrata a busca de ganho monetário em detrimento da preservação do Meio Ambiente, como as constantes perdas da cobertura vegetal da Amazônia, propiciadores propiciadoras do agronegócio. Com isso, o combate à exploração amazônica é um incontestável e urgente dever brasileiro.', 'A princípio, é preciso analisar as causas da destruição da Amazônia. Nesse sentido, muitos agropecuaristas inconscientes desmatam essa região, ao retirar a vegetação natural, para formar pastos, onde ocorrerá a criação de gado, o qual posteriormente será comercializado. Esses locais, com o decorrer do tempo, após o intenso pisoteamento pisoteio dos animais, desgastam-se e, consequentemente, perdem sua fertilidade. Além disso, também são realizados incêndios para facilitar a remoção da cobertura vegetal, o que libera CO2 em excesso, o qual fica retido no ar, intoxicando-o, principalmente pela falta de árvores que realizam a fotossíntese, ou seja, retêm dióxido de carbono e liberam oxigênio. Logo, esse tipo de pecuária não sustentável destrói o Meio Ambiente e deve ser combatido.', 'Por conseguinte, esses crimes contra a Amazônia suscitam debates acerca da responsabilidade governamental do Brasil, focadas, atualmente, nos incêndios iniciados em Rondônia, que se espalharam para outros lugares do país e, ainda, não foram resolvidos. Desse modo, ao considerar a soberania brasileira com relação à região amazônica, denota-se percebe-se a responsabilidade intransferível que o país tem de cuidar de sua preservação, além preservação. Além de prevenir crimes, o governo precisa fiscalizar adequadamente essas áreas e impedir a exploração desnecessária.', 'Portanto, cabe ao Ministério da Agricultura, Pecuária e Abastecimento incentivar, por meio de pagamento de subsídios agrícolas aos produtores, a prática da pecuária sustentável na Amazônia, ao rotacionar o uso do solo, evitando desgastá-lo, além de incitar a plantação de árvores para reduzir o impacto do agronegócio. Ademais, o governo deve fiscalizar essas áreas para que não haja atividades ilegais, impedindo a exploração mostrada em ""Avatar"".']",200,160,160,160,200,880
58,,"['No que se refere às queimadas e desmatamento, é possível afirmar que este problema tem crescido de modo considerável no Brasil, tendo em vista,  não só a falta de consciência da população, mas também a ausência de investimentos do poder público. Sob este impasse convém analisarmos as causas, consequências e possível medida em relação a este grande imbróglio que afeta a floresta amazônica.', 'Primeiramente, torna-se necessário analisar os motivos de tantas queimadas, que abrange cerca de 60% de todo território nacional . Isso se evidencia, na maioria dos casos, por interesses econômicos de pessoas que usam como estratégia o fogo para desmatar e posteriormente usarem o terreno limpo para usar,  tanto na pecuária quanto no plantio. Deste modo, torna-se inacreditável que cidadãos brasileiros aceitem acabar com o seu patrimônio mais precioso em benefício próprio, com consequência de prejudicar não só a ele, mas também a toda sociedade.', 'Outro aspecto a ser considerado é a ineficácia do governo em relação a este problema tão abrangente no nosso país. De acordo com o INPE (Instituto Nacional de Pesquisas Espaciais) o mês de agosto de 2019 apresentou o maior foco de queimadas dos últimos nove anos. Deste modo, a tendência é que aumente caso não seja tomada providências eficientes do poder público a este viés tão alarmante e prejudicial.', 'Fica claro, portanto, que providências precisam ser tomadas para diminuir estes altos índices de desmatamento no país. Para isso, é dever do governo em conjunto com o Ministério do Meio Ambiente , investir no aperfeiçoamento de leis contra as pessoas que desmatam a floresta, com o propósito de aplicar penas severas para todos que efetuarem queimadas, a fim de combater de maneira drástica e eficiente o problema do desmatamento no Brasil.']",120,160,120,160,120,680
80,Destruindo o racismo,"['O preconceito racial no Brasil deve ser combatido primeiramente nas próprias mídias nacionais e depois exterminado através  de uma ação social em todas as escolas do país, com o intuito de educar as crianças e jovens para não cometerem esse crime. Porém, isso só se tornará possível se todos começarem a refletir e a querer a mudar as suas atitudes em relação ao preconceito racial.', 'A discriminação contras os negros no país poderá ser encerrada,  se um projeto de lei,   proibir às  mídias nacionais de utilizar de uma forma excessiva a imagem de qualquer indivíduo da cor em papeis, como em novelas ou filmes, como se eles fossem bobos, eternos serviçais, analfabetos ou ainda como bandidos. Isso de fato irá se caracterizar como um repressão contra a liberdade de expressão das mídias, mas a justiça e os demais devem entender que, para se fazer um filme ou uma telenovela,   utilizando-se os negros, eles não precisam personificarem sempre esses papeis.', 'Além desta  ação, o racismo também poderá ser neutralizado se uma grande mobilização social nas escolas de todo o país for posta em prática, com a finalidade de instruir crianças e jovens com materiais didáticos em forma de panfletos ou apostilas,   de que os negros não devem ser hostilizados,   só porque a cor deles é diferente das delas. Fora isso, o material deve apontar também que,   os negros têm uma vasta contribuição cultural em nosso país, seja elas em forma de danças, cânticos religiosos ou culinária   e que eles são indivíduos como qualquer um.', 'O Brasil tem tudo para combater o preconceito racial em toda a sua extensão, seja o coibindo nas mídias   ou  nas escolas. Porém, isso só se tornará possível se todos começarem a refletir e a querer a mudar as suas atitudes em relação ao racismo, pois   caso contrario, de nada irá adiantar se cada pessoa não começar a se reeducar para eliminar de vez esse costume tão arcaico e errado.']",160,120,120,120,160,680
84,Insegurança armada,"['O porte (irrestrito) de armas por civis é ilegal desde o Estatuto do Desarmamento que entrou em vigor no ano de 2003. No entanto, muitos parlamentares defendem a revogação desta lei, medida que está longe ser a resolução da violência e pode ainda agravá-la.', 'Muitas pesquisas demonstram que pessoas armadas não é sinônimo de tranquilidade e segurança. O relatório  global da ONU  sobre homicídios aponta que o porte de armas está diretamente relacionado ao aumento do número de mortes. Essa realidade pode ser verificada nos EUA, recentemente, um civil portando armas de fogo matou 50 pessoas e uma mãe matou suas filhas. Assim, percebe-se que essa não é (a) melhor solução para o reduzir o problema da violência, pois este problema possui raízes mais  complexas.', 'Além disso, um estudo publicado no Diário Americano de Saúde Pública indica que pessoas tendem a utilizar uma arma de fogo contra uma pessoa conhecida, um amigo ou familiar. Isso demonstra que o fim utilitário da arma não seria para autodefesa como muitos políticos alegam, mas sim, em momentos de brigas e atitudes impulsivas. Desse modo, a solução para o problema deve-se embasar em medidas que reduzam a violência.', 'Portanto, o porte de armas é só mais uma forma de banalização da violência. Para Paulo Freire, a educação é essencial para que ocorram mudanças na sociedade, por isso é importante que o Ministério da Educação ofereça palestras nas escolas que desestimulem atos de violências e incentivem o respeito mútuo. Também é necessário que o governo crie propagandas publicitárias  que induzam os indivíduos a fazerem uma reflexão sobre  o mundo do crime  e suas consequências.']",160,160,160,160,200,840
16,Por que uma onda conservadora?,"['O embate entre esquerda e direita, iniciado na revolução francesa, vem moldando os países desde a sua criação. Os termos, praticamente, se tornaram confusos ao longo dos séculos e hoje em dia, cada um ou cada grupo, tem sua própria concepção do que significa tais termos. A partir disso, cada um procura se colocar em um lado do espectro, ou às vezes, prefere o centro. Em uma democracia saudável, ambos os lados convivem ou deveriam conviver pacificamente, às vezes até se revezando como governo. Porém no Brasil, esse convívio se tornou tóxico ao ponto de um não suportar o outro.', 'Após aproximadamente duas décadas de um governo militar considerado de direita, com seus erros e acertos, finalmente um governo civil tomou posse; e desde então a esquerda, ou para alguns, liberais, vem governando o país e tentando se perpetuar no poder. Essa tentativa se tornou mais clara com a chegada da extrema-esquerda extrema esquerda ao poder, em 2002. Sempre com pautas que agradam à primeira vista, ela foi ganhando cada vez mais seguidores. O que a maioria não percebeu, seguidor ou não, era que todas as boas intenções acobertavam os piores esquemas de corrupção que o mundo já havia visto. Compra de parlamentares, aparelhamento dos poderes da república , desvios bilionários de empresas estatais, tudo em prol de uma agenda maligna criada e aperfeiçoada desde então, por um “burguês socialista”, há uns dois séculos atrás, mais ou menos.', 'Portanto, não é de se espantar que uma onda de direita conservadora tenha surgido em peso no Brasil recentemente. Como citado no texto, anteriormente, uma democracia saudável precisa de ambos os lados dialogando e chegando a um consenso para um bem-estar da população. Não pode ser aceitável em um país como o Brasil qualquer tipo de ditadura, seja de direita, ou uma ditadura corrupta corporativista de esquerda. Se um governo conservador vai ser bom, só o tempo dirá, mas 15 anos de governo progressista já se mostrou uma péssima experiência.']",120,80,80,120,80,480
48,Ineficiência do sistema de saúde pública,"['De acordo com a Declaração Universal dos Direitos Humanos, promulgada em 1948, todo cidadão tem direito à saúde e ao bemestar social. No entanto, o que se observa na hodiernidade brasileira é o oposto do garantido pela ONU , uma vez que a ineficiência do sistema de saúde pública e a má distribuição de médicos apresentam barreiras para a solidificação do clímax social.', 'A priori, é importante ressaltar que, durante a ditadura militar foi criado o Instituto Nacional da Previdência Social (INPS), que prestava atendimentos somente aos empregados com carteira assinada, negligenciando trabalhadores informais e desempregados . Com o fim do regime, a Constituição Federal de 1988 garantia saúde a todos ao iniciar o Sistema Único de Saúde (SUS) . Conquanto, embora o sistema possua muitos aspectos positivos, o subfinanciamento acarreta em problemáticas como a falta de recursos e remédios, além do aumento de filas de espera.', 'Em complementaridade, segundo o Conselho Federal de Medicina, há cerca de 470 habitantes por médico. No entanto, os profissionais de saúde não estão distribuídos uniformemente pelo país, visto que as metrópoles nacionais concentram 60% dos profissionais . Com o objetivo de interiorizar os médicos, o governo Dilma lançou o programa “Mais Médicos”, contudo, o atual governo o encerrou, agravando o problema.', 'Infere-se, portanto, que é imprescindível a mitigação dos desafios para a solidificação do clímax social. Nesse sentido, urge que o Ministério da Saúde  crie políticas que incentivem a interiorização de médicos recém-formados, por meio de incentivos fiscais, a fim de democratizar o acesso à saúde. Além do mais, faz-se necessário que o órgão amplie o financiamento ao SUS, por intermédio de verbas governamentais, com a finalidade de reduzir a falta de recursos e as filas de espera. Desse modo, atenuar-se-ão, a médio e longo prazo, os impactos negativos da ineficiência do sistema de saúde pública e a coletividade aproximar-se-ia dos paradigmas propostos pela ONU.']",160,160,120,200,160,800
87,"Comportamentos das crianças, exige muita atenção!","['Sabemos, que a erotização infantil, não começa sem nenhum comportamentos demonstrado pela criança, em alguns casos ela não fala, mas através de suas atitudes podemos perceber.', 'É importante ressaltar, que o facil acesso que as crianças tem a internet pode ser um agravante para essa erotização, por isso é preciso um monitoramento, porque a internet tem o seu lado positivo de passar informações, mas ao mesmo tempo tem o seu lado negativo, que é o acesso a coisas inadequadas, por exemplo, a pornografia.', 'A criança não entende a erotização, a cabeça dela fica confusa, porque é algo que leva a autoexploração, pois proporciona um acesso fácil e imediato.', 'Para a criança sair disso é preciso favorecer a ela, atividades que a estimulem, dar livros para ter o seu momento de leitura, passear, brincar, e é importante que os pais estejam sempre proximos, cuidar o que os seus filhos estão acessando, isso é muito importante.']",160,120,80,120,80,560
48,Desafios e importância do SUS no Brasil,"['No século XVIII, as santas casas de misericórdia, administradas pelos religiosos, prestavam assistência médica gratuita, em forma de caridade, aos necessitados que não possuíssem condições financeiras para pagá-las.  É notório que o SUS (Sistema Único de Saúde Pública) tem desempenhado tal papel na contemporaneidade. Dessa forma, é válido analisar o que ele representa para a população brasileira e quais suas dificuldades para que se desenvolva de maneira mais eficaz.', 'Observa-se, inicialmente, que foi a partir da metade do século XX, que a saúde no Brasil passou a ser oferecida gratuitamente, deixando de lado o viés da caridade. Tal fato ocorreu devido à participação da sociedade civil no processo de construção do que veio a se tornar a saúde pública brasileira com a implantação do SUS . Vale ressaltar, que esse modelo de atendimento é garantido pela CF/1988 em seu Art. 196 em que garante a saúde para todos e o dever do Estado nessa prestação. Prova disso é que, de acordo com o Ministério da Saúde, cerca de 151 milhões de brasileiros são atendidos pelo SUS gratuitamente, corroborando assim os benefícios prestados à sociedade brasileira não importando sua classe socioeconômica.', 'Porém, apesar das positividades apresentadas, são indiscutíveis as dificuldades enfrentadas no cotidiano tanto dos profissionais quanto dos usuários que procuram esse serviço. Isso acontece devido à falta de profissionais suficientes na área da saúde, de remédios para os pacientes, sobretudo os com doenças terminais como câncer, além de outras . Dessa forma, tem-se filas enormes espera de tratamento, além do estresse sofrido pelos que estão envolvidos na situação, conforme tem sido exibido pelo Jornal Nacional em suas reportagens por todo o período de 2019 e 2020.', 'Portanto, percebe-se a necessidade de que o governo federal, por meio do Ministério da Saúde, libere recursos financeiros suficientes aos Estados da federação, para que estes, em parceria com as suas respectivas secretárias de saúde, possam contratar profissionais nessa área, além de investir nas compras de material básico e no financiamento dos tratamentos de pacientes graves em tempo hábil a salvar vidas. Dessa forma, será possível amenizar os efeitos negativos sofridos pelos usuários desse sistema, proporcionando maior satisfação tanto aos que desempenham suas atividades quanto queles que buscam atendimento, e assim será construída uma sociedade de bem estar para todos.']",160,160,120,200,160,800
90,Transfobia,"['Ao nascermos somos biologicamente designados a um gênero, masculino ou feminino, mas nem todas as pessoas acabam por se identificar com seu gênero e, ao longo do tempo, elas acabam por decidir o que querem ser. E aquelas que decidem trocar de sexo são chamadas de “transexuais"", algo que vem sendo discutido em ser uma causa que deve ser normalizada ou formada por pensamentos preconceituosos que expressam repulsão e ódio em relação a isso.', 'Em uma sociedade que luta por inúmeras causas é perturbador ainda ter que se preocupar com que gênero você deve ou não pertencer, já que todas as pessoas têm o direito de escolha.', 'De acordo com a Associação Nacional de Travestis e Transexuais(Antra), o número de violências contra transexuais apenas no Brasil no primeiro semestre de 2020  foi de 89, e nos últimos 8 anos este número chegou a mais de 800. A sociedade não pode mais ter o pensamento simplista e arrogante de que o gênero biológico é o “gênero definitivo” e partir para uma agressão mental e física a ponto de tirar a vida de quem vai contra o “natural”, fato que chega a ser desumano.', 'Além disso, vale adicionar que esses tipos de agressões também ocorrem em casa onde, de acordo com o “Sistema de Informação de Agravos de Notificação”, 49% das agressões começam pela residência.', 'Dessa forma, a escolha de se tornar transexual precisa ser respeitada, pois toda pessoa tem o direito de ser o que quiser, e para uma sociedade melhor precisamos acabar com esse ciclo de ódio e assim respeitá-los e aceitá-los.']",160,120,120,160,120,680
87,Erotização Infantil - BXA,"['De acordo com o Ministério da Mulher, da família e dos Direitos Humanos, a exposição de crianças e adolescentes na internet,  ocupa o 5º lugar no ranking do Disque 100, número usado para a denúncia de crimes cibernéticos. Nesse contexto, nós podemos analisar que esse tipo de exposição está ligada a uma cultura de erotização infantil, assunto no qual ainda não possui leis ou políticas suficientes para o combate a essa prática, além da falta de conscientização do quão prejudicial pode ser essa exposição.', 'Em primeiro plano, nós devemos analisar que esse tipo de cultura ela é muito perigosa. Com a existência desse tipo de erotização, pessoas maldosas se sentirão atraídas por esse tipo de conteúdo, e com isso, possa ser que, estabeleçam uma relação íntima com os menores. Também é importante destacar que, essas leis, devem ser aplicadas do mesmo jeito aos responsáveis que são coniventes com esse tipo de cultura em seus filhos , por exemplo, afim de torná-los populares no meio social em que vivem, com o alcance e visualizações.', 'Visto isso, é importante destacar, que haja para todos,  uma conscientização sobre os perigos e as consequências que essa cultura pode causar ao público infantil, já que esse tipo de erotização causa um envelhecimento precoce no indivíduo exposto. Como o que estava a acontecer com a cantora mirim MC Melody, que pouco tempo depois de se popularizar, entre 2016 e 2017, teve sua família bastante criticada, por causa das roupas decotadas e os gestos que a artista fazia em seus clipes, fotos ou vídeos.', 'Portanto, a cultura da erotização infantil é um problema,  porque, além de uma impunidade visível nas redes e no meio social quanto a esse assunto, pode causar um efeito de envelhecimento muito rápido e cedo na criança . Por isso, cabe ao Ministério da Educação , junto ao ECA , promoverem ações políticas e sociais, como leis e campanhas, afim de estabelecer maior segurança e consciência para a população.']",160,160,120,160,160,760
17,Uma perda histórica para o país,"['Na noite de domingo dia dois de setembro de 2018 por volta das 19:30 da noite , houve um incidente com o Museu nacional do Rio de Janeiro. Dentre tantos motivos relevantes, temos: destruição de fósseis antigos e assim como uma perca para o Brasil.', 'O Museu foi fundado em seis de junho de 1818, nesse ano completou duzentos anos da sua existência. Ninguém sabe como começou o incêndio, mas muitos acreditam que seja por conta das afiações assim como um morador local diz te visto um balão caindo no museu que poderia te causado o', 'devido incêndio. Foram perdidas muitas estruturas antigas e também a mais importante as fosseis de luzia .', 'O que aconteceu com o museu deixou vários brasileiros triste , porém foi uma perda de não só de objetos e sim de lembranças de pessoas importantes que conviveu la , ou seja, a familia real e que também foi contestado a independência.', 'O Michel Temer comentou que foi uma perda incalculável para o país e que foi perdido duzentos anos de pesquisas, assim como o MEC ofereceu ajuda para o que precisar para recuperar o patrimônio histórico do Brasil.']",0,0,0,0,0,0
82,Os perigos da automedicação,"['Os medicamentos foram criados para tratar doenças que há muitos anos atrás não havia cura. Um exemplo é a penicilina que até hoje é utilizada. No entanto, com o ritmo acelerado das cidades ? as pessoas acreditam que não podem mais adoecer, qualquer dor que atrapalhe sua rotina já é razão para se automedicar. Assim, o uso exagerado e de forma inadequada vem trazendo sérios problemas para a saúde da população.', 'Em uma sociedade capitalista e subordinada ao poder do capital, os seus cidadãos se tornam  colocam o trabalho acima da própria saúde. Outro aspecto a ser considerado é o grande avanço nas últimas décadas na indústria farmacêutica, com o desenvolvimento de medicamentos cada vez mais eficazes e com menos efeitos colaterais. Entretanto, isto não diminui os efeitos danosos do uso inadequado desses medicamentos, sendo ainda significativo o número de adoecimentos em hospitais por esta  mesma razão. A economia de tempo e a facilidade de aquisição tornam a automedicação a primeira opção para resolver do  problema.', 'Segundo dados da Organização Mundial de Saúde (OMS), em todo o mundo, 50% dos pacientes tomam medicamentos de forma incorreta. Esta  situação pode muitas vezes levar ao agravamento do problema, como, por exemplo, com o uso dos antibióticos que podem levam a  resistência bacteriana, fragilizando ainda mais a saúde do paciente. ? Assim como, ? em outros casos pode até mesmo encobrir problemas de saúde mais graves, ou levar a  dependência de medicamentos.', 'Sendo assim, cabe ao Ministério da Saúde a conscientização por meio de campanhas de saúde sobre os benefícios da utilização de medicamentos fitoterápicos, que ? por serem de origem natural, diminuem a probabilidade de problemas ocasionados pela incorreta automedicação. ? E também o incentivo por parte do governo federal  às empresas públicas e privadas a investir em melhores planos de assistência médica para os funcionários, reduzindo os impostos para as empresas que cumprirem a medida. Somente desta  maneira podemos  possivelmente diminuir os problemas gerados pela automedicação.']",160,160,160,160,160,800
85,A Honestidade é o principio de toda lei,"['O Brasil adota um sistema político de Democracia Indireta. Isso significa, que o povo elege seus representantes para durante um prazo determinado, em forma de mandato, representar o povo, e assim governar para toda a população, promovendo a igualdade e a justiça para todos. Mas, de fato é isso o que acontece com a nossa jovem democracia? O povo brasileiro se sente realmente representados por seus parlamentares? Claro que não! A Nação brasileira, acredita em promessas de campanhas, e depois seus candidatos esquecem, depois de eleitos ao invés de defender o direito da população. Só defendem seus próprios interesses.', 'Nosso Sistema Político permite que o povo, tenha participação ativa no desenvolvimento do país, isso quer dizer que a população pode opinar, através de manifestos e plebiscitos e tanto fazer como também mudar as leis. Só que isso não acontece. Até hoje, só quatro leis que estão em vigor no país, partiram de iniciativa da população! Ora, será que um país com mais de 200 milhões de habitantes, só teve capacidade para criar quatro projetos de lei? Não, é obvio que não! Só que depois que a lei é criada precisa passar por votação na Câmara e no Senado. E são os parlamentares quem decidem se aprovam ou não.', 'Enquanto os lobos fizerem as leis, as ovelhas sempre estarão em apuros. É necessário maior iniciativa popular atuante na vida pública. Simplesmente a Nação passa para esses representantes os bois e o chicote. Precisamos criar leis para garantir o direito do povo. Uma reforma política no Brasil hoje, se faz necessária e urgente. A Lei que deve ser criada é transformar corrupção em crime hediondo, com pena de prisão longa, perda de todos os bens materiais e banição da vida pública para sempre. Com essa lei, a corrupção não vai acabar. Mas, os lobos pensaram muito, antes de tentar passar as ovelhas para trás. Porque, honestidade não é uma qualidade. é um dever de toda a humanidade.']",160,120,160,160,200,800
70,,"['Nos últimos anos ocorreu um aumento do número de jovens brasileiros contaminados por doenças sexualmente transmissíveis (DSTs). Tal aumento está relacionado com fatores sociais, culturais, falta de informação e a banalização das doenças.', 'Outrossim, um exemplo da intervenção social no aumento desses tipos de doenças é o tabu cultural e religioso existente na hora de discutir sexualidade, sexo e métodos contraceptivos. Isso faz com que o assunto não seja tratado abertamente e de forma eficiente o que gera desconhecimento da realidade das DSTs entre os jovens.', 'Geralmente na época do carnaval as campanhas passam a se intensificar e focar na AIDS, doença causada pelo vírus HIV. Tal fato é problemático, pois mostra um posicionamento simplista do pais em relação as campanhas, uma vez que só focam em um doença quando existem várias e atuam apenas em uma época do ano.', 'Faz-se necessário, portanto, a ampliação das campanhas de forma que atuem em todas as épocas do ano e abordem varias doenças. A sociedade deve cobrar uma atuação do governo em conjunto com as escolas na criação de projetos de educação sexual através de aulas e palestras com profissionais da área da saúde.']",120,120,120,120,120,600
23,É transgênico,"['Os alimentos transgênicos fazem parte da alimentação de uma parcela dos brasileiros. A embalagem dos mesmos contêm um símbolo de um triângulo de borda preta, fundo amarelo e a letra T em de cor preto . A obrigatoriedade de identificação traz vantagens para o consumidor.', 'O símbolo exposto no rótulo agiliza a compreensão de que o produto é oriundo de compostos transgênicos. Muitas vezes as pessoas não lêm o informativo do produto devido as inúmeras frases que a embalagem contém, além da utilização de fontes pequenas que dificultam a visualização das palavras e o tempo que as pessoas não estão dispostas a gastar para ler todas as informações. Um exemplo que confirma a facilidade e agilidade de decodificar a informação através de símbolos é a utilização dos mesmos nas placas utilizadas pelo Sistema Nacional de Trânsito.', '', 'Outra vantagem é a maior abrangência de decodificação da mensagem. O Brasil, segundo pesquisa do IBGE de Dezembro de 2017, possui aproximadamente 11,8 milhões de pessoas que não sabem ler e escrever. Assim com a utilização da simbologia pode-se garantir o acesso da informação a uma parcela maior de consumidores. Isto permite a pessoa escolher o produto que considera mais adequado para a sua saúde.', 'Conclui-se que a simbologia traz benefícios ao consumidor. Entre os benefícios pode-se citar a agilidade e abrangência de decodificação da mensagem. Isto permite uma decisão de compra mais clara.']",120,0,160,160,120,560
28,De amor e de esperança o Brasil não desce,"['Após as famosas manifestações de 2013, muitos achavam que o povo brasileiro havia se tornado politicamente consciente, abandonando seu comportamento apático, outrora conquistado , para se tornar mais participativo, sabedor de suas responsabilidades.', 'Infelizmente, a teoria supracitada não vem se confirmando. Qual(is) seria(m) o(s) motivo(s) ? Evidentemente a análise para tal questionamento não é tão simplória quanto gostaríamos.', 'Há uma imensidão de motivos para tomarmos às ruas e demonstrarmos toda nossa insatisfação com o atual cenário político e econômico (foco no político) , todavia, será que vale a pena o risco de um cidadão de bem se misturar com baderneiros de face encoberta, ser alvejado por tiro de borracha ou sofrer os efeitos colaterais de bomba de gás lacrimogêneo e como recompensa saborear uma indigesta pizza?', 'Se tornou corriqueiro testemunharmos deputado correndo com mala recheada de dinheiro e ficando livre , senador recebendo propina e se fazendo de vítima presidente tendo obscuras visitas noturnas na garagem, tudo isso ocorrendo paralelamente a diversos escândalos econômicos.', 'Após tantas desilusões se torna possível compreender um pouco melhor o comportamento da sociedade brasileira, haja esperança e braço forte! A solução, assim como a análise , é altamente complexa . Passa por uma completa faxina política, reforma de leis, fim da impunidade e acima de tudo, voto consciente. Só assim voltaremos a viver um sonho intenso, um raio vívido.']",200,200,200,200,200,1000
11,O aquecimento global e os ursos,"['O aquecimento global vem afetando o mundo nos últimos anos, esse anos. Esse fator e é algo natural porem natural, porém, está aumentando drasticamente pela quantidade de combustíveis quem que são queimados diariamente, assim afetando o ambiente onde vivemos, ocasionando vivemos e ocasionando uma elevação na temperatura ambiente.', 'A partir disso disso, surgem vários problemas que afetam o habitat natural de vários animais, e um animais. Um deles e é o derretimento das geleiras que obrigam obriga os animais como o urso polar a mudar seus hábitos de caça.', 'Muitos ursos para se alimentarem Para se alimentar, muitos ursos começaram a invadir cidades, a cidades. Há relatos de que os ursos atacam pessoas para se alimentar. Muitos estão pensando na hipótese de caça aos ursos porem ursos, porém, esse método e é proibido em lei, além lei. Além disso, a agência do Meio Ambiente russa negou a licença para abater essa espécie pois a mesma espécie, que se encontra em extinção.', 'Portanto, medidas são necessárias para resolver esse impasse podendo ter algum órgão governamental responsável pelo meio ambiente para impasse. Algum órgão ambiental do governo deve se responsabilizar de por resgatar e alimentar esses animais para evitar futuros ataques contra pessoas. A Rússia e é o quinto pais do ranking de emissores de queima de combustíveis para combustíveis. Para que ela possa reduzir a queima de combustíveis combustíveis, deve investir em um combustível mais ""limpo"" para o ambiente por exemplo o etanol além de estimular o uso do mesmo ambiente, como, por exemplo, o etanol, cujo uso deve ser estimulado.']",120,80,80,80,80,440
63,Reparação ambiental,"['Em pouco mais de três anos, desastres humanos de Mariana e Brumadinho evidenciaram não só a inobservância estatal quanto ao manuseio das riquezas naturais, como também a necessidade urgente de medidas as quais evitem novas catástrofes no país. Nessa perspectiva, grandes corporações, sejam privadas ou estatais, assumem a culpa dos prejuízos socioambientais gerados, entretanto, as constates perdas humanas e naturais retratam a negligência dos principais causadores desse cenário. Assim, diligências legais há de serem tomadas a fim de que tais danos possam ser minimizados.', 'Geograficamente, os recursos naturais nacionais sempre atraíram olhares para exploração, exemplificando tais interesses desde a Carta de Pero Vaz de Caminha até as mais novas empresas de mineração ligadas a Vale. Dessa forma, ainda que a Lei do Crime Ambiental (9605/98) represente um avanço legal ao assunto, a perda de parte significativa dos rios Doce e Paraopeba, além da destruição de áreas florestais e subsequentemente os impactos aos indivíduos em seus entornos contrapõem uma realidade a qual deveria ser tutelada de modo intenso pelo Estado. Tal conjuntura é ainda intensifica pela morosidade da justiça em indenizar os moradores afetados pelo desastre, já que muitos agricultores e pescadores encerraram seus trabalhos após a poluição de rios e terras próximos.', 'Paralelo a isso, a afirmação ‘’A Amazônia não é nossa’’ proferida pelo presidente da república Jair Bolsonaro  corrobora a possível abertura da região para exploração de empresas, e com isso a eliminação de áreas de proteção ambiental, uma vez que tal espaço já lida com problemas relacionados ao tráfico de madeira e a disputa com espaços indígenas. De fato, áreas como a Amazônia e o estado de Minas Gerais tornam-se os principais alvos por parte de empresas as quais sem a devida fiscalização provocam prejuízos socioambientais quase que irreparáveis.', 'Logo, a fim de que as consequências sejam reparadas em meio a responsabilização jurídica dos atuantes, é preciso que a lei 9605 seja efetivada com o auxílio do Instituto do Meio Ambiente e Recursos Hídricos (INEMA) na regularização de corporações associadas diretamente ao meio ambiente, bem como propor a restauração de reservas florestais por parte de empresas culpadas por desastres ambientais. Ademais, cabe ao Ministério Público e órgãos de fiscalização a criação de fundações com objetivo de oferecer suporte social às pessoas no entorno dessas catástrofes, como a criação de cursos técnicos que permitam a sua reintegração ao mercado de trabalho. Poder-se-á, assim, tratar os recursos naturais como o verdadeiro patrimônio nacional.']",160,160,160,160,160,800
70,,"['A perda de grandes estrelas da música nacional e internacional na década de 1990, como Cazuza, Freddie Mercury e Renato Russo, provocou impacto na juventude da época, que passou a atentar para os métodos de prevenção às Doenças Sexualmente Transmissíveis (DSTs). Quase trinta anos depois, no entanto, o índice de contágio entre jovens de 15 a 24 anos mais que triplicou. Por quê?', 'Segundo especialistas, a evolução tecnológica na área da saúde levou à banalização do tratamento de tais doenças pelos jovens, dos quais, conforme pesquisa elaborada pelo Ministério da Saúde, 60% acreditam que a AIDS é reversível, ou desconhecem os sintomas da sífilis e do HPV, por exemplo. Outro dado alarmante, publicado pelo IBGE , revela que 52% dos jovens brasileiros temem mais uma gravidez precoce a uma DST, isso porque consideram que pegar uma doença venérea é muito mais difícil que engravidar.', 'Destarte, a falta de informação unida à displicência juvenil, contribuiu  para o aumento da taxa de infectados nas últimas décadas, que variou 187,5% somente entre 2006 e 2015, em consonância com os dados divulgados pelo Ministério da Saúde.', 'Logo, compete ao Poder Público, às escolas e à mídia promover e divulgar campanhas que instruam a população, principalmente os mais jovens, sobre os riscos e as consequências acarretadas pela transmissão das Doenças Sexualmente Transmissíveis; sobre os meios seguros de evitar o contágio, como os preservativos e o cuidado ao manusear objetos cortantes. O combate às DSTs entre os jovens começa com a conscientização e o exercício do respeito e da responsabilidade entre esses indivíduos.']",160,160,120,160,120,720
54,,"['Desde a Revolta da Vacina no Rio de Janeiro  em 1904, tem-se claro para o governo que, a melhor estratégia para a prevenção de doenças é através da propagação da informação sobre as patologias e a sua prevenção, bem como o fácil acesso da população Unidades de Pronto Atendimento(UPA).', 'Devido a falta de conhecimento sobre o que é a vacina e como ela age, muitos pais temem a existências de efeitos colaterais , e esta idéia é grandemente fortalecida por falsas noticias rápida circulalão. E visto que raros são os casos de contaminação e divulgação de alguma doença já erradicada, deu-se a população uma falsa sensação de segurança, esquecendo-se assim de sua gravidade e do papel da vacina para a sua prevenção.', 'Por outro lado, segundo o site G1 de informação, muitos pais, apesar de quererem, deixam de vacinar os seus filhos por não haver uma UPA perto de sua residência ou pelo fato do horário de atendimento da unidade não ser acessível devido a sua jornada de trabalho, que muitas das vezes é dupla.', 'Diante disto é imprescindível que o governo relembre a gravidade e o risco a que se expõem quando deixam de imunizar-se, explique-os sobre a vacina e seu funcionamento através de campanhas e propagandas em horários nobres, para que, noticias falsas não tenham efeito e seja realizado mutirões de vacinação em horários e dias flexíveis, para que assim tenhamos uma população mais consciente e livre de doenças.']",120,120,80,120,80,520
48,Desafios e importância do Sistema Único de Saúde,"['“Pouca saúde e muita saúva, os males do Brasil são”. O trecho do escritor Mario de Andrade, apesar de publicado em 1928, ainda é atual, visto que reflete a situação da saúde pública no Brasil. Diante disso, o Sistema Único de Saúde (SUS) é uma importante forma de garantir atendimento a toda população, mas tem desafios a transpor, como falta de capital e má gestão . Por conseguinte, ações do Governo Federal e da sociedade civil são necessárias.', 'A priori, é de responsabilidade do Governo Federal garantir, por meio de investimentos, que o acesso ao SUS seja uma realidade de todos. Isso porque o Sistema Único de Saúde é um direito de toda a população, como assegurado nos Princípios do SUS, porém devido à falta de estruturas hospitalares adequadas parte da população fica sem acesso a esse sistema. Nesse ponto, os indivíduos que não têm acesso a esse direito sofrem a violência simbólica . Esse termo do sociólogo Pierre Bourdieu refere-se à violência exercida sem coação física, mas que causa danos psicológicos e morais incorrigíveis. Logo, é substancial que o Governo Federal invista nesse sistema.', 'Outrossim, a sociedade civil deve cobrar uma gestão eficiente do Ministério da Saúde em relação ao SUS, visto que a má gestão é um desafio para essa importante parte da saúde pública . Nesse sentido, o excesso de burocracia desnecessária aumenta ainda mais as filas do Sistema Único de Saúde e, segundo dados da Comissão de Saúde da Assembleia do Mato Grosso, o tempo médio de espera nessas filas ultrapassa um ano. Portanto, é evidente que o Ministério da Saúde deve gerir competentemente o SUS.', 'Destarte, medidas são necessárias para que os desafios do SUS, importante sistema da saúde pública, sejam ultrapassados. Para isso, o Governo Federal deve recalcular o piso constitucional da saúde de maneira que a verba destinada nunca retroceda em relação ao ano anterior. Essa verba deve ser utilizada para adquirir e aperfeiçoar a infraestrutura hospitalar, além de manter profissionais capacitados no atendimento. Ademais, o Ministério da Saúde deve diminuir a burocracia para atendimento por meio da exigência de menos documentos e, assim, diminuir as filas . Tudo isso com a finalidade de enfrentar os desafios do Sistema Único de Saúde e, dessa maneira, diminuir as “saúvas” como afirmou Mario de Andrade.']",160,160,160,200,200,880
62,O Mau da Internet,"['É de conhecimento de todos que a internet mudou todo o mundo,  com sua massa de informações e na socialização de seus usuários onde são livres para seguir a vida de outros e comentar sobre. Mais nem sempre esses comentários é de boa índole, uma simples imagem ou frase pode dar origem a mensagens de ódio.', 'Se você é gay, negro ou prática religião de matriz africana, você tem a possibilidade de se tornar alvo de ataques, feito por pessoas intolerantes  transformando um lugar que deveria ser livre e seguro em um inferno. A escolha do anonimato fazem que essas pessoas, que não respeita a sexualidade, religião, e escolha política, seguros para proclamar o seu ódio humilhando-as, quebrando os direitos humanos que dar aos cidadãos a dignidade.', 'A denuncia é o único meio de acabar com esses comentários, mais infelizmente não é muito eficiente  e é por isso que a sociedade devem aprender a ser mais intolerantes  respeitando todos por suas diferenças, assim tornando a internet um lugar seguro para todos navegar.']",120,80,80,120,0,400
92,,"['Um dos fatores que contribuiram para a ascensão do Nazismo na Alemanha e a eclosão da Segunda Guerra Mundial,  foi a crença de que os judeus eram um dos culpados pela runa dos alemães,essa população foi perseguida e humilhada .Nos tempos hodiernos,a pandemia de Covid-19 trouxe mais uma vez esse problema,a culpabilização de algúem pela sua ocorrência,os chineses e povos de etnia amarela sofrem perseguições nas redes sociais,espancamentos e esteréotipos relacionados traços físicos,o Brasil busca uma forma de combater o racismo amarelo que persiste devido a penas brandas que em muitos casos não investigam e punem e a cultura enrraizada na população de desprezar outros povos.', 'Em primeiro plano,as leis no Brasil para crimes cibernéticos são brandas,apesar de haver leis que tipificam essas práticas como crimes .Nessa problemática,o preconceito contra negros e amarelos se tornam recorrentes na sociedade. A pandemia de C-19 teve seu início em Wulham na China,por esse motivo muitos brasileiros criticam os asiáticos,frases como""eles acabaram com o mundo"",""eles criaram um vírus e gora estão lucrando,""eu não compro nada deles,tudo está contaminado"",demostram o preconceito fomentado pelas leis brandas. Segundo o filósofo Voltaire,""preconceito é opinião sem conhecimento"",isto é,as pessoas não conhecem realmente o motivo de um fato e acusam os envolvidos aleatoriamente.', 'Outrossim,o Brasil tem uma formação preconceituosa que demostra desprezo pela cultura estrangeira. Por conseguinte,os asiáticos junto com africanos sofrem preconceitos. As redes sociais se tornaram um espaço propicio para essa prática devido ao anonimato que o deliquente se esconde. Apesar, dos chineses não terem nenhuma culpa na propagação do vírus,prestam grandes favores ao Brasil,fornecendo aparelhos baixos custos,a China hoje é um dos maiores parceiros comerciais dos brasileiros .Nesse viés,a desconstrução desses estigmas são difíceis,precisa de trabalho conjunto com aplicação de matérias relacionadas ao assunto na educação básica e a veiculação de propagandas nas redes sociais,como afimou o filósofo Maquiavel,""o preconceito tem raízes mais profundas que os príncipios"".', 'Em virtude do exposto,cabe ao governo federal,instância máxima de poder encarregada de tomar decisões públicas,em consonância com o Poder Legislativo,responsável por criar leis no país,endureçer as penas para quem praticar crimes contra asiáticos, retirando as multas e propondo privação de liberdade,com o fito de combater o preconceito amarelo no Brasil. Ademais, os governos federal e estaduais devem,através do Ministério da Educação incluir na matriz curricular matérias relacionadas ao preconceito contra outras etnias,principalmente a amarela,e por fim,a veiculação de propagandas,palestras e discussões alertando a população sobre a necessidade de amparo e compreensão,só assim o ocorrido na Alemanha diminuirá no Brasil.']",160,160,120,200,160,800
47,Dificuldades na educação à distância brasileira,"['De acordo com o pai da nação sul-africana e líder na luta contra o regime do apartheid, Nelson Mandela, “A educação é a arma mais poderosa que você pode usar para mudar o mundo”, porém o ensino ainda é uma das dificuldade enfrentada no Brasil, principalmente à distancia. Não só por conta da falta de internet e meios adequados para o estudo, mas também, no caso de crianças e adolescentes que precisam de mais amparo, alguns dos pais não estão preparados para ensiná-los.', 'É relevante abordar uma pesquisa feita pelo Comitê Gestor da Internet no Brasil (CGI.br) divulgada em 2.019, afirmando que 58% dos domicílios brasileiros não tm acesso a computadores e que 33% destes não dispõem de internet. Um número muito grande de alunos que não conseguem acessar adequadamente os meios de estudo e de atividades.', 'Vale ressaltar também que grande parte dos pais e responsáveis brasileiros de classe baixa não possuem uma formação completa nem mesmo de ensino fundamental, sendo assim, não conseguem auxiliar seus filhos nas atividades propostas pelos professores. Crianças e adolescentes precisam de certa atenção maior, por possuírem maiores dificuldades.', 'Verifica-se então que há uma dificuldade em relação ao Ensino à Distância no Brasil. Por conta disso, cabe ao prefeito da cidade , com investimentos, instalar internet em locais públicos, para que assim, a população possa ter fácil acesso s plataformas de ensino. Além disso, colocar computadores em locais como bibliotecas, para uso gratuito, pode diminuir os problemas do ensino à distância.']",160,160,120,160,160,760
92,Discriminação étnica e suas consequências,"['A pandemia do coronavírus – provocada pelo vírus Sars-cov19, surgido em Wuhan, na China -, que atingiu o Brasil na primeira metade do ano de 2020, evidenciou e intensificou a discriminação contra indivíduos de origem asiática, dado que o surgimento desse vírus é associado aos hábitos chineses. Logo, esse preconceito se dá, principalmente, a esteriótipos e à desinformação criados pela população brasileira , que podem ter desdobramentos graves não só para os cidadãos asiáticos, mas também para a sociedade.', 'Sob essa perspectiva, o conceito denominado Habitus, desenvolvido pelo filósofo francês Pierre Bourdieu, consiste na ideia de que os indivíduos desenvolvem padrões de pensamento – como o de hostilizar a cultura dos povos de origem asiática devido à esteriótipos- externalizados pela sociedade. Essa mentalidade habitual é, lamentavelmente, banalizada, o que evidencia não só a desinformação da população, mas também sua falta de empatia e respeito.', 'Ademais, esses hábitos podem ameaçar a cidadania das vítimas, a partir do momento em que elas são, eventualmente, excluídas e estigmatizadas pela sociedade apenas por causa de sua ascendência. A esse respeito, a Declaração Universal dos Direitos Humanos, promulgada,  em 1948, pela Organização das Nações Unidas (ONU), prevê a igualdade de direitos a todos os cidadãos. Entretanto, a maioria das pessoas de origem asiática lidam, principalmente, durante a pandemia com o estigma e o desrespeito de grande parte da população. Ocorre que, devido a isso, as vítimas desenvolvem traumas psicológicos, a exemplo de ansiedade e depressão, que podem, por sua vez, resultar em algo mais grave como um suicídio. Adicionalmente, essa discriminação pode gerar consequências para a coletividade, haja vista que as relações sociais seriam afetadas.', 'É necessário, portanto, com vistas a desmitificar esteriótipos e gerar informação à população brasileira, que o Ministério da Educação elabore campanhas informativas e educativas acerca da cultura asiática , que serão divulgadas por meio da mídia, especificamente, nas redes sociais, uma vez que têm maior abrangência. Essa iniciativa terá a participação de pessoas de ascendência asiática, que irão relatar casos em que foram desrespeitadas devido a sua etnia. Espera-se, com isso, que os ideais propostos pela Declaração Universal dos Direitos Humanos sejam exercidos na prática por todos.']",160,160,160,200,160,840
44,Aceitação do natural,"['O artigo 5º da Constituição de 1988, afirma que todos têm direito à igualdade. Entretanto, algumas mulheres se vem restritas a tal direito, já que suas condições biológicas não são plenamente aceitas pela World Athletics. Visando o enfrentamento desta problemática e o acolhimento às vítimas destas injustiças, é necessária a intervenção da Associação Internacional de Federações de Atletismo (IAAF) nos requerimentos exigidos, para que atletas femininas não tenham suas carreiras prematuramente interrompidas, mas sejam promissoras.', 'O caso mais recente deste tipo de parcialidade foi protagonizado pela velocista Caster Semenya, medalhista de ouro nos 800 metros rasos em 2009. A esportista pode deixar de competir devido circunstâncias que a acompanham desde o seu nascimento. Este fato desencadeou o movimento Let Her Run (Deixe Ela Correr),  mobilizado por atletas, médicos e cientistas que discordam do padrão exigido pela IAAF, e clamam pelo consentimento das condições naturais das participantes; também dispensando procedimentos cirúrgicos e/ou medicamentos desnecessários sugeridos pelo órgão.', 'Outrossim, é que o episódio reforça a desigualdade e o preconceito com o gênero feminino ; tendo em vista que a entidade relata que os limites de testosterona foram determinados para auxiliar a integridade do esporte. Ou seja, mulheres que ultrapassam o padrão não são exemplos representativos para o órgão. Ademais, ativistas de defesa dos direitos humanos mencionam que as identidades de gênero vão muito além do binário ""homem e mulher"", amparando assim a multiplicidade que tomou conta desta geração.', 'Destarte, é imprescindível que medidas sejam tomadas para extinguir este impasse da contemporaneidade. Para isso, a Associação Internacional de Federações de Atletismo deve rever suas exigências, não promovendo a liberação do doping, mas tendo como objetivo a inclusão e aceitação de mulheres consideradas fora do padrão imposto, com o intuito de não interromper carreiras precocemente. Deste modo, a IAAF demonstrará respeito todas as atletas e a sociedade desenvolverá um conceito mais igualitário.']",160,160,160,160,160,800
20,A fuga de mão de obra para outros países,"['Observa-se que nos últimos anos o número de brasileiros que emigram tem crescido. Essa é uma questão em que seus motivos devem ser avaliados, sendo eles: o desemprego, gerado pela crise, e a busca de melhores condições de vida.', 'Sabe-se que nos últimos anos o Brasil vem passando por uma forte crise econômica, tendo como uma das principais consequências o aumento no percentual de desempregados. Segundo o IBGE, em 2014, esse índice era de 6,8%, já em 2017, o número quase dobrou, chegando a 12,7%. Diante dessa realidade, muitos que não conseguem uma oportunidade de trabalho em nosso País, buscam uma ocupação remunerada em outros que possuem uma economia mais aquecida e estável.', 'Além disso, o País, possui outros importantes desafios, tais como: segurança pública, saúde e educação. Pode-se dizer que um dos fatores que auxiliam na manutenção desses problemas é a corrupção, no qual repercute na ineficiência dos governos. Infelizmente essa mazela está presente em toda nossa história, desde a Monarquia até a atual (sexta) República. Com isso, muitos concidadãos não vislumbram mais um Brasil mais justo e acabam buscando essa qualidade em países em que os impostos são revertidos em benefícios para população.', 'Diante do exposto, não podemos negar que o Brasil está perdendo parte da sua mão de obra para países que ofereçam melhores condições de vida. O que nos resta fazer é exercer nossos deveres como cidadãos e cobrar de nossos governantes medidas , mesmo a médio e longo prazo, contribuam para construir um país melhor.']",120,160,160,160,160,760
115,A linguagem na literatura brasileira,"['Atualmente                , vários clássicos literários brasileiros         vem         sendo lidos nas escolas do nosso país. O problema encontra-se no fato de que muitos jovens que leem Machado de Assis ou José de Alencar, por exemplo, não compreendem o que estão lendo.', 'É horrível ler                 algo                e não entender sobre                 o que fala                . Eis a questão: é válido simplificar a linguagem de um clássico?', 'A resposta pode variar de pessoa para pessoa. E é uma questão                 repleta de polêmicas                , como por exemplo, quando se simplifica a linguagem de um clássico da literatura brasileira, a pessoa que está reescrevendo a obra pode acabar mudando o         sentido da mesma         . Pode mutilar a obra do         autor, e         além disso, a literatura clássica é ensinada nas escolas por um         motivo. Enriquecer         o vocabulário dos         adolescentes, e         já que existem tantos problemas na compreensão desses livros, os alunos deveriam pesquisar em um dicionário ou até mesmo tirar as dúvidas com um professor. Então, como foi dito anteriormente, o lado negativo dessa adaptação dos clássicos seria a perda da essência da obra original. Porém o lado positivo seria que os jovens talvez se interessariam mais pela nossa literatura.', 'Mas então o que deve ser feito? Os jovens deveriam procurar alguém para tirar as suas dúvidas sobre o vocabulário coloquial das obras. Não é tão difícil compreender o que está escrito nesse tipo de livro, apenas deveria haver mais esforços e interesse dos leitores para com as obras.']",120,120,80,80,80,480
76,Gênero não condiz com capacidade.,"['A sociedade nem sempre teve um modelo patriarcal como o qual vivencia-se hoje, haja vista que no Período Neolítico o papel da mulher era superior ao do homem, devido a necessidade de descendentes para trabalhar na agricultura. Contudo, essa valorização foi perdendo-se até chega-se à atual dificuldade de equidade de gênero que ocorre no Brasil, principalmente no campo profissional. Logo, é necessário medidas para minimizar essa problemática.', 'É indubitável que o patriarcalismo impregnou-se nas raízes da sociedade, ao longo das evoluções históricas, e vem sendo transmitido de geração à geração de maneira banal. Isso pode ser observado nas próprias brincadeiras infantis, nas quais o homem é incentivado a ser desbravador, aventureiro e valente, enquanto as meninas brincam de boneca e são aconselhadas a como portar-se. Desse modo, as crianças criam na mente que a submissão da mulher e a superioridade do homem é uma coisa normal. Por conseguinte, é preciso mitigar essa divergência de gênero com o auxílio das próprias famílias, devido suas consequências.', 'Segundo pesquisas, apesar das mulheres somarem 51,5% da população, seu índice de desemprego é bem maior do que o do homem. Além disso, elas ganham e ocupam menos cargos de prestígio social, como chefias, cargos públicos no Jurídico e Legislativo. Assim, ainda que elas tenham conquistado muito espaço no mercado de trabalho, ainda são vistas como inferiores, fato que deve ser minimizado.', 'Destarte, infere-se que é dever dos pais incentivarem a equidade de gênero, com a participação da mulher nas decisões familiares e o incentivo a brincadeiras saudáveis que estimulem a igualdade, a fim de diminuir a disparidade entre homens e mulheres na sociedade. Também se faz preciso mais rigorosidade do Poder Jurídico em casos de inferioridade salariais às mulheres. Sob tal ótica, o Brasil tornar-se-á igualitário, com mais valorização mulher, como ocorria no Período Neolítico, visto que capacidade não condiz com gênero']",160,160,160,160,160,800
83,Além da competição,"['Nos últimos anos, o Brasil tem sido palco para diversos eventos esportivos, como por exemplo, as Olimpíadas e as Paraolimpíadas, que serão realizadas no Rio de Janeiro e atrairão os olhares do mundo para esse grandioso evento. No entanto, não se pode de modo algum reduzir a prática esportiva a esses megaeventos. De fato, mais do que atividade de competidores célebres ou negócio que envolve milhões, o esporte consiste em um poderoso meio de inclusão social, capaz de transformar vidas. De modo geral, tal poder transformador do esporte pode ser visualizado sob dois aspectos: no seu papel na formação ética dos indivíduos e no seu caráter socializador.', 'É importante pontuar, de início, que na Grécia Antiga, o esporte era difundido como forma de promover a paz e a harmonia entre as civilizações. Hoje, além de servir como método de lazer e de entretenimento, o esporte tem um enorme potencial na transmissão de valores e na norma de condutas sadias. Dessa forma, a prática de atividade física é um meio poderoso de mobilização e interação entre diferentes públicos, tendo por objetivo a inclusão e a diminuição das disparidades sociais.', 'Por outro lado, não se pode ignorar o papel inestimável do desporto no processo de socialização. Com efeito, como dizia Aristóteles, o homem é naturalmente um ser social e político, isto é, engajar-se na vida social não é um aspecto secundário da existência humana, mas algo constitutivo. Assim, o processo de socialização, de integração do indivíduo no interior da sociedade, não pode ser subestimado – e o desporto pode ter papel essencial nisso. Na verdade, a atividade esportiva produz, invariavelmente, uma comunidade de pessoas, uma integração entre os diferentes, afinal, mesmo o esporte mais solitário, implica algum tipo de cooperação e aprendizado mútuo.', 'Sendo assim, torna-se evidente que quaisquer intervenções fazem parte de um longo processo de conscientização que começa no ambiente familiar, com a missão de incentivar os seus membros, desde a infância, para a prática de atividades físicas, de modo que, além de melhorar a qualidade de vida, ajude no desenvolvimento de valores éticos; a escola, por sua vez, deve encontrar meios de inserir o esporte como uma ferramenta de inclusão social e não apenas como forma de recreação. Por fim, o poder público, por meio de ações afirmativas, promova um maior investimento nesse setor, a fim de tratar o esporte como um aliado no processo de modificação social, demonstrando que a prática desportiva vai além da competição.']",160,200,200,200,200,960
78,O futuro do ensino médio,"['Recentemente, o governo do estado apresentou uma medida provisória em relação ao ensino médio, que prevê uma série de mudanças, levando-se em conta que criou uma grande repercussão de opiniões contraditórias.', 'O governo optou a  medida provisória que seria uma escolha mais ágil e de curto prazo para uma aprovação mais breve, com isso  exilou as opiniões da sociedade, educadores e dos próprios alunos do ensino médio.', 'Com tudo, o projeto antevê um aumento de carga horária,  e das disciplinas que serão obrigatórias e uma alteração na grade curricular, que permitirá que o aluno escolha, a partir de determinado ponto  uma área de especialização, ou também a opção dos cursos técnicos que estarão incluindo [incluindos na reforma.', 'No entanto, é notário saber que na  proposta feita está integrando a diminuição de certas matérias disciplinares, que também tem  uma enorme grande importância para um bom desenvolvimento metal  do aluno, com isso, talvez não será a solução para melhorar a educação do país,', 'Dessa forma, é necessário discutir e integrar a opiniões dos cidadãos, principalmente dos educadores e alunos para saberem o que é necessário incluir e remover, pois é de quem de fato têm  as respostas para a melhoria da educação no Brasil, como também o governo deve instituir um site para que a população deixem  opinar e solicitar propostas para os ajustes da reforma do ensino médio.']",120,120,80,80,120,520
59,A fome não é o problema,"['Em aspecto mundial, a África é conhecida como um dos países mais pobres e enfrentam grandes problemas com a fome, segundo o que vemos na mídia. E em cenário brasileiro temos como exemplo Fortaleza, em que pelo menos 204.177 famílias, seguem em situação de extrema pobreza, de acordo com G1. A fome é um problema para ser erradicado e um dos retratos da desigualdade social no Brasil, enfrentado dia após dia.', 'No entanto, podemos  relacionar esta situação com a desigualdade em relação as classes sociais, pois uma pessoa com melhores condições financeiras estará mais viável de consumir alimentos que alguém que não possua renda suficiente, ou nenhuma, para se manter . Começando aí outro problema como o início ao roubo, para conseguir sobreviver de alguma forma, pegam coisas alheias em supermercados e até mesmo lanchonetes, para alimentar a si e na maioria dos casos, seus filhos.', 'Por outro lado, tivemos um progresso, pois a fome era declarada em 2000 com 1 bilhão de pessoas nessa situação, e hoje temos 820 milhões, de acordo com EXAME. Porém não é o suficiente, até ser totalmente erradicada. Não temos  poucos alimentos, porque a produção diária é grande, mas o desperdício existe. Grandes centros urbanos possuem um alto índice de comida jogada fora, coisas que iriam servir para aos mais necessitados, porém aquilo que não é vendido , vai para o lixo.', 'Contudo, podemos perceber que a fome não é o problema, mas sim atitudes mal tomadas. Faz-se necessário que o governo, representado por ministérios, atuem com projetos que vigiem feiras livres, supermercados e lanchonetes, e penalizem por quilo desperdiçado com multas cobradas em dinheiro que sirvam para doações. Além de um prazo com 6 meses, no mínimo, recebendo o benefício, para famílias carentes procurar emprego. Diminuindo assim o desperdício e aumentando o acesso igualitário para toda a população comprar seus próprios alimentos.']",120,120,80,120,80,520
140,Nostalgia sem argumentos,[],200,160,160,200,160,880
92,,"['A série ""Reing"", disponível no Globo Play, narra grande conflito entre reinados de diferentes países, no qual as alianças mais respeitadas e vantajosas são estabelecidas por meio da união das potências que detêm o poder, deixando as outras suscetíveis  ataques. Dentro disso, observa-se na contemporaneidade um cenário semelhante, uma vez que, no Brasil, o preconceito amarelo apresenta-se como um empecilho na sociedade. Neste sentido, entende-se que essa configuração se deve, essencialmente, à ótica estigmatizada disseminada nos veículos de comunicação e à desinformação acerca da cultura asiática.', 'Nesse contexto, é válido ressaltar como a internet possui notícias falsas e distorcidas, o que limita a interação social de muitos grupos. Dessa forma, o geógrafo Milton Santos, no texto ""Cidades Mutiladas"", disserta que a democracia só é efetiva quando atinge a totalidade do corpo social. Nessa perspetiva, os direitos universais nem sempre são desfrutados por todos, tendo em vista a dimensão dos estragos que as ""Fake News"" causam no julgamento dos cidadãos, influenciando a maioria a discriminar a conduta do outro simplesmente por ser desconhecida, de modo a fortalecer o preconceito amarelo. Consequentemente, a exclusão direcionada aos asiáticos prejudica também o Brasil, pois os laços e benefícios são rompidos.', 'Ademais, outro fator contribuinte para a permanência do entrave é a falta de informação no que tange a diversidade cultural de nações como a Ásia. Dessa maneira, consoante ao sociólogo francês Pierre Bourdieu, o ser humano é moldado de acordo com o ambiente em que vive. Nessa linha de raciocínio, é perceptível o quanto os indivíduos estão acometidos por uma bolha padronizada, na qual apenas as suas origens e virtudes são íntegras, deixando abertas as portas para o estigma e a intolerância e,  o governo, pouco nada faz para ampliar a bagagem de conhecimento mundial dos brasileiros.', 'Portanto, para o apropriado combate ao preconceito amarelo no Brasil, medidas devem ser efetivadas. Para isso, é necessário que o governo federal no papel do Ministério da Cidadania crie, por intermédio de ferramentas midiáticas e educacionais, mecanismos de avaliação sobre a veracidade das informações asiáticas divulgadas e introduza nas instituições de ensino básico a obrigatoriedade do estudo das culturas internacionais, com palestras, aulas específicas e conscientização ao respeito coletivo. Espera-se, com isso, consolidar relações estáveis entre os países e apaziguar a convivência de seus membros. Assim, divergências nacionais serão marcantes apenas nos reinados ficcionais.']",160,200,160,200,160,880
83,o que podemos aprender com a pratica* do esporte,"['Olimpíadas:  práticas de esportes em compentição, que  ocorre de quatro em quatro anos, Período suficiente para Sabermos a importância do esporte em nossas vidas desde a infância até a velhices O esporte não e apenas um meio de ganhar dinheiro, e também meios de aderir a uma boa qualidade de vida.', 'Na infância, o esporte tem como papel importante no desenvolvimento do crescimento físico e contribui também na educação escolar e na vida social', 'Segundo a vida cotidiana    quem pratica esportes  diminui o risco de  : obesidade,  stress  e  problemas cárdicos,   colesterol alto  e amnésia. Quando praticamos esportes  estamos  queimando calorias,   trazendo substância para o celebro através do suor(?)**', 'Muitas instituição usam o esporte como meio de  salvar vidas das drogas e violência, pois  ele e motiva para  ocarecimento profissional.', 'Com suas grandes importância, deve-se  abrir mais espaços para o esporte ser praticado, principalmente nos bairros mais carente, porque se ele e de tão grande importância,  não e só pra quem tem condições, e para todos.']",0,0,0,0,0,0
23,A Desinformação sobre Produtos Transgênicos,"['Não é possível falar sobre produtos transgênicos sem fazer uma reflexão a respeito do símbolo ostensivo impresso nesses alimentos. Por isso, é necessário considerar que se deva usar um rótulo comum, contendo as informações necessárias e não a letra “T” de forma e aparência depreciativa, desvalorizando assim esses alimentos.', 'Um fator a ser analisado em relação a situação em questão é que esses produtos geneticamente modificados, em dez anos de uso,  não foi registrado algum dano negativo à saúde de quem se alimenta deles. Entende-se então que apesar de ainda não ser um produto amplamente aceito pela população em geral, o ingrediente transgênico não representa riscos ao bem-estar das pessoas.', 'Outro fator importante é que os consumidores devem ser informados se determinado ingrediente de um produto é modificado geneticamente ou não, porém, essa informação do rótulo não precisa ser depreciativa ou passar a imagem de que se trata de algo perigoso ou prejudicial. Pode se verificar um exemplo disso nas embalagens atuais dos alimentos transgênicos.', 'Entende-se com isso, que um dos maiores problemas da informação dos rótulos citados é que os mesmos, do jeito que se encontram, com aparência de produto perigoso, prejudicam o comércio dos mesmos. Uma das soluções para isso seria manter a informação de que naquele alimento há ingredientes modificados geneticamente, porém, utilizando um símbolo normal, com explicações esclarecendo a população sobre os benefícios que esse produto pode proporcionar.']",120,0,80,80,120,400
22,Foro Privilegiado,"['O Brasil Império foi um período onde o país era governado por monarcas portugueses, Dom Pedro I e Dom Pedro II. Esse período possuía um sistema de governo distinto do atual, pois, dentre as inúmeras diferenças, os imperadores possuíam algumas regalias, como a hereditariedade e vitaliciedade do cargo. Na contemporaneidade , essa esfera de privilégios permanece por meio do “Foro Privilegiado”, que consiste num benefício que permite que políticos e ocupantes de determinados cargos públicos não sejam julgados na primeira instância como os cidadãos comuns. Muito se discute acerca da extinção desse benefício e os motivos que sustentam esse ato .', 'Segundo a Constituição de 1988, todos os cidadãos são iguais perante a lei, sem distinção de raça, sexo, religião e derivados. Dessa forma, o Foro contradiz esse princípio de igualdade, quando permite o benefício do julgamento distinto do resto dos cidadãos simplesmente por ocuparem cargos específicos, tendo em vista que o ser humano tem livre arbítrio para escolher a profissão que bem entender e todas constituem os pilares da sociedade.', 'Além disso, esse mecanismo pode fomentar a impunidade. Uma recente pesquisa da Fundação Getúlio Vargas evidenciou que 68% das ações penais concluídas no STF, entre 2011 e 2016, prescreveram ou foram repassadas para instâncias inferiores porque a autoridade em questão deixou o cargo. Na Operação Lava-Jato, por exemplo, mais de 22 mil pessoas pertencem ao Foro , um número relativamente alto de agentes públicos que precisam ser julgados pelos tribunais de instâncias superiores, que teriam pouca estrutura para isso.', 'Diante do que foi exposto, infere-se que o direito ao Foro Privilegiado é um mecanismo que precisa terminar em prol da diminuição da impunidade e permanência da genuína democracia. Por isso, cabe aos ministros do Supremo Tribunal de Justiça que votem a favor do fim desse benefício. Além disso, cabe a população, por meio de assinaturas on-line, a lutar, influenciando os ministros nessa decisão.']",160,160,120,160,160,760
26,A educação é um bebe ,"['Conhecimento sobre a realidade do brasileiro é para a política apenas números de lucro ou dívidas a serem pagas, pois são poucos que já passaram por escolas públicas e hoje nos representam, a base dos problemas educacionais começam em Brasília.', 'Educar a ignorância sobre o país trazida pelos alunos - que não entendem de política porque seus pais e amigos não debatem temas como crise econômica, corrupção ou alienação, por exemplo - enquanto a mídia anuncia, de modo sensacionalista, os feitos das operações policiais forma opiniões de que tudo pode ser feito e não existe justiça, logo é uma batalha árdua para qualquer professor.', 'A escola ajuda na formação de caráter, no entanto, nossos mestres não podem arcar com a responsabilidade fora do horário de aula. Os projetos para incluir os jovens, estão “sem verba” e diminuindo, não há incentivo da mídia ou do governo para que eles busquem realidades e se tornem resilientes em sua comunidade.', 'Segundo Rousseau “A educação do homem começa no inicio de seu nascimento”, logo é preciso educar os pais desde a infância, durante e após o nascimento de seus filhos, criar mais grupos para jovens e adultos entenderem a história e atualidade de nosso país.']",0,0,0,0,0,0
64,A Educação Sexual nos dias atuais,"['Cogita-se com muita frequência da ausência da educação sexual nas escolas no Brasil, sendo ignorado por muitos, desprezando sua importância, chegando assim a maturidade sem conhecimentos dos perigos e consequências da prática de forma errada do sexo, gerando assim problemas futuros, como gravidez indesejada e contração de doenças sexualmente transmissíveis (DSTs).', 'Antigamente e ainda hoje debater sobre sexo provoca certos tipos de constrangimentos para algumas pessoas, mas é de extrema importância para capacitar o jovem para o estagio da maturidade. Dados mostram que no ano de 2018 a cada mil adolescentes brasileiros entre 15 e 19 anos, 68.4% ficaram gravidas e tiveram seus bebês.', 'Todavia, a gravidez indesejada não é a única consequência da falta de administração da educação sexual nos espaços educacionais, o estudo Epidemiológico sobre a Prevalência Nacional de Infeção pelo HPV, constatou que dos 7586 pessoas testadas, 54,9% tinham o vírus da sífilis, sendo a mesma  felizmente uma doença fácil de tratar, mas que pode levar a óbito.', 'Em virtude dos fatos mencionados, é notável a importância da adoção da educação sexual nas instituições de ensino, principalmente para jovens e adolescentes de 15 a 24 anos de idade, contudo para evitar tais consequências deve-se primeiramente aos pais a importância de educar o filho dentro de casa, desde a infância, para assim quando chegar na fase da maturidade, ter conhecimento dos perigos e consequências da prática do sexo de forma errada,  por último  mas não menos importante, deve-se extingui os meios de comunicação que utilizam do sexo para chamar a atenção das pessoas, acabam por estimular e criar curiosidades precoces até em crianças, o que dificulta bastante o processo de conscientização e responsabilidade individual dessas sobre o assunto.']",120,160,120,160,120,680
50,Pandemia Mata,"['No quadro "" O grito"" o pintor Edvard Munch,  ilustra uma pessoa horrorizada, dessa maneira boa parte da sociedade transmite setimentos semelhantes como medo e pânico devido a uma pandemia ..O Brasil em 2009 combateu o virus influenza A H1N1.. Nesse contexto,o país entra novamente no ano de 2020 entra novamente em uma guerra pandemica contra o coronavrus ou cvid-19, foi indentificada pelos cientistas como uma doença de fácil diseminação pela população,o que pode levar  morte da pessoa contaminada. Dessa maneira, pouco incentivo em pesquisa cientifica por partes governamentais e na educação são agravantes da problemática .', 'Em primeiro lugar, é compreensível informa que o problema passa por baixa atuação dos setores do Governo Federal, Estados e municipios para trazer acesso financeiro para pesquisa no combate a pandemia como o coronavirus .De acordo com a geógrafa Mait Bertollo, apesar da pouca verba enviada para pesquisas epdemica no país a ciência continua buscando uma cura para covid-19 . Nesse sentido, segundo o Contrato Social  - o proposto pelo contratualista John Locke -, cabe ao Estado fornecer médidas que garantam o bem estar social.', 'Em segundo lugar, a falta de utilização de tecnologia nos laboratorios de pesquisa das Universidades públicas é outra fator que contribuem para a problemática, sendo que pode ser usada para fins da educação ciêntificar. Segundo Steve Jobs, um dos fundadores da empressa ""Apple"", ter corroborado com a ideia do mundo virtual como influenciador ao constatar que a ""Tecnologia move o mundo"". Sendo assim, o Ministério da Educação (MEC) precisa investir em equipamentos mais tecnologico auxíliando na eficiência na luta contra doenças virais.', 'Portanto,o Ministério da Economia precisa disponibilizar mais dinheiro para estudos ciêntificos no combate a virús, dessa forma os estudos avançam e a possibilidade de descoberta para doenças virais aumenta evitando  um número maior de mortes . Por outro lado, o MEC precisa criar o ""Bolsa virús"" , onde  o aluno recebe condições financeiras para estudar doenças com o propósito de combater o avanço de doenças epidemicas na população . Desse modo, a ciência consegui lutar contra a pandemia com maior eficiência e tranquilizar o povo, diferente do que a pintura ""O grito"" transmite.']",120,160,160,160,120,720
47,Obstáculos enfrentados pelo ensino a distância no Brasil,"['Segundo o filósofo Immanuel Kant, ""o ser humano é aquilo que a educação faz dele"".A educação é um direito crucial de todos, pois é por meio dela que o indivíduo garante seu desenvolvimento social, cultural e econômico. Apesar de sua importância, esse setor ainda sofre com inúmeras dificuldades. Posto isso, vale ressaltar os desafios enfrentados pela Educação a Distância (EaD) no Brasil, como a exclusão social e a falta de investimentos em pesquisas.', 'A priori, destaca-se o sistema de ensino excludente utilizado pelas instituições de EaD no Brasil,  como uma das principais adversidades encaradas por essa. A desigualdade social presente no país, impacta diretamente no meio educacional, sobretudo, no ensino a distância. Visto que esse método demanda acesso  internet e aparelhos eletrônicos, algo que não é realidade na vida daqueles que vivem nas regiões afastadas dos grandes centros e sofrem com a falta de infraestrutura básica, como saneamento e luz elétrica. De acordo com a pesquisa TIC Domicílios de 2018, cerca de 30% da população brasileira, ainda não tinha acesso internet naquele ano. Logo, é possível concluir que infelizmente, essa metodologia não é democrática.', 'Ademais, tem-se a deficiência de aplicações financeiras na área de estudos de cunho científico, como um dos obstáculos enfrentados pela instrução a distância em extensão nacional. A carência também é sentida pelas práticas de aprendizagem presenciais, mas tem ênfase na modalidade virtual, impedindo que ela se estabeleça com credibilidade no país .Sob esse viés, conforme disse o economista William Arthur Lewis ""educação não é despesa. Sempre foi investimento com rentorno garantido"".Ou seja, é fundamental que haja um bom financiamento em recursos dessa área, para que isso reflita em melhores resultados socioeconômicos.', 'Destarte, urge que os desafios afrontados pela EaD no Brasil precisam ser amenizados. Nessa perspectiva, cabe ao Governo Federal e ao Ministério da Educação ,  apresentar propostas com o obejtivo de promover a inclusão das minorias à sociedade, por meio do auxílio áreas carentes que sofrem com a ausência de recursos tecnológicos, disponibilizando os mesmos para uso público e  também, incentivar pesquisas de caráter técnico, através de melhores investimentos nesse setor, a fim de melhorar a qualidade do ensino a distância e torná-lo acessível para todos os brasileiros.']",160,160,160,200,160,840
47,Desafios da educação a distância no Brasil,"['Apesar de estar prevista como uma das ferramentas na educação brasileira, o ensino a distância na prática vem mostrando-se como um grande desafio. O que deveria ser uma alternativa para as escolas e alunos, revela a falta de uma estrutura básica, que dificulta a transmissão aulas e o acesso pelos alunos, e precariedade de treinamentos dos professores para uma preparação ideal para ministrarem conteúdos de maneira remota.', 'Nesse cenário, é importante ressaltar como o despreparo dos professores com esse tipo de tecnologia tornou-se um obstáculo para educação a distância. Com o país assolado pela pandemia do novo coronavírus, o uso do ensino de forma remota tornou-se necessário para preservação da saúde, e as dificuldades de adaptação dos professores com a nova realidade, trouxe à tona a falta de disponibilização de treinamento das escolas para os professores. Essa dificuldade de repassar de maneira adequada os conteúdos programáticos vem causando prejuízos inevitáveis ao ano letivo em curso.', 'Além disso, a precária situação em que vivem a maior parte dos alunos também provocam impacto na educação a distância. Sem acesso à internet de qualidade, e equipamentos de informática indicados, a maioria estão enfrentando dificuldades para assistir as aulas de maneira remota, além de não conseguirem manter uma rotina de estudos em casa. Isso vem preocupando pas e professores, pois a falta de adaptação ao sistema de ensino remoto tem afetado a frequência escolar, o que pode acabar influenciando no aumento da escola por aulas que não tem a estrutura para estudar em casa.', 'Portanto, para que não haja mais prejuízo ao sistema educacional brasileiro, deve-se iniciar com urgência a estruturação de escolas, realizando-se o treinamento adequado dos professores, para que  assim, quando necessária a utilização do ensino a distância, esse seja feito corretamente, mantendo-se a qualidade da educação. Faz-se fundamental  também, que os governos disponibilizem tecnologias que possibilitem o acesso uniforme em todo o país as aulas, por meio de internet de qualidade ou um canal de televisão.']",160,160,120,200,160,800
88,Estigma,"['O estigma associado s doenças mentais é um problema presente na sociedade brasileira e deve ser pautada com extrema importância. Nas redes sociais, surge o termo “cultura do cancelamento”, que exclui e puni o indivíduo da sociedade devido a um erro cometido, com objetivo de criar uma desconstrução social. Nesse sentido, o julgamento gera opressão e problemas mentais por conta da enorme cobrança da “cultura”, afetando a saúde. Diante dessa perspectiva, faz-se necessário a análise dos fatores que favorecem esse quadro como: ausência de medidas de apoio e a dificuldade de interação social.', 'Em primeiro lugar, deve-se ressaltar a ausência de medidas governamentais para combater o estigma, evidenciando que essas pessoas se encontram como grupo não pertencente ao “padrão normal”. Logo, a sociedade com sua falta de informação e o governo oferecendo tratamentos precários para os que sofrem de ansiedade, depressão, transtorno bipolar, entre outros, são a causa desse problema. Em conjuntura, segundo as ideias do filósofo John Locke, configura-se como uma violação do “Contrato social”, já que o Estado não cumpre sua função de garantir que os cidadãos desfrutem de direitos indispensáveis como saúde e igualdade, o que é infelizmente evidente no país.', 'Consequentemente, há uma dificuldade de interação social, pelo fato da desconsideração na existência das doenças mentais por parte de muitos. Outro fato é que no mundo virtual, existe uma comparação, que causa um mal afetando a saúde mental da sociedade por um todo. Segundo dados da Organização Mundial da Saúde (OMS), dentre os países da América Latina o Brasil é o mais depressivo. Diante de tal exposto, vale destacar que o suicídio é uma das consequências causados pelo mal da sociedade a esse grupo. Logo, é inadmissível que esse cenário continue a se perdurar.', 'Por tanto, é mister que o Estado  tome providências para amenizar o quadro atual para a diminuição das doenças mentais, onde o mesmo deve oferecer tratamentos eficientes, com psicólogos e psiquiatras por meio de consultas e grupos de apoio oferecidos tanto nos consultórios médicos como nas escolas e ambiente de trabalho. Além de, gerar campanhas informativas e conscientes na internet sobre as doenças. Somente assim, será possível dar um fim ao estigma social e ajudar a população brasileira.']",160,160,160,200,160,840
48,Importância e dificuldades enfrentadas pelo sistema de saúde público,"['Inspirado no britânico National Health Service, o Sistema Único de Saúde (SUS), é a denominação do sistema público de saúde brasileiro, o qual garante atendimento gratuito para milhões de habitantes, além de financiar pesquisas e administrar a fiscalização da qualidade dos alimentos.', 'Mediante a Constituição Federal de 1988, através do artigo 196, foi estabelecido que “é dever do Estado garantir a saúde e o bem-estar de seus habitantes”. Entretanto, desafios são enfrentados diariamente pela população, como a burocracia no atendimento e o longo tempo de espera para conseguir vagas para cirurgias.', 'Todavia, essas dificuldades enfrentadas decorrem, principalmente, do número de dependentes exclusivos do SUS (cerca de 162 milhões), o qual é muito maior do que os encontrados em sistemas semelhantes, como no Canadá e no Reino Unido . Esse grande número de dependentes prejudica o sistema brasileiro, que se encontra carente de infraestrutura.', 'Entre os recursos oferecidos pelo SUS, encontram-se consultas com especialistas, realização de cirurgias, atendimento de emergência em caso de acidentes, por meio do SAMU (Serviço de Atendimento Móvel de Urgência) e entrega de medicamentos gratuitos para doenças como diabetes, pressão alta, asma, HIV  e Alzheimer.', 'Neste momento de pandemia devido ao COVID-19, é notório o auxílio do SUS tornando possível a disponibilização de leitos de UTI , embora escassos, além de promissoras pesquisas para o desenvolvimento de vacinas, em parceria com a Fundação Oswaldo Cruz.', 'Ademais, é imprescindível que o sistema de saúde pública brasileiro evolua mesmo após a pandemia, através de um aumento de verbas estatais, melhorias na infraestrutura com aumento na quantidade de leitos disponíveis e proteção para com os profissionais de saúde, disponibilidade de outros medicamentos além dos já oferecidos, maior eficácia nos serviços do SAMU e desenvolvimento científico crescente , a fim de continuar garantindo um atendimento gratuito de qualidade.']",120,160,120,120,160,680
93,Melhor parto possível,"['A sequência de documentários “O renascimento do parto” relata uma série de empecílios que as famílias, principalmente a mulher e o bebê, encontram para terem acesso ao melhor parto possível no sistema de saúde do Brasil. Os documentários evidenciam como o excesso de intervenções médicas no parto, desde a cesariana agendada sem reais indicações até as intervenções no bebê logo após o nascimento, afeta de maneira negativa a saúde deste e da mulher, além de submeter ambos a riscos desnecessários. Neste cenário, o movimento de humanização do parto, com mulher e bebê sendo protagonistas e respeitados, é uma questão de saúde pública de suma importância, porém existindo uma lacuna colossal para sua efetiva e segura concretização principalmente no que diz respeito à qualidade dos serviços de saúde e conhecimento da população.', 'Em primeira análise, é imperioso ressaltar como a taxa de cesarianas no Brasil ultrapassa 50% dos partos, sendo inclusive maior nos hospitais privados em relação aos públicos . Vários são os motivos que circundam tal cenário, como conveniência de agenda e remuneração dos médicos e hospitais, falta de informação de qualidade dos exames de pré-natal para uma correta avaliação de riscos por parte da equipe de obstetrícia, qualidade dos serviços de atendimento à mulher em trabalho de parto, entre muitos outros, inclusive relacionados ao treinamento e experiência da própria equipe de parto que é direcionado intervenções. Essa realidade evidencia a negligência por parte do governo e precisa ser gradualmente melhorada com infraestrutura, treinamento e conscientização.', 'Ademais, é importante avaliar que para a mulher e o bebê serem protagonistas conforme é defendido pelo movimento do parto humanizado, é primordial que a educação para a família seja adequada, desde cuidados durante a gestação, importância de cada exame do pré-natal, às opções de intervenções que a mulher pode ter durante o parto e intervenções que são necessárias de acordo com diferentes quadros da mãe e do bebê, intervenções que a mulher pode negar de ser submetida e direitos que esta têm . Por exemplo, a lei federal que garante a mulher direito a acompanhante no trabalho de parto, parto e pósparto imediato ainda é negada e muitas vezes sem denúncia devido  ignorância a respeito disso.', 'Infere-se, portanto, que assegurar o direito da família ao parto humanizado é um grande desafio no Brasil. Sendo assim, é imperioso que o Ministério da Saúde, órgão público responsável pelo sistema e serviços de saúde, invista em infraestrutura e profissionais de obstetrícia para pré-natal e parto, para garantir acesso a gestantes de diferentes classes . Além disso, o Ministério da Saúde, juntamente com o Ministério da Educação, devem promover treinamentos mais assertivos aos profissionais de saúde, com maior ênfase ao parto natural, incluir na grade de biologia da educação básica mais conteúdos relacionados gestação, pré-natal e parto, divulgar cartilhas com informações relevantes nos centros de saúde e fornecer conteúdo de qualidade e atualizado nos meios digitais. Quiçá, assim, o melhor parto e melhor nascimento possível será acessível para brasileiras e brasileiros.']",160,160,160,200,120,800
91,O negacionismo e seus efeitos,"['“A Terra é plana"", essa é uma das inúmeras frases características de pessoas que \u200bnegam fatos comprovados pela Ciência. O negacionismo, busca de todas as formas refutar o conhecimento científico e descredibilizar anos de pesquisas, observações, hipóteses, testes e conclusões.', '\u200bA ""Idade das trevas"", denominação referente à Idade Média, é um exemplo da ignorância, fanatismo/dogmatismo presentes na negação do que é real, pois a maior instituição do período, a Igreja Católica, caçava aqueles que iam contra os seus princípios. Foi o caso de Galileu Galilei, que obrigado pela inquisição, teve que deixar de lado a teoria do heliocentrismo, de modo que se não o fizesse,  teria o mesmo fim de Giordano Bruno, a morte. Dessa forma, essa instituição se apresentava de maneira violenta contra aqueles que não seguiam seus pensamentos, prendendo seus adeptos à ignorância, às hipóteses sem nenhum embasamento lógico e científico.', '\u200b', 'Portanto, esse comportamento vai contra todo e qualquer exercício racional, as pessoas que o possui estão continuamente negando a realidade. O negacionismo é uma ameaça contra a Ciência e todas as sociedades, é usado muitas vezes por líderes políticos, como forma de alienar as massas populares, para que assim seja possível o controle desses indivíduos, bem como uma ferramenta para a consolidação de seus interesses. Um exemplo nítido do perigo do negacionismo, é o atual governo brasileiro e sua atuação frente a crise sanitária do (Covid-19) . O número de mortes já ultrapassa os 400 mil, e o vírus desde o início foi tratado como uma “gripezinha”, termo usado pelo presidente da República Federativa Brasileira.', '\u200bPensando nisso, ver-se que a educação é de extrema importância para o desenvolvimento das ideias. Uma sociedade consciente sobre a importância do conhecimento baseado na razão, é uma sociedade preparada para qualquer desvio dessa. Dessa forma, tal agente pode ser difundido cada vez mais nos meios de comunicação, principalmente nas redes sociais, por estudantes, influenciadores, professores, entre outros, como forma de barrar esse surto de negação dos fatos.']",160,120,120,120,80,600
88,Judas Iscariotes,"['A Bíblia retrata que Judas pela angústia de ter traído a Deus sucumbe ao suicídio. Ánalogo a isso,hodiernamente, na realidade brasileira, a exigência de uma vida perfeita bem como a falta de informação corroboram para o sofrimento diário de uma expressiva parcela da população que muitas vezes, infelizmente, possuem o fim de Judas. Destarte, faz-se imprescindível o debate acerca do estigma relacionado a doenças mentais, bem como medidas que atenuem esse quadro.', 'A priori, de acordo com a filosofia kantiana é necessário agir de tal maneira para que essa prática possa ser considerada universal. Entretanto a exigência de uma vida perfeita vai de encontro à máxima supracitada. Para ratificar essa tese, segundo a pesquisa realizada pela OMS  em 2017, o Brasil é o segundo mais afetado pela depressão mundialmente. Isso porque, com o fomento das redes sociais cria-se uma bolha social de vida perfeita em que parecer é mais importante que ser. E isso, por conseguinte, acarreta danos à saúde mental do indivíduo por não ser capaz de atingir o nível de perfeição modulado. Nesse sentido, é imprescindível ações que visem minimizar a questão em prol da saúde grupal.', 'Em segundo lugar, a ausência de interesse em relação a mazelas mentais perpetua o preconceito na sociedade. Para comprovação dessa assertiva, no Brasil Colônia do século XVIII, o preconceito advindo desse época contra os negros nela escravizados perpetua-se até o contexto contemporâneo. Sob essa ótica, engendra-se uma perspectiva da valorização da saúde e bem-estar físico em detrimento do mental, concomitantemente, a ataraxia - que conforme o Estoicismo refere-se a impertubalidade da alma- é deturpada. Portanto, é necessário a dissolução desse quadro urgentemente.', 'Depreende-se, dessa maneira, a urgência de medidas que revertam a problemática. Para isso, o governo federal, através de verbas governamentais direcionadas para a educação,  deve criar uma grade curricular de inteligência emocional nas escolas desde o nível fundamental até o ensino médio, com aulas que ocoram duas vezes por semana, a qual possuam psicólogos e especialistas da área da saúde mental, onde deve haver o diálogo sobre doenças mentais - como depressão, ansiedade e transtorno bipolar. Com o fito de estourar a bolha social da perfeição e assim instruir cidadãos e alcançar a ataraxia mental.']",160,160,160,200,200,880
94,ESCOLAS PARA CRIANÇAS COM TEA.,"['O autismo (transtorno do apetro do autismo – TEA) é uma condição de saúde caracterizada por dificuldade de socialização, principalmente no ambiente escolar. De modo que, nos argumentos dos que defendem a inclusão dos autistas em classes comuns, isso faria com que desde pequenos eles já desenvolvessem uma boa interação social com crianças e adolescentes comuns. Porém, essa proposta não oferece apenas atributos,endo assim, dentro dos seus aspectos negativos vale destacar: como a presença e um aluno autista em uma sala de aula comum pode interferir negativamente no âmbito escolar. Com isso convém analisarmos as consequências dessa situação.', 'Em primeiro plano, é cabível levantar a afirmativa que quando um aluno com TEA frequenta uma escola comum seu aprendizado fica tardio em relação aos demais colegas de classe . Isso acontece porque o cérebro de uma criança com autismo processa mais lentamente as informações comparado a uma criança neurotípica. Além disso, em uma escola pública as salas de aula comportam muitas crianças, por isso apenas um professor não consegue dar atenção para tantos alunos quanto mais um estudante com TEA.', 'Em segundo plano, cabe destacar que infelizmente em algumas escolas públicas o bullying é frequente, principalmente com crianças consideradas diferentes. Escrevo por experiencia pessoal, pois entre meus colegas de classe havia um menino autista e por causa disso, tive o desprazer de presenciar diversas cenas de bullying contra ele, o que certamente tornava a convivência em sala estressante para todos. Sendo assim, é importante que uma criança autista conviva em um ambiente onde se sinta acolhido, juntamente com outras adolescentes que compartilham da mesma condição de saúde, para evitar situações de exclusão por parte dos colegas de sala.', 'Em vista disso, cabe ao ministério da educação, órgão responsável pelo estudo e de todos os assuntos relacionados ao ensino, propor por intermédio de verbas governamentais, a criação de escolas públicas para crianças autistas. A fim de que, os pais que não tiverem condições financeiras para arcar com os custos de um estudo particular para um filho com TEA, fiquem despreocupados, pois saberão que a criança terá o ensino que precisa e não sofrerá maustratos por parte dos colegas de classe. Dessa forma, as crianças autistas poderão viver em um ambiente escolar mais agradável e incluso.']",120,120,120,160,120,640
51,Analfabetismo funcional,"['É incontrovertível que o analfabetismo funcional é a realidade de muitos brasileiros. Logo, o constante crescimento destes casos estão tornando-se alarmante. Desse modo, deve-se tomar providências, antes que este problema se agrave.', 'Bem como, são considerados analfabetos funcionais, sujeitos que sabem ler e examinar números, entretando, não conseguem interpretar e solucionar interrogações matemáticas mais complexas. Ademas, segundo pesquisa feita pelo Instituto Pró-Livro, 50% dos entrevistados declararam não ler livros por não conseguiram compreender seu conteúdo, mesmo sendo tecnicamente alfabetizados.', 'Além disso, o conhecimento é uma ferramenta fundamental para que o individuo possa questionar o corpo social em que se encontra. Desse modo, a falta de uma educação básica é um meio utilizado pelo Estado, cujo o objetivo principal é à desqualificação dos indivíduos para trabalhos bem remunerados. Logo, tornando-se mão de obra barata e abundante.', 'Diante disso, é de suma importância, que o governo brasileiro proporcione aos cidadãos mais pobres à possibilidade de uma educação básica de qualidade . Outrossim, o Ministério da Educação deve investir na criação de workshops para professores, onde, terão aprimoramento em seus mecanismos de ensino, para melhor combater o analfabetismo funcional.']",120,120,80,120,80,520
83,O esporte ensina o caminho certo,"['Durante as Olimpíadas o mundo viu diversas modalidades de esportes e as mais diferentes atitudes entre os atletas que competiam. O mundo presenciou um judôca que, em sua ignorância, se negou a cumprimentar seu openente, mas também viu uma corredora, em sua solidariedade, ajudar a outra a terminar a prova dos cinco mil metros. Estes fatos, entre outros ja assistidos em outras edições das Olimpíadas, fazem o público refletir quanto ao que o esporte ensina a juventude e a sociedade em geral.', 'No decorrer da história, o mundo presenciou atletas que usaram de artificios ilegais para atingir resultados, mas todos que foram pegos em tal ato foram punidos com a perda das medalhas conquistadas e impossibilitados de competir em outras edições de jogos, sejam olímpicos ou não, por um período de tempo. Mas a história também mostrou como as atitudes boas são recompensadas, (;) nesta edição dos jogos Olímpicos, que ocorreram no Rio de Janeiro, tanto a corredora que ajudou quanto a ajudada foram recompensadas com a classificação na fase final.', 'A conclusão que pode-se ter com tudo descrito acima é que o esporte ensina que quem procura os caminhos da ilicitude é punido, mas aqueles que buscam o caminho da solidariedade, do companheirismo, da bondade, entre outras virtudes que a prática esportiva trás , é agraciado com prêmios.']",160,120,120,200,200,800
65,"Redução da maioridade penal, uma solução ineficaz para o problema","['Nos dias de hoje , diariamente presenciamos o aumento constante nos crimes praticados por adolescentes brasileiros. Neste contexto, surgem várias alternativas voltadas para o combate dessa violência envolvendo o menor infrator, contudo são apenas medidas imediatistas que se preocupam apenas na repressão. A grande solução apontada por uma parte dos políticos e canais de comunicação seria a redução da maioridade penal.', 'Partindo desse ponto de vista, reduzir a maioridade penal seria apenas antecipar o encarceramento desses jovens que não recebem nenhum tratamento preventivo . Todos nós sabemos  que o sistema prisional brasileiro vive um verdadeiro caos, além de não regenerar ninguém , a maioria dos presídios estão super lotados.', 'Não podemos analisar o problema de forma superficial, a fim de apresentar uma resposta rápida para a sociedade que exige uma resposta, seria como podar uma árvore sem agir em sua raiz, todos os frutos continuariam estragados. Diante disso, podemos  dizer que uma solução eficaz se passa na prevenção primária, ou seja, agir na raiz do problema, nas escolas, na formação da criança e do adolescente.', 'Em razão disso, precisamos  investir nas escolas e nos professores, fazer com que as crianças permaneçam nas escolas. Isso, contudo, vai muito além de fornecer a matricula e livros medianos para os alunos, é preciso que o Estado assuma seu papel de garantidor, pare de pensar de forma meramente repressiva e invista na educação .', 'Portanto, a diminuição da violência entre os jovens no Brasil se passa em investir na educação da criança e do adolescente. Diante disso, indubitavelmente, podemos concluir que reduzir a maioridade penal seria apenas uma forma de maquiar o problema , pois uma solução efetiva está na prevenção e não na repressão.']",120,120,120,120,120,600
109,Medida necessária,"['O sistema de cotas para o ingresso nas universidades é um tema polêmico, com diversas opiniões. É verdade que consiste em uma medida que trará benefícios         a         sociedade. Porém, alguns especialistas em educação consideram-na desfavorável.', 'Os benefícios desse sistema começam no seu objetivo que é possibilitar o ingresso na universidade para aquelas pessoas que tiveram uma educação básica de baixa qualidade ofertada pelo         estado. Já         que         quando a         rede pública de         ensino         é comparada         a         privada, demonstra-nos resultados vergonhosos e, para comprovarmos         isto         , basta verificarmos                 o último IDEB em 2012.', 'O lado desfavorável do sistema de cotas, segundo alguns         especialistas e         que os alunos oriundos de escola pública estarão ocupando vagas para as quais não estariam realmente         preparados. O         que, segundo eles, poderá acarretar em         perca         na qualidade do ensino universitário e das pesquisas acadêmicas.', 'Compreende-se a necessidade de cotas nas universidades, uma vez que         irá         possibilitar o ingresso de pessoas que talvez fossem excluídas do mundo acadêmico por responsabilidade do         estado         . Portanto,                 os benefícios gerados pelo sistema de cotas são muito maiores do que previsões negativas em relação ao ensino acadêmico.']",200,120,120,120,120,680
88,O estigma com as doenças mentais,"['Na famosa série ""13 reasons why"", a jovem Hannah Baker, após sofrer com diversas situações em sua vida, resolve dar fim a mesma. Isso remete a um transtorno muito comum: a depressão, doença que de acordo com a OMS , afeta milhares de pessoas todos os anos ao redor do mundo, sendo o Brasil, o maior país da américa latina em casos confirmados. Porém, ainda continua recebendo um preconceito gigantesco e tratada como apenas um “drama”, quando na verdade vai muito mais além do que isso.', 'Vale destacar,  que a falta de empatia, compaixão e acolhimento a indivíduos que sofrem com algum tipo de transtorno não só a depressão, só deixa mais evidente o estigma em relação s doenças mentais na sociedade brasileira, ainda mais na atual situação em que se encontra o mundo, quando quadros como esses ganharam força e muitos tem medo de procurar aconselhamento psicológico para não serem taxados como “loucos”.', 'Com isso, é importante salientar que com a pandemia de coronavírus e o pouco que se sabe sobre o assunto, a população teve que se adaptar a um mundo novo, onde, o uso de máscaras é indispensável e ficar em casa se tornou mais seguro. Mas, esse isolamento social, não evitou que a ansiedade, bulimia, entre outros, chegassem até os lares das pessoas, prejudicando a saúde física e mental dos indivíduos e deixando a população cada vez mais doente.', 'Portanto, é preciso que o cuidado com a saúde mental seja tratado como prioridade, dessa forma, o governo juntamente com as escolas deveriam investir em palestras, promover campanhas e atividades de interação em grupos e disponibilizar psicólogos nos interiores . As mídias digitais,  poderiam utilizar de sua influência e aconselhar a busca pelo aconselhamento psicológico, divulgar como cuidar das pessoas mais próximas e campanhas de conscientização para abrir os olhos dos cidadãos sobre como essa doença é perigosa e não apenas um melodrama. Assim, tragédias como a de Hannah Baker poderiam ser evitadas.']",160,160,160,160,200,840
52,A gravidez perante aos riscos e a cultura,"['A gravidez no período da adolescência pode ocasionar problemas na saúde, além de existir cuidados com a nova vida que está sendo gerada; O Brasil possui níveis altos de muitos casos de gravidez entre 10 a 20 anos e somente obteve 17% de redução entre 2004 a 2015.', 'Um fator que influência muitas meninas novas são as culturas dos povos de onde elas se denominam, por exemplo, na Índia as meninas geralmente se desposam com um indivíduo mais velho, a fim de lhe dar um herdeiro ; O casamento apenas pode ser feito com o consentimento da família e da noiva, porém, todas são preparadas desde o nascimento para o enlace, por isso, se casam e ser tornam mães muito cedo.', 'Os riscos de saúde da gestante que se encontra na fase da puberdade, e também ao bebê  são inúmeros, como o aborto espontâneo, morte no parto da mulher ou somente da criança ou simplesmente dos dois, pode ocorrer o baixo peso ou subnutrição do feto, entre outros os problemas; A idade recomendada para se ter um filho está entre os 22 e 25 anos, abaixo ou acima desse parâmetro pode ocasionar problemas durante toda a gestação e no parto.', 'Primordialmente, perante ao contexto, o corpo da adolescente está em constante desenvolvimento e por isso ainda não se encontra preparado para formar uma vida. Sendo, assim, a responsabilidade da jovem aumentará, e com isso, algumas das moças acabam abandonando aos estudos, sendo no futuro difícil de cuidar do filho por não ter se adequado para o ambiente profissional; É importante cuidar da saúde e da alimentação, não fazer esforços para não haver complicações durante ao nascimento do filho.']",120,80,40,80,80,400
130,Relações no novo mundo,"['O convívio das diversas ?tribos? existentes no mundo globalizado vem trazendo diversas questões a serem discutidas principalmente no âmbito sociopolítico mundial. Vários grupos de diversas idades têm se visto diante de impasses como a adaptação às novas tecnologias por parte das gerações passadas e às regras de convívio por parte das gerações recentes.', 'Os mais jovens se vêm presos a internet, aos jogos online, ao ?X-box? e ?Playstation?,                 deixando                de lado         às         boas e velhas brincadeiras de rua,                 ficando                cada vez mais longe dos contatos interpessoais, se                 tornando                frios e muitas vezes não                 sabendo                lidar com os possíveis problemas que         possam a vir enfrentar         em suas vidas,                 reagindo                inclusive com certa violência àqueles que não comungam dos mesmos gostos e ideias, e                 estando                completamente às margens da vida política da sociedade.', 'Enquanto isto, os ""vovôs"" desta era informatizada estão passando apuros não só com as tecnologias que surgem                como os ""iPhone"",         ""iPed""         , entre outros aparelhos pequenos e sofisticados que têm mil e uma utilidades, mas também com a busca por uma solução para essas novas gerações tão consumistas e desregradas que querem aproveitar ao máximo da juventude e dos prazeres da vida, esquecendo-se dos reais valores da sociedade.', 'A solução para estes impasses pode estar na união de forças. Ao trazer o que há de excelente das gerações anteriores, como a conservação dos valores humanos, e somar à disposição e inteligência instantânea das novas gerações pode-se obter uma mistura fantástica tanto para a melhoria das relações sociais e tecnológicas quanto para a política, que contará com jovens preparados para um novo mundo, o mundo das diversidades.']",200,200,200,200,200,1000
68,A valorização de uma história cultural,"[""Segundo a lei da inércia, de Isaac Newton: ''Todo corpo permanece em estado de movimento ou repouso, a menos que seja forçado a mudar aquele estado por forças aplicadas a ele''. Portanto, o patrimônio atualmente encontra-se neste principio, pois as autoridades não fazem nada para deixá-los conservados e de bom agrado aos cidadãos, para que estes possam valorizar a cultura de sua cidade e mostrar as futuras gerações o quanto é importante dar continuidade as suas origens."", 'A falta de investimentos e a falta de uma população mais consciente, são os principais motivos para que os patrimônios estejam em estados críticos, de plena precariedade. Além disso, geram inúmeros transtornos que não são agradáveis, como acumulo de lixo e ponto para consumo ou venda de drogas.', 'No dia 2 de Setembro de 2018, na cidade do Rio de Janeiro, o Museu Nacional - mais conceituado do estado, foi dominado pelas chamas. Grande parte das pesquisas e documentos históricos foram perdidos, quase nada foi recuperado. Entretanto, pode-se perceber que o governo não mandava recursos a este museu por descaso e tudo foi perdido, decepcionando e entristecendo pesquisadores, aos quais esforçaram-se por anos para realizar descobertas e mostrar ao público suas pesquisas.', 'Dessa forma, viabilizando todas estes acontecimentos, ainda é possível reverter toda essa situação. Se os Orgãos Públicos implantassem medidas de investimento que envolvessem esses patrimônios, com certeza seriam muito mais conservados, principalmente pelos jovens, que estariam aprendendo e ao mesmo tempo, prezando muito mais a história de sua cidade, pois a cultura, deve sempre estar em movimento, conforme Newton destaca em sua teoria.']",120,160,120,120,120,640
86,**,"['Com a globalização, os fluxos de informação e contato com pessoas de todo o mundo têm sido sido facilitado pela internet. Dessa forma, as redes sociais se tornaram um local de interação e de grande influência na sociedade, entretanto, seu uso equivocado e inconsciente, pela sua importância, gera impactos na vida dos usuários, sobretudo na saúde mental, sendo capaz de moldar comportamentos e pensamento de seu público. Nesse sentido, convém analisar a má influência midiática e a falta de conscientização nesse meio cibernético.', 'Inicialmente, cabe mencionar a má influência midiática que provoca em seus usuários uma perspectiva enganosa sobre uma vida perfeita. Neste viés, as redes sociais se tornaram um instrumento mercadológico que perpetua padrões de beleza e estilo de vida a alcançar, idealizando e comercializando ideais de beleza. No entanto, ao alienar e influenciar os seguidores, eles tendem a se frustrar com sua realidade ao consumir e acreditar na falsa visão ideal de vida, reforçando sua insegurança e baixa alto-estima, contribuindo para uma geração mais depressiva e ansiosa . Com efeito, tal chaga social é estudada pelo sociólogo Adorno, que criou o conceito de ""indústria cultural"", o qual empresas utilizam a cultura para alienar novos consumidores de seus produtos. Assim, influenciadores se apropriam e moldam culturas e ideais a fim de lucrar, tornando nocivo á saúde dos usuários.', 'Além disso, a ausência de conscientização nas redes sociais resulta em indivíduos mais cada vez mais imerso no universo equivocado da internet. Sob esse aspecto, a idealização e romantização de procedimentos estéticos e cirúrgicos, que perpetuam ideais de beleza, torna uma geração de usuários mais inseguros e depressivos por não alcançarem os ideais exigidos. Desse modo, o ""Lip Lad"" - procedimento cirúrgico no abdômen - levantou a tese nas redes sociais depois de diversos influenciadores romantizarem tal procedimento invasivo e não conscientizarem seus seguidores sobre sua necessidade. Infelizmente, tal comportamento irresponsável é culpado pelos impactos das redes sociais no problema emocional dos indivíduos influenciados, por consumirem o conceito de ""indústria cultural"".', 'Portanto, é necessário que instituições responsáveis pelas redes sociais crie uma rede de comunicação online, por meio de palestras, debates e vídeos educativos que visem a conscientização dos usuários. Isto será feito, por exemplo, com figuras públicas desmitificando os ideais de beleza e reforçando a autoaceitação. Espera-se, com isso, que as redes sociais se tornem um local mais saudável, sem perpetuar padrões e impactar na saúde emocionar do usuário.']",160,200,160,200,160,880
84,,"['Insegurança , medo , revolta com a criminalidade e sensação de impunidade fazem parte do cotidiano dos brasileiros . Em meio a essa onda de descrença da segurança pública , a tramitação no Congresso nacional de um projeto de lei que torna mais branda a restrição ao porte de armas divide opiniões e gera polêmica . A falsa sensação de segurança que a posse de armas dá ao cidadão, preocupa autoridades , pois se aprovada  qualquer pessoa maior de 21 anos , mesmo com antecedentes criminais , poderá adquirir legalmente uma arma . A aprovação desse projeto de lei acarretará consequências negativas à sociedade.', 'Segundo Tomas Hobbes , o homem em seu estado natural vive para se autoconservar , se proteger .  É a ideia de todos contra todos,  e isso leva a sociedade a um estado de caos absoluto . Trazendo esse pensamento para os dias atuais , especialistas acreditam que que a facilitação a posse de armas não trará segurança aos cidadãos , e sim um estado de caos na sociedade ; (.) Portanto ,trata-se de uma medida equivocada ,  ineficiente e populista , já que os números provam que com o Estatuto do Desarmamento houve uma queda significativa no índice de mortes por armas de fogo . A revogação desse estatuto significaria um retrocesso .', 'Por outro lado , é compreensível que diante de uma segurança pública falha , a sociedade veja a posse de armas como uma forma desesperada de autoconservação , legítima defesa . Mas , a medida mais cabível nesse momento seria uma reestruturação do aparelho de segurança do Estado , que levaria a resultados a longo prazo . Medidas como essa , que tramitam na Câmara , têm caráter imediatista , sem aprofundamento no problema e em tudo que implica . Países como Estados Unidos , onde a política de armas é totalmente flexível , pretendem tornar esse acesso as armas mais difícil, em virtude de tragédias ocorridas.', 'Isso posto , é essencial que o Estatuto do desarmamento continue em vigor ; suas falhas precisam ser corrigidas e se possível deveria existir uma reformulação desse Estatuto , que vise ser mais eficiente . É necessário também uma fiscalização eficaz no controle de armas , pois os números de armas ilegais no país é preocupante . É importante também que a segurança do Estado  traga sensação se segurança para a sociedade . As leis precisariam ser mais severas , para que ocorra uma atenuação da violência e uma menor sensação de impunidade .', 'Assim como propôs Hobbes , com a estruturação da sociedade , o Estado firma um contrato social com os cidadãos – onde estão inclusos leis , direitos , deveres etc – em que visam tornar o corpo social mais estável e organizado, fugindo do caos .']",120,200,200,200,200,920
138,A estrutura social diante do medo,"['A sociedade é organizada por uma estrutura rígida formada por cada cidadão e o que ele desempenha nesse meio. Mas um erro nessa estrutura leva          o          rompimento da mesma, comprometendo os resultados gerados pelo conjunto.                E quem tem coragem de assumir seu erro? Instintivamente para a                 sobrevivência da vida social do indivíduo, este busca a covardia negando seus erros.', 'O fato acontecido em Janeiro de 2012 do abandono do navio que estava naufragando com 4.000 pessoas a bordo pelo capitão Francesco Schettino mostra claramente a                 busca pela covardia                em meio a um momento de desespero pela negligência cometida.', 'O ser humano é um animal racional, mas possui um         extinto         de fuga quando está ameaçado, o que não é raro. Um indivíduo num primeiro momento                 busca a covardia                quando precisa assumir seus erros, como é o caso         anterior o qual         o capitão                 buscou a fuga a ficar para salvar vidas dos tripulantes.', 'Depois que toda a estrutura social está desestabilizada é necessário a busca novamente pela rigidez cuja coragem tem essa função.                ?Vada a bordo, cazzo! ?(""suba a bordo, diacho!"") são palavras emitidas pelo comandante Gregorio de Falco diante do ocorrido. Nesse momento o fato de                 pedir pela volta do capitão é colocar a coragem em prática.                  Coragem e covardia são duas palavras antagônicas que formam o individuo                e, consequentemente, a sociedade. Por isso         esta         estrutura está sempre                 em situação de um pêndulo, ""vai e volta"", que, diante de um erro, a pessoa busca, por instinto, não assumir seus desleixos                com medo das consequências que pode         ameaçando         a estrutura, mas no fim a coragem de outro restaura a estabilidade.']",80,80,0,0,0,160
67,Guardiões da Natureza,"['Diz a história brasileira atestada e documentada no arquivo nacional, que no dia 22 abril de 1500 Pedro Álvares Cabral e sua frota invadiram o Brasil . Chegando cá, só encontraram os índios! Os verdadeiros donos das terras . Logo, não seria melhor perguntar para eles o que eles querem? Como desejam seguir seu destino? Por que que no Brasil todo direito é negado? Por que só existe no papel? Direito não é direito? Então, por que o povo brasileiro tem que mendigar o seu direito? Por que,  que professores tenham que fazer greve para receber aumento salarial?', 'Não é bom para o país, que quinhentos e dezoito anos depois do descobrimento do Brasil, o povo indígena ainda sejam ignorados, desrespeitados e negligenciados por quem por dever deveriam proteger. O homem branco invade terras indígenas para promover desmatamentos, garimpos e degradação do meio ambiente. E às vezes ainda exterminam tribos inteiras em nome do progresso, da ganância e da covardia.', 'Aonde há índios, há florestas, rios, peixes, e um meio ambiente preservado e fértil. Eles são necessários a natureza. Os índios devem nos ensinar seus conhecimentos e jamais ser obrigados a aprender o nosso . Eles têm um modelo de sociedade perfeita. Vivem com o que precisam e nunca com o que dá mais dinheiro. São os verdadeiros guardiões da natureza. Nunca trazem problema nem confusão para a sociedade dita civilizada. E têm o direito de viver em paz e felizes.', 'O governo e a nação brasileira devem proteger os guardiões das florestas. Transformando as terras indígenas em terras sagradas e tombadas para o patrimônio histórico e cultural. Deve ter um órgão de vigilância 24 horas por dia para proteger cada palmo de solo indígena. O Brasil é muito grande e tem muita terra para ser explorada, não precisa degradar o ambiente dos índios . Respeito é tudo o que eles precisam para viver, amar, cuidar e morrer na terra. Ser índio não é uma escolha, é ser escolhido por Deus para cuidar da natureza.']",120,160,120,120,120,640
87,A EROTIZAÇÃO PREMATURA (VI),"['A erotização infantil se caracteriza pela exposição a conteúdos e situações que incitam a sexualidade prematura. O que tem se tornado mais comum, devido as opções para a propagação desse tipo de conteúdo. As mídias sociais e brincadeiras entre familiares com conotações sexuais, resultam na proximidade da petiz com a voluptuosidade.', 'O contato com esses conteúdos impróprios impulsionam a sua curiosidade. Tendo por conseguinte a perda de sua puerícia, que acaba replicando a sexualidade que lhe foi apresentada em seu cotidiano, como brincadeiras e gestos. Tornando as crianças mais vulneráveis á violência e ao abuso sexual.', 'Assim a prevenção é a melhor medida. Sobretudo é importante deixar as crianças se desenvolverem em um ritmo saudável e próprio. Com cuidados e supervisões de seus responsáveis em relação as mídias sociais, dispositivos eletrônicos e orientações sobre atividades adequadas à idade, assim como a comunicação com os pais. Destarte as crianças são introduzidas a sexualidade de forma natural e no tempo adequado.']",160,120,120,120,120,640
49,O Papel dos Influenciadores Digitais,"['Conforme o filósofo britânico John Stuart afirmou ""sobre o seu próprio corpo e mente, o homem é soberano"" . Não obstante, esta revelação se relacionando ao tema não é legítima, pois os influenciadores digitais não só suscitam os seus seguidores em opiniões, mas também em determinadas ações.', 'Em primeiro lugar, atualmente, a internet faz parte da vida cotidiana do ser humano, sendo uma grande fonte de muitas informações essenciais. Sob outro ângulo, a mesma pode ser utilizada por pessoas que querem se aproveitar das outras, fomentando a realizar diversas situações que não são corretas.', 'Em segundo lugar, o sujeito que foi manipulado a realizar tal ato ou ""opinião"" deverá sofrer diversos danos a si próprio , mesmo que não perceba, como danos morais, sociais e até físicos. Além disso, essas pessoas têm a certeza que estão fazendo o correto, pois foram fomentados por certos influenciadores digitais. Conquanto, isso é apenas uma ilusão.', 'É evidente, portanto,  medidas necessárias para resolver este impasse. Para tal, as redes sociais, pois é o meio por onde acontece , deveriam banir tais pessoas que engodam o seu público, por meio de diretrizes rígidas sobre o assunto supracitado, a fim de que não ocorra mais essa persuasão, tendo como corolário a liberdade de expressão de cada indivíduo. Destarte, conseguiremos  seguir a afirmação de John Stuart.']",120,120,120,120,120,600
62,Propagação dos discursos de ódio,"['A invenção da Internet foi fundamental para que as pessoas pudessem ter espaço para expressarem suas opiniões e comentários acerca de todos os assuntos, essa ação foi de certa forma incentivada principalmente pelo surgimento das redes sociais. Antes, a sociedade em geral só conseguia obter informações através da mídia tradicional (jornais, televisão, rádio, entre outros meios) e isso significava pouca possibilidade de argumentar e de questionar sobre aquilo que não concordavam. Hoje em dia essa situação é bem diferente, assuntos são discutidos com uma enorme amplitude de ideias e discursos. Mas até que ponto esses discursos são saudáveis e contribuem para a construção do conhecimento?', 'A internet traz a sensação ilusória de anonimato e isso faz com que muitas pessoas não tenham medo de dizer o que realmente pensam, faz com que não se importem nem mesmo com a forma como transmitem suas ideias. Essa atitude pode fazer com que muitos indivíduos acabem propagando discursos de ódio, ou seja, muitos acabam aceitando e repassando ideias e comentários preconceituosos e ofensivos, pois sabem que, se aplicadas, as consequências não serão graves, já que a Constituição brasileira não possui nenhuma lei que puna pessoas que propaguem esses discursos.', 'Quase sempre compartilhados rapidamente, é muito difícil deter o acesso de usuários das redes sociais a esses discursos, o que faz com que muitas pessoas leiam, comentem e causem uma polêmica ainda maior. Mas é exatamente isso que muitos indivíduos desejam, tentam influenciar e manipular o pensamento da maior quantidade possível de pessoas, que muitas vezes acreditam sem nem questionar o que leem e ainda repassam a informação para mais pessoas, gerando uma eterna onda de discursos de ódio, já que sempre terão pessoas que concordam e outras que discordam daquilo que foi compartilhado . Muitos, ao invés de tentarem argumentar e causar uma discussão que possa contribuir com o conhecimento começam a ofender um ao outro, fazendo e incentivando inclusive ataques racistas, homofóbicos, misóginos, xenofóbicos, etc.', 'É preciso que o Governo, principalmente o Ministério da Ciência, comece a pensar em medidas que possam diminuir a propagação de discursos de ódio, como a criação de algoritmos que sejam capazes de identificar comentários ofensivos e discriminatórios, além de uma equipe que possa fazer isso manualmente, usando os modelos existentes dentro de empresas que trabalham para o funcionamento de redes sociais. Mais que isso, é necessário também que seja criada uma lei para punir os responsáveis por incitarem esses discursos, assim como a divulgação sobre o tema para a sociedade em geral e o incentivo à denúncia por parte dos usuários de redes sociais.']",160,160,120,160,120,720
69,,"['O Brasil destaca-se no cenário internacional como exportador de grãos e carnes. Através das inovações tecnológicas como os fertilizantes químicos, os agrotóxicos e as sementes transgênicas os produtores brasileiros consolidaram a produção nacional no mercado externo, favorecendo a balança comercial. Todavia, o uso dos agrotóxicos ainda é um dilema pois a segurança quanto ao seu uso é incerta. Nesse contexto, haja vista que a agropecuária é fundamental para o desenvolvimento econômico, a pesquisa científica nas instituições públicas deve ser incentivada para a resolução dos entraves ligados aos agroquímicos.', 'Convém ressaltar, a princípio, os riscos que os agrotóxicos representam saúde humana e ao meio ambiente . A presença de vestígios desses compostos nos alimentos está relacionado a doenças como o câncer e o seu uso recorrente pode levar a degradação do ecossistema local,  através da contaminação do solo e da água. Dessa forma, a negligência governamental frente a essa questão acarreta não só na saúde da população como também prejudicam os biomas brasileiros.', 'Sob este viés, observa-se a falta de engajamento da comunidade científica brasileira. Tal fato dificulta a ação dos parlamentares e mantêm as medidas contra os agrotóxicos somente no papel. Ademais, os esforços para a ampliação da agropecuária no Brasil têm se voltado para a ampliação da produção, em detrimento do desenvolvimento sustentável.', 'Diante dos fatos supracitados , o Estado deve reforçar as instituições de referência na área como a Embrapa (Empresa Brasileira de Pesquisa Agropecuária) e a Esalq (Escola de Agricultura Luiz de Queiroz) com o intuito de elaborar medidas alternativas ao uso dos agrotóxicos. Assim, o Brasil não só superará a questão atual como também consolidará o setor agrícola em âmbito internacional.']",120,160,120,160,120,680
83,Prática esportiva,"['Em tempos onde a comunicação é feita em frações de segundos e o mais fácil e prático encurta distâncias, a prática esportiva vem tornando-se um meio não só de lazer,mas principalmente a busca por uma vida mais saudável,já que, o sedentarismo e a obesidade, são grandes vilões da sociedade moderna.', 'Num passado não muito distante, a prática esportiva entre as crianças era muito comum nos momentos de lazer. Uma partida de peteca,queimada,vôlei,pega-pega,enfim,todas estas atividades e outras não citadas, exigiam esforço físico da garotada.Desta forma, não havia tanta preocupação com a obesidade e a vida sedentária,pois involuntariamente, brincava-se praticando esportes.Se este já era um ponto que contribuía com a integridade física da criança,ainda entrava a questão da alimentação,já que, nesta época,a comercialização de alimentos com processamentos industrializados,com corantes artificiais e enlatados era bem menor.', 'Por outro lado , hoje,com tantas inovações da internet,com as redes sociais à tona e jogos de última geração, dificilmente você se depara com um jovem longe das telas, brincando nas ruas como tempos atrás.Hoje,na maioria dos casos,se os pais não impõem regras,os filhos ficam o tempo todo em frente a um game e o que é pior, com uma lata de refrigerante e um salgadinho do lado,ou seja,aliados à uma alimentação equivocada.Daí,não há tempo pra correr,exercitar, perder calorias e o estresse surge, consequentemente.E é justamente esta rotina, uma das causas do crescimento do número de óbitos por infarto e depressão entre os jovens.', 'Cabem aos pais, incentivarem os filhos a praticarem esporte e mostrar a importância do mesmo aliado a uma boa alimentação.No começo,pode parecer difícil trocar o conforto do sofá por alguma atividade física,porém,após os exercícios, você verá a real quantidade de benefícios que lhe poderá serão proporcionados.Você queima calorias,ganha maior disposição,ganha massa muscular,alivia a ansiedade e diminui o estresse.', 'Portanto,deixe de lado o controle remoto ou qualquer outro que seja e vá praticar esportes,aliás,é uma prática que não é proibida,basta você ir ao médico,realizar alguns exames e avaliações de aptidão física e ganhar o pódio,que,se não for de medalhas,será de maior expectativa de vida.Boa sorte!!!']",120,120,160,120,200,720
22,O direito ao foro privilegiado e os privilégios aos poderosos no Brasil,"['No Brasil existe grande quantidade de privilégios para os altos escalões do poder político, em especial a nível federal, mas estados e municípios também não ficam atrás, quando se fala em beneficiar os poderosos com mais regalias. Uma dessas benesses que vem causando grande discussão nos últimos tempos é o chamado foro privilegiado.', 'As críticas a esse instituto são muitas, mas a maior delas tem a ver com a impunidade. Não são raros os casos em que deputados e senadores ou outras autoridades com foro especial são denunciados por crimes cometidos e os processos acabam prescrevendo nas instâncias superiores, em especial no Supremo Tribunal Federal, talvez por acúmulo de trabalho para apenas onze ministros ou até mesmo pela falta de vontade política de se punir os poderosos no país.', 'Por outro lado, existe quem defenda o argumento de que o foro por prerrogativa de função seria uma proteção para o exercício do cargo público, uma vez que na primeira instância as autoridades estariam sujeitas a um denuncismo que poderia prejudicar o andamento dos trabalhos na função que exercem. Esse argumento pode ser facilmente refutado quando se observa a experiência de países como os Estados Unidos e a Suíça, que não adotam esse instituto e as autoridades não ficam impedidas de exercer suas funções por causa de um suposto entrave judicial.', 'Atualmente o STF está discutindo a redução do alcance do foro especial, visando limitar o instituto aos crimes praticados por parlamentares durante o mandato e em razão dele. Existem também iniciativas legislativas no Congresso Nacional para extinguir esse privilégio, apesar de que, como tem-se observado nos últimos tempos, os parlamentares não costumam legislar contra seus próprios interesses e esse é um tema bastante sensível para os deputados e senadores, em sua maioria respondendo a processos por crimes, como o caso dos denunciados pela operação Lava Jato por desvios de verbas públicas e recebimento de propina.', 'Assim, o que se observa hoje no Brasil é uma cultura de benefícios explícitos a autoridades, muitos deles injustificados nos tempos atuais , como é o caso do foro privilegiado. A Constituição Federal de 1988 diz em seu artigo quinto que todos são iguais perante a lei. Se isso é verdade, o foro especial não se justifica e é uma contradição a esse princípio.']",200,200,200,200,200,1000
63,Progresso?,"['Qual seria o custo do progresso? Preservação e desenvolvimento podem andar juntos? Segundo especialistas e ambientalistas em todo o planeta  o custo é alto, desde o aquecimento global até a crescente contaminação dos recursos hídricos, nosso planeta, a fauna, a flora e os seres humanos estão sofrendo com os impactos ambientais decorrentes das ações de grandes corporações. No entanto, auxiliar preservação e desenvolvimento não é impossível, bastam-se apenas medidas conscientes de impactos positivos.', 'Em primeiro lugar, as grandes empresas necessitam de maior fiscalização do Estado e severa punição ao cometer alterações prejudiciais ao meio ambiente. Apesar de a constituição brasileira punir as empresas que lesam o meio ambiente ainda ocorrem tragédias causadas por negligência de grandes empresas e falha fiscalização. Como, por exemplo, o rompimento de uma barragem de rejeitos considerada de ""baixo risco"" e com ""alto potencial de danos"" da mineradora Vale em Brumadinho, Minas Gerais. É necessário, portanto, um tratado com obrigações legais para empresas ampliando a responsabilização das empresas por violações.', 'Ademais, se fazem necessários, por parte das mineradoras, programas com enfoque em atenuar ao máximo o efeito das suas intervenções no ambiente. Já que há risco de contaminação do solo e de águas superficiais, é essencial um correto direcionamento dos compostos químicos descartados e contenção da poluição gerada pelos elementos químicos, aliada a uma utilização sustentável dos recursos minerais, visto que não são renováveis. Assim, a construção de barragens de rejeito deve ser feita em locais afastados de áreas preservadas para evitar a perda de espécies nativas.', 'Os gigantes do segmento industrial podem aderir a fontes de energias renováveis e reciclagem de seus produtos. A troca de combustíveis fósseis por energia solar, energia eólica e até compostos orgânicos são alternativas perfeitas e já aderidas por empresas do segmento industrial. Também, parcerias com outras empresas como a Tetra Pak, empresa multinacional de origem sueca, que produz telhas e placas para a construção civil, canetas e vassouras a partir da reciclagem de suas embalagens.', 'Portando, desenvolvimento e preservação conseguem trabalhar juntos. Com o tempo mais e mais startups, companhias e países abraçam a causa sustentável. Como por exemplo a LifePack, empresa colombiana que criou o Papelyco, talheres e pratos descartáveis que podem ser plantados. Logo, alcançamos o verdadeiro progresso quando não damos importância só ao desenvolvimento econômico, mas também ao meio ambiente.']",120,160,120,160,120,680
91,,"[""A cada dia aumenta o número de pessoas que desacreditam dos cientistas, isso é notável em programas de entrevista na TV aberta e também em ''podcasts'', aonde os convidados demonstram seu ponto de vista dizendo não acreditar na ciência. Essas pessoas acabam influenciando os telespectadores que são leigos nesse tipo de assunto, isso faz com que o negacionismo cresça cada vez mais na sociedade, percebe-se que isso é um grande erro, pois, a maioria dos que veem esse conteúdo tem um enorme banco de informações disponível em seu aparelho tecnológico, facilitando a pesquisa sobre ambos os lados."", ""Não só as entrevistas que causam essa influencia, como também as ''fake news'',por exemplo, os cidadãos anti-vacinas, que por meio de informações erradas em sites, passaram acreditar que essas foram produzidas para causar a morte, ao invés de servir como proteção para a população."", ""Ademais até mesmo os superiores do governo passam uma visão errada sobre os cientistas, assim como dita na frase do residente da República: ''Se você virar jacaré, o problema é seu''. Essa fala fez diversas pessoas começarem a sentir medo e pensar duas vezes antes de tomar a vacina, mesmo com fatos cientificos e testes comprovando que era impossível de isso ocorrer . A partir dai que o aumento de negacionistas na sociedade fica maior, isso demonstra o quão a população é inocente e facilmente manipulada com falsas informações."", ""Assim como citado antes, muito dessas influencias são transmitidas através da TV aberta, sites, videos em plataformas digitais e entre outros lugares possiveis. Portanto, apresentadores e influenciadores digitais poderiam se reunir, organizarem-se e criar um programa aonde  o objetivo é desmentir as noticias falsas que circulam no mundo digital, por meio de fatos cientificos, falas de especialistas e fontes confiáveis. Com isso a sociedade conseguira identificar o que é a mentira que eles presenciam no dia a dia, os próprios ''podcasts'' poderiam comentar sobre, para que a verdade seja espalhada mais rapido, acreditam-se que com essa proposta o combate a ''fake news'' e o negacionismo fariam eles diminuir cada vez mais, chegando a um ponto aonde a maioria passe a confiar mais na ciência e deixar de lado boatos sem comprovação nenhuma.""]",120,160,120,160,160,720
84,Da revolução,"['Com a revolução industrial e o aumento populacional dos centros urbanos, ocasionado pelo êxodo rural, ocorreu a guinada da violência, consequentemente, a necessidade de segurança individual. Todavia, segurança não está relacionada com o porte de armas, de modo direto, e sim com questões socioculturais.', 'Nos EUA, forte defensor da política armamentista, não é raro ataques em ambientes públicos como o recente massacre na boate Pulse, em Orlando. Deste modo, é claro o cenário de que, uma sociedade armada não significa baixos índices criminais, e sim que está propensa a atentados diversos, desde extremismo religioso à intolerância sobre orientação sexual, que têm no porte de armas a rota para se manifestarem, colocando em xeque a suposta segurança gerada.', 'No Brasil, país com um dos maiores indicadores de linchamentos, a arma ao civil levanta a seguinte reflexão:Uma comunidade vingativa, que tenha acesso a armas, zelaria pela segurança ou manifestaria sua vingança de forma mais cruel que o linchamento?', 'Necessário, pois, não associar armas à segurança, visto que são objetos de destruição. Um agrupamento social seguro será possível quando população e Governo trabalharem juntos a fim de erradicarem qualquer tipo de intolerância. Além disso, uma legislação, no caso de porte, que melhor defina as condições de uso, e que obrigue cursos de reciclagens efetivos e periódicos aos portadores de armas de fogo.', 'Nesse sentido, poderia a arma surtir algum efeito no tocante à segurança, quando bem empregada e em situações de última alternativa. Dar acesso às armas nos moldes em que o Brasil se encontra, acentuaria o grave problema da polícia que mais mata no mundo, da barbárie nas brigas de trânsito e dos altos índices de violência causada pelos desesperados que recorrem ao crime como última medida de sobrevivência.']",160,160,160,200,200,880
84,Porte de  armas no Brasil,"['No ano de 2003, foi aprovado no Brasil o Estatuto do desarmamento, restringindo o uso de armas de fogo na sociedade. Após 12 anos, um Projeto de Lei no Congresso pretente revogar o Estatuto, facilitando e ampliando o acesso no país.', 'Segundo pesquisa, desde que foi aprovado, o Estatudo do desarmamento, mais de cem mil pessoas deixaram de ser mortas no Brasil e o número de homicídios teve queda.', 'Mas, atualmente, com o aumento da violência e deficiência da polícia e outros profissionais e do Estado em combatê-la, a população brasileira sente necessidadede de ter o direito a se defender contra os bandidos(maioria armados), para maior segurança, pois estão com medo de sair ou ficar em suas residências devido a grande criminalidade que enfrentam no dia-a-dia.', 'Caso o projeto seja aprovado, a pessoa, que deverá ter 21 anos ou mais, vai cumprir requesitos mínimos, como passar por exames psicológicos para conferir se não tem problemas mentais e está apta para o porte de arma. Ela também deverá ter curso de tiro.', 'Se o Estado e profissionais não garantem boa segurança a população, logo ela tem direito de defesa e ao porte, usando a arma apenas para a necessidade de proteção contra criminosos; e não utlizá-la em brigas à toa, como atribuem os contrários ao Projeto de lei se ele for aprovado*.']",120,160,120,120,160,680
58,A importância de preservar a floresta amazônica,"['Atualmente, muito se tem discutido acerca da importância de preservar a floresta amazônica. A floresta amazônica é considerada o ""pulmão"" do mundo e, também, a maior floresta tropical do planeta. Por esse motivo é importante preserva-la, pois, ao longo dos últimos anos, ela vem sendo desmatada, sofrendo incêndios e animais sendo caçados.', 'De acordo com o site G1 um a cada três focos de queimadas na Amazônia está relacionada com o desmatamento. São várias as consequências e impactos gerados pelo desmatamento, com a intervenção do homem sobre o meio natural acarreta desequilíbrios como,  a perda da biodiversidade, a erosão dos solos, extinção de rios, entre outros.', 'Portanto, medidas precisam ser impostas para minimizar esse problema. É preciso que o governo proponha palestras nas escolas para incentivar a sustentabilidade, o plantio de árvores e a exploração das áreas e dos recursos naturais de uma forma que não prejudique o meio ambiente.']",120,160,80,120,80,560
56,Atual condição dos presos no Brasil,"['A atual situação carcerária do Brasil é algo muito precária . Vemos em jornais, revistas , internet , como o número de presos tem aumentado nos últimos anos , principalmente no Brasil . O número de detentos é maior que o número de vagas que possui nas prisões , segundo o site de notícias G1.com, as regiões norte e nordeste são as que mais crescem em relação ao aumento de presos nas penitenciárias . Brasil é o terceiro com maior número de presos , principalmente nas regiões norte e nordeste este problema tem aumentado drasticamente , nos estados do Amazonas, Acre, e Tocantis . Mais da metade são jovens e negros , cerca dos 75% deles , não chegaram ou não concluíram o ensino médio , quase 46 mil são mulheres e 62% dessas estão ligadas ao tráfico de drogas ', 'De acordo com a INFOPEN ( levantamento nacional de informações penitenciárias ) os detentos são de maiores aos 29 anos de idade, no norte e nordeste a criminalidade cresceu por conta da pobreza ,com este aumento as coisas só pioram . Por exemplo o massacre que ocorreu , e cerca de 40 detentos foram mortos por uma disputa interna dos líderes de facção , os mesmos , por falta de celas ficam nas viaturas .', 'Com o resultado divulgado pelo instituto de pesquisa econômica aplicada (IPEA) 37% dos presos provisórios não são condenados á pena de prisão ao final do processo ,ademais vale destacar que 93 mil estão na cadeia injustamente .Há muitas vagas em construção , porém não é o suficiente . O número de criminalidade aumentou por razão do desemprego no país e com isso o número de presos também cresce ,mais da maioria foram presos por roubos e furtos', 'Desta forma uma das alternativas é que o Governo Federal passam a ter um monitoramento eletrônico que diminuiria grande parte do número de presos e que nas celas ficariam somente os detentos mais perigosos para a sociedade . Os resultados seriam bons por conta de que um preso gasta muito,já o monitorado o Estado gastaria menos . Uma outra alternativa é colocar estes presos para trabalharem , pois em muitos estados isso ainda não acontece com estes trabalhando, a sua penalidade diminuiria ,e sairiam mais cedo das prisões , diminuindo assim o número de detentos .']",120,160,80,120,120,600
55,"Efetivação dos direitos indígenas, já!","['No livro “Macunaíma”, de Mário de Andrade, é retratada a imagem do índio com o “herói sem caráter”, que assume diversas faces. Essa visão abordada na obra analogamente com a realidade brasileira é reflexo do processo de colonização, onde os povos já existentes no país foram desvalorizados. Deste modo, faz-se necessário a efetivação das medidas de valorização e garantia dos direitos indígenas, que foram instituídos pela Constituição Federal Brasileira de 1988.', 'Em primeiro plano, em consonância com a literatura, é expressa na novela televisa “Uga Uga” a teoria de valorização das pessoas primitivas, que consiste na apresentação do índio como herói e protetor, representado pelo personagem Tatuapú. Diferentemente da perspectiva trazida pelos livros, series e TV – a realidade vivenciada por esses indivíduos é de extrema calamidade – marcada por traços de inferiorização que foram trazidos desde o processo de colonização, quando foram escravizados e denominados como “negros da terra”, em meados do século XV. Esta é uma situação que necessita ser desmitificada pelo governo com o cumprimento das leis já existentes, objetivando a promoção da dignidade e engrandecimento desta minoria social.', 'Outrossim, no artigo 231,  da constituição é conferido aos povos nativos os direitos à diferença e a terra. Entretanto, algo que deveria ser incontestável e garantido de forma eficaz conforme o que apresenta na lei é alvo de grandes embates em cenário nacional – que geram constantemente conflitos – oriundos da falta de demarcação de terras e respeito às diferenças.  Pois,  muitos não reconhecem as tradições e formas de organização social dos indígenas. Sob essa ótica, o médico e escritor Augusto Cury afirma: o sonho da igualdade só cresce no terreno de respeito pelas diferenças. Ademais, o grande desafio que é posto ao Brasil é assegurar plena indubitabilidade do texto constitucional e reconhecimento das divergências entre a população.', 'Portanto, é necessário que o Ministério da Educação e Cultura (MEC) - órgão governamental responsável por tratar e melhorar a política nacional de educação em geral - promova campanhas de conscientização abordando acerca da importância de garantia dos direitos indígenas. Com a finalidade de reparar os danos trazidos aos índios decorrentes da colonização. Esta campanha deverá ser amplamente divulgada na mídia, seja na TV, rádio ou internet. Com intuito de alcançar o maior número possível de seres humanos e tornar-se realidade o cumprimento de tudo que é citado na lei constitucional.']",160,160,120,120,120,680
150,Onde tudo começa,"['Conta-se         que uma         história, na maioria das vezes,         existe         até três versões. Uma versão da pessoa A, uma versão da pessoa B e a verdade!                 Todavia, existe uma          “história”, com          apenas uma          versão, e          nela, a verdade,          talvez          para os envolvidos, é a menos importante. Violência escolar:          Uma          história, com muitas versões, poucas verdades e quase nenhuma solução.', 'Podemos destacar vários                 fatores                que podem contribuir para a violência escolar. Entre         elas: Criação         que vem de casa,                falta de         dialogo         ,                ignorância e                 a falta de necessidade                .', 'Talvez, seja um dos                   fatores                  mais importantes é         a criação.                 A maneira como a criança cresce e se desenvolve          dentre          de um          lar, é          um          fator          importante de como ela irá de comportar na sua vida. Uma criança que cresce em meio a brigas, não é que necessariamente irá ser briguenta, pois existem outros          fatores          para isso, todavia, existe uma grande parcela de chance dela querer arrumar brigas.', 'Um outro                 fator         importante, é         o que passa na cabeça de uma pessoa que briga.                 A pergunta correta talvez seria: Pra que isso? É necessário isso mesmo? Qual a verdadeira razão de se chegar “aos finalmentes” sem passar por um diálogo ou buscar um entendimento?                A                 falta de necessidade                desse ato é tão grande, que chega a espantar em alguns casos.', 'Portanto, se queremos melhorar a violência escolar,         deve-se         começar pelas nossas casas e por nós mesmos.                 Onde a maioria das crianças espelha-se. Um diálogo, a forma de falar, comportar, e como tratamos as outras pessoas, é muito bem observado pelas crianças e isso pode influenciar a maneira como essas crianças crescem e se desenvolvem.                Comportamentos         bom, poderá          gerar crianças, pessoas melhores, evitando partir para “os finalmentes” e tendo atitudes melhores.']",0,80,80,80,80,320
132,Muito além da violência,"['O MMA não foi a primeira atividade violenta que surgiu,                mas o seu grande destaque no cenário nacional está gerando muita preocupação. As diversas técnicas de artes marciais o         torna         , de fato, violento, porém não o         descaracteriza         como esporte uma vez que ele proporciona condicionamento físico, abstração, além das vantagens sociais e econômicas, como emprego e renda.', 'O interesse da população por lutas vem de longo tempo. Na Roma Antiga, os coliseus enchiam quando os gladiadores combatiam. Hoje, mesmo com a grande variedade de golpes que um atleta pode usar, o MMA trata-se de um esporte violento onde o principal objetivo não é a morte do adversário como acontecia entre os gladiadores ou incitar a violência para além dos octógonos, lugar das lutas,                 e sim disciplinar o indivíduo.', 'Além da disciplina, o sucesso do MMA está contribuindo para a inauguração de várias academias e para a valorização do profissional que o ensina. O esporte contribui para a integração         social estando as vezes         disponível até gratuitamente em         lugares         mais carentes, e ainda proporciona         as         crianças um tipo de conhecimento que poderá ser a fonte de renda delas, seja como professor ou atleta no futuro.', 'Em suma, o principal objetivo do esporte é contribuir para uma boa formação do indivíduo e não para o crescimento da violência. Por isso, é importante que professores sejam qualificados e         os atletas profissionais de alto nível e influência         estejam sempre reforçando a ideia principal da atividade.                 A nós outros,                cabe a capacidade de distinguir o que é esporte do que é violência sem propósito.']",160,160,200,160,160,840
95,MARCO TEMPORAL INCONSTITUCIONAL,"['Marco temporal é uma ação no Supremo Tribunal Federal (STF) sobre demarcação de terras indígenas, que se for aprovada, pode impactar cerca de 303 territórios indígenas.', 'Para um primeira análise, deve-se saber que em 2009, um conflito envolvendo terras indígenas, acabou desencadeando na tese do marco temporal. Era uma ação para decidir a quem pertenceria de direito erra indígena Raposa Serra do Sol. Os ministros do STF argumentaram em favor do povo indígena, alegando que eles estavam ocupando aquelas terras em 05 de outubro de 1.988, quando foi promulgada a Constituição federal (CF).', 'Diante disso, a Frente Parlamentar da Agropecuária, mais conhecida como bancada ruralista, defende que somente os povos que já estavam ocupando as terras quando em 05 de outubro de 1988 pode reinvindicá-las. Baseiam-se no verbo ""ocupam"", no presente, do artigo 231 da (CF): ""São reconhecidos aos índios sua organização social, costume, língua, crença e tradições, e os direitos originários sobre as terras que tradicionalmente ocupam, competendo à União demarcá-las, proteger e fazer respeitar os seus bens"".']",160,80,120,120,0,480
48,A eficiência e problemáticas do Sistema Único de Saúde,"['A Constituição Federal (1988) assegura, no artigo 6, os direitos da sociedade, sendo um deles saúde. Portanto, é obrigação do Estado ofertar projetos de políticas públicas de qualidade, por conseguinte, foi necessário a criação de um sistema federal para unificar e organizar os hospitais públicos do Brasil, o Sistema Único de Saúde (SUS). Contudo, a falta de recursos públicos, desde a criação do projeto, causa o mau funcionamento dos núcleos hospitalares, resultado da falta de logística do Ministério da Saúde.', 'Primeiramente, a Constituição brasileira (conhecida como Constituição “Cidadã”) garante a toda população tratamento e prevenção de doenças, quaisquer que sejam . As unidades médicas não podem negligenciar tais assistências para os necessitados, assim, atendendo milhões de pessoas ao ano, o Sistema Único de Saúde (SUS) disponibiliza vacinas a cirurgias de alta complexidade “gratuitamente”, sendo assim o maior sistema de saúde pública universal.', 'Em segunda análise, o projeto de implementação da saúde pública no Brasil apresenta falhas que são denunciadas a partir da captação de recursos públicos, como os desvios dos recursos públicos,  causando o déficit de tais para os estados e municípios. Os interesses políticos, dentro do Ministério da Saúde, também assolam o projeto constitucional. Os descasos são apresentados constantemente por servidores do âmbito público e privado, como aponta o programa “Greg News”, apresentado por Gregório Duvivier, no canal do YouTube da HBO.', 'Em virtude dos fatos mencionados, conclui-se que o Ministério da Saúde é o principal responsável por administrar o Sistema Único de Saúde (SUS), portanto deve fiscalizar permanentemente as atividades, criando assim, uma ouvidoria em conjunto com a Polícia Federal, órgão que fiscaliza e apura denúncias. Para que,  haja a punição de interferências políticas e desvios de dinheiro, reavendo futuramente o dinheiro ao Ministério, com o intuito de investir em outras obras e hospitais, licitamente.']",160,160,120,200,120,760
59,Saco vazio não para em pé,"['Rachel de Queiroz, em sua obra ``O Quinze´´, retrata a história da forte seca no estado do Ceará no ano de 1915 marcada pela escassez de alimentos. Apesar de ser uma obra fictícia, assemelha-se na questão atual da fome no Brasil. Entretanto, mesmo com os avanços sociais e econômicos essa problemática ainda persiste, ficando clara assim a necessidade de alterações.', 'Em primeiro lugar, cabe destacar a má distribuição de renda. Mesmo que o Brasil tenha saído do mapa da fome em 2014, não foi o suficiente para diminuir a desigualdade que permear até hoje. Segundo o IBGE (Instituto Brasileiro de Geografia e Estatística), cerca de 7 milhões de pessoas passam fome no pas. Porém, não é pela falta de alimentos, e sim, pela falta de dinheiro, pois não tem como comprá-los. Devido a isso, há consequentemente,  casos de desnutrição, doenças epidêmicas e até mesmo emigrações oriundas do desemprego.', 'Em Contrapartida, há grande extensão territorial, cuja agricultura é muito desenvolvida  fazendo com que o Brasil seja um dos maiores exportadores do mundo. Historicamente, o país já exportava produtos para outras nações, como por exemplo, o Pau-brasil, cacau, algodão, entre outros. Prejudicando dessa forma, a distribuição de alimentos em todo seu território. Contudo, problemas naturais como as secas e inundações corroboram para que o setor agrícola entre declínio e, posteriormente, agrave mais o cenário da fome.', 'Fica evidente, portanto, que medidas devem ser tomadas para diminuir a fome no Brasil. Cabe ao governo  especialmente ao Ministério da Cidadania, investir por meio de verbas públicas na distribuição de cestas básicas para famílias carentes a curto prazo e a longo prazo geração de empregos para aumentar a renda familiar. Também alertar por meios de campanhas publicitárias junto com a mídia sobre o enorme desperdício de comidas e de como evitá-las. Ademais, por meio de leis, estabeleçam medidas que haja equilíbrio na exportação dos produtos sem prejudicar a economia do país, visando chegada de mais alimentos na mesa dos brasileiros. Só assim,  essa problemática será vivenciada apenas na ficção.']",120,120,120,120,120,600
50,Ciência,"['Desde os primórdios da humanidade , o ser humano busca maneiras de lidar com seu meio, seja combatendo  doenças, ou sobrevivendo  em ambientes hostis . Atualmente tais práticas se tornam ainda mais necessárias, especialmente em função do terror que vem sendo causado pelo coronavírus no Brasil. Posto isso, é inquestionável a colaboração do governo quanto ao direcionamento de verba aos laboratórios, e a atuação de grandes empresas de eletrônicos na fabricação de equipamentos para combater a doença.', 'Primeiramente, o governo mais que ciente do que está prestes a enfrentar,  deve disponibilizar capital às áreas da ciência responsáveis pelo estudo de vírus e meios de combatê-los , que são de extrema importância para o povo. Fato é que: uma doença viral apenas é vencida quando a população está imunizada contra a mesma , o que conhecido como a imunidade de rebanho. Ou seja, antes de tudo é necessário a descoberta de uma vacina. Logo, é substancial a intervenção por parte do estado com incentivo da área científica.', 'Ademais, a ciência não anda sozinha, é preciso também o uso da tecnologia para efetivar as descobertas. Posto isso, as grandes empresas de eletrônicos devem suprir não somente os laboratórios, mas também as necessidades hospitalares, que são principalmente os respiradores, cumprindo assim sua importância para com o povo. Isso se constata quando uma vacina não pode ser tão facilmente disseminada em função de necessitar altíssima tecnologia para ser criada e manipulada, o que a torna inviável a muitos laboratórios.', 'Portanto, é como diria Esopo, “Do mesmo modo que a união traz a força, a discórdia leva a uma rápida derrota”. É preciso união em prol de um objetivo, sendo ele, combater o Coronavírus. Isso somente será possível através de parcerias entre governo, laboratórios e empresas como Embraer, capazes de produzir equipamentos para atender hospitais e laboratórios. O sistema de saúde brasileiro deve ser visto como um meio de tratamento, e não agonia. Com parcerias, será possível suprir demandas hospitalares, e consequentemente, amparar a população.']",160,120,120,160,120,680
67,"Questões Indígenas, uma discussão social","['Segundo a Organização das Nações Unidas para a Educação, a Ciência e a Cultura – UNESCO: “a representatividade indígena constitui alicerce cultural e histórico dentro do país. Então, buscar garantir seus direitos configura ação ética frente uma sociedade moderna que os torna minoria. Portanto, quando se debate demarcação de terras, normativas constitucionais de proteção aos povos tradicionais e etnocídio,  tematizam exemplos problemáticos no Brasil.', 'Nesse contexto, relatórios acadêmicos da Universidade Federal do Pará – UFPA mostram o impacto das grandes construções hidrelétricas, tal como a Usina de Belo Monte no estado do Pará, pelo qual denunciam a expulsam da população indígena naquela localidade. Dessa forma, embora existam Órgãos protetores, como a Fundação Nacional do Índio – FUNAI e direitos previstos desde a Constituição de 1988, situações inconcebíveis acontecem . Por isso, às vezes  não falta conscientização, mas sensibilidade e caráter na construção de um país ético e democrático.', 'Por conseguinte, precisa haver um diagnóstico de situações concretas, buscando identificar e denunciar os descasos sofridos por eles, no entanto, a efetividade das ações dos Órgãos competentes apresenta deficiências nessas resoluções. E como já dizia o antropólogo Darcy Ribeiro: “fomos nós que criamos o problema indígena”. Logo, é dever de Estado estabelecer diretrizes constitucionais sérias e eficazes aos povos tradicionais. Também, mais que uma questão de direitos é reconhecer que uma nação se consolida mediante seus valores históricos e a disseminação sociocultural dos povos constituintes.', 'Com base nessas considerações, as discussões envolvendo os índios geram problemáticas sérias, sejam pela falta de uma gestão política comprometida ou interesses capitalistas de grandes empresas. Todavia, outras soluções seriam imprescindíveis para resolver o impasse. O Ministério da Cultura e seu então ministro Sérgio Sá Leitão devem elaborar centros especializados de monitoramento 24 horas em comunidades indígenas espalhadas pelo Brasil. Sendo assim, estudantes acadêmicos de sociologia, história, filosofia e áreas afins, fariam parte desses centros e ajudariam a desenvolver metodologias protecionistas. Isto posto, uma nova geração de cidadãos equacionarão um país mais justo e politicamente correto.']",160,160,160,160,160,800
54,,"['O começo da imunização por vacinas data do século XVIII, quando foi inventada a vacina contra a varíola, que mais tarde,  se tornaria a primeira doença infecciosa erradicada por esse meio de tratamento. Foi a partir desse momento que a visão sobre a prevenção contra doenças foi revolucionada, passando a ser o principal meio de erradicação destas pelo mundo todo.', 'No seriado televisivo “Law and Order: Special Victims Unit” foram apresentados dois episódios onde a desinformação em se tratando da vacinação  foi a principal responsável pela infecção de diversas crianças, adolescentes e até mesmo adultos com o vírus do sarampo. Os episódios tiveram sua aparição em 2009 e 2015, e retrataram o quadro em que o Brasil se encontra atualmente onde a insuficiência de informação sobre a imunização causa desconfiança e descrédito por parte da população, que em resposta não adere ao calendário de vacinação, prejudicando a saúde coletiva do país.', 'Outrossim, a precariedade dos órgãos públicos de saúde, juntamente com a falta de certas vacinas em tais lugares agrega a dito descrédito, fazendo-se pensar que o governo busca apenas manipular a população com argumentos que buscam somente o ganho capital, já que sem as vacinas disponíveis de forma gratuita, a imunização é feita unicamente de forma particular.', 'Diante dos argumentos supracitados, em um primeiro momento, cabe ao Ministério da Saúde em parceria com plataformas de comunicação, como rádios e jornais, promover campanhas dinâmicas com profissionais qualificados além de palestras presenciais em cidades, apresentando os riscos e benefícios da vacinação, esclarecendo as dúvidas e desmistificando falsas informações, fazendo com que a população esteja totalmente ciente de todas as questões cabíveis, como lhes é de direito.']",120,120,80,120,80,520
72,A Manada,"['É possível afirmar que o crescente número de fake news preocupa o Brasil; isso se evidencia não só ao exército de perfis falsos usados para influenciar eleições no país, como também a fácil manipulação das pessoas à opinião pública.', 'Podemos perceber que os fake mercenários, são usados por pelo menos uma empresa, serviço oferecido normalmente para candidatos e grupos políticos; o objetivo é de forjar a posição da população nas eleições . Contratam pessoas para controlar perfis falsos, com fotos roubadas, nomes e cotidianos inventados. Segundo o site BBC Brasil, quatro ex-funcionários da empresa , reuniu vasto material com histórico de atividades online de mais de 100 supostos fakes e identificou 13 políticos que teriam se beneficiado da atividade. Infelizmente, o brasileiro que aceita esse tal serviço é mais desonesto quanto os representantes do país , pois percebe-se que o cidadão não se importa com a democracia.', 'Somado a isso, podemos dizer que a sociedade é facilmente controlada. O chamado “comportamento de manada”, é uma massa de opinião que estimula o próximo a mudar seu posicionamento em determinado assunto; sem refletir ou se informar a respeito, o indivíduo apoia e compartilha a ideia desses fakes. Como dizia o sociólogo Michel Foucault, nada é político, tudo é politicável, tudo se torna político , é o que se nota em redes sociais, debates e discussões em defesa de candidatos; cria-se um “político de estimação”.', 'Torna-se evidente, portanto, que o governo em consonância com a polícia,  desenvolvam estratégias para rastrear os perfis falsos, monitorando as atividades maliciosas na internet e, localizem para que sejam punidos. Logo fazse necessário que escolas  por meio de palestras orientem pais e alunos sobre s fake news, para saber identifica-las e denuncia-las à redes sociais como facebook, twitter etc; para que sejam deletados e não mais popularizados. Desse modo, com a ajuda da população consciente e do governo, esse mal poderá ser combatido.']",120,120,160,160,120,680
63,,"['Em virtude do cenário atual o aumento de grandes indústrias e empresas traz forte consequências ao espaço natural, pois, com o relativo crescimento das mesmas , o meio ambiente é prejudicado. Averiguara-se que os impactos ambientais ocorrem desde o século XVIII no início da revolução industrial com o aumento das indústrias e consequentemente da poluição.', 'Contudo, o aumento dos impactos ambientais causados pelas empresas e indústrias tem sido algo preocupante, visto que as mesmas estão negligenciando o cuidado e a segurança com o meio ambiente  ocasionando desastres e fortes impactos ao espaço. Efeito disso é a destruição de habitats naturais; desaparecimento de espécies; diminuição de mananciais; aumento de doenças e o agravamento do efeito estufa.', 'Portanto, com tais problemas levantados são de extrema importância a participação do homem, reduzindo a poluição do meio natural; do governo juntamente com o MM —Ministério do Meio Ambiente — proporcionando a rigorosidade na proteção da fauna e flora e na punição contra crimes ambientais de todos os tipos, exigindo a reparação dos problemas causados ao espaço natural;  e de empresas que devem rever seus modelos para não afetar tanto o meio ambiente  priorizando a segurança do mesmo , deste modo tentando reduzir a poluição e os impactos causados.']",120,120,120,120,120,600
135,Aborto,"['Ao permitir a livre escolha do aborto de anencéfalos, o Supremo Tribunal         Federal,         gerou, mais uma vez, uma polêmica. Como toda         questão controvérsia         , a sociedade se divide dentre as opiniões que variam entre a legalização (que ocorreu) e a proibição, que é defendida vigorosamente por integrantes da                 CNBB                , por exemplo.', 'Colocar vidas em jogo não é tarefa fácil.                O STF agiu para que fosse possível uma melhor qualidade de vida, e menor sofrimento para o feto anencéfalo e para a gestante. Num país cuja incidência de anencefalia é a quarta do mundo, decidiu-se algo necessário e contra conceitos e doutrinas empregados há centenas de anos. Algo delicado de se discutir, porém imprescindível. A livre escolha de dar continuidade à gestação cabe agora às famílias, que dentre suas crenças,         decidirá         o que acreditam ser o melhor para eles.', 'Só que a incerteza é um grande problema. A dúvida se a criança sobreviverá, ou quão limitada ficará; isso torna essa questão ainda mais complicada. Em um pensamento pessimista, ""quem não irá morrer""?. Isso só mostra a frieza          que          algumas pessoas encaram a vida. Não é possível comparar doenças comuns à ausência de cérebro!', 'É sabido que essa discussão não acabará tão cedo. O que o STF decidiu, inteligentemente, foi a opção do aborto de anencéfalos, para aqueles que o quiserem; e não o aborto de qualquer feto, porque este é um assunto muito mais polêmico. Nada melhor que, como cidadãos,         tenhamos         o livre-arbítrio.']",200,120,120,160,200,800
91,O Efeito Dominó da Desinformação,"['Negacionismo é o ato de nagar ou não reconhecer conceitos básicos, incontestáveis e apoiados por consenso científico, em favor de idéias tanto radicais, quanto controversas. Em vista disso, é perceptível a permanência, e o constatante crescimento da disseminação da insipiência na sociedade brasileira. Assim, cabe a análise acerca de causas, consequências e possível soluções da problemática.', 'Na história, é de conhecimento geral o caso do "" Negacionismo do Holocausto"" , onde foram negadas todas as mortes e atrocidades decorrentes dos atos nazistas, semelhantemente, é visto na contemporaneidade o constante ato de negacear fatos e conclusões científicas, através da injúria, e desvalorização. Diante disto, é possível verificar como causa deste fenômeno a desinformação e o compartilhamento incessante de informações falsas ou semiverdadeiras na internet, as quais se apoiam em fatos corrompidos, ocasionando consequências muitas vezes irreversíveis, como no caso de crianças com paralisia infantil, pela privação espontânea da vacinação.', 'Em vista dos argumentos apresentados, torna-se necessária a busca por soluções para o efeito dominó, desencadeado pela insciência. É imprescindível que o uso das fake news seja diminuído, desta forma, torna-se oportuno a criação e atualização constante de sites oficiais que sejam chamativos e confiáveis, o uso de meios acessíveis para a parcela da população sem acesso internet, como anúncios oficiais diários em rádio, e o esforço para um ensino de qualidade, ampliando o pensamento crítico e refutando a ignorância.']",160,120,120,160,120,680
60,,"['“No meio do caminho tinha uma pedra, tinha uma pedra no meio do caminho”. O trecho do poema de Carlos Drummond de Andrade retrata muito bem a Reforma da Previdência Social, tal que ela insere uma pedra no caminho do brasileiro, pois as medidas da Reforma definem que o tempo de contribuição das pessoas passar a aumentar e a remuneração irá diminuir. Contudo o governo deve mudar sua ideia sobre tal, pois o povo deve ser beneficiado e não prejudicado.', 'Em princípio o governo usa como argumento para implementação dessa reforma um déficit, que de acordo com eles continuará a crescer se as regras atuais de concessão do benefício permanecerem. Todavia para o Presidente da Associação Nacional dos Auditores Fiscais da Receita Federal, Vilson Antonio Romero Romério, não há déficit, pelo contrário o total de recursos que a união arrecada é superior aos gastos. Em 2015 sobraram mais de 65 bilhões de reais que tem sido usado para o pagamento da dívida pública.', 'Além disso, de acordo com o site BBC o gasto da Previdência é de 730 bilhões distribuídos pelos 40 milhões de cidadãos. No entanto desses 40 milhões de pessoas  39 milhões recebem 520 bilhões e teremos um milhão de habitantes recebendo 210 bilhões, sendo esses últimos juízes e senadores públicos. Com isso podemos  perceber que a elite está recebendo muito e a reforma deve ser feita nessa desigualdade.', 'Portanto  os governantes através da Receita Federal de reformular com calma reforma da Previdência, pois ela ainda não está em déficit deixando mais severa para os 1 milhão de habitantes privilegiados, com isso a desigualdade diminuiria e acabaria tirado essa pedra no caminho do povo brasileiro.']",120,120,120,120,80,560
57,,"['Localizado na famosa Rua das Pedras, em Armação dos Búzios, interior do estado do Rio de Janeiro, o Cine Bardot causou surpresa nos habitantes da região ao anunciar, em 2018, seu fechamento, tanto por falta de verbas como por ausência de espectadores. O antigo cinema foi palco de diversos festivais e exibições da 7ª arte, levando ainda mais cultura aos turistas e moradores do local. Apesar de reaberto após alguns meses, a situação descrita leva a uma análise da atual falta de credibilidade do cinema no Brasil. Indubitavelmente, razões como a segregação desse tipo de cultura, atrelado ao seu desvalorizamento, impedem que, no país, a democratização do cinema ocorra, situação que precisa ser gerenciada.', 'A priori, é de fundamental importância salientar os motivos que levam a uma segregação desse tipo de arte. Decerto, a maior parte dos cinemas no país se localizam em cidades grandes que apresentam um desenvolvimento significativo, como São Paulo e Brasília. Enquanto essas localidades possuem, no mínimo, 5 salas de exibição de filmes -distribuídas em vários bairros- municípios menores e não tão urbanizados suportam no máximo 1 ou 2 e, normalmente, em seus respectivos centros, o que pode vir a ser um empecilho para aqueles que morem longe e não têm condições de se deslocarem a qualquer momento para as áreas privilegiadas. Além disso, os preços de uma exibição também devem ser levados em conta -normalmente, os finais de semana custam mais caro, e, como grande parte do povo só apresenta disponibilidade nesses dias, a ideia é rapidamente descartada.-', 'Ademais, outro ponto que deve ser discutido diz respeito a desvalorização das obras cinematográficas brasileiras. Sem dúvidas, os brasileiros nutrem um preconceito com grande parte dos longas produzidos no solo do \'país tropical\' , dando visibilidade somente aos que repercutem em âmbito internacional -como é o caso de ""Cidade de Deus"", obra que abordou a história do combate ao tráfico nas favelas brasileiras e tornou-se extremamente elogiada pelos críticos-. Com toda a certeza, o apoio dos próprios integrantes do país frente as produções é extremamente importante, visto que, de forma geral, os filmes só permanecem em cartaz quando há uma grande procura sobre eles.', 'Portanto, para que a democratização do acesso ao cinema no Brasil ocorra, o Governo Federal, cujo mandatário é o residente Jair Bolsonaro, deve, por intermédio de decretos, incentivar a construção de cinemas em locais não tão privilegiados, disponibilizando verbas para as prefeituras dessas respectivas cidades, a fim de levar a 7ª arte a todos. Outrossim, as escolas públicas e municipais devem realizar, mensalmente, exibições de filmes do país aos seus alunos. Dessa forma, a democratização acontecerá, e os cinemas não serão mais negligenciados, como foi o caso do Cine Bardot.']",120,80,80,120,40,440
60,Estamos envelhecendo,"['É notório que o debate em torno da reforma previdenciária gera muita discussão,pois, essa decisão é importante para o Brasil. Ao discuti-la deve-se levar em consideração a pirâmide etária brasileira. E também os privilégios que ela pretende extinguir.', 'Conforme dados do nstituto brasileiro de geografia e estatística (IBGE).  A população brasileira está envelhecendo .Devido ao aumento da qualidade de vida. Se comparada com décadas passadas a taxa de natalidade diminuiu muito, e isso,  também contribui para o envelhecimento da sociedade. Daí surge a importância de levar em consideração a reforma da previdência e sua perspectiva sobre esse fato e sua inclusão no debate.', 'Outro aspecto relevante a ser considerado, consiste no congelamento do teto de aposentadoria da classe política e dos servidores do alto escalão do governo. Pois isso influenciará diretamente nos fundos de aposentadoria e diminuirá a alíquota para aqueles que recebem menos. O que diminuirá a enorme disparidade nas aposentadorias.', 'Nesse sentido, devemos analisar a reforma sob uma perspectiva da realidade e dos fatos. E não sob olhares ideológicos e sensacionalistas . Haja vista que a população está envelhecendo e existe poucos com muito e muitos com pouco.']",120,120,120,120,120,600
48,Saúde sob pressão,"['A minisserie sob pressão relatar sistema de saúde no Brasil, médico Evendro seu equipes verdadeiro sob pressão aonde equipe médica tem lutar para saúde vida com minino do equipamento também lista com a corrupção na saúde.', 'Em primeiro análise S (sistema de unidades de saúde ) vivencia grande problema que é corrupção dos governos. Livro do príncipe (Maquiavel ) relata que governo quando vai ser eleito para governar principal papel vai ser saúde pública e assim tudo e só para incana sociedade.', 'Em seguida análise desafio de saúde pública e lista com hospital não tem equipamento as vezes nem local para colocar os pacientes.', 'Verefeica-Se então a necessidade  governo  faz um lei para mundo saúde pública fazer lei mas pura e o corrupção dentro governo e hospital assim sociedade vai de direito de saúde pública que possa atentem todos sociedade como esta na constituição brasileira']",80,120,120,160,80,560
50,Combate ao coronavírus por meio da ciência,"['No filme” Eu sou a lenda” retrata a história de um cientista ,  que diante do caos em que se encontra o planeta, procura a cura de um vírus . Desta forma é notável a importância que a ciência tem ,tanto a humanas quanto as exatas ,para o combate de uma doença. É preciso ressaltar que mesmo que haja um desenvolvimento nesta parte ,há muitos países que carecem destes privilégios e sobretudo , deve-se destacar as ciências humanas como um solução..', 'Convém ressaltar de início , a trágica doença que afetou a Europa no século XIV , a peste negra , matando  um terço da população na época . Com isso pode-se fazer um paralelo com a pandemia do coronavírus, por ser transmissível. Todavia a ciência está restrita somente á países desenvolvidos ,como Estados Unidos , Reino Unido e outros  . Desta forma o progresso de uma vacina nestes países é bem mais agilidoso ,ajudando  as outras regioões menos desenvolvidos a combaterem a pandemia, porém colocando estes dependentes ,pois não há investimentos e assim deixando-os  em situações precárias , alastrando a doença.', 'Ademais , as ciências humanas , como a filosofia , história, principalmente a psicologia , também tem uma grande importância nesta luta contra o vírus . Estas constituem as ferramentas necessárias para manter o equilíbrio na sociedade ,como a exemplo de ter o conhecimento sobre o passado a fim de não comete-los no presente .Desta forma com as muitas notícias acerca disto ,o caos mental das pessoas se alastra rapidamente , segundo o site de noticias New Ab é natural que haja transtornos de estresse , de ansiedade e outros sintomas decorrentes . Todavia, mesmo que seja algo normal de se acontecer , é necessário buscar ajuda para a situação não se tornar mais agravante , como citado anteriormente , na filosofia , sociologia , psicologia e outras .', 'Destarte , com os problemas abordados é de suma importância que haja uma atuação por parte do Governo Federal . A exemplo de fazerem maiores investimentos nas ciências não somente nas exatas , como também nas humanas , a fim de evitar uma Sociedade transtornada e caótica. Além disso , atuar em parceria com a mídia , como jornais televisivos , rádios ,e redes sociais para divulgarem informações positivas e fazerem programas para distraírem o público diante do caos  . Ademais é de suma relevância a união de países, com desenvolvimento científico maior,ajudarem os menores ao combate deste vírus , com intuito de encontrarem uma cura rapidamente e evitar de acontecer como na época da peste negra']",160,160,120,160,120,720
86,Redes socias,"['As redes socias que servem não só apenas para compartilhar pensamentos e estilos, mas funciona como uma epécie de diario virtual onde as pessoas passam metades de seus dias colocando como suas vidas são interessantes, mas sabe-se que não é assim na realidade, problemas mentais que giram entorno desse mundo digitalizado tem sido considerado como uma das maiores doenças do século. Assim, configura-se um problema de contornos específicos que emerge devido a falta de debate e a educação lacunar,', 'Primeiramente, é preciso salientar que a falta de debate e uma causa latente do problema, Segundo o filósofo Foucault, na sociedade pós-moderna temas são silenciados para que estruturas de poder sejam mantidas. Sob essa ótica, ve-se uma grande influencia na falta de debate sobre saúde mental, as midias que se aproveitam desse ideia construida pouco importa-se como isso tem um impacto gingantesco no que envolve a relação do úsuario com o meio digital. O tik tok rede social que tem se popularizado cada vez mais, tem um ideia que se baseia em danças sincronizadas e exibizam de jovens pré-adolescente semi-nuas.', 'Em segundo plano, outra causa para configuração do problema a má influencia midiatica, De acordo como o filosofo Kant, se há um problema social, há como base uma lacuna educacional. Nessa linha de pensamento, se a sociedade sofre, houve como principal estopim para esse sofrimento,  uma educação falha, já as escolas pouco tem trazido a como o comportamento do usuario na internet pode influencia gradativamente na sua saude mental. A expressão perdir ""\x08iscoito"" um bom exemplo disso, uma expressão ultizada jovens que pedem a atenção nas redes, por seguidores, para que não sejam esquecidos nesse mar vasto de personalides destorcidas;', 'Portanto, uma intervenção faz-se necessária, para isso é preciso que os gorvenos estaduais , com parceria com as escolas, promovam debates, que podem acontecer no periodo contra-turno, com a participação de psicologos e professoras, expondo porque a sade mental é uma grande fator a se preservar, quando o assunto é o perfil midiatico. Além disso, esses eventos devem ser abertos ao publico, para que acha ainda mais impacto no que tangue a sade mental. Assim podera se configurar um Brasil melhor.']",120,120,120,160,160,680
87,A cultura da erotização infantil,"['A sexualização precoce tem impactado cada vez mais o processo de formação da criança. Por consequência, uma fase que deveria acontecer de forma gradual e espontânea, é adiantada, levando as crianças a pularem etapas cruciais da infância e afetando negativamente a formação psicológica infantil.', 'Primeiramente é importante destacar que muitos dos conteúdos que são mostrados na internet tem ganhado bastante alcance, se esquecendo que parte do público são crianças. Automaticamente, estas crescem achando normal essa erotização, pulando etapas importantes e cruciais que deveriam acrescentar qualidades à formação do caráter infantil. Como resultado, passa a ser criado uma espécie de influência no desenvolvimento sexual que acontece precocemente.', 'Além disso, vale ressaltar que a mente da criança, ao ver com frequência esse tipo de conteúdo, cresce acreditando que a sexualização é algo normal e obrigatório de acontecer independentemente da idade, pois se elas podem ver, elas podem ser . Com isso, crianças crescem com o psicológico moldado dessa forma, podendo  futuramente, influenciar outras.', 'Portanto, a fim de diminuir os impactos da erotização infantil, as mídias sociais, juntamente com a família, deveriam restringir seus conteúdos, mostrando às crianças somente o que é apropriado, ocultando os conteúdo inapropriados e de potencial influência. Dessa forma, ocorreria a diminuição da influência da sexualização sobre as crianças.']",200,120,120,200,160,800
52,Gravidez na adolescência no Brasil,"['No filme ""Mary Shelley"", exibido pela provedora global de televisão Netflix, é retratado a vida de uma adolescente. Nele, a protagonista se apaixona e acaba engravidando aos seus 16 anos de idade . Na vida real, o mesmo acontece constantemente no Brasil, visto que não há medidas eficazes de prevenção. Isso ocasiona numa série de nascimentos não planejados que trazem consequências, como o risco de vida de meninas e a evasão escolar das mesmas.', 'Dados revelam que , em 2011, o país teve 2.913.160 nascimentos, sendo 533.103 nascidos de meninas com idade entre 15 e 19 anos e 27.785 nascidos de meninas de 10 e 14 anos. Além disso, 30% das garotas que engravidaram na adolescência acabam tendo outro filho no primeiro pós-parto. Essas pesquisas mostram que quanto menor for a idade da menina maior serão os riscos que um filho(a) poderá trazer na sua vida sexual, psicológica, estudantil e familiar.', 'Esse problema pode ser solucionado se instituições, como escolas, fizerem palestras de educação e conscientização sexual . O governo tem por sua obrigação a distribuição de anticoncepcionais, como a camisinha, para que a população usufrua desses métodos contraceptivos. Além disso, é de extrema importância o acompanhamento familiar e profissional, no caso psicólogos, para evitar uma possível gravidez indesejada.']",120,120,80,120,80,520
85,,"['O projeto de lei de iniciativa popular permite (a) qualquer um propor mudanças no funcionamento da estrutura sócio-política do país. Nessa perspectiva, os eleitores têm o direito de apresentar projetos ao Congresso Nacional , tendo que reunir assinaturas de pelo menos 1% do eleitorado nacional. Diante disso, a pergunta que não quer calar é : Quais mudanças podem socorro da população em prol de projetos que mudem esse viés?', 'O instrumento de iniciativa popular foi assegurado pela Constituição em 1988 e apenas quatro projetos foram convertidos em lei , como a Lei da Ficha Limpa, que impede políticos condenados judicialmente possam concorrer nas eleições .Ainda ,outro projeto de lei que foi aprovado foi no momento do presidente João Goulart, que decidia se (o) sistema brasileiro seria presidencialista ou parlamentarista. Porém, a população lamentavelmente não mobiliza- se em prol de criações de novas leis que realmente precisam de mudanças, não contribuindo para o real significado da palavra democracia : O o povo no poder.', 'Nessa esfera, a sociedade poderia enxergar facilmente no dia a dia, diversos futuros projetos de lei , como  a correlação de manifestantes populares e um poder político, em prol do fim de greves de professores. Para isso, seria  necessário outro projeto que reivindicasse o salário correto aos professores, e também é válidos projetos em relação à municípios ,como a não propagação de lixo em certos lugares que prejudicam a saúde e o paisagismo natural da cidade. Pode – se ver que muitas pessoas não se interessam em promover projetos de lei por acreditar no voto que deu ao político, esperando por ele , mudanças políticas e sociais na cidade.', 'A sociedade tem o poder de mudar o funcionamento e propor diversas leis ao Brasil, através da iniciativa popular. Portanto , é necessária a ajuda de Instituições de Ensino, incentivando os jovens e demais à proporem a mudança no país, com documentários baseados na história da antiguidade, mostrando a mudança ser possível sim . A mídia deve propagar por comerciais apelativos e corroborar para a movimentação da sociedade, fomentando manifestações  de paz e ideias para projetos de lei através dos meios de comunicação.']",120,120,160,160,200,760
7,Avanço da tecnologia no sistema financeiro,"['Bitcoin O bitcoin é um exemplo de avanço a tecnologia da tecnologia, pois é a primeira e maior moeda criptografada, digitalizada e conhecida mundialmente, sem interferências estatais. Após seu surgimento houveram surgimento, houve muitos benefícios já que os compradores não precisam necessariamente de uma regulamentação própria e específica e nem de autorização para obtê-la.', 'É notório que possivelmente tal revolução está será mais significativa com o passar dos anos, já que tudo se resume em tecnologia, vale tecnologia. Vale salientar também que entre 10 países que fazem o uso dessa moeda o Brasil está em 9º (nono) lugar, segundo a Blockchain. Sendo assim assim, é exequível observar que alguns bancos tendem a desenvolver ligações com blockchain por excluir a necessidade de intermediários nas realizações de transações, e assim não ser cobrado de forma excessiva como geralmente acontece.', 'Portanto Portanto, observa-se que tal mudança seria vantajosa para o consumidor e também para os bancos se houvesse a ligação entre ambos pois ambos, pois diminuiriam as taxas para transações, a superlotação de pessoas em bancos e até mais segurança já que são criptografadas.']",80,80,80,80,0,320
133,Manifestar-se corretamente,"['Novamente após o fim das eleições voltou a ter conflitos, existentes entre a população e o          Estado, isto          tudo se deve à reeleição da candidata.          Mas então desta forma          se pergunta-se, qual o papel do Estado          sobre os cidadãos, e          até que ponto ele pode intervir?', 'Desta forma         pode-se dizer que o         Estado, tem         todos na palma da mão. Então se você sair do percurso traçado por ele, você deverá arcar com as consequências. Um exemplo claríssimo         disto         é Rafael Braga Vieira um ex-morador de rua         que após estar lutando por seus direitos em manifestações ano passado foi preso         .', 'Mas o inusitado da história é         que além dele ser preso ele         foi punido com dez dias de solitária, por estar junto de uma pichação que dizia: “você só olha da esquerda para a direita, o Estado te esmaga de cima para baixo”.', 'Acredita-se que essa punição que Vieira recebeu foi certa                , e o Estado agiu de forma cabível,                 podendo alegar como ele          adquiri          e possui equipamentos que registra fotos em uma          penitenciaria         .', 'Portanto é                 “bonito” manifestar                , mas que seja da forma correta, para que o Estado não caia de cabeça em cima de você. No caso de         Vieira         que aparecia em uma foto,                 alega-se                que         deveria ser mais vigiado as cadeias         para que         não viesse a acontecer isto novamente, a         forma correta para         isto         deveria ser a revista de presos,         selas         e até mesmo de visitantes, com muito mais cautela e cuidado, e também um monitoramento em torno dos presídios para que não haja arremessos de equipamentos eletrônicos do tipo.']",80,0,80,0,80,240
51,Analfabetismo funcional no Brasil,"['O analfabetismo entre jovens e adultos vem sendo reduzido no Brasil, de acordo com dados da Pesquisa Nacional por Amostra em Domicílio (PNAD) – que passou de 11,5% em 2004 para 8,7% em 2012. Apesar da redução do analfabetismo entre essa camada da sociedade, segundo o Instituto Pró-Livro, 50% da população brasileira não leem livros por não conseguirem compreender seu conteúdo, embora estes sejam tecnicamente alfabetizados. É preciso mudar este contexto no país; esse cenário desafiador demanda esforços mais eficientes por parte do Poder Público, da família e das instituições formadoras de opinião  a fim de garantir uma melhor qualidade no ensino do letramento.', 'O direito à educação de qualidade a todos é reconhecido na Constituição Federal de 1988, antes deste dispositivo o ensino público era tratado como uma assistência, um amparo dado àqueles que não podiam pagar. No Brasil, entretanto, há uma discrepância entre o que é defendido pelo meio jurídico e a realidade vivida pela população, sobretudo, os menos favorecidos. Esses indivíduos sofrem, diariamente, com a falta de materiais didáticos e de profissionais qualificados . Além de que muitos ainda sofrem por não terem comida suficiente em seus domicílios, gerando com isso uma perda na qualidade do aprendizado, visto que muitos por não terem se alimentado antes de irem para a escola, acabam sendo prejudicados durante o primeiro contato na sala de aula.', 'Ademais, apesar da redução do analfabetismo no país, o número permanece expressivo. As escolas, muitas das vezes, não levam em consideração os aspectos socioeconômicos dos alunos em sala de aula . Professores desqualificados, sem perspectivas tanto na formação profissional quanto no interesse dos estudantes em apreender os conteúdos transmitidos, já que esses se sentem desmotivados com os métodos utilizados por aqueles . Essa desmotivação implica em afastamento por parte dos estudantes dos locais de aprendizado, visto que se sentem incapazes de vencer.', 'Diante disto, é dever do Estado cumprir o que determina a Carta Magna, em especial o que preceitua a educação de qualidade no serviço público a todos. Como também cabe à família e às instituições formadoras de opinião se engajarem na formação destes discentes, priorizando o desenvolvimento do letramento para a construção de sujeitos críticos. A fim de que possam torna-se pessoas livres e capazes de discernir sobre aquilo que leem para que seja possível produzir um país melhor; gerando bem-estar, crescimento social e econômico do país.']",160,160,120,160,160,760
128,O caminho do meio,"['As pesquisas científicas são importantes ferramentas para o desenvolvimento, já que pressupõem uma análise criteriosa de dados que levam a conclusões que podem ditar o rumo da humanidade. Tudo, em ciência, é busca, nunca uma chegada, pensamento contido na frase do escritor Graça Aranha: “a marcha da ciência é como a do homem no deserto: o horizonte sempre foge”. E ser cientista, como dizia Albert Einstein, é abdicar do interessa próprio para priorizar o “bem comum” das máximas aristotélicas. Entretanto, é sabido que muitas das considerações científicas dão margem ao interesse corporativo e a supremacia de nações, levando à manipulação de dados.                Esse é o caso das pesquisas sobre as mudanças climáticas, que avaliam catástrofes, muitas delas no Brasil, país rico no quesito natureza. A partir dessas considerações, fica o dilema: priorizar a divulgação científica internacional, mesmo suspeita de fraudes, e evocar a consciência climática e ambiental, ou ignorar aquela – que é duvidosa -, e partir para o desenvolvimento econômico?', 'Os          pensamentos extremados, no Brasil também, se distinguem entre os que avaliam seriamente os riscos de uma catástrofe climática iminente e desprezam qualquer intervenção humana que possa piorar essa situação caótica e os que, descrentes dos resultados duvidosos e exagerados do IPCC (Painel Intergovernamental para Mudanças Climáticas) – que incluem perdas em relação ao verde da Amazônia, aos recursos hídricos do Nordeste e à paisagem dos mangues -, priorizam o crescimento econômico.                Entre tais posições está a dos chamados “ecocapitalistas”, que ponderam o desenvolvimento e a prevenção a riscos à natureza. Assim, ganha-se de qualquer maneira: se o clima realmente está mudando, as medidas preventivas estão sendo tomadas, e mantém-se o crescimento econômico; se as considerações científicas sobre o clima são uma história forjada, da mesma forma há crescimento e preservação.', 'É esta posição independente que o Brasil deve assumir, intermediária e isenta de                 ações categóricas                . O crescimento econômico e a valorização ambiental devem ser encarados como                 duas faces da mesma moeda:                é o desenvolvimento sustentável. Assim, também, dispõe-se de maneira positiva a aparição brasileira no cenário internacional. Retomando Aristóteles, é o caminho do meio, o meio termo, que levará ao verdadeiro progresso.']",160,120,120,120,160,680
48,Sus,"['A Constituição Brasileira de 1988, conhecida como cidadã, garante direitos básicos aos indivíduos - saúde e educação por exemplo. No entanto, ao observar os desafios enfrentados pelo Sistema Único de Saúde , percebe-se que o ideal proposto na Carta Magna não é respeitado. Nesse aspecto, convém analisarmos à omissão dos governantes e a desigualdade social como impulsionadores desse revés.', 'Em primeiro lugar, é importante postular as autoridades como causadoras das dificuldades enfrentadas . Segundo Aristóteles, a função do Estado é garantir o bem-estar social por meio de justiça. Porém, ao contrário do que diz o filósofo, o investimento inócuo e a falta de fiscalização governamental com a verba designada esse direito inalienável comprometem o acesso igualitário dos cidadãos, já que são inexistentes políticas para combater o desvio de dinheiro.', 'Outrossim, a desigualdade social no país é diretamente responsável pela importância do SUS . Em sua obra ""O cidadão de Papel"", Gilberto Dimenstein apresenta o Brasil e seus contrastes, uma das maiores economias do planeta e um dos lugares mais injustos para se morar . De acordo com dados do Programa das Nações Unidas para Desenvolvimento, o Brasil é o segundo país com a pior distribuição de renda do mundo. Dessa forma, a maior parte da população não tem condições de arcar com os custos abusivos das instituições privadas de saúde, dependendo única e exclusivamente do público.', 'Infere-se, portanto, que medidas urgentes sejam tomadas para mitigar o entrave. O Governo Federal , deve exigir dos prefeitos e governadores por meio de relatórios e notas fiscais que comprovem o investimento feito por eles, com o objetivo de sanar fraudes com o dinheiro público. Ademais, o governo ainda deve criar políticas por meio de reformas tributárias, com a finalidade de baratear os instituições de saúde particulares, deixando-as acessíveis à sociedade e evitando o colapso dos hospitais públicos. Desse modo, o prometido na Constituição Federal poderá ser enfim, colocado em prática.']",160,160,120,200,160,800
36,Um passado que reflete o presente,"['É de conhecimento geral que por volta do século XVI (16) até o século XIX (19)  a escravidão era um problema enfrentado por diversos países, como Portugal, Espanha, Inglaterra e até mesmo o Brasil. Apesar de ser representado na história, após a colonização, este é um fato que existe há muito tempo, desde a época em que os povos eram vendidos como mercadoria, em que os guerreiros que perdiam a guerra, se tornavam escravos dos que venceram. Infelizmente, esta é uma realidade também dos dias atuais. Acreditava-se que havíamos conquistado a liberdade com a aprovação da Lei Áurea em 1888, mas hoje, vê-se que é bem diferente.', 'No século XVI, após a colonização do Brasil, a escravidão apenas se expandiu. Bernardo Guimarães, autor do livro A Escrava Isaura, chocou a sociedade de sua época ao retratar em seu livro a história de uma escrava branca que “não merecia ser escrava”, mas seu sucesso veio devido ao ir de encontro com a realidade vivida neste tempo, tornar alguém escravo era totalmente legal e ele acreditava que todos tinham o mesmo direito de ter a liberdade. Hoje, conquistamos o direito de nos expressar como queremos, mas nem sempre ele é respeitado, a escravidão abrange um contexto muito maior que o rótulo de exploração que conhecemos.', 'Atualmente, nota-se que a população ainda é escravocrata, exemplo disto é a mão de obra barata na China, uma de suas empresas muito requisitadas, exige uma extensa carga horária de trabalho de seus funcionários, há muito esforço e desgaste físico e mental, e eles afirmam mal terem tempo pra descansar. E ainda existe a escravidão do indivíduo em meio à mídia, você precisa perder sua identidade pra poder se tornar alguém. Infelizmente, temos a força pra acabar com esse sistema, mas não temos a sabedoria para agir.', 'Levando em consideração esses aspectos, são de suma importância a ação do governo junto a instituições privadas e a mídia, sobre conscientização do trabalho escravo ser um ato desumano, já que tiram do indivíduo seus próprios direitos; Haver uma fiscalização em todos os setores comerciais, afim de que evite a continuação da exploração; Escolas promoverem palestras e campanhas para incentivar o jovem a não se acomodar, mas também conscientizá-lo de que ele não deve se deixar ser usado como objeto por ninguém.']",80,80,80,80,80,400
92,"Abre o olho, preconceituoso","['No dia 24 de outubro de 1871, uma multidão saqueou e assassinou brutalmente chineses residentes na Calle de los Negros, em Los Angeles. 19 chineses foram mortos na chacina, considerada o maior linchamento da história dos Estados Unidos. Os assassinos foram absolvidos. Em vista disso, percebe-se que o preconceito contra pessoas amarelas não é recente e deve ser combatido . É primordial, portanto, que a punição a atos xenofóbicos seja mais rigorosa e que se eduque a população para respeitar a pluralidade, combatendo a intolerância.', 'Em primeiro lugar, é importante destacar que a intensificação da violência contra asiáticos, observada atualmente após a descoberta do novo coronavírus na China, é reflexo da discriminação velada desses povos, que persiste há séculos. Apesar dos brasileiros terem fama de calorosos e receptivos, imigrantes amarelos sofrem preconceito, sendo estereotipados: enquanto as mulheres são fetichizadas, os homens são vítimas de emasculação. Ambos, porém, são considerados intelectualmente superiores aos indivíduos de outras etnias. Além de reforçar o racismo contra negros, o mito da minoria modelo, que rotula os asiáticos como inteligentes e disciplinados, também é prejudicial aos amarelos, que passam a ser vistos como ameaça às vagas de emprego dos demais. Ademais, tal generalização afeta negativamente a saúde mental desses indivíduos, já que, desde a infância, é exigido deles um desempenho muito superior ao demandado de outras crianças. Segundo Nelson Mandela, ex-presidente da África do Sul, ""A educação é a arma mais poderosa que você tem para mudar o mundo"". Assim, a politização da população é essencial no combate ao racismo.', 'Em segunda análise, é insuficiente não ser preconceituoso, é imprescindível engajar ativamente contra a discriminação e exigir das autoridades competentes leis antirracistas mais rígidas, assim como políticas públicas, colaborando com uma realidade mais justa e igualitária. Em vista disso, existe o movimento ""Stop Asian Hate"", surgido nos Estados Unidos em resposta aos ataques contra ásio-americanos. Campanhas como essa, que despertam o envolvimento de diversos indivíduos, são de suma importância, já que dão maior visibilidade ao imbróglio, suprimindo a discriminação velada.', 'Destarte, o Poder Legislativo, em parceria com o Poder Executivo, deve implantar, com urgência, políticas públicas para diminuir a desigualdade étnico-racial . Além disso, no âmbito escolar, é dever do Ministério da Educação promover palestras ministradas por especialistas de descendência asiática, sobre o racismo, com a distribuição de folhetos para os ouvintes, com a finalidade de educar a população, tal como recomendou Nelson Mandela. Dessa forma, o preconceito amarelo será combatido.']",160,160,120,200,160,800
6,"Preservação do meio ambiente, um dever de todos!","['As pautas ambientalistas têm sido cada vez mais discutidas no cenário mundial, o qual em que, mais recentemente, passou passou-se a discutir sobre a exploração da floresta amazônica. A grande questão é se a floresta deve ganhar ""status"" internacional ou se deve continuar sendo responsabilidade dos países que compõem abrangem a Amazônia. Mas seria justa justo que apenas alguns países da América do Sul tivessem que ceder suas florestas em prol do planeta, enquanto outras nações que já exploraram suas vegetações não pagam nada por isso?', 'A floresta amazônica é a maior do mundo e sua exploração causaria muitos impactos ao planeta, no entanto, não se pode exigir que apenas os países que compõem abrangem a Amazônia paguem a conta pelos países que já exploraram suas vegetações. Para que isso ocorra de maneira justa, todos os países deveriam ter uma porcentagem mínima de floresta preservada, e os que não conseguissem manter o mínimo, deveriam pagar aos que possuem mais áreas preservadas.', 'Dessa maneira, o Brasil seria capaz de extrair recursos financeiros da Amazônia sem ter que explorá-la, mantendo, assim, a integridade do ecossistema do planeta.', 'Com isso, pode-se concluir que é preciso sim preservar a floresta amazônica, mas essa tarefa também é responsabilidade dos países que já exploraram suas vegetações e devem, portanto, pagar por isso. Assim, o Brasil preservaria suas florestas em prol do planeta e seria remunerado pelas nações que não puderam fazê-lo.']",160,160,160,160,160,800
90,Transfobia no Brasil é questão de origem,"['Um fato triste e que todos sabem é que infelizmente nosso país possui um histórico de atitudes e crimes contra tudo e todos que fogem do que é considerado ""correto"", perfeito ou bonito, por um grupo de pessoas que carregam essa ideia ultrapassada através dos séculos . Estas pessoas não são poucas e convivemos com as mesmas diariamente, seja no ambiente de trabalho ou até mesmo na família.', 'Outro ponto importante  e que talvez nem todos saibam  é que ninguém nasce com ideias racistas, homofóbicas entre outras e sim adquirem pensamentos e comportamentos do tipo, de acordo com o que ouvem ao longo de sua formação pessoal, seja em casa, na igreja ou até mesmo escola. Sendo assim as mesmas crescem odiando ao próximo pelo simples fato de ele ser quem é e entre esse grupo de odiados, estão as pessoas trans, que são discriminadas, violentadas e até mortas simplesmente por assumirem quem são.', 'Sabendo que ninguém nasce odiando o outro por seu gênero ou opção sexual, o que podemos fazer para combater a violência e discriminação contra pessoas trans,  é intensificar o conhecimento sobre sexualidade e gênero desde a infância, tanto na escola quanto em casa. É preciso também desfazer o conceito de que é ""errado"" ou desagradável ser e conviver com transsexuais, dando a estes a oportunidade de um emprego digno, ensino e respeito perante a sociedade, com leis e penas rígidas para pessoas que cometerem transfobia.']",160,120,120,160,160,720
84,Armamento civil,"['Há indiscutivelmente diversos fatores que corroboram para que o porte de armas pela população civil seja um problema. Sobretudo, diante das constantes notícias sobre o aumento da violência no Brasil. Se por um lado existi quem defenda o uso de arma como exercício do direito de legítima defesa.  Por outro, o aumento da violência e das mortes por arma de fogo produzem repulsa sobre essa temática. Sendo assim, é valido analisar os fatores intrínsecos dessa problemática.', 'É importante pontuar, de início, que no Brasil o porte de arma para o civil era liberado. Contudo, diante do individualismo e revanchismo gerado pela Ditadura Militar, os casos de morte tornaram-se banais e os índices de vítimas de armas de fogo no país eram exorbitantes. No entanto, em 2003 com a promulgação de medidas restritivas ao acesso a armas pela população, possibilitou uma queda no número de homicídios após décadas de crescimento ininterruptos .', 'Entretanto, atualmente, diante do cenário de violência – motivados pelas desigualdades sociais -  e falta de segurança pública surgiu, no Brasil, o debate em voltar com o armamento civil. O direito à autodefesa, diante da incapacidade do Estado de garantir segurança pública, consiste em uma das principais bandeiras defendidas em favor do Projeto de lei que visa à revogação do Estatuto do Desarmamento. Dessa maneira, constrói-se uma cultura de medo, na qual o cidadão precisa se armar por esta sob constante ameaça de sofrer violência.', 'Sendo assim, torna-se evidente a necessidade do Estado de investir em segurança pública, na busca por construir um país cujos princípios de igualdade, liberdade e fraternidade possam ser uma realidade ao alcance de todos. A escola, por sua vez, aliada à mídia, por meio de campanhas e palestras,mostrem que o armamento não é uma opção a ser considerada, já que se mostra perigoso e nocivo à sociedade, além de não representar uma solução para a diminuição da violência. Desse modo, deixaremos de mascarar o problema e passaremos a solucioná-lo.']",160,160,160,200,200,880
87,Cuidado nunca é demais,"['A cultura da erotização infantil é uma causa séria que ocorre quando as crianças são expostas a conteúdos sexuais que acabam gerando problemas na infância de tais.', 'Esta situação acontece no Brasil e deve ser combatida para a proteção das crianças.', 'Tal problemática da cultura da erotização infantil ocorre independente da classe social trazendo à realidade a frase do filósofo chinês Confúcio: ""A cultura está acima da diferença da condição social."". Ou seja, todas as crianças podem ser vítimas de má influência em seu ambiente de convívio.', 'Um caso importante a ressaltar é o da famosa atriz e símbolo sexy do cinema Marilyn Monroe onde teve sua vida marcada por negligência de cuidados do trabalho dela, onde ela se relacionou com um homem mais velho num filme quando criança . Marilyn Monroe teve sua infância comprometida, o que prejudicou sua saúde mental e a levou ao suicídio. Então este é um caso  de muitos, que a sociedade brasileira deve tomar como exemplo para cuidar melhor e não envolver as crianças em erotização alguma.', 'É obrigação da família garantir uma infância saudável e que haja o devido acompanhamento escolar caso seja notado abandono ou desprezo familiar. Assim sendo as crianças que são os adultos do futuro venham a fazer cada vez mais um país melhor para se viver bem,']",160,120,120,120,120,640
59,A fome no Brasil,"['Muito se tem discutido recentemente, acerca da fome, um problema social que persiste por consequência de má gestão com o dinheiro público, contribuindo assim, para o acréscimo de pessoas desempregadas.', 'Recentemente, o presidente Jair Bolsonaro disse que é ""uma grande mentira"" que pessoas passem fome no Brasil. Sendo que os registros da prefeitura constam que em Fortaleza, pelo menos, 204.177 famílias seguem em situação de extrema pobreza.', 'Convém frisar,  que o Brasil é um país extremamente rico em agricultura, a maior parte dos produtores trabalha com a exportação de alimentos, caracterizando a má distribuição de renda.', 'Portanto, medidas precisam ser impostas para minimizar esse problema. O governo deve repensar projetos sociais a curto prazo, reformulando antigas iniciativas como o Fome Zero e o Bolsa Família. E sociedade deve se solidarizar, por meio de campanhas de doações, em parceria com a mídia e as ONGS. Só assim, acabaremos  com esse problema que mata pessoas diariamente.']",120,120,80,120,120,560
55,Manifesto Indigenista,"['Mário de Andrade, em sua obra “Macunaíma”, evidencia a importância dos indígenas na formação da identidade étnica e cultural brasileira. Não obstante, nota-se que, desde a colonização até os dias atuais, os nativos são vítimas de preconceito e segregação. Nesse contexto, faz-se necessário analisar como a negligência governamental e os fatores histórico-culturais influenciam a questão.', 'A princípio, nota-se que o Estado é falho no que tange à garantia dos direitos constitucionais das populações indígenas, que deveriam ter seus territórios garantidos e suas culturas respeitadas . Além disso, consoante a Nicó Coudra, os nativos brasileiros passam por uma “crise de voz”, uma vez que, embora tenham o direito de se expressarem e lutarem pelos seus direitos, nem sempre eles são de fato ouvidos, fato que está diretamente ligado à ausência de indígenas na política brasileira. Atrelado a isso, com o avanço do agronegócio e o fortalecimento da bancada ruralista, esses povos vêm sendo submetidos a um espólio territorial pelos fazendeiros, que buscam expandir suas terras.', 'Outrossim, conforme o sociólogo Max Weber, algumas ações do indivíduo são explicadas pelos hábitos e costumes existentes na sociedade. Nesse sentido, nota-se que a desvalorização e o preconceito pelos quais os indígenas são vítimas decorrem da estereotipação sofrida por estes no âmbito social brasileiro. Sob esse viés, no dia 19 de abril, em comemoração ao “Dia do Índio”, é comum ver crianças indo à escola fantasiadas de índio, o que fortalece a imagem desses povos como seres folclóricos.', 'Destarte, urge que as ONG’s – Organizações que suprem a ausência estatal em diversos setores –, em parceria com o a sociedade civil organizada, pressionem o Estado para criação e aprovação da lei de cotas para índios no Legislativo, mediante protestos e petições online, como intuito de garantir uma maior representatividade indígena no âmbito político. Ademais, é papel do Ministério da Educação  orientar as escolas para que, no tradicional “Dia do Índio”, haja eventos nessas instituições que visem homenagear e dar maior visibilidade às dificuldades sofridas pelos nativos.']",160,160,160,160,160,800
49,Disseminadores de idéias,"['Digital influencer é o idivíduo que trabalha com a divulgação de marcas e produtos, utilizando a internet e redes sociais como o veículo que leva as informações diretamente ao público-alvo. Destarte é comum que esse profissional atraia seguidores de acordo com o estilo de vida que demonstra através das redes, característica que também pode causar efeitos negativos à sociedade no caso de uma má influência , atitudes politicamente incorretas ou antiéticas, além de crítica e rejeição por parte do grande público.', 'Ao criar uma imagem atraente, moldada como intuito de causar admiração e persuadir os seguidores a buscar os mesmos hábitos, recorrer aos mesmos produtos e soluções, o influenciador cria uma relação de credibilidade com seu público . Dentro desse contexto surge a responsabilidade de servir de bom exemplo diante das grandes massas.', 'A visibilidade e a capacidade de implantar idéias e hábitos que irão ser reproduzidos por inúmeros indivíduos dentro da sociedade implica a necessidade obrigatória de agir com coerência, respeito e educação, a fim de contribuir com a conscientização da sociedade , caso contrário o conteúdo produzido pode ocasionar desserviço à mesma .', 'Representar marcas e influenciar massas tornou-se papel de grande importância, onde não há lugar para hipocrisia ou falta de visão da sociedade como um todo , a exposição pùblica implica responsabilidade, não somente em produzir informações mas também em transmitir uma imagem que possa servir de exemplo a ser seguido.']",160,120,120,120,40,560
44,*Competições esportivas e o corpo da mulher*,"['A definição das diferenças entre os corpos feminino e masculino se dá em grande parte devido aos hormônios produzidos em cada corpo, segundo a necessidade biológica de cada ser. Porém conhecendo a diversidade de corpos não se pode definir um corpo feminino como base para todos os outros e desconsiderar que existem alterações hormonais que podem ocorrer com qualquer pessoa. Alterações nos níveis hormonais podem acarretar uma série de problemas mas não somente de saúde, podendo gerar conflitos e dúvidas sobre a sexualidade do indivíduo.', 'Um fator muito decisivo sobre a participação de um competidor em esportes olímpicos são os seus níveis hormonais, criado para impedir que participantes utilizem qualquer tipo de dopping para que seu desempenho seja superior ao dos demais participantes. Muitos ainda acabam utilizando propositalmente de diversos tipos de drogas para levar vantagem na competição, visto que é cientificamente comprovado a melhora no desempenho quando se utiliza estimulantes hormonais. Mas quando essa alteração não for por meio de dopagem ainda assim não é permitido sua participação na competição.', 'Caso como da competidora sul-africana Caster Semenya repercutiu mundialmente, a mesma possui níveis acima do normal de testosterona. Segundo a World Athletics isso traria uma vantagem para a competidora, e para que participasse das competições teve que fazer uso de medicamentos para que diminuissem os níveis do hormônio em seu corpo níveis considerados aceitos para o corpo de uma mulher nas competições.', 'O fato da competidora possuir uma condição fisíca diferente das demais participantes não poderia ter servido de critério para a não participação nas competições. A comissão olímpica deveria junto com os demais compedidores verificar que como não foi uma dopagem proposital para melhorar seus desempenhos, ela deveria competir como qualquer outra mulher. Não é escolha do indíviduo possuir uma alteração em seus hormônio mas é dever das competições repararem as desvantagens. Algo que poderia amenizar os impactos das possíveis vantagens que ela teria seriam selecionar competidoras que também possuíssem níveis elevados de testosterona. Realizarem competições equivalentes ao preparo físico de cada atleta também faria com que realizassem uma competição justa e igualitária.']",200,160,160,200,160,880
43,Ostracizados,"['Na antiguidade clássica, o ostracismo era uma prática comum que se caracterizava pelo afastamento de cidadãos que cometiam atos contra a liberdade pública, a fim de deixá-los no esquecimento. Do mesmo modo, essa ostracização ocorre nos dias atuais com a cultura do cancelamento nas redes sociais. Nesse contexto, a impossibilidade de transformação social devido à supressão do diálogo e o aumento das injustiças sociais são aspectos relevantes dessa problemática.', 'Em primeira análise, cabe ressaltar que o diálogo e o questionamento são as principais ferramentas para a transformação social. De acordo com o conceito de maiêutica, da filosofia socrática, o espaço para um diálogo saudável suscita perguntas que levam ao indivíduo descobrir suas próprias verdades e, muitas vezes, mudar de opinião sobre determinado assunto. Dessa forma, o silenciamento de algumas vozes é uma forma rasa de lidar com questões estruturalmente muito complexas como, por exemplo, o preconceito.', 'Nesse sentido, a falta de oportunidade que o “cancelado” tem para expor suas razões fomenta a exclusão social. Um exemplo disso é o caso do americano Emmanuel Cafferty que, em junho de 2020, perdeu seu emprego e teve sua imagem vinculada a grupos supremacistas brancos nas redes sociais por um gesto que teria feito despretensiosamente ao alongar seus dedos das mãos. Tal fato se reflete para milhares de pessoas que são canceladas todos os dias nas redes sociais.', 'Diante do exposto, é preciso que a realidade atual seja repensada. Cabe, portanto, ao Ministério da Educação  promover o entendimento sobre a importância do diálogo em detrimento da atual cultura do cancelamento. Isso pode ser feito por meio de debates nas escolas que elucidem situações de preconceito e injustiças sociais, a fim de promover a tolerância e o diálogo pacificador. Tal medida poderá ser promovida pela inclusão de carga horária obrigatória nas aulas de filosofia e sociologia sobre o módulo “Educação e Cidadania”. Desta maneira, espera-se construir um corpo social harmônico e livre do ostracismo.']",200,200,160,200,200,960
70,,"['Desde o Iluminismo, entende-se que uma sociedade só progride quando um indivíduo se mobiliza com o problema do outro. No Brasil, hodiernamente, quando se observa o número de infectados com doenças sexualmente transmissíveis (DSTs) verifica-se que esse ideal iluminista está constatado na teoria e não na pratica e a problemática persiste intrinsecamente ligada à realidade do país, seja pela falta de investimentos governamentais no apoio às vítimas, se já pelos tabus sobre a conscientização de tal assunto.', 'É indubitável que a gestão governamental esteja entre as causas do aumento de DSTs em jovens e adultos. Segundo Aristóteles “ a política deve ser utilizada de modo que por meio da justiça, o equilíbrio seja alcançado na sociedade”. De maneira análoga, verifica-se que esse conceito se encontra deturpado no Brasil à medida que as estruturas especializadas para prevenção, identificação e tratamento se encontram em condições precárias, quando não inexistentes.', 'Outrossim, destaca-se o preconceito como impulsionador do problema. Tristemente, a existência da discriminação contra portadores de tais doenças é reflexo da valorização dos padrões criados pela consciência coletiva. No entanto, segundo o pensador e ativista Michel Foucault, é preciso mostrar as pessoas que elas são mais livres do que pensam para quebrar pensamentos errôneos construídos em outros momentos históricos. Assim uma mudança nos valores da sociedade é necessária para transpor a barreira à discriminação de pessoas com DSTs.', 'É evidente, portanto, que medidas são necessárias para resolver o problema. Cabe, ao governo federal, por meio do ministério da educação e o ministério da saúde, realizar campanhas de testes rápidos para identificação das DSTs, além de encaminhamento para o devido tratamento. Palestras em escolas, realizadas por agentes de saúde e psicólogos são necessárias para a sensibilização do uso de preservativos e sobre a inclusão social das pessoas afetadas, afim de que diminua os índices de jovens com DST e a discriminação dos portadores da doença, para que ideal iluminista seja constatado na pratica.']",120,160,120,160,120,680
140,"Brasil, século XXI","['Durante as décadas         de 60 até meados da década de 80 do século passado, era comum         ligar          a televisão e se informar                sobre manifestações dos tipos mais diversos.         Era         possível perceber que a maior parte das pessoas         envolvidas         eram jovens.', 'O desenvolvimento                das tecnologias da informação - principalmente a internet -         proporcionaram         uma proliferação de informações e troca de ideias         nunca         visto na história da humanidade. A organização em grupos ligados por interesses comuns também ficou mais fácil. Um pouco diferente do que acontecia em décadas passadas, as causas que         tem         atraído os jovens brasileiros nem sempre         tem         conotação política. Muitos desses grupos - geralmente gestados nas redes sociais ? reúnem-se para promover uma guerra de travesseiros em algum ponto das grandes cidades do país, para promover um passeio no metrô usando roupas íntimas e outros eventos que não passam nem perto do campo político.', 'Toda manifestação social ou cultural é válida.         Só acho uma pena         o fato de que alguns movimentos que poderiam ganhar         as ruas, acabam         morrendo no mundo virtual.                 Parece mais fácil                postar um comentário de indignação no twitter do que sair às ruas e exigir mudanças que beneficiem a sociedade brasileira.']",160,120,80,120,80,560
88,O estigma associado às doenças mentais na sociedade brasileira.,"['O filósofo grego Aristóteles cunhou que apenas o conhecimento pode nos levar a obtenção da essência da plenitude humana. Nesse viés, analisa-se que a falta de conhecimento por parte da sociedade ao estereotipar pessoas com doenças mentais vai contra essa prerrogativa. Nesse âmbito, observa-se que o fato desse assunto ser ainda considerando um tabu e a negligência governamental ao lidar com esse problema, perpetuam a continuação desses estigmas.', 'Em primeira análise, é necessário perceber que as doenças mentais são assuntos pouco comentados, e, portanto, um tabu na sociedade brasileira. A série “Atypical” apresenta um garoto de 16 anos chamado Sam que possui autismo. É possível perceber nessa produção que Sam sofre bullying e preconceito na escola, porém se sente perfeitamente  vontade com seu melhor amigo e sua irmã, pois eles o tratam da mesma forma que tratam outras pessoas. Embora ficcional, esse exemplo trabalha analogamente com a existência de estereótipos na sociedade, que tende a segregar pessoas com doenças mentais por pensarem que elas são incapazes de conviver em sociedade. O fato desse assunto ainda ser pouco comentado corrobora a falta de conhecimento sobre esse assunto por parte da população.', 'A Constituição federal, documento mais importante do país, garante o direito à saúde como inerente a todo cidadão brasileiro. Nessa prerrogativa, observa-se que o Estado tem agido com indiferença, visto que o tratamento de doenças mentais é precário, e, muitas vezes, inexistente ao observar a falta de profissionais qualificados nos ambientes de saúde pública, como psicólogos e psiquiatras. Situação essa extremamente preocupante.', 'Portanto, é necessário que medidas sejam tomadas quanto a estigmatização de pessoas com doenças mentais. Nesse sentido, a fim de extinguir essa prática, o governo federal, na figura do Ministério da saúde e da educação, deve incluir inteligência emocional como componente da grade curricular do ensino fundamental e médio, pois assim será possível que as próximas gerações sejam ensinadas sobre como lidar com essas doenças e respeitar quem as possui. Dessa forma, através do conhecimento, poderemos alcançar a plenitude da essência humana, como dissertou Aristóteles.']",160,160,160,160,160,800
38,O bem estar é prioridade,"['É possível afirmar que uso da substância fosfoetanolamina já deixou de ser uma novidade há muitos anos pois o uso da mesma é de conhecimento público tendo em vista que por meio das autoridades políticas do nosso país uma lei foi sancionada dia 13 de abril de 2016 permitindo o uso da substância por pacientes diagnosticado com neoplasia maligna. Em contra partida autoridades de âmbito científico desaprovam o uso da substância enfatizando a complexidade deste assunto.', 'As autoridades políticas tomaram um posicionamento favorável defendendo os diretos da população afetada. mediante as evidências que foram apresentadas pôr pacientes que pôr sua vez comprovam a eficácia do uso da ""pilula do câncer"" assim chamada a fosfoetanolamina adotada como forma de tratamento. Tornando lícito o uso dessa substância e proporcionando assim melhoria no tratamento de pacientes já diagnosticado.', 'Somado a isso, podemos dizer que as autoridades cientificas pôr sua vez não ignora o fato de se exija uma melhor apuração de provas científicas que comprovem a eficácia do tratamento com uso dessa substância. levando em consideração não apenas a possível melhoria de pacientes que já utilizam dessa forma de tratamento. Mais também priorizando todo os meios de análises que os assegurem de que seja totalmente benéfico a saúde dos pacientes.', 'Dessa forma se faz necessária a elaboração de uma fiscalização aprofundada no controle de fabricação e distribuição dessa substância medicamentosa proporcionando segurança as seus usuários e desenvolvendo novas pesquisas e contribuindo com a saúde da população de forma politica e científica utilizando todos os recursos possíveis para tamanho investimento na área da saúde.']",80,80,80,80,80,400
100,A pressa é inimiga do bom motorista,"['As cidades          vem          crescendo num ritmo fora do normal, com isso, o número de carros cresce em um ritmo incontrolável (só a cidade de São Paulo, segundo o Detran tem uma frota que chega a quase 7 milhões de carros, sendo que o último milhão foi alcançado em apenas 3 meses), gerando assim, congestionamentos insuportáveis nas grandes vias, o que para algumas pessoas é algo que proporciona momentos de puro stress, impaciência, arrogância, individualismo, fazendo com que mostrem seus lados mais ""maquiavélicos"".', 'Diariamente encontramos notícias sobre acidentes de trânsito         no qual         a vítima não só se feriu pelo acidente, mas também pelas agressões sofridas,                 geradas por um temperamento agravado pelo fato de estar ""estacionado"" no trânsito                , mas como podemos evitar esses                 temperamentos                cada vez mais violentos no trânsito? Primeiramente vamos ao foco do problema, se moramos em uma grande metrópole dificilmente         consiguiremos         fugir dos         congetionametos         , mas talvez conseguimos vias alternativas que façam com que andamos em um fluxo normal, mas se não temos essa opção e temos que encarar de fato o problema, temos que fazer com que o momento         que estivérmos         ""congelados"", seja um momento (sabemos que é difícil) agradável,         sendo ouvindo         uma música,                 resolvendo aquela cruzadinha que seu filho deixou no carro, ou até mesmo, terminando aquela peça de tricô que ficou pela metade,                não importa, o negócio é encontrar algo que faça esquecer que         aquele         momento você tem que ser melhor e ultrapassar aquele carro pela direita, que seu carro é mais potente e deve estar na frente daquele com uma potência menor, que você é a única pessoa com pressa em toda a cidade, por isso devia estar lá na frente, são esses pensamentos que fazem alimentar a violência nas pessoas e tranformam-         as         em ""monstros"" do trânsito.', 'percebemos         que os congestionamentos são algo inacabáveis nas grandes cidades, pois o ritmo dessas cidades cresce         incontrolávelmente         , infelizmente aumentando os índices de violência, enfim, não devemos continuar associando trânsito à violência, afinal isso faz aumentar todos os nossos níveis de ""negatividade"", mas temos como controlar isso, basta querermos e não nos tornarmos mais um da turma dos ?apressadinhos de plantão?.']",120,120,120,80,120,560
70,,"['No poema do italiano Girolamo Fracastoro , Syphilis é um pastor de rebanho grego que desperta a ira divina e é castigado com pústulas pelo corpo-sintomas de uma doença conhecida atualmente como sífilis.Fora da ficção, as DST´s são um tema em pauta no Brasil, pois elas vêm apresentando aumentos, principalmente entre jovens, prejudicando a saúde deles. Por isso, são necessárias intervenções para combater a questão.', 'De acordo com uma pesquisa realizada pelo Ministério da Saúde,cerca de 60% das pessoas não utilizam preservativos. Esse dado evidencia a baixa eficiência das campanhas de conscientização, já que elas têm como principal função o incentivo a camisinha e a não utilização dela, pela sociedade, é alta. Vale frisar,  que as propagandas ocorrem em poucos meses do ano,e existe uma carência de informações sobre outras DST´s (pois só há sobre a AIDS)  e a gravidade que elas representam para os indivíduos expostos. A existência desses mecanismos são de suma importância,por isso é crucial mudanças em suas abordagens para garantir sua eficiência.', 'Além disso, os jovens sem o conhecimento adequado acabam presos no estereótipo de saúde. Isto é, se a aparência do parceiro é saudável, ele não pode ter uma doença, então é seguro manter relações sexuais sem camisinha. Uma lógica errada, visto que levantamentos como o da Organização Mundial da Saúde(OMS) constataram que aproximadamente 5 milhões da população brasileira sexualmente ativa já foi contaminada em alguma ocasião por essas enfermidades. Logo, a desinformação da juventude é um fator que não só coloca em risco a qualidade de vida desses, mas também contribui para o aumento das DST´s.', 'Portanto, são necessárias medidas para resolver o impasse. O Ministério da Saúde deve abordar,nas campanhas de conscientização, a AIDS e outras DST´s e ressaltar suas gravidades e seus sintomas,como também tornar essas ações efetivas durante o ano todo e disponíveis em redes sociais e aplicativo de relacionamentos, para o alto alcance dos jovens, além de implementar máquinas de preservativos nas escolas públicas,faculdades e postos de saúde para aumentar a distribuição e o uso. Ademais, o Ministério da Educação (MEC) deve inserir ,nas escolas, palestras e disciplinas sobre orientação sexual , com especialistas para desmistificar, alertar e tirar dúvidas dos alunos e seus familiares, sobre essas enfermidades. Feito isso, situações como a de Syphilis não farão parte da realidade da juventude brasileira.']",120,160,120,160,120,680
106,Ferocidade insana,"['De um lado o carinho demasiado, do outro a agressividade, e em meio a tudo isso os animais clamando piedade. Trata-se da ligação entre o ser humano e os bichos de estimação, que existe desde os tempos remotos e ao longo do tempo ganhou bastante prestígio. Uma interação que vem sendo abordada por diversos campos de estudos, como psicologia, antropologia, sociologia e medicina veterinária.', 'Muitos bichos são tratados como membros da família. Em alguns casos são tratados como pessoas.                Um verdadeiro equívoco. A ""humanização"" e os mimos em excesso podem gerar transtornos         a esses         animais. Por conta disso, muitos destroem a casa,         tem         crises de ansiedade, fazem suas necessidades em locais inadequados e demonstram agressividade.', 'Entretanto, os maus-tratos e violências são bem mais prejudiciais do que os cuidados em excesso. Recentemente houve uma intensa repercussão nas redes sociais sobre um fato que chocou a população. Uma enfermeira de Goiás foi gravada espancando um cachorro até a morte. Isso tudo ocorreu em frente ao filho da mulher, que tem apenas três anos de idade.', 'Diante disso percebe-se que a agressão e o grau elevado de cuidados não são benéficos aos animais domésticos, nem mesmo quando a intenção é o adestramento. Segundo a         constituição         brasileira, praticar ato de abuso, maus-tratos, ferir ou mutilar animais, sejam eles silvestres, domésticos ou domesticados, nativos ou exóticos é um crime e a pena é a detenção, que pode variar de três a doze meses, além do pagamento de uma multa.']",120,120,80,80,80,480
95,1abelha,"['No livro ""A Ilha"", do escritor Aldoux Huxley é retratado um futuro distópico em que a harmoniosa sociedade de Pala, pela abundância de petróleo que possui, é destruída pelos poderosos que vivem longe dessa ilha. Com isso, situação semelhante ocorre no Brasil entre agroempresários e indígenas, em evidência o debate acerca do marco temporal e sua natureza. Assim, é valida a discursão sobre o exposto, bem como medidas que atenuem a questão.', 'A priori, é necessário o esclarecimento sobre o assunto. Assim, o marco temporal trata no tocante a demarcação das terras indígenas, entretanto, a problemática está na data em que é validada. Nesse viés, é imperioso ressaltar que antes da chegada dos europeus -em 1500-, os povos originários já habitavam o país. Além disso, a natureza tal como os animais fazem parte de usa cultura e por isso, a questão não se trata apenas de delimitar terras, pois para essa comunidade, a natureza faz parte da sua história, formadora da sua identidade. Portanto, ressaltando a alteridade desse povo, é crucial a dissolução desse quadro urgentemente.', 'Outrossim, é fundamental o respeito pela integridade do povo indígena. Nesse sentido, o marco temporal vai de encontro a dignidade dessa gente pela pretensão de limitar não apenas terras, mas a história de todo um povo. Isso porque, de acordo com essa tese os indígenas não podem reivindicar terras que não estavam ocupando antes da constituição de 1988. Concomitantemente, esse argumento é refutável levando em consideração a histórica perseguição contra essa comunidade; como os bandeirantes, que capturavam índios para escravizar e por isso, houve o extermínio desse povo de suas terras antes da promulgação dessas leis.', 'Em suma, para que haja a resolução dessa questão é imperioso que o STF( Supremo Tribunal Federal), órgão de máximo poder, favoreça a comunidade indígena por meio da ratificação contra o marco temporal, através da alegação da efetivação da Constituição que afirma o direito originário dos índios sobre a terra e respeito com a sua cultura.  Com o fito de que diferentemente da destruição corrida em Pala, a comunidade indígena tenha a sua dignidade respeitada.']",160,160,160,200,200,880
68,,"['A identidade de um pais está intimamente relacionado a sua cultura, sendo assim a preservação do seu Patrimônio Histórico e imprescindível. No Brasil tem- se muitos casos de que a Cultura Nacional perdida em incêndios, inundações em seus museus que aos poucos são esquecidos pelos Poderes Públicos.', 'Através dos museus, centro culturais a sociedade consegue acesso a sua história que, sem o conhecimento dela, não há sociedade como disse Edmund Burke:  ´´Um povo que não conhece a sua história está condenado a repeti-la``. Além disso os Patrimônios Históricos são locais para pesquisas. Os museus levam consigo a preservação da qualidade de vida, pois dentro deles tem objetos que estão ligados vida e história da população  criando nelas uma ligação de pertencimento. Os Patrimônios Históricos, também, são fonte de renda por conta do turismo que ajuda na economia local ou nacional.', 'Por tanto os Patrimônios históricos necessitam de atenção especial, e para isso preciso que haja periodicamente reformas nos museus, ruas, praças que são considerados Patrimônios Históricos, por empresas especializadas para que tenham zelo e disciplina durante a reforma. Deve haver também um investimento considerável no IPHAN para que ele possa ampliar sua atuação.']",120,120,120,120,120,600
39,O governo melhor que o governo,"['Egoísmo, oposição e impunidade são definições que podemos encontrar no atual governo brasileiro. Muitas são as pessoas a favor do Impeachment , porém há também uma parte da população que ainda se prende ao atual governo, defendendo suas ideias e pensamentos a respeito do Brasil.', 'O que os cidadãos brasileiros argumentam a favor do impeachment é que já estão cansados, de tanta corrupção, impostos tão altos, e qualidade de vida decaída. A milhares de anos com o sistema democrático brasileiro implantado nunca se houve tantas manifestações e ingratidão em relação ao governo, contudo, não houve também impostos absurdos e a tão falada “crise econômica”. Vários são os fatores que propiciaram a instalação dessa crise, porém não se justifica o erro ocorrido pelo governo, que ainda pode afetar por mais alguns anos a população.', 'Já a população que se coloca contra o Impeachment justifica sua posição demonstrando que o governo já fez várias melhorias para o país e a crise instalada se dá por fatores que vão além da crise política; porém como deduziu a pensadora Eça de Queirós “Políticos e fraldas devem ser trocados de tempos em tempos pelo mesmo motivo”.', 'Portanto, o Impeachment pode ser visto como uma forma de melhorar o atual governo que se encontra de forma crítica e vergonhosa. Thomas Hobbes, filósofo inglês, declarou que qualquer governo é melhor que a ausência de governo, é preferível da anarquia, violência civil generalizada e do medo permanente. Cabe ao Ministério da Justiça adaptar as leis, e levá-las a risca; conscientizar a população através de palestras e mídias alfas, para assim voltarmos a ter governos como na Era Vargas.']",120,120,80,120,80,520
38,Qual é o papel do Estado?,"['No último ano houve um grande aumento nas discussões sobre a liberação da fosfoetanolamina e o papel dos Três Poderes nessa deliberação. É indiscutível que decisões de vida ou morte não devem ser tomadas por órgãos públicos ou cientistas. Nesse caso cabe ao portador da doença, optar pelo uso do medicamento se julgar necessário, além de que, há momentos que o indivíduo não tem nada a perder.', 'Em determinadas situações o cidadão tem o direito de decidir o que achar melhor para ele. Principalmente quando se trata da vida desse indivíduo. Nesta circunstância, cabe ao Estado apenas monitorar as pesquisas e certificar-se que estão seguindo corretamente e os pesquisadores através de seus estudos sobre o medicamento orientar e explicar as possíveis complicações, para que o portador da doença faça a melhor escolha.', 'Mesmo os cientistas afirmando que o medicamento não passou por todos os testes , há ocasiões, tais como, pacientes em estado terminal que veem no remédio a única opção de uma possível recuperação. Já foi provado que apenas o fato do paciente acreditar, há uma considerável melhora na qualidade de vida desse indivíduo, haja vista que não há muitas alternativas nesse tipo de situação.', 'Entende-se, portanto, que certas escolhas devem ser direcionadas aos que mais irão sofrer as consequências do que for definido. Além disso faz-se necessário lembrar que o objetivo e garantir o melhor tratamento para os portadores do câncer, nesse caso é preciso deixa de lado interesses econômicos e políticos.']",160,200,120,120,120,720
63,,"['De acordo com Isaac Newton  toda ação gera uma reação de igual direção e intensidade, e sentido. Nesse contexto a devastação ambiental, oriunda de uma visão econômica ávida congruente com o gerenciamento negligente capitalista dos recursos naturais, tem nos direcionado a resultados funestos.', 'Não obstante os impactos ambientais já ocorridos , outras barragens se encontram em alerta, podendo a qualquer momento se romper,ocasionando mais danos incalculáveis não apenas a nação canarinha mas também a biodiversidade mundial.', 'É indubitável a existência de punições acerca de tais crimes, porém a ineficácia se faz presente, adivinda talvez da aliciação do poder judiciário afinal o processo criminal muitas vezes não é concluído, deixando impunes os culpados da dilaceração da natureza.', 'Em decorrência dos fatos mencionados, fica evidente a necessidade de uma educação ambiental tangente as grandes corporações, todavia na ocorrência de infrações que perpetrem as penas cabíveis. É imperioso também haver circulação de peças publicitrias principalmente na tv, afim de alcançar e conscientizar a multidão a contribuir com a sustentabilidade e conhecer os riscos sofridos com a falta dela.']",120,120,120,120,120,600
71,A importância do diálogo,"['Em 2017, o jogo da baleia azul chocou o país ao ser apontado como causa de algumas atividades suicidas entre jovens de diversas nacionalidades. Além disso, a estréia da série "" Os treze porquês"", da gigante do streaming  Netflix, expôs uma triste realidade retratando a depressão e os abusos físicos e psicológicos como coisas comuns na vida escolar e cotidiana de alguns adolescentes, trazendo à tona um importante debate sobre saúde mental na juventude moderna.', 'Nesse quesito, um estado psíquico e mentalmente instável, comum entre jovens, é atrativo para o que a psicologia chama de ""gatilho"", em que por não ter preparo emocional e apresentar graus variados de depressão ou trauma, ocasionam em casos alarmantes de suicídio. Um exemplo disso é a narrativa da adolescente Hannah Baker, da série ""Os treze porquês"", que tira sua própria vida devido ao intenso bullying escolar e ao estupro do qual sofreu.', 'Ademais, existem fatores que dificultam a prevenção do suicídio, como pode ser observado nos casos em que, após um jovem se suicidar, os próprios pais do mesmo alegam não terem conhecimento da vida pessoal do filho, apontando uma preocupante escassez do diálogo, que seria essencial para garantir o preparo emocional deste. Sem conhecimento da família sobre os problemas pessoais, o jovem tende a se sentir isolado em seus traumas e acaba não conseguindo apoio para seguir em frente.', 'Em suma, o suicídio é resultado de diversos fatores, externos e internos, que levam à ideia de que a morte, nestas circunstâncias, é a única saída. Com base nisso, a Netflix acertou em produzir a série ao estimular que esse tabu fosse discutido em ambientes familiares , permitindo que hajam oportunidades de diálogos. Dentro dessa lógica, o Ministério da Saúde, junto das mídias televisivas, devem elaborar programas e documentários que sejam exibidos em rede aberta, a fim de conscientizar a população. Não apenas, cabe também ao Ministério da Educação  elaborar campanhas efetivas contra o bullying nas escolas, aliando-se à responsabilidade dos familiares de garantir, com acompanhamento psicológico, a saúde mental dos jovens brasileiros.']",160,160,120,160,120,720
85,"Desprezo à sociedade feminina, um problema, mil soluções.*","['É de grande notoriedade que, a vinte e oito anos para ser exato no ano de 1988 o país ficou marcado entre o fim da ditadura e o começo da democracia, naquele ano foi promulgada a nova Constituição federal, em vigor até hoje. Desde a elaboração e aprovação da constituição apenas 4 leis de iniciativa popular foram criadas. Talvez um dos maiores dilemas atuais do Brasil seja lutar por democracia (fim da corrupção), mas existem vastos problemas; por exemplo; a violência contra a mulher. Mas a onde entra a questão de ""Lei de Iniciativa Popular”?', 'Em meio a uma proliferação por parte da população em questões governamentais, hoje o brasileiro tem sua liberdade de expressão ou livre-arbítrio para expor indignações com certas ações de nossos representantes ou por crimes cometidos por parte do próprio brasileiro, por assim dizer uma das 4 leis criadas pela iniciativa popular foi a lei “Daniella Pérez” para crimes hediondos ,esse fato bárbaro ocorreu em 1992, a vítima Daniella é filha da autora de  novelas Glória Pérez, de imediato houve uma comoção profunda pela população que em conjunto a mãe da vítima reuniu mais de 1 milhão e 300 mil assinaturas, lembrando que para uma lei de iniciativa popular ser aprovada é necessária uma adesão de no mínimo 1% do eleitorado, além da adesão de 0,3% do eleitorado de pelo menos cinco estados da federação.', 'Como já dizia o grande filósofo karl marx ""A natureza do homem é de tal maneira que ele não pode atingir a própria perfeição senão agindo para o bem e a perfeição da humanidade"" , nessa frase o filósofo ressalta a luta de classes entre os homens; por exemplo ; (:) vivemos no século 21 e ainda lutamos por igualdade entre os sexos (homens e mulheres). Como no fato descrito anteriormente uma das leis de iniciativa popular foi criada a partir do assédio feito pelo homem que acabou com o assassinato de Daniella Perez. No Brasil, a partir dos dados divulgados no balanço da Central de atendimento à Mulher 85% dos relatos correspondem à violência doméstica e familiar contra a mulher na maioria por parte dos maridos ou namorados.', 'Logo, é indubitável que haja uma solução através dos nossos representantes, cuja iniciativa venha principalmente pelo brasileiro, pois à a força de um país está na população que ali reside, é necessário que estes manifestem-se contra este tipo de violência crucial, pois há séculos a população feminina vem sofrendo repressão e machismo(.)  é notório lembrar que as escolas têm também papel importante na vida e crescimento de crianças e jovens ensinando-as através de palestras e discursos com os pais, uma forma de manter sempre a educação com a mulher e com todos que assim convivem. É importante, afinal criar lei através da população para o combate da violência à mulher.']",120,120,160,200,200,800
59,Fome um problema evidente no Brasil,"['A fome é um problema que é notoriamente ligado desigualdade social, no qual países com índice de pobreza elevado são resultados de uma administração mal executada, sendo essa problemática muito recorrente em países da África, Ásia e América do Sul. Assim, pode-se afirmar que o Brasil parte dessa realidade, tendo em vista que 25,4% da população ainda vive na pobreza.', 'Convém lembrar que de acordo com a constituição de 1998 toda a população brasileira tem o direito de se alimentar, contudo o pas não consegue cumprir essa lei em virtude do constante aumento nos preços dos alimentos, ficando inviável para famílias de baixa renda, nas quais muitas das vezes vivem com menos de um salário mínimo, tornando-se a realidade de 204,177 famílias de Fortaleza. Outro fator existente que pode-se  mencionar é que em consequência da falta de alimento em sua casa,  diversas crianças chegam á escola apenas com o intuito de comer a merenda fornecida na instituição, sendo muitas vezes a única no dia.', 'Entretanto, o país vem conseguindo combater a problemática da fome, em comparação aos anos 2000 onde havia cerca de 1 bilhão de pessoas sem uma alimentação adequada, hoje são cerca de 820 milhões que vivem essa realidade, portanto nota-se um grande avanço . Toda via, os mecanismos utilizados no século XX não mostram resultados satisfatórios nos tempos atuais, tendo em vista que o problema da fome não é a quantidade de alimento produzido, mas sim do alto índice de desemprego que atingiu 13 milhões de pessoas, sendo o maior deste 2012, de acordo com o IBGE (Instituto Brasileiro de Geografia e Estatística).', 'Em suma, o constante aumento dos preços dos alimentos juntamente com a taxa de desemprego auxiliam na propagação da fome no Brasil. Dessa forma, deve-se investir na estrutura econômica e social para que haja mais oportunidades para a população se especializar e engrenar no mercado de trabalho. Além disso, com o Ministério da Cidadania dando o apoio necessário para as famílias que realmente precisam dos benefícios,  para que a desigualdade social não venha ser um retrato constante mo Brasil.']",120,160,120,160,160,720
57,A democracia no cinema,"['É notório que a democratização do acesso ao cinema no Brasil está gerando muitas discussões com opiniões muito diferentes entre governo e artistas/produtores de filmes.', 'Dentre tantos fatores relevantes, destacam-se: a atual situação do cinema nacional diante da redução de verbas para o setor e a censura velada que artistas, diretores e produtores dizem estar sendo feita contra a categoria artística.', 'Sabe-se que o setor de entretenimento no Brasil é negligenciado, sendo que as poucas políticas públicas de subsídio ao setor estão sendo, pouco a pouco, reduzidas e, em alguns casos, retiradas totalmente.', 'O atual governo além de restringir a verba destinada a indústria do cinema nacional, interferiu também no conselho que administra o setor, retirando e colocando integrantes conforme lhe convinha.', 'Retirou-se representantes dos artistas e da sociedade civil e foram integrados representantes do governo em suas vagas.', 'Além disso, é visível que existe uma forma de “censura velada” a muitas obras de artistas que não pensam e nem conduzem seus trabalhos da maneira que o governo quer.', 'Muito embora os representantes do governo e até mesmo o próprio presidente tentem, inutilmente, diga-se de passagem, passar uma imagem de democracia cultural, é óbvio que não é o caso no momento artístico atual brasileiro.', 'Portanto, torna-se necessário um trabalho mais efetivo da sociedade no sentido de pressionar seus deputados e senadores para impedir que esse tipo de atitude continue e o livre acesso da população ao cinema seja garantido.', 'Diante disso a indústria do cinema nacional manifesta sua indignação e seu repúdio às tentativas de manipular a produção artística brasileira.']",160,40,40,80,0,320
92,Preconceito amarelo,"['O preconceito amarelo está se fortalecendo dia após dia, podemos vê-lo  por exemplo na nova febre musical, o tão conhecido kpop. Mas não apenas nesse quesito, atualmente os insultos aos orientais estão mais populares por conta da aparição do Covid-19.', 'O Kpop vem ganhando visibilidade no Brasil desde dois mil e dezesseis, e junto as músicas e coreografias, o preconceito também vem se fazendo presente. Pessoas usam suas características físicas para tratar como um insulto, por exemplo os seus olhos. Muitos ao verem um asiático automaticamente lhe chamam de “gay”, “xing ling”, entre outros.', 'Em dezembro de dois mil e doze um novo vírus foi descoberto na China, o que causou uma pandemia mundial. E com isso muitos estrangeiros culpam os asiáticos, chegando a cometerem insultos verbais  até insultos físicos; frases como “Vocês são doença” se tornaram virais durante esse período. Ataques e ameaças acontecem principalmente através de redes sociais, textos de ódio e descriminalização são frequentemente utilizados por essas ferramentas de fácil acesso e visibilidade.', 'Usar as redes sociais são uma forma de solução, através de textos, publicações, páginas contra tal preconceito, músicas, poemas, protestos e etc. Hoje em dia uma grande parte da população tem acesso direto internet, assim os protestantes podem alcançar o publico com mais facilidade.']",160,120,120,120,40,560
88,Coragem,"['Falar sobre doenças mentais é muito complexo. Mesmo sabendo que o mundo está doente e que as mulheres são mais afetadas em 30% a mais que os homens, é estarrecedor. A vida moderna e os problemas antigos. A atualidade tem exigido muito mais das mulheres que dos homens. Rotina tripla, responsabilidade dobrada, empoderamento, luta por igualdade e justiça tem feito muito estrago na cabeça e na vida do sexo supostamente aceito como frágil. O Brasil é o campeão mundial de feminicídio e do abandono materno/infantil. E quem tem que segurar as dores dos filhos? A mulher. Coragem! Coragem! Coragem! Em tudo que pensa e faz. Coragem! Coragem! Coragem! Você pode mais.', 'Não há um ser nesse mundo que aguente vivenciar tanta injustiça sem pirar. O serviço público para doenças mentais não é acessível para todo mundo, onde pedir ajuda com o profissional certo? A quem recorrer? Se o governo não está disposto a tratar as causas e muito menos as consequências. Fica muito mais complicado enfrentar a luta sozinho. Se a recuperação está na psicologia por que os órgãos competentes não investem mais nesses profissionais propulsionando um acesso mais livre? Falta vontade e competência para vestir a camisa do outro mesmo que por um segundo e vê que ele não precisa de criticas nem julgamentos e sim de ajuda e logo.', 'Às vezes, a solução é bem simples, e a pessoa só precisa ser ouvido e mudar o foco dos pensamentos. Thomas Edison, cientista norte americano, inventor da lâmpada elétrica. Antes de conseguir fazer a lâmpada fez 1200 experiências antes, e um amigo falou, você errou 1200 vezes para conseguir acertar. Ele falou não, eu sei 1200 maneiras de não fazer uma lâmpada. Para ele tudo é aprendizagem e não erros. Nem todos terão o resultado desejado na primeira experiência. O importante é não se apegar ao que não saiu como esperado e tentar novamente de um novo jeito e seguir tentando. Cada um só vê o triunfo do outro. Mas ninguém sabe como foi a caminhada para chegar lá.', 'A vida é como a primeira infância! Observe o caminho que a criança faz até conseguir dar o primeiro passo. Quantas vezes ela cai? Quantas vezes se levanta e institivamente começa outra vez. Cada tombo que leva fica mais forte até aprender a não cair mais. Tudo se resume a busca pela felicidade ou ao protótipo de felicidade que cada um criou. A felicidade é muito relativa, para um a felicidade é conseguir beber um copo d’água, porque sua condição renal não permite. Para outro é ter a água, porque sua condição socioeconômica, geopolítica e negligencia politica não permitem. São muitos os fatores que implicam na saúde mental de um indivíduo, um povo e uma nação. O segredo da vida e da saúde mental é seguir. Viver cada dia fazendo o seu melhor sem se prender ao passado.']",120,120,120,120,80,560
82,Ferramenta da saúde,"['Sistema de saúde precário, falta de médicos, ? e atendimento inadequado, ? são apenas alguns fatores que influencia na  automedicação. Muitas vezes praticada a fim de se obter a cura, está hoje em constante progresso, apesar dos problemas, para se tornar uma ferramenta segura.', 'Primeiramente, vale ressaltar tais fatores importantes, onde a problemática como, por exemplo: a intoxicação, reação alérgica ou agravamento do diagnóstico é presente na falta de orientação do cidadão, pois prefere definir sua doença baseando-se nos sintomas e buscar alivio com MIPS (Medicamentos Insetos de Prescrição), ? do que enfrentar dificuldades de consultar um médico.', 'Entretanto, de acordo com a OMS (Organização Mundial de Saúde) ? é uma pratica necessária, pois ? além de evitar a superlotação em UBS e hospitais, grande parte das doenças que atinge a população é autolimitada, tornando-se assim exclusiva para essa pratica  para baixo risco.', 'Nessa perspectiva, portanto, para se combater os problemas causados pela automedicação, cabe à mídia e instituições escolares ajudar orientando a população com base no uso racional de medicamentos. Onde, autoridades governamentais devem fazer uma lei para tornar a automedicação uma ferramenta segura para pacientes, investindo em instituições hospitalares para obter sua eficácia.']",80,80,80,80,80,400
52,O Problema da Gravidez Precoce,"['Segundo a OMS (Organização Mundial da Saúde), quando mais pessoas têm informação sobre o tema , mais tarde iniciam sua vida sexual. Sendo assim, evitam a gravidez precoce, que além de afetar o emocional dos envolvidos, afetam também a socioeconomia.', 'Ademais, a gravidez precoce é um problema de saúde pública, por muitas vezes o corpo da adolescente não está preparado para gerar outra vida . Logo, gera riscos à gestante, tanto físico, como emocional, pela opressão da sociedade com este delicado assunto, com medo de contar aos seus pais, por exemplo, podendo até levar ao suicídio como forma de solução, abortos clandestinos, entre outros. Além disso, o bebê também pode ser afetado, como muitas adolescentes escodem de seus pais não fazem o pré-natal corretamente.', 'Certamente, terá impacto socioeconômico, pois as adolescentes param de ir à escola, não terminando-a e consequentemente irá apresentar dificuldades de conseguir um emprego. Portanto, gerará um ciclo que se repetirá na próxima geração, onde um dos motivos da gravidez precoce é baixa escolaridade, baixa renda, dificuldade à acessos contraceptivos e uma tentativa de mudança de vida, como o desejo precoce de ser mãe.', 'Em suma, a gravidez precoce é um problema e deverá ser solucionado. Com grande envolvimento das escolas, com a inclusão da disciplina educação sexual, onde tratará sobre os métodos contraceptivos, abordando temas relacionados, “cada um tem seu tempo”, por exemplo . Ainda mais, implementando psicólogos e aumentando a relação com a família nas escolas, com palestras. Por fim, o apoio da ídia e profissionais da saúde para disseminar a informação, pois a esta é essencial para a solução do mesmo.']",120,120,120,120,120,600
81,A educação é o melhor caminho,"['Na Segunda Guerra Mundial, milhões de judeus foram mortos em campos de concentração nazista  pelo simples fato de serem adeptos ao Judaísmo. Na História, este  é um dos casos mais terríveis de intolerância religiosa, que é o desrespeito e até agressão física ou psíquica a seguidores de religiões diferentes.', 'Em nível mundial, os casos mais assustadores de intolerância são feitos pelo Estado Islâmico ? que realiza ataques terroristas e assassinatos a pessoas que não aderem à sua ideologia fanática. No Brasil, as religiões que mais sofrem são as afro-brasileiras,  já houveram  casos de apedrejamentos só por eles terem ritos, danças e roupas características, como turbantes.', 'Tais particularidades de cada religião causam uma sensação de estranhamento, medo  e como reação muitas pessoas passam a odiar e até agredir os religiosos. E como disse o filósofo Jean-Paul Sartre, qualquer forma de violência é sempre uma derrota, além disso, esses atos vão contra o que a maioria das religiões prega, que é a pacificação e o amor ao próximo.', 'Por isso, é necessário desmistificar o medo do que é diferente, ou como a filosofia ensina, deixar o senso comum e construir o senso crítico. Para tanto  é preciso reforçar o ensino sobre religiões na matéria de Sociologia, mas sem favorecer nenhuma. Na matéria de História, ensinar a importância das religiões, especialmente as afro-brasileiras  que desde a colonização influenciaram os costumes e a culinária do Brasil.', 'Já em relação aos agressores, eles devem ser punidos e passar por um processo de reeducação, assim como os alunos, na tentativa de fazê-los respeitar as diferenças e não cometer mais esses crimes. Pois como disse Immanuel Kant, o ser humano é aquilo que a educação faz dele, logo, o ensino é o melhor caminho para combater a intolerância religiosa no Brasil.']",160,160,160,120,160,760
98,É mais fácil comer o problema do que acabar com ele.,"['Podemos dizer que a responsabilidade                 dessa forma de alimentação                é realmente da         propagando ou ate         mesmo dos fabricantes? De certa forma sim, mas a população também tem uma grande parte em culpa, pois todos nós ingerimos uma quantidade enorme de informação que nos dizem como esses produtos industrializados e os famosos                 fast-food                podem prejudicar o nossa saúde e mesmo assim fingimos de que isso não nos         prejudicara         .', 'As crianças e os adolescentes são os mais influenciados pelas propagandas e a divulgação dos produtos, pois                 a maioria deles                tem como atingir esse público e assim fazer com que a                 obesidade infantil                aumente em nossa sociedade.', 'Essa publicidade dos fabricantes pode influenciar         em uma         grande parte da população. Mas então por que não é criada uma lei para mudar essa forma de divulgação? E os pais não         vêm         como isso afeta os seus filhos? Ou é realmente culpa da sociedade que se faz de         surdo para não ver         os problemas que isso nos causa?', 'A sociedade sabe os riscos dessa forma de alimentação e         ate         mesmo                 o ministério                alega ser um problema de saúde pública, mas da mesma forma não tenta resolver um problema que para muitos         e         algo simples, mas que no fundo tem uma gravidade imensa.                 E se para o governo é simples então é só resolver e assim tudo seria, mas uma vitória para o país.', 'A culpa pode ser considerada de todos, mas isso não é uma desculpa para podermos tampar os         ouvida         para o problema e abrirmos a boca para de certa forma “acabarmos” com ele.']",120,120,80,120,80,520
7,Revolução econômica moderna,"['', 'Com o passar dos anos anos, a tecnologia cada vez mais toma espaço em setores da vida cotidiana, o cotidiana e o dinheiro não ficaria fora disso. A criação do bitcoin em 2009 está abrindo portas para uma revolução econômica moderna.', 'A criptomoeda chega para ultrapassar os bancos convencionais onde convencionais, em que o governo exerce um forte controle estatal controle, através da emissão de moedas tradicionais no sistema financeiro atual tradicionais. Por sua independência, os governos de todo o mundo ainda não sabem como regulamentar esse tipo de moeda, visando que tornaria seu controle obsoleto.', 'Contudo, sua anatomia é o que conquista, agilizando transações econômicas, o econômicas. O sistema ""blockchain"" é formado por uma cadeia de blocos trancados por uma forte camada de criptografia, que torna impossível invadir esses recipientes, assegurando também que as moedas não sejam utilizadas mais de uma vez e cheguem ao destino certo.', 'Esse sistema, uma espécie de livro contábil contábil, registra as transações de recebimento e envio de valores da em criptomoeda, garantindo a segurança desejada pelos consumidores. A criptomoeda ainda não tem uma definição exata, mas veio para divergir o sistema financeiro mundial.']",80,0,0,0,0,80
46,.,"['A partir da discussão ocorrida no senado em relação à privatização do saneamento básico, tornou-se uma questão pertinente para o século XXI . Nesse sentido, é colocada em pauta a falta de investimento neste importante serviço e isto, consequentemente, afeta a qualidade de vida da população, uma vez que não possui uma cobertura eficiente. Além disso, também existe uma preocupação sobre o valor da tarifa que será cobrado pela empresa responsável, isto é será que com a privatização, o serviço continuará sendo democrático?', 'Em primeiro lugar, a falta de investimento no saneamento básico retarda o desenvolvimento do país, uma vez que o Índice de Desenvolvimento Humano (IDH) avalia qualidade de vida da nação, na qual está diretamente ligada a este serviço público. Portanto, com a privatização deste, haverá uma empresa privada que controlará a qualidade do serviço e terá uma melhora na cobertura deste benefício, pois caso a meta não seja comprida existirá sanções de descumprimento. Além disso, terá uma melhora na fiscalização e regulamentação do contrato, já que se trata de uma empresa privada.', 'Em segundo lugar, de acordo com Papa Francisco, a violação dos direitos humanos ocorre também com extrema pobreza e com as estruturas econômicas injustas, uma vez que gera grandes desigualdades. Dessa forma, a maior preocupação populacional é com o valor da tarifa, por conta das grandes desigualdades existentes no país . No entanto, é importante dizer que a água não é gratuita, sendo tarifada também nos serviços públicos, cuja se encontra, atualmente, em até seis metros cúbicos treze reais e quarenta centavos mais o valor que excede o volume. Nesse contexto, a tarifa pública e a privada são praticamente iguais, no que difere apenas no valor investido na companhia privatizada, entretanto, ainda é necessário resolver a questão tributária para que haja uma democratização nesse sistema.', 'Portanto, medidas são necessárias para resolver este impasse. Cabe a Agência Nacional de Águas (ANA) a criação de um projeto de lei, qual deve ser entregue à Câmara dos Deputados. Tal projeto consiste na verificação da renda tributária, por meio do cadastro da população de baixa renda no número do NIS (Número de Identificação Social), dos cidadãos que desejarem o saneamento básico. Nesse sentido, os que ansiarem este serviço e tiverem uma renda menor que dois salários mínimos deverão receber um desconto proporcional ao seu estilo de vida calculado por um especialista em economia, a fim de estabelecer uma democratização na privatização do saneamento.']",160,160,160,200,160,840
68,,"['O patrimônio histórico é importante para reconhecer as lutas de ancestrais, que influenciam diretamente na sociedade. Entretanto, não recebem uma grande valorização, como no caso do Museu Nacional do Rio de Janeiro, que segundo uma pesquisa feita pelo site G1 SP não recebia manutenções e cuidados com frequência. Devemos aumentar o valor por conseguintes fatores, como,  representação da identidade do local e importância para fonte de pesquisa.', 'Deve valer o reconhecimento de uma história através de casas, carros ou estátuas. Esses aspectos corroboram para entender, e localizar determinados locais. Um exemplo disso são as casas de Goiás Velho, que foram construídas pelos bandeirantes, que vieram para Goiás em busca de ouro. Apesar de ser um importante ponto turístico do Estado, uma pesquisa feita pelo guia da cidade, Ricardo Lopes, mostrou que de 2010 a 2017, os turistas diminuíram cerca de 37%.', 'Além disso, outra vertente que atribui para que haja o aumento do valor da herança, é importância dela para os estudos científicos. Neste contexto, o exemplo da Luzia, do Museu Nacional do Rio de Janeiro, um fóssil que estudado, descobriram que tem cerca de 11.000 anos . Com essa descoberta, a Universidade de Manchester, trouxe à vida algo que mudou o conceito das teorias sobre o povoamento. E com isso, o historiador inglês Richard Neville, publicou em seu blog ""sem esse fóssil não chegaríamos tão perto das feições dos negros da África da época.""', 'Interfere-se, portanto, que mudanças devem acontecer para engrandecer esses monumentos. Desse modo, o governo deve intervir, aumentando a divulgação desses lugares, através de cartazes e propagandas na televisão, com objetivo de aumentar novamente a busca desses lugares, para o conhecimento das origens da população. Ademais, o centro de pesquisa brasileira, poderia receber um número maior de investimento da República Federativa,para restaurar os itens queimados no incêndio,  e iniciar novas buscas de fósseis com o intuito de concretizar teorias.']",120,160,160,160,120,720
28,Se calaram ,"['Descontentamento com a política atual, vem deixando os brasileiros inercios ?', 'O povo a algum tempo estavam nas ruas protestando para terem seus direitos, atualmente a voz do povo se calou, sem forças para lutar sem esperanças que o país possa mudar depois de tanta corrupção, porém a polícia resolveu intervir com operação lava jato .', 'A lava jato esta cada vez mais empenhada em achar os corruptos para que o país possa melhorar e possamos ter a chance de vermos essas pessoas que não ajudam seus semelhantes e roubam o dinheiro que lhes pertence atrás da grade, o povo terá não só sua voz restaurada como sua esperança de lutar pelos seus direitos restaurada.', 'No entanto, para uma melhora antes deve-se conhecer o candidato que se vota para não haver problemas, mas caso for eleito e não cumpri as promessas, as pessoas devem fazer manifestações para terem devidos direitos.']",80,80,80,80,80,400
48,Brasil e o SUS,"['Ter a saúde como um direito amplo a todos, faz com que o SUS seja motivo de orgulho para o Brasil com relação ao cenário internacional, mas quando olhamos para o cenário interno é fácil perceber que muitas pessoas não partilham dessa mesma índole. O sistema de saúde enfrenta dificuldades como atender a demanda, pagar pelos tratamentos, e oferecer uma estrutura de qualidade. Mas antes é preciso lembrar como ele surgiu e para que realmente serve.', 'O Sistema Único de Saúde criado na constituinte de 1988, veio para substituir o Instituto Nacional de Assistência Médica e Previdenciária (Inamps), que garantia serviços de saúde apenas ao trabalhadores, deixando a população desempregada, à margem das Santas Casas, que certamente não davam conta da demanda social. O SUS nasceu do desejo de oferecer serviços médicos de qualidade a toda população, sem qualquer distinção, e para isso, esse direito foi colocado como um dever que o Estado deve proporcionar.', 'O sistema oferece atendimento de serviços primários a atendimentos complexos, e de urgência, ele é responsável por atender mais de 162 milhões de pessoas, muitas delas esperam por 3 a 5 meses por uma consulta, ou cirurgia, os médicos são mal distribuídos pelo território, a maior parte se concentra no Sul e Sudeste, em alguns casos a administração pública chega a questionar a qual esfera pública determinado serviço pertence, se está sob responsabilidade municipal, estadual, ou federal, fazendo a burocracia aumentar . É necessário ressaltar que antes da pandemia de Covid-19, o SUS já se encontrava em uma situação alarmante, mas era tratado como uma questão impossível de se resolver, com o coronavírus autoridades tiveram que aumentar o número de leitos que já era escasso, para suprir a demanda.', 'Ele vem a muito tempo necessitando de atualizações e aprimoramentos. O SUS garante serviços como: vacinação em massa, obstetrícia, odontologia, hemodiálise, etc. É preciso otimizar a gestão desse sistema, de forma que as decisões não fiquem sujeitas a vontades políticas, como vem acontecendo nos últimos anos, um mês o Brasil não possui um Ministro da saúde, cargo fundamental para a gestão do SUS em tempo de pandemia, o jeito de inibir o SUS das vontades políticas o transformando em um órgão independentes para ser gerido por profissionais técnicos,  ajudaria a aumentar a transparência de onde os recursos são aplicados, fazendo com que a população saiba para onde o dinheiro público está indo, e sentir orgulho assim como os britânicos sentem do NHS.']",160,160,120,160,80,680
68,A importância da cultura,"['Temos no mundo todo materiais de grande importância para a cultura, que nos ajudam a saber e entender sobre a vida e a rotina de nossos antepassados, que nos fazem refletir e ver as mudanças do mundo atual para o passado e que são tesouros realmente valiosos.', 'No ano de 2018 o Museu Nacional do Brasil pegou fogo por conta de uma negligência dos responsáveis pela instituição, uma grande perda não só para o nosso país, quanto para o mundo todo, e o principal motivo foi falta de verba causando assim um grande incêndio. No museu havia milhares de materiais históricos muito antigos, esqueletos de dinossauros, fóssil mais antigo do mundo, entre outras enormes perdas. Por conta de uma irresponsabilidade perdemos  um contexto histórico muito importante, de muita cultura, onde o dinheiro não compra e não substitui']",120,120,80,80,0,400
47,Educação em tempos de pandemia,"['Atualmente no mundo enfrentamos uma das maiores pandemias de todos os tempos, ocasionado pelo Covid-19, o vírus que se alastrou rapidamente. Com esse vírus que se propaga pelo contagio , foi necessário obter medidas como o início do isolamento social, o fechamento dos comércios assim como das faculdades e escolas de todo mundo, afim de controlar o vírus que se espalhou rapidamente o que trouxe à educação a distância como uma real necessidade.', 'Recentemente o Instituto Nacional de Estudos e Pesquisas Educacionais Anísio Teixeira (Inep) lançou uma enquete aos estudantes, na qual os mesmos precisavam escolher qual a nova data da realização do Exame Nacional do Ensino Médio (Enem) que satisfaria o maior número de estudantes após o seu adiamento resultante da pandemia . Tal assunto tem gerado uma grande repercussão nas redes sociais, pois muitos estudantes possuem pouca infraestrutura e acesso aos conteúdos da plataforma online.', 'Por um lado, a educação à distância é o meio mais seguro de se proteger, devido as aulas presenciais estarem fora de previsão até a pandemia terminar ou ser controlada por completo. Entretanto muitos estudantes vêm enfrentando dificuldades por não possuírem materiais adequados para seus estudos, tais como: computadores, acesso à internet ou a conteúdos da plataforma. É necessário ainda citar que alguns estudantes se sentem prejudicados quando comparados a estudantes de cursinhos e escolas particulares que possuem apoio e são acompanhados de perto . Além disso, até os professores estão com dificuldades de se aliarem as tecnologias para conseguir levar conhecimento e conteúdos aos estudantes.', 'Dito isto, é necessário que o governo distribua os conteúdos aos estudantes em casa para que não saiam do isolamento, assim como também é necessário que alguns cursinhos pagos sejam liberados gratuitamente aos mesmos que não possuem condições para pagar. Levando em conta ainda que o governo precisa liberar renda aos professores para que eles venham orientar e acompanhar os alunos online.']",160,120,120,160,120,680
118,Necessidade x abusos,"['O uso de animais em experimentos científicos                 (para fins farmacêuticos)                é um tema bastante peculiar, pois coloca                 duas coisas                em oposição: a necessidade de se         testar         os medicamentos                 que - após os testes - serão usados por muitos cidadãos, e a questão da proteção aos animais usados nestes.', 'Todavia, vale frisar que         estes         testes são necessários         devido aos efeitos colaterais que os medicamentos trar-nos-ão         .', 'Muitos remédios antes de serem colocados à exposição dos cidadãos         devem ser analisados,         isto porque         [pois] alguns podem trazer efeitos indesejáveis                 ao usuário do mesmo. Exemplo                : há um medicamento denominado sulfato de salbutamol, utilizado por asmáticos e         outrem         que têm problemas respiratórios.         Este         medicamento tem como efeito colateral a taquicardia (aumento dos batimentos cardíacos) e                 isso é um exemplo                . Os testes em animais,         justamente         servem para         saber se estes efeitos de antemão         , antes que o remédio seja liberado para o uso dos cidadãos; assim todos saberiam dos riscos e prevenir-se-iam. Em suma, os testes são necessários. Não obstante, desde que sejam para fins médicos e que não exagerem na         quantia         de animais usados, serão benéficos a todos.', 'Com relação às manifestações, há um problema: foram feitas de forma delituosa, já que         houvera         invasão duma propiedade privada e furto                 destes                animais.         Este         problema, outrossim, deve-se à falta de informações sobre os experimentos que ocorreram em tal laboratório, pois - segundo os propietários - foi tudo feito         com legalidade         , apesar dalguns animais terem sido encontados em situações                 estarrecedoras                .', 'Portanto, antes de quaisquer coisas, é preciso haver mais sabedoria em relação a quem pratica uma invasão do tipo, porque,         muita vez         , é preciso o sacrifício duma vida para                 perpetuar                outra.']",120,120,120,120,80,560
49,Os limites dos digitais influencers,"['Em reportagem exibida no programa Balança Geral SP, no começo de 2020, o youtuber,  que popularizou o desafio da rasteira,  pediu desculpas, após a “brincadeira” feita por ele, e que foi amplamente copiada por crianças e adolescentes, ter causado a morte de uma jovem. O episódio,  expõe o papel dos influenciadores digitais em inspirar ações de um determinado grupo e os impactos negativos, que seus conteúdos, apresentados sem filtros ou supervisão, causam ao usuário.', 'Diante do crescente numero de casos envolvendo ações controversas de influenciadores digitais, como o dos que postaram vídeos em suas redes sociais, onde lambiam vasos sanitários. Fica clara a responsabilidade social, que estes criadores de conteúdo carregam, ao incentivar ações e comportamentos, seja, em um corte de cabelo ou em um posicionamento político, seu poder de influência se tornou altamente relevante, diante de um público, que passa em média 9 horas por dia conectado internet, conforme dados do Comitê Gestor da internet no Brasil.', 'Apesar da importância que desempenham, falta aos influencers noção de seu papel como pessoas públicas, tendo em vista, o grande número de seguidores que defendem atitudes questionáveis como frequentar festas em meio a uma quarentena . Assim cabe,  a outra parte do público o bom senso em compreender os limites da relação de confiança que deve ser tomada e cobrar comportamentos coerentes com o trabalho que por eles é realizado.', 'Percebe-se, então  a necessidade da criação de um mecanismo nas redes sociais para restringir a má utilização das plataformas por pessoas cujo o conteúdo atinja uma grande massa, a criação de um filtro específico para os influenciadores digitais com bloqueio do conteúdo e banimento da rede por determinado período ou permanente. A supervisão rigorosa de tais personalidades pelas redes sociais que as promovem mostra-se necessária uma vez que a internet se tornou a principal ferramenta de comunicação da sociedade brasileira.']",160,160,120,120,120,680
86,Redes sociais,"['Atualmente, as redes sociais possuem grande impacto na vida das pessoas, mudando a forma como pensam, relacionam e agem, chegando ao ponto de poder mudar uma geração, de acordo com o site Medium. Na saúde mental, esses impactos tem sido mais negativos que positivos gerando doenças mentais que se não forem controladas podem vir a se tornar um grande problema para o futuro da humanidade.', 'Sendo assim, de acordo com o Hospital Santa Mônica, a mais nova doença do século é adicção por internet, ou seja o vício de se manter sempre conectado. A tela infinita de ""status"" das redes sociais, seja ela, Facebook, Twitter ou Instagram, gera o hormônio dopamina, conhecido como hormônio do bemestar, porém este hormônio age de forma rápida. Assim, a pessoa sempre volta por mais, passando horas vendo atualizações sem fazer nada construtivo.', 'Outras doenças mentais relacionadas redes sociais são depressão, ansiedade e transtornos alimentares. A vida perfeita msontrada nas redes sociais motiva o ser humano a alcançar aquele nível de perfeição. Como é uma perfeição fabricada, torna-se impossível alcançar, gerando insatisfação com sua própria vida e existência. Então, a doença avança chegando ao ponto do ser humano querer abdicar de sua própria vida.', 'Logo, o ser humano não deve deixar sua vida ser controlada pelas redes sociais. O Ministério da Saúde junto com o da Educação devem agir de maneira a ensinar como se usar as redes sociais de forma saudável e promover o desapego a internet, sendo de uma a duas horas por dia. Ensinando a utilizar este tempo de forma mais produtiva para si mesmo, lendo um livro, conversando com pessoas reais ou simplesmente se conectando consigo mesmo. Há vida fora das redes sociais, a humanidade só precisa se lembrar disto.']",160,160,160,200,160,840
85,O avanço democrático,"['Na constituição federal de 88 exist eum trecho: ”ninguém será obrigado a fazer ou deixar de fazer senão em virtude de lei” neste recorte é garantido o direito de escolher entre fazer e não fazer.   Se o brasileiro tem garantia constitucional para escolher entre o bem e o mau  então, por quê é obrigado a votar?', 'O código eleitoral é uma peça do Ato Institucional! No artigo sétimo penalizam: quem deixar de votar ou não justificar sua ausência.   Qual a força da Constituição para derrubar uma lei ou forçar novos estudos para adaptá-la ao foco da cidadania?  Se o governo é do povo, o próprio povo ou parte, pode escolher em não votar?', 'As coisas boas saem de moda! É o caso da matéria Organização Social e Política Brasileira, hoje considerada pré-histórica porque a grande maioria dos adolescentes nunca ouviu falar deste assunto.  Cenário trágico: - você é obrigado a votar em quem não conhece; nem sabe o que vai fazer? Quanto vai gastar?  Se vai fechar o posto de saúde perto da sua casa ou destruir o currículo escolar? Ou, promover pancadões? Como tomar as rédeas do país pelo voto?', 'O Detran possui um sistema de prova teórica e prática que adaptada ao sistema eleitoral seria: - teórica:  ao aplicar o exame de conhecimentos básicos sobre cidadania, direitos e deveres e o sistema político; já a prova prática (seria): - além de aplicar a lei da ficha limpa deve ser exigido uma apresentação anual sobre ética e combate à corrupção.   Se a comissão aprovar apenas teórico a pessoa é capaz de eleger um político caso, também aprovada na prática a pessoa além de votar pode ser eleita.', 'Um sistema eleitoral onde os integrantes têm consciência do que estão fazendo tem a tendência de obter sucesso. Lei obsoleta tende apenas par a emperrar o progresso democrático e para garantir a máxima satisfação é de bom tom que seja concedido a escolha de votar ou não.']",120,160,120,160,120,680
65,A criminalidade juvenil no Brasil,"['Os crimes realizados por menores de idade tem ganhado destaque nos últimos anos visto que o número de casos e de reincidentes aumenta e as práticas para reduzi-los não são eficientes.', 'A criminalidade entre jovens geralmente é ocasionada por falta de escolaridade, pouca perspectiva de sucesso na vida fora do crime, influência de terceiros, dificuldades financeiras entre outros fatores. No Brasil, apesar de o ensino ser valorizado, ainda faltam oportunidades e incentivos para que os mais pobres terminem os estudos e encontrem emprego. Isso  muitas vezes, acaba sendo um estímulo para que o jovem não finalize os estudos e inicie uma vida no crime, por acreditar ser mais fácil de obter sustento e que dificilmente será punido por infringir a lei.', 'Dentre os crimes mais praticados por adolescentes estão o roubo, tráfico de drogas, homicídio e furto . Para evitá-los, o governo precisa gerar mais oportunidades de emprego aos mais carentes e também melhorar o sistema de ensino já que muitas vezes o jovem tem contato com o crime dentro da própria escola, utra ação que deve ser tomada é o aumento da segurança pública pois muitos criminosos vem na impunidade uma chance de continuar na vida do crime pois percebem que as leis não funcionam como deveriam.', 'A criminalidade no Brasil é um tema delicado pois envolve diversos setores como segurança, educação, legislação, entre outros. É preciso realizar uma reestruturação em muitas vertentes destes setores para que mudanças significativas possam ser identificadas nos próximos anos.']",120,80,120,120,80,520
69,,"['É indiscutível que o uso de agrotóxicos no Brasil tem gerado grande debate na sociedade. O uso de pesticidas tem sido cada vez mais comum no país, aumentando não só as chances de doenças cancerígenas, como também ganhando apoiadores para leis menos rígidas em relação ao seu uso.', 'O câncer pode ser visto como uma consequência do uso desenfreado de agrotóxicos. Visto que seu uso excessivo nas plantações, como forma de evitar insetos, passa a ser extremamente nocivo ao corpo humano. Por conter muitas substâncias químicas em sua criação, existe a possibilidade de após anos de consumo o aparecimento de doenças.', 'Além disso, com a chance de mudança na lei acerca dos agrotóxicos, muitos ruralistas apoiam o projeto. O principal prejudicado passa a ser o ser humano, tendo em vista que mais produtos seriam aprovados sem ter o total conhecimento dos perigos que podem causar . Também, laboratórios não teriam o tempo necessário de examinar e fazer testes sobre os reais perigos desses venenos.', 'Desse modo, o debate sobre agrotóxicos no país cresce cada vez mais. Deve ser feita ampla divulgação sobre os riscos e doenças que podem ser causadas pelo uso exagerado nos alimentos, e criar um projeto de lei que limite o uso de pesticidas no Brasil permitindo assim ter conhecimento real sobre seus riscos para a população. Podendo assim , ter tempo de ser analisada e decidida sobre a possibilidade de comercialização.']",120,120,120,120,120,600
43,Cultura do cancelamento na rede social 8,"['Um dos melhores influenciado digital do Brasil Felipe Neto  tem sido vítima de acusação falsa e de ameaças na rede social desde que começou a fazer críticas a Jais Bolsonaro. Em entrevista ao jornal nacional infuciado digitar afirmou que não imaginava que reação fosse tão forte.', ""Em primeiro analistas, vemos que importo e grande sociedade cancelamento, disse '''Alisom v. Marque e jornalista com MBA em marketing digital e mestre em administração ele explica que cancelamento existe há muito tempo mas em nível e compressões diferentes do que difrente do gente conhece e vivecincia,o movimento #me too que denunciava assédio sexuais e o abuso de homens conhecido com mulheres."", 'Em seguida análise vimos que o impacto do cancelamento rede social,  de um lado nos temo um grupo de pessoas privilegiada que pela primeira vez na vida estão sendo confronto com sua atitude que na melhor são morealmente inconcebível e criminosa', 'Verifique-se ambiente em que acontece esse linchamento virtual como Twitter, Facebook e Instagram , que leva ao cancelamento, não possui ainda regras claras sobre o que é possível fazer por lá ou não. No entanto, isso pode ser uma oportunidade de constituir novas mobilizações, entendendo limites, formas de até melhorar as redes sociais e de criar fóruns públicos, além de permitir a atuação de educadores, políticos, pessoas do sistema judiciário, sendo mais possível criar um debate geral sobre condutas puníveis e educativas e como lidar com punições recorrentes']",120,120,80,80,80,480
45,Violação na segurança,"['Em 3 de janeiro de 2020 começou a valer a lei de abuso de autoridade que criminaliza constranger o indivíduo se sobrepondo a ele através de alguma profissão . Porém, infrações deste porte vêm sendo cometidas no Brasil. Sendo assim, melhores medidas são necessárias para contornar a situação que é causada por preconceitos sociais e por punições fracas ou nulas.', 'Deve-se pontuar, de início, que a soberba em muitos casos se alinha a discriminação social . Um exemplo notório é do policial militar João Paulo Servato, que foi filmado pisando no pescoço de uma mulher negra em uma abordagem na capital paulista, e infelizmente este caso se assemelha ao de George Froid nos Estados Unidos e demais outros . Nesse sentido, a fala de São Tomás de Aquino, que defende que todas as pessoas devem ser tratadas com a mesma importância, é contrariada.', 'Paralelo a isso, a legislação não é aplicada de maneira devida ocasionando penas inábeis a quem comete atos ilegais. Desse modo a democracia imposta no Brasil fica ineficaz, porque as demandas apresentadas na Constituição ou até na Declaração dos direitos humanos são violadas.', 'Logo, medidas estratégicas são necessárias para alterar o cenário. O Ministério da Comunicação, em conjunto com o da Justiça, deve propor palestras sobre a comunicação ou atos não violentos em delegacias ou escritórios oficiais, além de exercer a prática das leis, através de especialistas no assunto que enfatizem as normas de conduta . Por conseguinte, a população estará satisfeita e os índices de violações de direitos diminuirão.']",160,160,120,200,160,800
92,,"['Segundo à filósofa francesa Simone Beauvoir, ""o mais escandaloso dos escândalos é que nos habituamos a eles"". Essa afirmação pode ser facilmente aplicada à questão do preconceito amarelo no Brasil, uma vez que, mais escandalosa do que a ocorrência dessa problemática é o fato da sociedade se habituar a essa realidade com indiferença. Consequência tanto da má aptidão educacional quanto do abismo social . Diante disso, torna-se fundamental a discussão desses aspectos, de modo a interessar-se por uma melhora no corpo social.', 'Em primeira análise é imperativo destacar a principal causadora desse problema - a falta qualidade pedagógica. Conforme alegou o filósofo prussiano Immanuel Kant, ""o homem não é nada além daquilo que a educação faz dele"", sob essa perspectiva percebe-se que enquanto houver falta de terá falhas no país. Durante a pandemia do coronavírus - ou covid-19 - muito se ouviu que os culpados foram os chineses, que eles tinham criado o vírus em laboratório. A partir disso o preconceito contra os amarelos (asiáticos) aumentou bastante, fator decorrente da ignorância, já que existe muitas pessoas que por ausência de acesso à educação  acabaram crendo que a covid-19 havia sido produzida de propósito e passaram a discrimina, como geralmente são conhecidos, ""os japas"", ocasionando um grande nível de preconceito amarelo.', 'Consequentemente, é relevante ressaltar o abismo social - primordial tripé da desigualdade social - como elementar impulsionador do descaso escolar . Considerando a alusão, ""a injustiça secular dilacera o Brasil em dois países distintos: o país dos privilegiados e o país dos despossuídos"" - do escritor brasileiro Ariano Suassuna - reflete prontamente no corpo rasiliano, visto que,  no Brasil existe a maior colônia de japoneses fora do Japão, nota-se que eles se tornaram brasileiros, porém a desigualdade contra os mesmos durante o surto do novo coronavirus achou-se muito elevada devido a rejeição por sua raça. Ficarão conhecidos por disseminar o vírus, por esse motivo estão sendo cada vez mais agredidos.', 'Por fim, são necessárias medidas exequíveis capazes de mitigar os desafios supracitados. Necessita-se que as instituições escolares, encarregada de garantir educação a todos, implementem  aulas interativas por intermédio de métodos de aprendizagem como palestras sobre a inclusão dos asiáticos e o seu papel como um ser humano não responsável pelo aparecimento da covid-19. Ademais a mídia, maioral em relatar fatos fis, deve divulgar campanhas e comerciais de TV explicando a verdadeira existência do vírus. Assim, a contemporânea sociedade brasileira se tornará o oposto do que foi mencionado por Beauvoir, longe de se habituar aos escândalos.']",160,160,160,200,160,840
84,Legítima defesa ou incitação à violência?,"['O uso de armas de fogo pela população civil é uma questão polêmica, envolvendo lados positivos e lados negativos. Atualmente, a lesgilação brasileira dificulta o acesso de armas de fogo pela população, embora como em qualquer outra situação, pessoas fora da lei acabam tendo acesso a armas. A restrição ou permissão de armas de fogo pelas pessoas poderia ser um ato de incitação ao crime, ou olhando por outro lado, seria uma maneira de dá segurança para uma grande parte da população brasileira.', 'Nos dias atuais o que mais se vê nos noticiários são massacres realizados por pessoas com  arma de fogo, e isso poderia ser enxergado (como sinal) de que algo está errado, ou seja, seria necessário dificultar o acesso das pessoas a armas de fogo, pois embora muitas pessoas poderiam usar para se defender, para manter-se em segurança, outras pessoas usariam de forma negativa, aumentando a taxa de criminalidade.', 'Para ter posse de uma arma é necessário que haja treinamento específico do portador para saber usá-la, e haver o reconhecimento de o porquê aquela pessoa querer ter acesso a uma arma de fogo, sendo que as pessoas podem mentir em relação a isso, e tendo como resultado o aumento da violência, elevação da taxa de mortes, entre outros. Havendo a uma desorganização social.', 'Observando que o lado de negativo da liberação de armas de fogo pela população é grave, é necessário que continue havendo dificuldade para as pessoas terem acesso a armas. Pois, é algo que põe em risco a vida de outras pessoas, e até mesmo do portador da arma. Portanto, o uso de armas pela população civil deve ser encarado como algo que não é fundamental para manter a organização social de uma população.']",160,160,160,160,200,840
56,O preocupante cenário carcerário brasileiro,"['O sistema prisional, é uma questão que vem gerando bastante polêmica e notícias para jornais, imprensa e redes de comunicação, devido aos diversos problemas que acontecem dentro dos presídios brasileiros, tais como: mortes, rebeliões, proliferação do tráfico, condições desumanas, entre outros. Com sua implantação na França, em 1971, o estabelecimento de reclusão em sistema prisional para medidas contra crimes penais ganhou força, sendo assim, adotado em todo mundo.', 'O Brasil possui a terceira maior população carcerária do mundo, ficando atrás apenas dos Estados Unidos e da França, de modo que, 40% dos presos brasileiros são provisórios e aguardam o lento sistema judicial brasileiro , o que leva à superlotação de celas, condições desumanas e deixando cada vez mais de lado a implantação de ressocialização dos mesmos  na sociedade, que segue cada vez mais falha, devido a reincidência dos presos após determinado período.', 'Ao contrário do que se pensa, o aumento de encarcerados participantes de facções criminosas que controlam o tráfico e o crime nas ruas de dentro das prisões, é um ponto que vale ser ressaltado. A superlotação segue em alguns presídios como estratégia para domínio e liderança, devido à falta de funcionários e estrutura adequada do local. O excedente número de presos e violação dos direitos humanos devido condições irregulares do qual se mantém o detento, acabam que, por falta de recursos para atender a demanda inserida, levam em muitos dos casos, que os presos recorram ao judiciário serem colocados sob liberdade devido violação de sua integridade humana, o que resulta em uma falha e incompleta medida penal.', 'Dentre inúmeras razões e argumentos sobre o assunto, vale apostar em reforma de presídios, oferecendo espaços para integração educacional, revisões dos códigos penais, criação de medidas alternativas e avaliação da complexidade e grau do crime, incluindo o aumento de audiências de custódia e acelerando os julgamentos dos detentos. Algumas opções como trabalho comunitário, uso de tornozeleiras e medidas mais eficazes para a ressocialização destas pessoas na sociedade, baseada no acompanhamento em longo período para garantia, podem ajudar à combater este cenário que encontra-se precário e preocupante.']",120,120,120,120,120,600
62,Rastro de ódio,"['A Segunda Guerra Mundial teve seu início marcado por discursos de ódio contra outras etnias, raças, religiões e orientação sexual. Quase oitenta anos após o fim da guerra  mensagens como as proferidas por Adolf Hitler ainda persiste na sociedade, sendo não só disseminada pelas redes sociais que abrange um número muito maior de pessoas como também deixa um rastro de ódio e destruição fora dela.', 'Inicialmente, pode-se destacar que o advento das redes sociais permitiu que pessoas se relacionassem com um numero maior de indivíduos e das mais variadas formas, porém também propiciou que por meio delas pudessem se disseminar mensagens de repudio contra diversos grupos da sociedade de forma mais abrangente, espalhando o ódio. De acordo com o portal de noticias G1 em 2018 a polícia de Goiás investigava uma usuária do Facebook que havia postado em sua página mensagens pregando a intolerância e incitando a morte de homossexuais afirmando que “Gay bom é gay morto”. É, portanto, inaceitável que em pleno século XXI ainda não se consiga conviver com as diversidades e se desrespeite os direitos de cada indivíduo.', 'Somado a isso, o ódio iniciado nas redes acaba sendo exteriorizado deixando um rastro de horror fora do ambiente “on-line”, pois incita indivíduos radicais a tomarem medidas, que culminam na agressão verbal, física e até morte dos alvos desse ódio. Durante a Segunda Guerra Mundial para dispersar sua mensagem sobre a superioridade da raça ariana o Chanceler alemão Adolf Hitler reuniu multidões em praça pública, quase um século após seu discurso, o australiano Brenton Tarrant abrir fogo contra fiéis de duas mesquitas na Nova Zelândia filmou o feito e compartilhou nas redes sociais para também semear sua aversão à diversidade . É inaceitável o fato de que a internet venha sendo utilizada como veículo para pregar o ódio, a violência e a intolerância, sem que sejam tomadas medidas a respeito.', 'Dessa forma, o uso das redes sociais para disseminar discursos de ódio contra etnias, credo, orientação sexual, raças ou ideologia política, comprova a urgência de medidas por parte do governo federal e da sociedade como um todo. O Ministério da Ciência, Tecnologia, Inovações e Comunicação, em parceria com empresas de tecnologia, deve fiscalizar o uso das redes sociais para propagação de mensagens de ódio, com capacitação profissional na identificação de possível incitação e apologia à violência, além da conscientização da população jovem para o uso das redes sociais e da punição para quem dissemina, compartilha ou incita ódio e violência na internet. Espera-se, com isso, promover o uso consciente das redes sociais pela população e a coibir a propagação de manifestações de ódios nas redes de comunicação.']",120,160,120,160,160,720
50,Corona vírus,"['Sabemos  que o corona vírus é uma pandemia, e que ele transmite uma doença chamada covid-19 possui vários sintomas são eles febre, tosse e falta de ar; e ela pode trazer várias complicações são elas pneumonia, SDRA, choque céptico e a morte.', 'Nesse sentido, a ciência é muito importante, pois em tempos de transmissibilidades virais,  são os cientistas (pesquisadores) que fazem pesquisas em busca de uma vacina,  No Brasil, a ciência não é muito valorizada, por isso não vemos  tantos profissionais da área, e os que existem não têm o reconhecimento que é devido.', 'É a ciência que nos momentos de surtos, epidemias e pandemias, entra em ação fazendo exames, pesquisas entre outros procedimentos científicos são os cientistas são os cientistas que nos fazem alertas sobre determinadas doenças, assim tendo um papel fundamental de proteção da sociedade. Quem gerencia a área científica brasileira é o Ministério da ciência, tecnologia, novação e comunicação, mas sabemos que boa parte das pesquisas científicas vêm das universidades federais, que no ano de 2019, o MEC  efetuou vários cortes, que prejudicaram a ciência brasileira, e isso afeta muito a evolução científica no Brasil.', 'Com isso, governo federal deveria exigir que todas as escolas tivessem laboratórios (com seu investimento, claro), e que todas elas incentivassem os jovens que a ciência é uma das áreas mais importantes para nossa  sociedade . O campo científico brasileiro,  só será reconhecido com investimentos a longo prazo, sendo assim, se a partir do 6° ano do ensino fundamental, os estudantes tiverem incentivo científico, poderemos  ter grandes cientistas no futuro.']",120,160,120,120,120,640
69,Harmonia entre o meio ambiente e agrotóxicos,"['Sendo um país com sua estrutura econômica fundamentada na agricultura desde seus primórdios , o Brasil depende deste setor primordial para a economia. Porm, o uso imprudente de agrotóxicos gera um conflito entre as partes interessadas, sejam elas produtoras, consumidoras ou em defesa do meio ambiente.', 'Basicamente, a vantagem do uso de pesticidas nas lavouras é o controle de pragas e doenças. Há a possibilidade de se fazer uso de técnicas caseiras para o controle dos mesmos. No entanto, é provável que tais técnicas não sejam eficazes em larga escala de produção, sendo mais utilizadas em hortas de pequena extensão.', 'A grande questão do uso de agrotóxicos é a ampla gama de desvantagens atribuídas ao seu uso, tais como a contaminação de frutas e verduras as quais o ser humano faz uso em sua alimentação diária e também a contaminação do solo, permitindo que o mesmo se torne fraco. A própria água pode ser contaminada, gerando consequências desfavoráveis tanto para animais aquáticos quanto para o homem, que utiliza tal agua e ingere peixes e outros animais que podem estar contaminados, consequentemente nada benéfico para a saúde e para o meio ambiente.', 'Tal conjuntura é demasiada contraditória, já que o defensivo que o ser humano utiliza na agricultura para auxiliar no controle das plantações, evitando perdas na economia, traz retornos nada satisfatórios. Por exemplo, os gastos com a descontaminação de rios e perda de peixes chegam à casa dos milhões. E a inadimplência se torna cada vez maior.', 'A possibilidade de se fazer uso de pesticidas de forma responsável sem danificar o meio ambiente é delimitar a quantidade que pode ser usada nas lavouras e a conscientização do descarte correto das embalagens de tais produtos , somados ao rigoroso controle das entidades relacionadas, tais como o governo e suas esferas estaduais e municipais, por conseguinte, a , órgãos de responsabilidade ambiental e social, entre outros. Sendo assim, presume-se que o meio ambiente e os agrotóxicos cheguem a um consenso.']",120,120,120,120,120,600
136,Protestar só na urna!,"['Em alguns meses, estaremos enfrentando as urnas novamente para escolher                 alguns de nossos representantes para o país                ,                que não é uma tarefa muito fácil.', 'Nesse          ano de          eleições          podemos observar que as pessoas estão com uma visão diferente, que esperam que aconteça uma verdadeira mudança na nossa          politica         . Acompanhamos uma         serie         de protestos no Brasil inteiro, querendo um basta em toda corrupção e em falsas promessas. Mas, será que é através de protestos nas ruas que iremos conseguir alguma mudança?', 'A arma principal para isso acontecer         é         as urnas, é nosso voto.         Onde         teremos o poder nas nossas mãos para decidirmos o futuro do nosso         país, essa         sim é a melhor forma de protestar com consciência e dignidade.', 'A hora de protestar é agora, então não desperdice seu voto. Votando         nulo         você         se mostrara         que não está satisfeito com a situação, mas também não         apresentara         nenhuma forma de solucionar o problema e estará ""jogando fora"" um de seus maiores diretos.', 'Portanto, pense na consequência e no peso de seu voto para o nosso         país, não         basta apresentar apenas os problemas e as falhas, você também pode ajudar a resolver todos eles. Vote consciente.']",160,200,160,160,200,880
24,Uma questão de saúde,"['O consumo de drogas no Brasil é exacerbado e preocupante, o número de usuários só cresce. A violência é, muitas vezes consequência do consumo de drogas, as pesquisas apontam que quem mais consome drogas são jovens de classe média, são esses os maiores protagonistas desse enredo cruel, chamado droga, a classe média sustenta o tráfico, mas são eles os usuários as maiores vítimas, culpá-los seria uma infame sem tamanha, o tráfico é fruto de políticas mal elaboradas.', 'O mundo padece diante da droga é terrível como ela abstrai o que a de melhor em uma pessoa, são eles os traficantes que precisam de punições severas, eles que são algozes de toda uma sociedade, ou melhor do mundo, a lei deve mira naqueles que espalha o mal por toda a parte, punições duríssimas, nada de penas brandas é preciso coragem para enfrentar tamanho descalabro, o confronto precisa ser duro e bem elaborado, para que não aja falhas irreversíveis .', 'A problemática é agravante e requer a participação forte do estado e da sociedade, a guerra nos grandes centros, tem se gravado muito, a população já não tem mais um momento de paz, a todo momento os tiroteios que são intermináveis e agoniantes, os traficantes se sentem donos das comunidades, impondo suas regras.', 'E nos perguntamos cade as políticas públicas, que deveriam amenizar essa situação, os traficantes se escondem atras das verdadeiras vítimas. Aumentar o numero de instituições prisionais e aplicar penas mais duras, seria o começo para da um basta no tráfico, não seria o de todo o fim , mas amenizaria o problema.', 'Vamos arregaçar as mangas e enfrentar esse problema de frente.']",120,120,120,120,120,600
58,Amazônia Degradada,"['Em sua canção “Amazônia”, o cantor Roberto Carlos, relata a destruição da flora e fauna amazônica causada pelas intensas queimadas ocorridas, fato que se tornou recorrente no ano presente em razão da negligência da sociedade. Situação desenvolta em relação a fatores como a alta emissão de gases poluentes na atmosfera contribuindo com o aumento de temperatura, causando o efeito estufa, tornando-se propício o início de incêndios, outro fator determinante é a intensa atividade extrativista da madeira.', 'Em primeiro lugar, os animais serão os primeiros a sofrerem com esse impacto ambiental,  em decorrência dos problemas mencionados anteriormente , perderão seus abrigos e formas de obtenção de alimento, afetando até mesmo sua reprodução, episódio que compactua na extinção de espécies ou migração para áreas inapropriadas causando acentuado desequilíbrio ecológico.', 'Em segundo lugar, o solo empobrecido de nutrientes não oferecerá o suporte a flora que ocasiona o desaparecimento de frutos e plantas medicinais , em decorrência, s árvores que são importantes filtradoras  deixarão de existir com o ritmo acelerado da destruição da amazônia, a redução das chuvas é outro ponto irrefutável já que é ela que faz com que ocorra a formação de massas úmidas de ar através dos vapores orgânicos que emite.', 'Em suma a amazônia abriga diversos biomas que estão sendo destruídos dia após dia, vale ressaltar que este problema de larga escala se ecoa por nove países por tanto cabe aos mesmo estabelecimento de leis mais rígidas, em relação as penalidades lançadas sob os causadores mesmo que indiretamente das queimadas e desmatadores, como a reclusão. Mais fiscalização no perímetro de adentramento da mata, implantação de um número padrão de árvores a serem plantadas por metro quadrado ocupado por pessoas, e principalmente o estabelecimento de uma cota de emissão de gases para s indústrias. Enfim, com por meio dessas ações poderia se compensar a destruição já causada.']",120,120,120,120,120,600
85,Projeto de lei,"['Inofensivos ou maliciosos, diante dessas duas características como definiremos os nossos adolescentes. Como vítimas de um sistema que os desprezam e não os acolhem ou como seres inteligentes e com discernimento suficiente para responder pelos seus atos?', 'A definição mais cabível é maliciosos, porque adolescentes entre 16 e 17 anos, já possuem um elevado entendimento e conhecimento de mundo, do que é correto e do que incorreto, é tanto que como prova disso aos 16 anos o título de eleitor pode ser tirado, disponibilizando a esse menor o direito do  voto. Sendo assim, também cabem aos mesmos responderem criminalmente como um adulto. Por isso, fica explícita a capacidade de escolha que esses adolescentes possuem, se podem e escolhem quais serão os seus representantes governamentais e entendem claramente os efeitos das suas escolhas para o seu país, também são capazes de entender que é extremamente errado roubar ou matar alguém, por está ferindo ao próximo.', 'Diante disso, adolescentes de 16 ou 17 anos não são inofensivos, e com isso é necessário os punir severamente, porque a impunidade gera mais violência, quando menores comentem crimes hediondos a punição geralmente são de três anos de medidas socioeducativas na DCA (Delegacia da Criança e do Adolescente). Punições mais rígidas no caso da prisão, levaria esse menor a refletir a respeito de não cometer crimes,  por causa das suas consequências, a impunidade desperta nesses adolescentes a ousadia de cometer delitos por saberem que não responderão por tais atos.', 'Portanto, o projeto de lei da redução da maioridade penal deve ser aprovado pela constituição, por tratar-se de adolescentes com atitudes maliciosas, assim como o governo juntamente com o instituto da criança e do adolescente devem criar campanhas esclarecendo a toda população que todo ato que ferir ao próximo, é considerado um crime, e os que descumprirem a lei receberão punição, levada em consideração pelo crime cometido e não pela idade do criminoso, só assim acabaremos com as impunidades.']",120,80,120,160,120,600
47,Desafios do ensino à distância no Brasil,"['Desafios do ensino à distância no Brasil.', 'O Japão atualmente é referência em educação de qualidade, dispondo de um dos melhores sistemas de ensino à distância do mundo. Em contrapartida  no Brasil, o ensino à distância não é uma realidade para muitos brasileiros. Dentre tantos fatores relevantes temos: o alto índice de desigualdade social e a falta de investimentos para que as instituições educacionais possam oferecer uma educação com mais qualidade e eficiência para os estudantes.', 'Sabe-se que a implantação de uma ferramenta como a tecnologia na educação , atualmente, é crucial para o processo estudo-aprendizagem, caracterizada por uma didática mais dinâmica em comparação com a convencional. Mas não são todos que tem acesso a este recurso. De acordo dados estatísticos do IBGE , 20% da população brasileira não tem acesso internet, e 45 milhões de estudantes que pertencem a rede pública de educação correspondem a esta parcela da sociedade que não está conectada a esse espaço virtual. Por isso é imprescindível o livre acesso s plataformas digitais, a fim de implantar uma educação de qualidade todos.', 'Ademais, a inserção do ensino à distância na educação pública será um desafio para o Estado, que deverá solucionar inúmeros problemas. A esse respeito, por exemplo, o instituto Datafolha divulgou dados que evidenciam que mais da metade do profissionais docentes de escolas públicas não se sentem preparados para lidar com o ensino à distância e não possuem afinidade com o mesmo . Logo, investimentos devem ser feitos nesse setor que representa uns dos principais pilares de qualquer sociedade, como disse o ativista e símbolo do movimento negro no mundo Nelson Mandela, “ A educação é arma mais poderosa que você pode usar para mudar o mundo”.', 'Portanto, para efetivar uma educação de excelência no país é preciso que o Estado - órgão responsável- desenvolvam iniciativas sociais juntamente com empresas privadas de tecnologia e internet, por meio de doações ou a disponibilidade em baixo custo de aparelhos e banda larga para instituições públicas e famílias carentes, além de projetos de qualificação tecnológica acessíveis para os professores. Só assim, o ensino à distância será efetivado e a educação pública restaurada, beneficiando não só o setor da educação, mas também o Brasil de forma geral.']",160,160,160,200,160,840
89,Tentativa Número 2 (KMQ),"['Durante a Idade Média ocorreu uma grande pandemia gerada por uma doença denominada ""Peste Negra"", nesse período teve um grande índice de contaminados e mortos. Na atualidade, infelizmente, a humanidade está passando por um processo semelhante devido ao vírus Covid-19. Em casos como esses é de grande importância o isolamento social para evitar mais contaminações.  Mas, isso não está sendo concretizado no Brasil, seja pela falta de conscientização da população, ou seja pela ineficiência do Estado em garantir os direitos cívicos aos cidadãos.', 'Primeiramente, é importante destacar como o entendimento das pessoas ajudam a minimizar o panorama supracitado. Segundo o sociólogo brasileiro Betinho, ""Só a participação cidadã é capaz de mudar o país"". Sob tal ótica, fica evidente que os brasileiros tem um grande papel no enfrentamento da problemática, já que o isolamento social se mostra mais efetivo com a participação da população. Isso de acordo com a pesquisa publicada na revista científica ""Plos One"", que aponta o isolamento como uma grande arma na redução de mortos. Dessa forma, a sociedade brasileira deve ser orientada a participar da medida para melhor combate à pandemia.', 'Segundamente, é necessário evidenciar como a ineficiência do governo pode agravar a situação. A Constituição federal de 1988 assume que é dever do Estado mediante a políticas sociais e econômicas garantir o direito à saúde a todos. Entretanto, não está sendo seguro a eficiência dessa prerrogativa, haja vista a aglomeração gerada em locais de recolhimento do auxílio emergencial, devido a pouca eficácia no que diz respeito a entrega dessa garantia a população menos favorecida, comprometendo o isolamento social. Com base nisso, são imprescindíveis mudanças para reverter tal conjuntura.', 'Portanto, o Ministério da Saúde deve, por meio das mídias digitais,  realizar campanhas educativas visando esclarecer a população da importância do isolamento, isso com dados e comprovações científicas, com o objetivo de fazer a sociedade se comprometer com a medida, assim tornado mais eficaz a redução de contaminações. Ademais, o Ministério da Economia deve, por intermédio de divulgações em redes sociais, fornecer dias e horários para uma quantidade determinada de pessoas irem recolher o benefício do governo, com o intuito de diminuir a aglomeração em pontos de recolhimento do auxílio.']",200,160,160,200,160,880
57,,"['Atualmente, temos mais facilidades para assistir filmes em casa . A netflix por exemplo é um meio, pessoas preferem pagar por mês do que ir até um cinema, as vezes por falta de transporte . Temos também, os programas de filmes na televisão e no youtube. Nos dias de hoje com acesso à internet, tudo fica mais fácil e não precisamos sair de casa, fazemos o filme vir até nós.', 'Além disso, o cinema também é um boa forma de entretenimento, quando lança algo novo, todos procuram um mais próximo para ir. Acredito que tenha sido um avanço, pois lucraram bastante, mas houve uma decaída por falta de investimentos. Muitas cidades não tem condições por falta de recursos.', 'Portanto , devemos tomar as seguintes medidas para resolver o impasse. O governo poderia fazer melhorias paras os cinemas, que não houvesse muitas salas para pouca população. Fazer também uma mudança de horários para as estréias, ser gratis para queles que não tem condições nenhuma, também ter acesso. Abaixar os preços dos alimentos, pois não podemos entrar com mercadorias de outros lugares.']",120,40,40,80,40,320
89,,"['O estado de calamidade social e econômica vivido pelos brasileiros sofreu uma potêncialização em decorrência da pandemia mundial da covid-19. Paralelo a isso, há a extinção de políticas públicas, provenientes da pandemia, de apoio financeiro ao cidadão hipossuficiente econômico e a empresas privadas.', 'Visto isso, a necessidade financeira dos cidadãos mais pobres geram neles uma severa vunerabilidade á exposição social para garantir o seu sustento, causando aglomerações. Cabe ressaltar que as pequenas empresas cumprem papel fundamental na geração de emprego, garantir a sobrevivência dessas empresas é garantir também postos de trabalho e aquecimento da economia local.', 'Por conseguinte, a continuidade de postos de trabalhos já ocupados sofrem ameaças constantes provenientes da situação nacional, situação esta que afeta diretamente todos os setores econômicos do país.', 'Indubitávelmente, é necessária a participação da esfera de saúde pública, esta que atua diretamente no combate ao novo coronavírus. A proteção do SUS e seus agentes é fundamental e requer a participação de todos os brasileiros para que haja um combate efetivo a pandemia.', 'Posto os fatos, é compreensível que políticas sociais e fiscais se fazem necessárias para a garantia de sustento do cidadão em um isolamento social. A continuidade do auxílio emergencial e de incentivos fiscais são primordiais para a manutenção de empregos e afirmação do isolamento social. Campanhas de consciêntização em relação ao sistema nico de saúde se farão eficientes na valorização da saúde pública, visto que todos os braslieiros são diretamente influênciados por esse sistema . Assim, podemos concluir que as ações gorvenamentais serão de extrema importância e implicarão diretamente no imaginário do cidadão brasileiro, garantindo a ele uma maior consciêntização frente ao isolamento social']",160,120,120,160,120,680
78,,"['A proposta da reforma do ensino médio pegou muita gente de surpresa e dividiu opiniões entre quem é a favor ou contra,  e entre aqueles que ainda não consegue ter uma opinião formada. De fato  é necessário que algo  mude, pois a educação no Brasil está muito defasada, com escolas sem infraestrutura, professores com salários muito baixos. Não adianta fazer uma reforma se os problemas na educação continuar.', 'Por um lado à reforma seria interessante  a escolha das disciplinas traria mais interesse dos alunos por estudar apenas aquilo que gostasse, porém essa escolha é precoce , e sem a certeza do que gosta ou não, por não ter dito a chance de conhecê-la uma vez que teve que optar.', 'A reforma deveria começar pela melhoria da infraestrutura, condições de trabalho aos professores, aulas mais didáticas para o conhecimento de todas as disciplinas de forma mais prático, mas para um melhor entendimento é preciso conhecer que se defina a base nacional comum curricular .']",80,80,80,80,80,400
43,Cultura do ódio gratuito,"['De acordo com o jornalista Alison V. Marques, a cultura do cancelamento começou a ganhar mais força em 2017, quando houve um movimento contra o abuso sexual. Nesse contexto, esse fenômeno na sociedade contemporânea vem aumentando a cada dia nas redes sociais e gerando grandes impactos na vida das pessoas ""canceladas"", principalmente famosos e figuras públicas. Além disso, está sendo criados inúmeros fakes para atacar pessoas até mesmo sem motivos.', 'Segundo o filósofo iluminista Voltaire, nem sempre podemos agradar, mas podemos falar sempre agradavelmente, porém sabe-se que no meio virtual é impossível acontecer um debate saudável e a criação de fakes para atacar, fazer discursos de ódio contra as pessoas só aumentam, podendo causar depressão, crises de ansiedade naqueles que recebem, mesmo sem ter feito nada de grave.', 'Nota-se que a internet está se tornando um ambiente problemático. A maioria das figuras públicas enfrentam situações complicadas ao se pronunciarem sobre qualquer assunto, pois uma simples fala pode gerar uma bola de neve , por outro lado, alguns perdem a total razão quando praticam atitudes discriminatórias, injustas, o que torna merecedora do cancelamento, assim perdem seu direito de defesa, pois não há argumentos que possam reverter atitudes racistas, machistas, homofóbicas e preconceituosas.', 'Portanto, tais medidas seriam suficientes para combater a cultura do cancelamento na sociedade contemporânea, os empresários dessas redes sociais devem fiscalizar de maneira reforçada páginas que podem ser fakes, por meio de detectores, deletando automaticamente os discursos de ódio e criar campanhas onlines para conscientização, a fim de punir as pessoas e evitar que esse tipo de situação aconteça. Dessa forma, teremos uma sociedade mais saudável.']",200,160,120,160,160,800
50,Coronavírus,"['A área da saúde no mundo hoje,   ocupa um lugar muito importante quando o assunto é o bemestar da sociedade. Graças ao avanço da tecnologia e dos sistemas de saúde atuais, é que se torna possível o diagnóstico de doenças de diversos tipos, dentre elas, as infecciosas que são capazes de alcançar um nível epidemiológico muito grande, podendo  levar até mesmo a uma pandemia. E quando isso acontece, é inevitável que vários continentes possam ser infectados ou até mesmo o Planeta Terra inteiro pode sofrer as consequências drásticas de uma contaminação em massa.', 'No ano de 2020, o Brasil está a lutar contra o novo coronavírus, que surgiu na cidade de Wuhan  na China. E vem procurando métodos para tentar salvar vidas e encontrar a cura para conter o avanço da pandemia. Uma crise como essa já foi enfrentada há anos atrás, mais especificamente em 2009, onde se teve que trabalhar arduamente na procura de um método para eliminar o vírus da influenza A H1N1. Situações como essa enfrentada antes, nos  mostra a importância que tem a ciência e o investimento na área de rede de pesquisas, para que possam ser desenvolvidas vacinas e medicamentos essenciais que visem o bemestar das pessoas.', 'Um dos fatores que impossibilitam o avanço de estudos na saúde quando o assunto é o contingenciamento de doenças infecciosas como o novo Coronavírus, é a falta de disponibilização de recursos financeiros necessários para que seja encontrada uma vacina e ao mesmo tempo que possa ser mantido o SUS (Sistema Único de Saúde), que é muito importante quando o assunto é atender as necessidades das pessoas de forma gratuita . A partir disso percebemos o quanto é essencial que seja ressaltada a importância que tem a ciência quando falamos sobre combates e descobrimento de métodos necessários para tentar diminuir e conter o avanço de doenças, não só no Brasil, e sim no mundo inteiro.', 'As medidas que poderiam ser tomadas diante dessa pandemia,  seria  investimento em tecnologia na área de pesquisas da saúde , para que possam ser realizados estudos mais afundo e específicos dos agentes causadores da doença, liberação de equipamentos essenciais para proteção de trabalhadores que estão na linha de frente dessa causa, e por último, atendimento de qualidade e com recursos necessários no SUS para que os diagnósticos possam ser feitos com precisão.']",160,160,120,120,120,680
130,Prole moderna,"['Hodiernamente                o mercado de trabalho necessita de                 profissionais inteirados, modernizados tecnologicamente                a ponto de atender à globalização,                 enfocando                as buscas por                 pessoas desinibidas                , e são os jovens         a grande maioria que se encaixam         nesses padrões. Porém, sentindo-se intimidados os         ""antigos profissionais"", procuram         delimitar esse espaço crescente, gerando                 aversões                no ambiente profissional.', 'Estes         conflitos dificultam o desenvolvimento de ambos, inclusive até da própria         empresa, um         exemplo bem comum encontra-se no                 setor hierárquico                , cujos         nomenclaturados ""baby boomers"", acabam         muitas vezes não aceitando serem chefiados por pessoas das gerações X e         Y; Há         também a apreensão que tem como consequência a demissão, principalmente dos ""pós anos 90"",                 que além de visar o lado financeiro, tendem a migrar para espaços mais sociáveis, evitando situações enfadadas.', 'Especialistas sugerem que os ""vetustos"" reciclem-se atendendo as demandas atuais,         se modernizando         assim como o tempo, para que as competições não se tornem prejudiciais e sim ampliem o nivelamento de empregabilidade. Já as         empresas, procurem         não estandardizar a contratação somente em uma geração, e também assegurar funcionários antigos, pois         experiencia         e paciência, também são adjetivos essenciais.', 'É condizente          à          frase                :         A         antiga geração critica os costumes e atos da nova, porém vive de acordo com essas mudanças. Torna-se inevitável a busca por amodernados, capacitados à nova era, tentar combater isso é perder-se em um conservadorismo desnecessário.']",120,120,120,80,0,440
60,Reformar ou não reformar? Eis a questão.,"['A discussão sobre a Reforma do Sistema Previdenciário Brasileiro não é novidade para a sociedade. Assunto complexo e polêmico, que morde  um valor considerável da economia nacional. Caso não seja feito nada a respeito, uma parcela ainda maior da produção do Brasil, será para arcar com a Previdência Social, um caminho que talvez não tenha volta.', 'Diante disso, faz-se necessário a mudança das regras. O atual governo de Jair Bolsonaro lançou a PEC da Reforma da Previdência, que altera vários pontos relevantes, um deles é a forma de calcular a aposentadoria. A mesma hoje,  é calculada sobre a média de oitenta por cento dos maiores salários. A Emenda propõe que o cálculo seja feito sobre todas as contribuições, desde o início da carreira do contribuinte.', 'Outra proposição seria, aumentar a idade mínima da aposentadoria ural, para 60 anos, tanto homens, quanto mulheres. Atualmente, os trabalhadores rurais têm seu direito garantido ao aposento a partir de 60 anos, para homens e 55 anos para mulheres. Também é proposto,  aumentar a idade mínima de contribuição rural, de 15 anos para 20 anos,', 'Portanto, o intuito é diminuir o gasto com a Previdência, pois a cada ano,  a população fica mais senil e em contrapartida, há menos jovens e adultos para contribuir com o INSS . Este rombo exponencial,  que assola a economia pode gerar um colapso sem precedentes, que danifique a Nação e não haja solução.']",120,120,120,120,80,560
88,Desintegrando o estigma,"['""É mais fácil desintegrar um átomo que um preconceito"". A frase mencionada pelo célebre físico alemão Albert Einstein,  retrata a barreira imposta pelo corpo social à sociedade. De maneira análoga, hodiernamente, a frase expressa pelo físico vai de encontro com a realidade brasileira, uma vez que o estigma associado às doenças mentais faz-se presente no país. Nesse contexto fatores como o preconceito social e a negligência estatal agravam a situação.', 'Diante disso, é fulcral pontuar o preconceito como impulsionadora do imbróglio. Nesse sentido, de acordo o sociólogo Zygmunt Bauman, vivemos em tempos líquidos, ou seja, uma época de artificialidade nas relações humanas que é caracterizado pelo individualismo. Sob tal ótica, fica clara a falta de empatia da nação sobre a população com doenças mentais, tendo em vista o comportamento social ao agir de maneira preconceituosa, com julgamentos e com a falta de apoio . Tudo isso mostra como os indivíduos com problemas de saúde mental são estigmatizados e, por consequência o modo com a qual passam enxergar a doença, assim, criando obstáculos para que haja um tratamento precoce.', 'Outrossim, é impetrativo ressaltar que o estigma associado às doenças mentais deriva da baixa atuação dos setores estatais. Consoante ao artigo 6º da Constituição federal de 1988- ei de maior hierarquia jurídica do país- garante que toda a população tem o direito à saúde e que é dever do Estado a garantia desse direito. No entanto, é fato que isso não ocorre no Brasil, visto que a falta de atuação da entidade estatal, no que concerne á criação de mecanismos que auxiliem na desconstrução do estigma associado às doenças mentais, por exemplo a criação de campanhas que normalizem o tratamento psicológico, é alarmante. Dessa forma, a negligência estatal contribui para que o Brasil persista na posição de país mais depressivo da América Latina.', 'Portanto, medidas são necessárias para combater o estigma associado às doenças mentais no cenário brasileiro. Por isso o Estado, no papel do Ministério da Saúde, responsável pela política Nacional de saúde do Brasil, deve investir na contratação de profissionais da saúde, como psicólogos, para atuarem nos postos de saúde e escolas, facilitando e incentivando a busca por tratamentos das doenças mentais. Ademais, o Ministério da Educação deve criar campanhas, principalmente nas escolas e universidades, de repúdio ao preconceito e normalização de acompanhamentos psiquiátricos. Destarte não haverá mais estigma associado às doenças mentais e o Brasil conseguirá desintegrar o preconceito.']",160,200,160,200,200,920
84,Sem armas estamos mais seguros,"['A violência é aumentada, onde existir mais pessoas armadas, quem possui permissão para portar arma, engana-se por achar que estar seguro é um perigo eminente sobre quem não tem controle psicológico e não sabe usá-la. Vários atos violentos praticados por quem possuía permissão para o porte de arma, resultaram em mortes que poderiam ter sido evitadas caso fosse restringindo o porte de arma para população civil em todo o mundo.', 'Nos Estados Unidos da América ocorreram ataques por pessoas armadas em intervalos de tempo cada vez menores nas escolas, cinemas e recentemente a uma boate e registrou-se que as armas utilizadas foram facilmente e legalmente adquiridas pela sociedade civil, mostrando para as autoridades deste país o aumentando dos números de vitimas atacadas por pessoas desequilibradas que possuíam porte legal de arma. No Brasil sabe-se que o número de mortes causadas por armas é bastante grande e a tendência seria aumentar, caso o Brasil facilite o acesso legal ao armamento do cidadão.', 'Entretanto , lutar contra a lei que busca facilitar o acesso ao armamento do cidadão civil é um começo para não vermos os massacres sangrentos que ocorreram nos Estados Unidos, vamos cobrar do Ministério da Justiça, divulgações de campanhas com conscientização de que arma de fogo com o cidadão, só aumentará os números de mortes, causando dores e sofrimentos para várias famílias.']",120,160,160,160,200,800
76,Empresas tendenciosas,"['No cotidiano de todos os brasileiros escuta-se, frequentemente, que as mulheres estão conquistando o seu lugar no âmbito profissional, porém esse fato, na prática, nem sempre significa equidade de direitos trabalhistas.', 'No ano de 1932, durante o governo Vargas, o voto feminino no Brasil foi permitido iniciando-se, portanto, uma maior participação das mulheres na democracia. No meio trabalhista, a mulher também conquistou o direito de prestar um serviço com a carteira assinada, entretanto em pleno século XXI, o homem acaba sendo o preferido e o que ganha maiores salários.', 'Um estudo divulgado pelo IBGE (Instituto Brasileiro de Geografia e Estatística) revela que mulheres recebem, aproximadamente, 23,6%  a menos do que os homens mesmo em casos de cargos trabalhistas iguais. Muitas empresas, em uma entrevista de emprego, por exemplo, preferem contratar um homem à uma mulher, pois alegam àquele mais potencial do que esta última quando, na realidade, as mulheres trabalham não só em empresas como também em seus respectivos lares demonstrando, assim, serem capazes de desempenhar um ótimo trabalho tanto quanto o sexo masculino.', 'É de suma importância, então, que os nossos órgãos governamentais façam fiscalizações, juntamente com a Polícia Federal, nas empresas que são tendenciosas a um tipo de gênero e as punam conforme às leis vigentes para que possamos ter equidade de gênero não só no poder em votar, mas também no direito a salários e tratamentos trabalhistas iguais.']",120,120,120,120,120,600
69,,"['No final do século passado, os efeitos provocados pela Revolução Industrial desencadearam consequências sérias para a humanidade, entre essas a busca por métodos de produção cada vez mais intensos. Como consequência disso, hodiernamente o consumo abusivo de agrotóxicos no Brasil nasce para suprir a demanda alimentar da população. Contudo, tais práticas apresentam contrastes perturbadores que necessitam ser superados.', 'Primordialmente, convém mencionar que o principal alvo dessa imprudência é o corpo social. Isso posto, que agentes químicos contaminantes são absorvidos pelas plantações e transportados para aqueles que por meio dessas obtêm seu alimento pela cadeia alimentar. Ademais, os compostos tóxicos atingem o solo e posteriormente os lençóis freáticos que contaminam os rios. Nesse sentido, o uso de agrotóxicos não é propício para o meio ambiente, nem para saúde humana.', 'Segundo Sócrates, filósofo grego, sábio é aquele que conhece os limites da própria ignorância . Tendo em vista essa perspectiva, transfigura-se perceptível a negligência da sociedade em tratar assuntos ligados a questão. Destarte, é descabida a ausência do Estado junto ao Poder Legislativo perante à criação de políticas para conter esse contratempo. Consequentemente, a situação tende a permanecer estacionada no tempo', 'Diante disso, faz-se necessário a adoção de medidas para sanar o impasse. De tal modo, cabe ao corpo social manifestar-se de forma conjunta por meio de protestos para coagir a criação de possíveis soluções. Aliado a isso, cabe ao Estado  por intermédio dos Ministérios do Trabalho e da Agricultura  regulamentar técnicas de produção sustentáveis através de métodos de cultivo biotecnológicos, já existentes no mercado, a fim de promover o cultivo adequado das plantações e a saúde da população. Por fim, leis devem ser criadas por legisladores e executadas pelo Ministério da Justiça para limitar o uso de agrotóxicos e garantir tanto o bem-estar do ser humano, quano do meio ambiente.']",120,160,120,160,160,720
45,---,"['A Teoria da Eugenia, cunhada no século XIX e que teve como base do nazismo, defende o controle social por meio da seleção de aspectos considerados melhores. Sob essa perspectiva, portanto, haveria seres humanos superiores, a depender de suas características. No contexto brasileiro atual, a noção eugênica de superioridade pode ser percebida na questão do abuso de poder por vontades particulares. Nesse sentido, observa-se uma configuração de um grave problema em virtude da ineficácia das leis e o individualismo.', 'Em primeiro plano, é imprescindível verificar a insuficiência legislativa um entrave para a garantia de uma justiça na sociedade. O filosofo John Locke defende que “As leis fizeram-se para os homens e não para as leis.” Ou seja, ao ser criada uma lei, é preciso que ela seja planejada para melhorar a vida das pessoas em sua aplicação. No entanto, na questão do o abuso de poder, a legislação não tem sido suficiente para a resolução do problema.', 'Em segundo plano, o individualismo apresenta-se como outro impasse para a resolução. Na obra “Modernidade Liquida”, Zygmunt Bauman defende que a sociedade atual é fortemente influenciada pelo individualismo. A tese do sociólogo pode ser observada de maneira especfica na realidade brasileira, no que tange ao abuso do poder . Em virtude disso, há, como consequência, a falta de empatia, pois para se colocar no lugar do outro, é preciso deixar de olhar apenas para si . Essa liquidez que influi na questão de abuso de poder funciona como um empecilho para a resolução.', 'Para esse fim, é necessário que o Ministério da Justiça e o Ministério da Saúde , juntos, realizem duplamente ações de punição e de atendimento psicológico aos agressores e às vítimas. Enquanto este se daria em postos de saúde por meio de acompanhamento de um profissional especializado em tratamento pós-trauma, aquele aconteceria por meio da agilização dos processos já abertos, a fim de garantir que o cenário de injustiça seja modificado. Dessa forma, o Brasil poderá superar o abuso de poder.']",160,160,120,200,160,800
87,infâncias roubadas,"['Na sociedade contemporânea as crianças e pré-adolescentes vem tendo acesso a conteúdos eróticos e adultos, os quais levam elas a terem um comportamento mais sexualizado. Por consequência disso, a infância lhes é tomada pela influencia de comportamentos adultos nas midas que tem acesso, isso ocorre,  não só pela erotização de roupas para crianças, mas também pela instigação das redes sociais na infância.', 'A priori as roupas mais cobiçadas entre as meninas são as que sensualiza o seu corpo. Outrossim , esta pratica acaba por torna-las adultas de forma precoce roubando toda a magia da infância,Dessa maneira, as garotas se tornam mulheres muito cedo sem nem terem tempo de brincar de boneca, por causa, da influencia das mídias, desenhos e series tem em sua vida.', 'A posteriori as redes sociais tem sido campo no qual são muito expostos s crianças e pre-adolescentes a culturas mais maduras criando padrões de beleza infantil. Assim, muitos são manipuladas a seguir este padrão tornando-as mais adultas, é exemplo disto a atriz Mel maia que desde muito pequena foi exposta a um mundo muito adulto, o que a fez tornar-se mulher feita muito cedo, dessa forma mutos outros influenciados pela atriz tiveram o mesmo destino.', 'm vista dos fatos apresentados faz se necessário que o ministério da educação-responsável pelo ensino no Brasil -  por meio de parcerias com os pais, pro,ovam palestras e conversas abertas sobre a sexualização para assim conscientizar desde cedo sobre esta pratica , afim de mais nenhuma infância ser roubada pela ""adultizaçao"" precoce.']",120,160,160,200,160,800
48,Saúde democratizada,"['Excesso de burocracia, falta de infraestrutura, poucos profissionais. Entre os vários desafios enfrentados pelo Sistema Único de Saúde (SUS) figura a carência de gestão, o que corrobora para a perda de qualidade de serviço desse órgão público. Apesar dos desafios, esse sistema representa um papel de suma importância na sociedade brasileira. Nesse sentido, convém analisar seus aspectos negativos e positivos.', 'Em primeira instância, cabe ressaltar que em razão do pouco investimento prestado pelo governo a qualidade desse serviço público é comprometida . Segundo Humberto Costa, médico e ex-ministro da saúde, em 2020, diante dos casos alarmantes de Covid-19 no Brasil, o governo bloqueou 10 milhões de reais que seriam destinados ao SUS. Como consequência, faltam leitos, remédios, materiais básicos para segurança dos profissionais e equipamentos como respiradores. Infelizmente, devido a isso, milhares de vidas são perdidas diariamente, por falta de assistência.', 'Por outro lado, esse serviço de saúde pública é essencial no tecido social. Segundo o Instituto Brasileiro de Geografia e Estatística (IBGE), aproximadamente 77% da população brasileira depende, exclusivamente, do SUS. Com isso, percebe-se que a Universalização da saúde é o principal aspecto positivo desse serviço, que mesmo sendo falho, ainda beneficia muitas pessoas, haja vista que, além de financiar consultas e cirurgias grátis, ainda doa remédios para a população.', 'Destarte, para que a população possa usufruir de melhor assistência no sistema, é necessário que o governo financie equipamentos essenciais nos hospitais públicos, por meio do aumento de verbas destinadas ao SUS. Espera-se com isso, que todos os cidadãos brasileiros tenham acesso a um serviço público de saúde qualificada.']",160,160,120,200,160,800
54,Vacinação,"['Ocorrida em 1904, a Revolta da Vacina teve como objetivo a vacinação obrigatória da população carioca. Todavia, não obteve sucesso, visto que,  a sociedade manteve-se contra o ato rejeitando-a. Hodiernamente, o Brasil enfrenta surto de doenças que poderiam ser controladas pela vacinação. Entretanto, tal como a população de 1904, as pessoas não possuem informações confiáveis a respeito da vacina desconhecendo, assim, seus benefícios.', 'A priori, os movimentos “antivacina” e a falta de informação fazem com que a sociedade rejeite a imunização. O presidente da Sociedade Brasileira de Imunizações (SBIM), Juarez Cunha, em uma determinada entrevista para a revista Saúde Abril, afirmou que muitos pais nunca souberam sobre pólio, rubéola e difteria, doenças que são combatidas pela vacina, e consequentemente optam por não vacinar seus filhos. Assim, a falta de informações fazem com que os pais negligenciem a vacinação.', 'Todavia, as vacinas são essências para garantir a prevenção de possíveis doenças que ameaçam a saúde humana. A exemplo tem-se a rubéola que, de acordo com a pesquisa realizada em 2017 pelo Ministério da Saúde foram registrados cerca de 30 mil casos no Brasil. Graças ao aumento da taxa de vacinação, o índice diminuiu consideravelmente chegando a nenhum caso confirmado em 2017. Dessa forma, é notável a importância da vacinação para todo o país de forma coletiva, podendo até eliminar doenças que antes eram temidas.', 'Portanto, são necessárias medidas capazes de mitigar tal problemática. Para tanto, cabe ao Ministério da Saúde  em articulação com o governo federal propor palestras e eventos educativos tendo como público toda população, trazendo especialistas na área da saúde, relatando a importância das vacinas, a fim de esclarecer as principais dúvidas da sociedade. Desse modo, os indivíduos tornarão informados e casos como a rejeição da vacina como o ocorrido em 1904 não retornarão.']",120,160,80,120,80,560
108,Geração Coca-Cola,"['A compulsão por comprar é um fenômeno que ocorre na maioria da população moderna. Não se restringe apenas ao Brasil, o consumismo afeta todo o mundo, principalmente         nos         países                 ricos e emergentes, como os Estados Unidos, China, Japão, Índia, entre outros.                Cada vez mais o ato de comprar se torna lazer e diversão. O que ninguém percebe é que se pode chegar         um         ponto em que consumir desenfreadamente gerará         problemas,         tanto econômicos quanto psicológicos.', 'A sociedade atual está completamente mudada. Segundo pesquisas realizadas no Reino Unido, crianças de 10 anos conhecem aproximadamente 400 marcas famosas. Isso revela o poder do marketing e a amplitude de faixa etária do público alvo que as propagandas atingem. Antigamente, a única preocupação das crianças         era         quanto         ela poderia         brincar na rua. Hoje, é como se competissem para ver quem tem mais e os melhores brinquedos. Essa ""competição"" surge da sensação de status social por possuir o que há de melhor.', ""Como argumenta a                 autora Cássia D'Aquino                , as famílias que costumavam aproveitar o tempo livre em praças, parques, ou até mesmo em ambientes particulares, hoje optam por levar os filhos ao shopping para comprar. Isso mostra que as crianças estão cada vez mais precoces no quesito do consumismo."", 'O         que         pode ser considerado como uma porta de entrada para o consumo exagerado         são         os cartões de crédito,         cheque         especial,         12 parcelas         sem juros...         Cegos         pelas propagandas apelativas, qualquer um cai na armadilha de que é ""só um pouquinho por mês"" e         acabam         se prejudicando quando         recebem         a fatura.', 'Pelo vício de adquirir cada vez mais, os consumistas sempre acabam gastando mais do que podem. O problema que isso acarreta é dívida. E, devendo, não se pode mais comprar como antes,         e         essas pessoas acabam muitas vezes ficando depressivas. É por esse fato que é necessário um controle sobre o impulso de consumir, para que esse hábito não se torne vicioso e muito menos prejudicial.']",160,200,160,160,120,800
86,A SAÚDE MENTAL NAS REDES,"['Black Mirror é um seriado britânico que explora, de maneira niilista, a relação do homem com a tecnologia. Atrelado a isso, na sociedade brasileira atual, há uma forte influência das redes sociais na vida das pessoas - sejam elas crianças, adolescentes, adultos ou idosos. Nesse sentido, essa exposição nesse veículo midiático pode proporcionar alguns danos à saúde mental. Nessa perspectiva, convém avaliar como que as mídias sociais ocasionam danos para a saúde mental e quais as consequências disso para a população, com o objetivo de propor intervenções válidas para essa problemática social.', 'Em princípio, atualmente, as redes sociais são fortemente associadas a uma gama de problemas psíquicos na população brasileira. Consoante a isso, a forte exposição que as pessoas apresentam nas redes sociais alteram o seu comportamento – ainda mais no período pandêmico atual, em que é recomendado o isolamento social. Com isso, esses indivíduos tendem a copiar comportamentos de influenciadores, comparam-se com os outros internautas e, ainda, procuram desesperadamente por seguidores e “curtidas” em suas postagens. Com essa lógica, esses indivíduos estão mais propícios a desenvolver problemas com a sua saúde mental, pois esses veículos midiáticos têm a constância de ditar regras, modas e comportamentos e, com isso, orienta os seus internautas. Logo, é substancial a mudança desse quadro.', 'Outrossim, vale ressaltar que muitas são os impactos que provêm do uso das redes sociais. Assim sendo, isso pode ser explicado pela forte capacidade que as mídias digitais possuem em viciar os seus internautas, porque proporcionam a eles uma série de hormônios que geram prazer e alegria. A título de exemplificação, depressão, ansiedade e baixa autoestima são alguns dos impactos que essa alta exposição pode desencadear. Como exemplo ficcional, no episódio intitulado “Queda Livre”, da série Black Mirror, uma sociedade hipotética é hierarquizada de acordo com a quantidade de estrelas que as pessoas recebem de uma determinada rede social. Observa-se, entretanto, que a protagonista é fortemente afetada por essa mídia e, por isso, é capaz de realizar atitudes antiéticas para pode se manter no pódio dessa rede social. Desse modo, o seriado critica a maneira com que a sociedade acaba sendo afetada, psiquicamente, pelas mídias digitais. Em síntese, é crucial que seja elaborada intervenções para mitigar essa problemática social.', 'Percebe-se, portanto, que as redes sociais desencadeiam muitos problemas na saúde mental dos cidadãos brasileiros. Dessarte, as escolas, intuições responsáveis pela educação formal,  deve elaborar a disciplina Educação Digital, sob a tutoria de docentes aptos, com o fito de poder educar aos discentes sobre a influência das redes sociais na saúde mental. Somado a isso, o governo federal, órgão de maior instância de poder no Brasil, em parcerias com as mídias digitais e televisivas, deve propor a elaboração de propagandas que informe a população a respeito dos impactos que as redes sociais podem acarretar na saúde mental das pessoas. Posto isso, com essas medidas, as consequências do uso das redes sociais na saúde mental seriam ceceados no território brasileiro.']",160,200,160,200,200,920
73,,"['""Isso é coisa de preto"". Pare para pensar, e reflita se em algum momento de sua vida, você não proferiu, ou já ouviu alguém dizer  está célebre frase . Pois é, estas são algumas das muitas palavras que os negros já estão acostumados a ouvir. Uma pesquisa do Instituto Locomotiva,  mostrou que 72% dos negros já ouviram: eu cabelo parece bombril""; 51% já escutaram: ""trabalho de preto""; 58%: ""seu macaco"";  é recorrente nos dias atuais, devido às conjecturas históricas  do nosso país.', 'Brasil,  uma nação, com certeza, das mais miscigenadas que se tem atualmente. Fruto da herança herdada pelos nossos colonizadores. As diversas diferenças que se tem hoje no biotiopo da população, poderiam qualificar o nosso país como um dos mais igualitários que se existe, no entanto, contriando tudo e todos, as coisas não funcionam assim. Mesmo, a população negra ou parda, sendo 51% dos brasileiros, isso não foi o suficiente para que estes,  não sejam as maiores vítimas das mazelas que a assolam a sociedade. Eles são os mais assassinados, eles são a maioria nos presídios, eles ganham menos, mesmo exercendo a mesma função. --- E detalhe meu caro leitor,  se você é mulher e negra no Brasil a situação é muito pior.', 'Por fim,  em vista de tudo que foi apresentado, nós tínhamos tudo par ser um lugar onde todos teriam as mesmas oportunidades, mais fazer o qu? Se as coisas não seguiram o rumo que seria o ""normal"". Claro, o que deve-se fazer,  é tentar amenizar as disparidades. As cotas raciais devem continuar, as punições por crimes devem ser revistas e melhoradas para não ter ""brechas"" na lei, e o mais importante, educação voltada para formação de cidadões com mais respeito e consciência de igualdade, outras medidas são necessárias, mas, como disse Oscar wilde: O primeiro passo é o mais importante na evolução de um homem ou nação .']",80,120,120,120,80,520
75,Sem segurança não há avanço,"['Para tratar deste assunto primeiramente deve-se saber diferenciar o porte de armas com a posse de armas. Posse é o ato de possuir uma arma em sua residência, o que é legalizado, desde que o indivíduo seja o dono da residência e esteja capacitado. O porte de armas é o ato de transportar uma arma de fogo em locais públicos.', 'O fato de ter uma arma de fogo consigo não anula as possibilidades de ser morto em um assalto ou qualquer outro ato de criminalidade, pois querendo ou não os criminosos já têm uma certa habilidade em relação as armas, o que deixa o cidadão brasileiro um passo atrás por não ter muito contato com tal objeto.', 'Além disso, os índices de mortalidade aumentariam ao invés de diminuir, pois em qualquer situação em que uma pessoa se sentisse ameaçada bastava pegar sua arma e atirar.', 'Para o avanço do país precisa-se ir mais além do que apenas legalizar o porte de armas. Necessita-se tomar medidas tais como, o desarmamento de criminosos, melhorias na segurança e educação, leis mais severas e acabar de vez com a corrupção.']",120,80,80,80,80,440
52,Gravidez na Adolescência em Evidencia no Brasil,"['O grau de Informação para esses adolescentes que tem Gravidez precoce entre 12 a 19 anos é baixo, pois também é questão Cultural e Social.', 'Existem alguns fatores que contribui para altas taxas de gravidez na Adolescência. Hoje em dia as famílias estão muitas ocupadas com trabalho e meio social e com meio Tecnológico e acabam perdendo tempo, que poderia ser destinado ao momento familiar e deixando que a Educação dos seus filhos sejam terceirizadas. Outro fator é a falta de conhecimento da sexualidade desses adolescentes  não ser conscientizados pela família, Dialoga entre os filhos mostrando a responsabilidade e consequências que terão , além disso podem adquirir Doenças Sexualmente Transmissíveis, A qualidade de vida baixa também influencia para o aumento desse Índice, pois muitas delas abandona os estudos, casa dos Pais para se envolver na Prostituição e por serem Adolescentes inexperiente sem Informação adequada acabam ficando gestantes, mudando toda sua rotina, e assim passando até dificuldades financeiramente,, por sua vez muitas delas traz problema emocionais e transtornos psicológicos.', 'Dessa forma o Governo poderia criar programas de incentivos, e informativos educacionais sobre sexualidade para diminuir esse índice, e não teria tanto impacto na Saúde Pública, e a s famílias dialogar entre os filhos abordando riscos e consequências e responsabilidades, usar a mídia e a tecnologia como principal fonte de conhecimento e Informação não só para os adolescentes mas para toda população conscientizar.']",80,120,80,80,80,440
79,Onde não há educação! Há Problemão,"['O sistema penitenciário no Brasil é caro e ineficaz. O Ex- Ministro  da justiça  José Eduardo Cardozo  falou em rede nacional que se fosse condenado a cumprir pena em um presidio comum brasileiro se mataria antes. Disse que se existe um inferno com toda certeza os cárceres nacionais são as inspirações do capeta. E as pessoas riem e ainda acham pouco tudo o que um condenado passa.', 'Um governo que não investe em educação porque acha que é caro.  Pagará muito mais caro o preço da ignorância. Quando uma pessoa entra no mundo do crime ganha uma passagem sem volta, então  a missão dos governantes e da sociedade é impedir que o crime destrua cada vez mais famílias  seja  como vitimas  ou  como causadores.', 'á   Com educação de qualidade, porque ela é a única e a mais poderosa arma capaz de mudar qualquer sistema. Educação primeiro! Onde não há educação faltará tudo. Se no passado uma família era capaz de cuidar de 15 filhos, por que hoje não tem capacidade de educar e disciplinar um? O que mudou no mundo da década de 70 até hoje? Será que a resposta para esse caos no mundo não estar no passado? Até quando a sociedade brasileira aceitará viver presa mesmo que em cárcere de luxo? Enquanto o poder politico negligência suas obrigações de educar e cuidar de seu povo.', 'Esse é um problema nacional e deve ser enfrentado com coragem e responsabilidade, e não com paliativos provisórios que logo ficam eternos. Essa situação deve ser extinta para sempre para que assim esse sistema se transforme em uma nova realidade, que seja barato, eficaz e lucrativo pelo menos na dignidade humana. Talvez um novo olhar, um novo toque e uma nova chance de escolher um novo caminho.  Porque até agora eles não tiveram escolhas, foram escolhidos por esse sistema desigual, pois a realidade mostra que eles não valem nada, e todos sabem que quem mais pode prejudicar a sociedade são aqueles que acreditam que suas vidas não têm valor.']",120,120,120,120,120,600
79,Direitos humanos,"['""Toda pessoa tem direito a um nível de vida suficiente que lhe assegure a saúde e o bem-estar."" Essa é a afirmação que se encontra no artigo 25, parágrafo 1º  da Declaração Universal dos Direitos Humanos. Contudo, o documento escrito pela Organização das Nações Unidas (ONU) não é obedecido pelo sistema carcerário brasileiro, que mantém seus prisioneiros em condições de insalubridade, tortura e superlotação. Diante disso, é necessária uma maior atenção do Governo para intervir no problema.', 'Ainda citando a Declaração Universal dos Direitos Humanos, artigo 5º: “Ninguém será submetido à tortura nem a penas ou tratamentos cruéis, desumanos ou degradantes.” Trata-se de mais um definição que não se aplica aos presídios brasileiros, uma vez que os detentos são agredidos com frequência pelos agentes penitenciários e, além disso, são torturados física e psicologicamente durante os interrogatórios policiais. Depreende-se através  disso que o sistema carcerário brasileiro não é eficiente, uma vez que apenas castiga o prisioneiro ao invés  de fazê-lo entender a gravidade de seus delitos, evitando novos crimes.', 'Outrossim, a insalubridade aliada à superlotação das cadeias não condicionam  a saúde e o bem-estar assegurados pelo documento da ONU. Tais problemas podem causar conflitos entre os prisioneiros, o que foi o caso de um complexo penitenciário em Manaus. Classificada como a segunda maior chacina ocorrida no Brasil, ficando atrás apenas do massacre de Carandiru, em São Paulo, a rebelião manauense resultou em 56 mortes, incluindo esquartejamentos e decapitações.', 'Portanto, o sistema prisional brasileiro necessita de atenção e reforma gerida pelo Governo Federal. Ao invés  de construir novos presídios, o foco deve ser a conscientização dos detentos, o que pode ser feito através  de melhorias na qualidade e no acesso à educação pública. Dessa forma, impede-se que novos delitos aconteçam, evitando assim a superlotação das cadeias. Além disso, é função do Governo fornecer ambientes bem equipados que atendam às  necessidades básicas dos detentos, como saneamento, alimentação e lazer. Assim, é possível haver respeito e harmonia no convívio entre prisioneiros sem privá-los de seus direitos.']",160,160,160,160,160,800
1,A qualificação profissional no Brasil,"['Promulgada pela ONU em 1948, a Declaração Universal dos Direitos Humanos garante a todos os indivíduos o direito ao trabalho e ao bem-estar social. Conquanto No entanto, a o o nível de qualificação profissional exigido atualmente impossibilita que essa essa essa parcela da população desfrute desse direito universal na prática. Nesse sentido, convém analisarmos as principais consequências de tal postura negligente para nossa sociedade.', 'A educação é o fator principal no desenvolvimento de um país. No entanto, apesar de ocupar a nona posição na economia mundial, o Brasil possui um sistema de ensino público ineficiente, e insuficiente e o resultado desse contraste é claramente refletido na falta de qualificação profissional do povo brasileiro. De acordo com o IBGE (Instituto Brasileiro de Geografia e Estatística), 41,3% dos trabalhadores brasileiros são informais. Diante do exposto, fica evidente a exclusão social vivenciada pelos profissionais com baixa qualificação, visto que a seleção de perfis será mais criteriosa e baseada no conhecimento técnico, aumentando assim a concorrência no mercado de trabalho.', 'Faz-se mister, ainda ainda, salientar a necessidade de promover melhorias no sistema de educação inclusiva do país. Nesse âmbito, as transformações no mercado de trabalho vem vêm ocorrendo com mais velocidade graças ao rápido desenvolvimento tecnológico e científico. Logo, o profissional do futuro terá que aperfeiçoar seus conhecimentos, assim como saber manejar as novas tecnologias.', 'Portanto, indubitavelmente, medidas são necessárias para resolver esse problema. O MEC deve investir em cursos profissionalizantes para pessoas desempregadas com o objetivo de auxiliar na inserção dessas sua inserção no mercado de trabalho. Já o Ministério do Trabalho Trabalho, em parceria com as empresas empresas, deve fazer atualizações nós nos cursos já existentes de seus trabalhadores com o intuito de manter-los modernizados e presentes mantê-los atuzalizados na utilização de novas tecnologias. Pois só assim assim, como dizia Nelson Mandela: ""a educação é a maior arma que se pode usar para mudar o mundo"".']",80,120,120,80,120,520
87,Crescimento forçado,"[""Na obra ''Sociedade do espetáculo'', do escritor francês Guy Debord, é retratada uma sociedade ideal, na qual todos os cidadãos gozam de discernimento sociocultural. Contudo, essa sociedade proferida pelo autor está muito distante da realidade brasileira, visto que há inúmeros problemas, por exemplo a cultura da erotização infantil, dificultando que o país alcance o patamar proposto por Guy. Nesse contexto, fatores como negligência familiar agravam essa situação."", 'Diante disso, é fulcral pontuar que a cultura da erotização infantil deriva da baixa atuação dos setores governamentais, no que concerne à criação de mecanismos que coíbam tais recorrências. De acordo o pensador Friedrich Hegel, o Estado é responsável por proteger seus “filhos”, entretanto, isso não ocorre no Brasil. Devido à baixa atuação das autoridades, é notória a exploração do trabalho infantil por meio da exposição, principalmente nas mídias socais, a qual vai de encontro com a lei do Estatuto da Criança e Adolescente que proíbe o trabalho exercido por menores. Consequentemente, tal ato contribui com o aumento da cultura da erotização desses indivíduo. Desse modo, faz-se mister a reformulação dessa postura estatal de forma urgente.', 'Ademais, é imperativo ressaltar a negligência familiar como impulsionadora do problema. Nesse sentido, consoante ao artigo 227 da Constituição federal de 1988- ei de maior hierarquia jurídica do Brasil- é dever da família assegurar o direito à proteção das crianças. No entanto, é fato que parte da população não desfruta desse direito na prática, visto que não há um monitoramento, dos pais, sobre aquilo que as crianças estão expostas nas redes sociais, por exemplo a músicas sensuais, especialmente as cantadas por menores de idade, que, por conseguinte, os induzem a um comportamento adulto e a passar uma visão erotizada da própria imagem. Tudo isso retarda a resolução do empecilho, já que a negligência familiar contribui para a perpetuação desse quadro deletério.', 'Portanto, diante do problema exposto, medidas são necessárias para conter o avanço da problemática na sociedade brasileira. Por isso, a fim de solucionar a exploração do trabalho infantil e negligência familiar, é preciso que o Estado, no papel do Ministério da Educação, crie uma série de ações que tenha como finalidade o monitoramento do trabalho infantil nas redes sociais e de alertar a família sobre os riscos da falta de monitoramento. Essa ação deverá ser realiza por meio da distribuição de profissionais para a fiscalização da exploração do trabalho de menores nas mídias digitais, além de disponibilizar propagandas que mostrem s famílias a importância do monitoramento do que é assistido por seus entes. Destarte, não haverá mais problemas com a cultura da erotização infantil e o Brasil se aproximará da sociedade ideal de Guy.']",160,200,160,200,160,880
61,Suicídio no meio profissional,"['Tem se tornado cada vez mais comum a mídia e os meios de comunicação relatarem fatos relacionado ao “suicídio”. Jovens, idosos, crianças sem separação em classes sociais ou “títulos” em que se permeiam. Atualmente até mesmo pastores, padres, policiais tem se tornado vitima desse ato.', 'Sabe – se que não é de hoje que é gerado esses acontecimentos, séculos atrás já era bastante comum, basicamente no século XVIII (romantismo), o suicídio já era considerado um dos “mal do século”.', 'Vários motivos levam o ser humano a tomar uma atitude tão drástica como essa, mas já dizia Zigmunt Baumann: “não são as crises que mudam o mundo, e sim nossa relação a elas.” Não é o contexto que o homem vive, suas emoções que deverá dar o domínio de si e determinará suas atitudes e sim princípios pensados com sabedoria, emoções são só momentâneas.', 'É de conhecimento geral que policiais tem sobre si uma carga imensa, uma responsabilidade gigantesca e suas ações necessitam serem atuadas sempre com muita cautela. Correm perigos diariamente, o estresse, cansaço físico e emocional por muitas vezes tomam conta, é incomparável o peso carregado.', 'E o que leva o ser humano a suicidar –se é o vazio na alma, é a busca incansável por socorro e nunca alcança – lo, é sofrer desesperadamente e não ter onde recorrer, tentar ser forte o tempo todo escondendo feridas e as mais profundas tristezas. Mas o que homem precisa entender é que a morte não é a solução, em cada processo seja a dor ou o oposto existe um propósito.', 'Tanto policiais quanto pessoas que trabalham com seres humanos, trabalhos que geram de fato grandes responsabilidades, cansaços extremos e que trabalham com emoções, a OIT (Organização Internacional do Trabalho) deveria sancionar uma lei ao qual tais trabalhadores teriam acesso a psicólogos, terapeutas, conselheiros facilmente, dentro da própria empresa em que atuam. Onde com toda certeza, ajudaria muito nesse processo. Podendo até mesmo fazer com que o suicídio causado por sobre carga profissional se torne apenas uma mazela na historia brasileira.']",120,80,40,80,40,360
87,,"['É indubitável que a cultura de erotização infantil se faz cada vez mais presente no mundo contemporâneo. Incentivados pela mídia, crianças e adolescentes estão sendo expostos cada vez mais a situações não condizentes com suas faixas etárias, o que pode acarretar em problemas futuros.', 'Em primeira análise, é importante salientar que a mídia atualmente se constitui como um dos principais fatores que corroboram no processo de erotização infantil, uma vez que crianças e adolescentes estão expostos a diversos conteúdos muitas vezes inadequados para sua idade. Um exemplo recente foi a obra cinematográfica “Cuties” produzida pela plataforma de streaming Netflix, que recebeu diversas críticas por incentivar a erotização infantil, uma vez que as protagonistas do filme que representam crianças de apenas 11 anos aparecem em poses sexualizadas em um palco de dança.', 'Ademais, vale também ressaltar que uma ruptura precoce da infância, etapa primordial na vida de qualquer criança, pode levar o mesmo a apresentar problemas em seu desenvolvimento podendo até mesmo estimular o aparecimento de doenças psicológicas, tais como ansiedade e depressão.', 'Tendo em vista os aspectos mencionados, urge, portanto, a necessidade de medidas que garantam o crescimento saudável das crianças e adolescentes. Portanto, para reverter tal situação, é necessário que o governo federal  crie campanhas de conscientização sobre “A cultura de erotização infantil”, mostrando os impactos negativos que a problemática pode causar na vida das crianças e alertar os pais sobre a importância de supervisionar os conteúdos voltados aos mesmos.']",200,120,120,200,160,800
73,,"['A busca por igualdade de oportunidades para os negros no Brasil é um desafio centenário, que possui inúmeros entraves pelo caminho. Observando a historia do país, nota-se que o centro desse obstáculo remonta a formação cultural brasileira, desde o período de colonização portuguesa. Medidas estão sendo executadas para superar essa adversidade da sociedade brasileira.', 'Dados estatísticos apontam que o Brasil foi o país que mais recebeu escravos durante o mercantilismo europeu, pós a abolição da escravatura em 1888, milhares de antigos cativos,  passaram a marginalização da sociedade por falta de oportunidade de inserção social . Como consequência dessa situação os negros passaram a obter os maiores índices de analfabetismo, menores taxas de empregos formais e maiores taxas de crimes que resultou em cerca de 60% da população carcerária do país.', 'O artigo 5 da Constituição Federal descreve que todos são iguais perante a lei, sem distinção de qualquer natureza, ou seja, uma garantia de igualdade jurídica e social, embora na prática a lei frequentemente não é cumprida. Exemplo como o Pastor Martin Luther King que buscava pacificamente nos Estados Unidos  nos anos 1960a igualdade de negros e brancos,mostra o papel que a organização social possui na construção de uma sociedade.', 'Portanto, indubitavelmente, superar os desafios para a igualdade dos negros é fundamental para o país. Medidas como as cotas raciais são positivas para esse fim, o rigidez da lei contra o crime de racismo afetar diretamente, diminuindo as taxas desse crime. Criação pelas secretarias da educação e justiça de projetos educacionais como palestras escolares, debates nos meios de comunicação com objetivo de conscientizar as famílias da importância do convívio pacifico, somado com iguais oportunidades para qualquer etnia ou grupo social é essencial para o exercício da cidadania brasileira.']",160,120,120,160,120,680
88,doenças mentais,"['Em dados divulgados pela OMS  mostra que 11,5 milhões de brasileiros tem depressão. Em uma sociedade que visa de forma antagônica pessoas com algum transtorno mental, vê-se um problema que expõe as vísceras, uma falta de conhecimento populacional e uma falta de debate sobre a problemática que cria raízes no mundo pós-moderno. Que precisa ser revertida de forma eficaz.', 'Em primeira análise, uma falta de debate se torna uma das tangentes do estigma associado aos transtornos mentais visto o silenciamento por parte das mídias e do governo sobre as doenças mentais que causam grande desequilíbrio social e econômico . Atingindo milhões de pessoas no mundo; em frase celebre o pensador Foucault diz o seguinte sobre o silenciamento de questões socias: Na sociedade Pós-moderna, temas são silenciados para que estruturas de poder sejam mantidas. Nesse ponto de vista, se há algo, mídia ou governo, que está lucrando com a imagem de perfeita de influenciador emocionalmente estruturado, não há porque haver debate, já que está gerando lucro. Dificultando ainda mais a resolução do problema.', 'Além disso, uma sociedade sem conhecimento dos problemas que lhe afligem, está fadada ao fracasso. A falta de conhecimento populacional é uma causa que contribui com o preconceito aos transtornos mentais, visto que não há uma campanha eficaz que, vise desarticular uma sociedade preconceituosa. Nesse sentido, na teoria da percepção do estado da sociedade, de Émile Durkheim, sociólogo francês, abrangem-se duas divisões: ""normal e patológico"". Seguindo essa linha de pensamento, observa-se que um ambiente patológico, em crise, rompe com o seu desenvolvimento, visto que um sistema desigual não favorece o progresso coletivo.', 'Depreende-se, portanto, a relevância da importância da saúde mental e da normalização dos transtornos mentais, como algo comum ao ser humano. Para isso, é preciso que o Estado proporcione rodas de debate, usando a mídia como meio de propagação, com a presença de psicólogos, psicanalistas e professores. Os eventos ocorreram por meio de lives. Além disso, o meio educacional deverá trazer o preconceito associado aos transtornos mentais para a sala de aula, por intermédio de debates e palestras, na área das Ciências Humanas, como forma de esclarecimento populacional. Assim, haverá um ambiente estável que visa a desmistificação dos transtornos mentais, normalizando pessoas com essas condições.']",160,160,160,200,160,840
45,As ações que prevalecem,"['O escritor brasileiro Paulo Coelho descreveu em um artigo escrito para o The Washington Post que sofreu tortura física e psicológica no período da ditadura militar. Atualmente, devido as alterações políticas e sociais, esse processo histórico ditatorial, ocorre quando policiais coibem manifestantes de protestarem pacificamente.', 'Uma manifestação política e social ocorre quando os integrantes de um grupo não estão satisfeitos com as ações do representante no governo brasileiro sendo que, os próprios cidadãos escolheram ele sob a forma da democracia representativa . Por isso, Hobbes quando afirma que "" o homem é o lobo do homem"", quer dizer que a individualidade se sobrepõe ao coletivo em diversos momentos de construção social.', 'Enfim, a lei existe para ter um funcionamento eficiente e não algo que precise a todo instante de reparos por causa das atitudes equivocadas seja, por parte de policiais, promotores de justiça. Com isso, é inaceitável que os menos favorecidos economicamente não possam expressar seus pensamentos, ter liberdade de ir e vir nos âmbitos sociais. Logo, o Ministério Público  precisa fiscalizar as ações policiais e, a punição a quem persistir se beneficiando de modo irregular do cargo, merece ser exonerado do mesmo.']",120,120,80,120,80,520
114,Traumas sociais,"['As tragédias têm o poder de nos aterrorizar em um primeiro momento, para depois provocar inúmeros questionamentos. O massacre de Realengo no Rio de Janeiro, além da comoção nacional, provocou debates acerca dos motivos que levaram aquele rapaz a praticar tamanha insanidade.', 'Com o objetivo de dar uma resposta rápida e mais cômoda, nossos políticos levantam a bandeira do desarmamento. Buscam, com isso, jogar a responsabilidade para a sociedade. Esquecem que essa matéria já foi tratada no Plebiscito, o qual refletiu a opinião nacional pela não proibição à venda de armas.', 'Prevenir crimes dessa magnitude não passa por atitudes simplistas como essa. Há outros fatores que favorecem ou incentivam massacres de inocentes, quais sejam o fanatismo religioso, distúrbio mental ou vingança.', 'Esse último parece ser o motivador principal, uma vez que depoimentos dos ex-colegas de sala de aula dão conta                que o atirador de Realengo era discriminado. Essa circunstância também aflora nos caos ocorridos em outros países, notadamente no EUA.']",160,200,160,200,200,920
49,o papel dos influenciadores digitais,"['O psiquiatra e escritor brasileiro Augusto Cury afirma que ""nada é tão perigoso para aprisionar a inteligencia do que do que aceitar passivamente as informações\'\'.Essa visão, embora correta não é efetivada no cenário nacional no que concerne a falta de olhar crítico da sociedade em relação aos papéis desenvolvidos pelos influenciadores digitais. Portanto, é imprescindível relatar sobre os pontos positivos e negativos do trabalho que tem sido efetivado por esses profissionais.', 'Atualmente, observa-se que os influenciadores digitais desempenham uma atividade relevante . Essa modalidade foi criada recentemente, em decorrência da acensão das redes sociais. Com o propósito de divulgar uma marca e aproximar os clientes de produtos e serviços, esses especialistas proporcionam uma humanização da comunicação, uma vez que suas atuações abrangem várias temáticas como culinária, jornalismo, entre outras. Por conseguinte, contribuindo para o crescimento intelectual da população.', 'Por outro lado, essa nova ferramenta de marketing vem sendo utilizada para formar e moldar opiniões das pessoas, posto que uma parte dos influênces fazem uso de sua oratória para convencer pessoas . De acordo com Pierre Bourdieu, sociólogo francês, não existe democracia efetiva sem um verdadeiro crítico . Dessa maneira, entende-se essa questão como uma problemática, posto que o direito  liberdade previsto na Constituição Federal tem sido violado.', 'Portanto, são necessárias medidas capazes de mitigar essa problemática. Com intuito de transformar a situação vigente, cabe ao Ministério da Educação em parceria com a mídia abordar sobre a necessidade de um posicionamento crítico referente ao conteúdo transmitido na internet e redes sociais . Isso deve ocorrer por meio de promoções de palestras e informativos abrangendo todas as faixas etárias. Assim, tornando a sociedade mais consciente e por conseguinte, proporcionando o crescimento da nação']",160,160,120,160,160,760
95,A demarcação das terras indígenas como direito constitucional,"['A Constituição federal de 1988, lei suprema do Brasil, garante em seu artigo 231 o direito à terra para os povos nativos, entretanto, recentemente seu significado vem sendo questionado pela tese do “arco temporal”, critério o qual afirma que a demarcação das terras devem ser realizadas apenas para os povos que já a ocupavam no ano da promulgação da Constituição. Tal critério apresenta problemáticas a serem discutidas ao se analisar as conveniências da proposta a seus apoiadores e a trajetória histórica dos povos nativos brasileiros desde a colonização portuguesa.', 'Convém lembrar que a bancada ruralista, frente parlamentar que atua em defesa dos interesses dos proprietários rurais é um das maiores apoiadoars do “Marco temporal”, tal circunstância pode ser facilmente relacionada ao fato de que as terras dos indígenas são de grande interesse para uso na agropecuária . Cabe ressaltar que tal fato fomenta as preocupações acerca do desmatamento, já que a demarcação de terras indígenas é considerada uma grande estratégia para preservação ambiental, enquanto que com o território na mão dos grandes latifundiários, ela é desmatada para criação de gado e plantio de alimentos.', 'No desenho “Moana”, produção dos estúdios da Disney, é abordada a ligação que os povos nativos de uma ilha possuíam com a terra que habitavam. Paralelo a isso, fora da ficção, os indígenas brasileiros também afirmam que possuem uma conexão com a área em que moram, a qual os auxilia a realizar a manutenção da própria cultura, sendo válido citar que, durante a colonização portuguesa no Brasil, em 1500, seus antepassados foram expulsos de seus territórios e usados para mão de obra escrava, tendo sua cultura e família oprimidos pela coroa pportuguesa. Os indígenas só conseguiram recuperar algumas terras vários séculos depois e em quantidade pífia em comparação a enorme quantidade de território ocupado antes da chegada dos portugueses.', 'Em virtude dos fatos mencionados, faz-se necessário que o Supremo Tribunal Federal, poder legitislativo brasileiro, cumpra com sua função de garantir os direitos constitucionais e recuse propostas que relativizam os artigos da constituição em detrimento de interesses próprios, garantindo assim os direitos dos povos indígenas e mantendo suas terras por direito, a fim de continuarem a conservar sua cultura em segurança.']",160,160,120,120,160,720
92,A invisibilidade da xenofobia com pessoas asiáticas.,"['O preconceito está presente em diversas formas do corpo social, e uma delas é a xenofobia com os povos asiáticos. Dessa forma, destaca-se avaliar o preconceito amarelo presente na sociedade. Ademais deve-se analisar a construção de estereótipos e a sua contribuição para a dispersão do preconceito. Assim, são necessárias medidas realizadas por meio da educação para barrar essa problemática do âmbito social.', 'Nesse viés uma das bases do preconceito amarelo é a formação de rótulos para classificar uma etnia. Outrossim, na série americana “Modern Family” - disponível na plataforma de streaming Netflix - a personagem Lilly mudou-se do seu país atual, o Vietnã, para os Estados Unidos após a sua adoção e por possuir determinadas características é chamada de chinesa e japonesa. De maneira análoga, esses rótulos usados para designar distintos países ignora fatores socioculturais, pois uniformiza diferentes povos em um só. Em suma, essa base precisa ser desconstruída para derrubar essa corrente da xenofobia.', 'Além disso, a partir desses estereótipos é gerado dispersão de assédios verbalmente. Do mesmo modo, na série “Sombra e Ossos” - disponível na Netflix - a personagem principal é privada de algumas ações e agredida a com preconceitos verbais por ser da etnia “Shu”. De forma semelhante à realidade além dos estereótipos serem negativos por si mesmos, eles ocasionam a dispersão do preconceito principalmente verbal. Em síntese, com a derrubada de rótulos ocorrerá a reação de desmonte do preconceito amarelo.', 'Portanto, frente à problemática social do preconceito amarelo, são necessárias medidas. Urge ao Ministério da Educação - na sua função de fomentar a educação brasileira - promover a visibilidade da discussão da xenofobia com asiáticos. Desse modo, por meio de palestras e debates em instituições públicas e privadas gerar o fito de diminuir gradativamente os estereótipos e, consequentemente, o preconceito amarelo.']",160,160,120,200,160,800
85,Do pensamento maquiaveliano ao fim da opressão,"['Ainda que em uma democracia representativa, o povo não tenha direta participação nas leis, ele ganha esse direito com ferramentas como o referendo, o plebiscito e as leis de iniciativa popular. Entretanto, com base na análise da histórica situação brasileira de ampla desigualdade social, percebe-se a falta da voz expressiva do povo na política brasileira. Isso se dá principalmente pela defectível educação que faz com que o povo fique alienado da política.', 'Se para Maquiavel o desejo do governante é sempre de oprimir e (o) desejo do governado é de não ser oprimido, podemos inferir que em uma democracia representativa isso se vale, já que os políticos, escolhidos pelo povo, tentem a representar os seus próprios interesses. Nesse cenário, cabe ao povo, para não ser oprimido, utilizar de sua própria voz nas decisões políticas, mas isso não vem acontecendo na sociedade brasileira, tendo em vista que, desde 1988 só foram aprovadas quatro leis de iniciativa popular.', 'Assim sendo, a desigualdade social no Brasil não apresenta grandes mudanças e o povo acaba ficando sem aparato na política. A falha na educação brasileira tem importante participação nesse panorama, haja vista que, para formar cidadãos verdadeiramente críticos, deve-se deter de um bom ensino. Isso faz com que grande parte da população não entenda sobre sociedade, política, e pior, não queira entender tornando mais fácil a opressão imposta pela elite.', 'Diante dessa problemática, cabe, portanto, ao povo, por meio da análise das leis e de como estão sendo aplicadas, a maior participação política, não se alienando e nem dando liberdade para que o político possa fazer o que quiser. As instituições de ensino também devem atuar com a melhora no seu método de ensino, isso por meio de aulas específicas sobre política e sobre o papel do cidadão, fazendo com que os jovens não apenas entendam, mas queiram aprender mais sobre isso.']",160,80,160,160,160,720
124,Lixo ou Luxo,"['Devido                 ao aumento                da população das grandes cidades e                 com o aumento                do consumo de produtos, a quantidade de lixo também                 tem aumentado                . Os aterros e lixões quase que não estão suportando mais a quantidade de resíduos sólidos.', 'O         cidadão, tem          toda responsabilidade com as consequências do meio social, político e econômico em que convive, portanto não por acaso que temos grandes problemas com o lixo em nosso mundo. Por consequências que deixamos de lado achando que esse problema irá se resolver sozinho.                Necessitamos de conscientização por parte da população.', 'Devemos pensar                 em infinitas possibilidades                para dar um fim útil ao lixo, porém só temos uma solução a reciclagem, que em algumas partes do país         já estão sendo exercidas,         mas é em                 penas proporções                o que não resolve o problema por completo.         A varias publicidades         sobre o destino correto do lixo, mas nada que resolva.         Ha         muito tempo existem pessoas que sobrevivem do lixo, que muitos acham que não tem utilidade.', 'O         acumulo          de lixo                em esgoto pode causar enchentes,                diminui a vazão de água.                 Fora os que ficam espalhados pelas ruas causando odor e péssima visão de infraestrutura e causar doença.', 'Mas,                   a         também projetos que andam         mudando, a         renda familiar de pessoas         pobre         que catam material reciclável das ruas. E mudando o conceito da sociedade sobre jogar lixo no lixo, fazer a separação dos resíduos recicláveis dos orgânicos, para facilitar as coletas.', 'No entanto, a solução mais adequada seria a reciclagem, e buscar viver de uma forma mais ecológica para diminuir a degradação do meio ambiente como por exemplo reutilizar os papéis usados.']",80,120,80,80,80,440
70,Um perigo silencioso,"['No dia 7 de julho, no ano de 1990, falece o cantor Cazuza, cuja morte foi causada pela AIDS, uma das mais famosas DSTs . Atualmente, raramente há mortes causadas por DSTs, mas não porque as doenças vem sendo reduzidas. Muito pelo contrário, aumenta cada vez mais o números de jovens infectados.', 'Em fevereiro deste ano, o Ministério da Saúde divulgou que casos de HIV e Aids entre jovens de 15 a 24 anos aumentou 85% nos últimos 10 anos. Um dos fatores que faz esse número ficar cada vez maior é os jovens negligenciarem esses tipos de doenças . Isso acontece pela razão de a luta pela doença não foi vivenciada pela geração que hoje tem até 30 anos, considerada assim ""normal"" pelos mesmos.', 'Assim dizia Arthur Schopenhauer, filósofo alemão: ""O maior erro que um homem pode cometer é sacrificar a sua saúde a qualquer outra vantagem"". Mas infelizmente é exatamente isso que acontece. Os jovens contraem s DSTs  devido a falta de proteção adequada, a camisinha. Alegam “reduzir o prazer”, “ser difícil de colocar”, “prejudicar a ereção” e “não ter sempre à mão”, claras desculpas que podem acabar em um grande problema.', 'Então conclui-se que medidas devem ser tomadas urgentemente. Devem ser feitas palestras e medidas na forma educacional dos adolescentes, por especialistas como médicos, enfermeiros, psicólogos, para que mitos sejam quebrados e mostre também como é a vida com alguma DSTs, mostrar que vale a pena se prevenir. É importante que esse assunto não seja considerado uma incógnita pelos adolescentes, importante que haja um suporte dos pais. Esse assunto deve se tornar comum, diariamente comentado e falado pelas mídias em geral, para que não haja preconceito e as barreiras sejam quebradas.']",120,160,120,160,120,680
82,Automedicação pode se tornar um perigo,"['Atualmente é constante o número de pessoas que automedicam  sem prescrição médica, além disso, que adotam o hábito de aumentar as doses dos medicamentos. A automedicação é necessária para a saúde humana, sendo ela regulada,  ao  contrário  pode desencadear muitas consequências, como desenvolver microorganismos  mais resistentes e intoxicações involuntárias  levando a óbito.', 'Em primeiro plano,observa-se como os indivíduos evitam ir ao médico consultarem o seu problema e buscar uma medicação, eles simplesmente levam em consideração recomendações de pessoas que se sentiram bem com algum medicamento. O problema está na forma como devem consumir,pois, os organismos não são iguais, e essa medicação  pode reagir diferente entre essas pessoas,  e assim desenvolver microorganismos   mais resistentes ao invés de elimina-los .', 'Além disso, é notável como o uso de medicamentos sem qualquer uma prescrição médica acarreta problemas como:  a intoxicação. Os medicamentos que mais causam intoxicações são os analgésicos,antiflamatórios  e antérmicos ,isso de acordo com pesquisas. Muitas substâncias causam alergia, e muitas reações alérgica  podem desencadear até mesmo a morte, por esse motivo é essencial a prescrição médica.', 'Desse modo,as autoridades deverão investir em palestras para alertar os indivíduos das consequências que a medicação desregulada causa,  e procurar um ponto ótimo na regulação de consultas sem precisar combater a automedicação. Logo,o governo deverá ampliar as áreas de atendimento à saúde, para que todos os indivíduos possam e sintam-se a  vontade de procurar um médico sem temerem a exaustiva espera para um atendimento.']",120,120,120,120,120,600
13,"Em 15 de Janeiro de 2019, o presidente Jair Bolsonaro","['Em 15 de janeiro de 2019, o presidente Jair Bolsonaro liberou o porte de arma de fogo no Brasil. É notável que partidos opostos e indivíduos que se puseram contra o armamento estão indignados, pois acreditam que não trará segurança aos Brasileiros . Mas, o outro lado da oposição considera-se a legalização um avanço para a sociedade, pois obtém-se segurança, dando o poder de legitima defesa.', 'Atualmente, andasse sempre atentos pelas ruas, pois á vários casos de homicídio, violência e criminalidade, tentas-te proteger pode causar graves consequências e até mesmo gerar um custo maior, do que haverá com o roubo. Não é qualquer cidadão que terá uma arma de fogo, aplicaram-se leis e testes psicológicos para aqueles que desejam adquirir o armamento. Segundo o pesquisar do (FBSP) Fórum Brasileiro de Segurança Pública, David Marques aponta que, sem o estatuto, poderia ter mais homicídio 30,0 mortes para casa 100 habitantes.', 'Entretanto, outros meios de seguranças seriam precárias para a população Brasileira , como contratar mais policiais qualificados, investir na educação. Não haveria necessidade de armas em residências.']",40,40,40,40,40,200
26,Valores invertidos,"['Cogita-se, com muita frequência que a valorização do professor está em falta no Brasil. Devido à inversão de valores e a carência de uma boa política.', 'Em consequência disso, vê-se todo instante noticiários sobre o desprezo ao professor, seja em questão salarial, que é precária, como também em desrespeito constante da parte de alguns alunos.', 'Na sociedade brasileira a educação está se perdendo aos poucos, e o governo, por sua vez, acaba contribuindo para isso, não dando o apoio financeiro necessário para a evolução dos estudos.', 'Por outro lado, a população coopera para a desvalorização dos professores quando deposita um destaque superior a profissões de entretenimento ao invés das que são essenciais para a vida de um ser humano.', 'Levando-se em consideração esses aspectos, conclui-se que os cidadãos brasileiros, de forma geral, precisam de uma mudança ética e moral em relação à educação. É necessário uma reforma na política com leis que reconheçam o verdadeiro valor de um professor.']",80,120,80,120,120,520
49,Os cuidados com a redes sociais,"['O Influenciador digital é um indivíduo que possui um público fiel e engajado em seus canais online e, em alguma medida, exerce capacidade de influência na tomada de decisão de compra de seus seguidores. É a maneira subconsciente que o mercado encontrou de moldar os pensamentos, comportamentos e atitudes das pessoas sem que elas tenham consciência disso.. Até que ponto isso pode ser positivo ou negativo na vida do indivíduo?', 'Grandes marcas tm liderado no mercado devido a blogueiros que praticamente convence o público de que aquele produto é o melhor . Por outro lado os influenciadores devem agir sempre de forma ética para que a sua imagem não seja denegrida,  Por exemplo : omo alguém pode dizer que determinado produto é um excelente emagrecedor sendo que ele mesmo não tem o corpo físico que condiz com o que ele está oferecendo', 'Em época de pandemia o que se espera é que os influenciadores digitais tragam exemplos para que seus seguidores possam se espelhar neles e juntos combater O vírus de maneira consciente de modo que se multipliquem os bons exemplos,', 'O trabalho dos influencers pode gerar indivíduos com uma mente capitalista e pode também gerar em si mesmo uma frustração por não ter alcançado o objetivo , enfim devemos avaliar até que ponto as redes sociais podem influenciar em uma opinião.']",120,120,120,120,0,480
131,Útil para o eleitor?,"['Ano de 2014, Brasil. Em meio aos muitos problemas no país, como falta de educação, falta de segurança e de atendimento satisfatório na área da saúde, e, talvez, o mais triste e desanimador, os inúmeros casos de corrupção dos políticos,         onde         o nosso dinheiro, o do contribuinte, simplesmente ""desaparece"", cá nos vemos, mais uma vez, a ter o nosso direito de escolher nossos governantes por meio do voto. E para ajudar-nos com essa importantíssima escolha, temos para nossa ""felicidade"", o horário eleitoral gratuito no rádio e televisão.', 'O direito de votar nos representantes de seu país, que seria teoricamente uma oportunidade legítima,                 otimista                e de muito orgulho, torna-se, para muitos brasileiros, um engodo, uma perda de tempo e uma repetição do que se vê todas as vezes. Veem-se políticos de vários partidos por todos os lados prometendo mudanças (muitas vezes                 fajutas                e que são prometidas em todas as eleições, mas não         se desenvolvem         ), esses mesmos políticos andando pelas ruas (especialmente nos lugares mais pobres) abraçando velhinhas e segurando bebês no colo (o que nenhum brasileiro mais aguenta ver) e também disputando espaço no malfadado horário político eleitoral.', 'O horário político eleitoral tem uma função digna, que é a de apresentar à população os candidatos e suas propostas, ajudando-nos a escolher em quem votar. Posso aqui apresentar pontos a favor e contra o horário eleitoral. Contra o horário eleitoral observamos que a maioria da população brasileira tem um baixo nível de escolaridade e não tem consciência política, sendo, por isso, muito inocente e fácil presa de políticos inescrupulosos, que mostram belas imagens na televisão e apresentam propostas miraculosas para melhorar a vida do povo. Essa maioria não indaga o ""como"" aquele político vai cumprir sua promessa, não pesquisa sua história e, portanto, vai acreditar em tudo de belo que vê sendo apresentado. Não fosse isso, o programa é televisionado em um horário em que a maioria das pessoas chega em casa depois de um dia inteiro de trabalho e muitos consideram que o programa atrapalha         sua         entretenimento normal na TV. Há também os que argumentam que isso não influencia o eleitor e que é apenas um desperdício do dinheiro público.', 'Por outro lado, não seria o horário eleitoral uma das únicas ferramentas genuínas de tornar um povo ignorante mais conhecedor da política de seu país? Afinal de contas, é abrangente e tem a possibilidade de apresentar diversos perfis de candidatos. Talvez fosse hora de acabar não com o horário eleitoral, mas com a tradição que existe nesse país da demagogia, de tratar o povo com descaso e visando apenas um objetivo: mais dinheiro e poder. Quando conseguirmos essa mudança, acredito que finalmente passaremos a ver o valor do horário eleitoral gratuito.']",200,200,160,160,120,840
50,Doenças e a pesquisa científica,"['O coronavírus é um novo tipo de vírus que se originou em uma pequena província na China e se espalhou rapidamente pelo globo, por causa dos meios de transporte e da globalização.. Então, como se trata de um novo vírus, não há pesquisas relevantes sobre ele e seu tratamento . É indubitável afirmar que , as pesquisas científicas são imprescindíveis para que a pandemia seja amenizada, uma vacina criada e as crise controlada.', 'Certamente, não é a primeira vez que a ciência auxilia no conhecimento de uma doença e sua prevenção. A exemplo disso, têm-se a influenza A H1N1, a varíola e a febre amarela. Foi por meio de pesquisas científicas nas área da Saúde,Geografia e Biologia que inúmeras doenças possuem tratamento e prevenção efetiva.', 'No entanto, uma pesquisa demanda um certo tempo para ser concluída. Uma vez que, os cientistas não recebem o investimento financeiro equivalente à importância de seu trabalho ; deste quadro põem empecilhos em no progresso da ciência .Tem-se por exemplo  o caso do Ikaro Alves de Andrade que teve sua pesquisa cortada enquanto estudava o coronavírus.', 'Diante do exposto,faz-se necessário uma ação energética governamental. Logo, é responsabilidade das Universidades, tendo em vista a pandemia, concentrar os estudos na amenização da atual crise, para que a doença seja contida e seus efeitos reduzidos . Ademais, cabe ao Governo Federal disponibilizar subsídios necessários e benéficos aos pesquisadores  ; com o objetivo de incentivar e valorizar a produção de matérias essências a sociedade']",120,160,120,160,160,720
46,Privatização,"['A Constituição Federal assegura o acesso de todos ao saneamento básico. Porém, na prática, muitos cidadãos brasileiros não usufruem dele. Para solução dessa questão, o Marco Legal do Saneamento Básico foi aprovado pelo Congresso Nacional e permite que empresas privadas cuidem do tratamento de água e coleta de esgoto. Uma consequência da privatização, na Alemanha e nos Estados Unidos, foi o aumento das contas cobradas ao consumidor, o que tem chances de ocorrer no Brasil, caso não haja a fiscalização. Portanto, o que foi proposto como melhoria, no caso a desestatização, não é a resolução mais plausível.', 'Primeiramente, é essencial ressaltar os objetivos do Marco Legal do Saneamento Básico. De acordo com o Congresso Nacional, espera-se que o acesso ao tratamento de água aproxime-se de 99% da população, enquanto que a coleta de esgoto chegue a 90% dos brasileiros. Caso isso se concretizasse, seria um grande avanço, visto que, conforme dados da pesquisa Atlas Esgotos, apenas 45% da população tem o saneamento básico em condições adequadas. Portanto, com a o aumento da abrangência deste setor, o que é previsto pela Constituição Federal estaria presente na prática.', 'Porém, com a privatização do saneamento básico, problemas podem aparecer, como por exemplo, aumento da conta de água e consequente redução da abrangência do serviço. De acordo com o jornal, The Guardian, nos Estados Unidos, a desestatização do setor resultou no aumento em 80% das tarifas cobradas. Também, em uma reportagem, da revista Veja, havia a informação de que, na Alemanha, as empresas privadas passaram a cuidar deste serviço, o que resultou em um problema semelhante ao do Estado norte-americano e na redução do número de pessoas com acesso aos serviços. Logo, a resolução proposta pelo Marco Legal do Saneamento Básico pode não ser a mais viável, caso não haja monitoramento dos serviços.', 'Por conseguinte, para que a privatização possa ser realmente uma solução, é essencial a fiscalização, por parte do Poder Legislativo e Tribunais de Contas, da qualidade do serviço prestado e do valor cobrado . Isso seria possível por meio da verificação das movimentações nas contas públicas das empresas privadas. Somente assim, seria possível perceber irregularidades e estabelecer punições por intermédio da lei. Dessa forma, com o monitoramento, o saneamento básico estaria nos parâmetros adequados e, consequentemente, grande parte dos cidadão brasileiros usufruiriam dele, conforme consta na Constituição.']",160,160,120,200,160,800
46,O novo marco da Lei  11.485,"['Neste momento de pandemia fica evidente o quanto os serviços de saneamento básico são essenciais à vida das pessoas. E, apesar de sua garantia como direito humano, a universalização do acesso à água tratada ainda é um entrave na sociedade atual. Nesse sentido, a privatização desse serviço ganha destaque no Brasil, evidenciando um cenário de maior preocupação social, uma vez que um bem universal se tornará manobra de econômicos.', 'Primeiramente, cabe ressaltar que seguindo a lógica capitalista de Adam Smith que visa ao lucro máximo, com a privatização do saneamento básico, as regiões que já vivem em uma realidade excludente seguirão negligenciadas. Um exemplo disso é a cidade de Manaus, na região Norte, que nas mãos no poder privado, há mais de 20 anos, possui apenas 12,5% de cobertura de esgoto e desses,  apenas 30% é tratado, conforme noticiado no Uol Notícias em julho de 2020.Dessa forma, fica claro que o Novo Marco da Lei 11.485, que prevê a privatização do saneamento básico no país, a fim de garantir o acesso ao saneamento a todos até 2033, não vem para atender os anseios da maioria da população e sim aos interesses grandes empresas.', 'Além disso,a decisão de privatizar tal serviço em países subdesenvolvidos é uma lógica mal fundamentada que não leva em consideração os altíssimos investimentos em infraestrutura. Uma prova de como a iniciativa privada não dá conta da universalização pode ser visto no artigo publicado no jornal eletrônico Outras Palavras em julho de 2020, em que revela que mais de 250 cidades da Europa e dos Estados Unidos reestatizarem o serviço. Desse modo, é evidente que a desestatização não garante a universalização do acesso ao saneamento em países em desenvolvimento em que imperam a desigualdade econômica e social.', 'Dessa maneira, visando ao avanço coletivo é preciso que a realidade atual brasileira seja repensada. Urge, portanto, que o Estado detenha o controle da participação de empresas privadas no setor de saneamento. Isso pode ser feito por meio da fiscalização e planejamento, que se encontrarão previstos em contratos de parceria público privado (PPP), a fim de que seja possível a universalização do acesso à água tratada e, consequentemente, à saúde a todos os cidadãos, conforme assegura a Declaração Universal dos Direitos Humanos.']",160,160,120,160,160,760
95,FBS #4,"['Na obra ""Utopia"", do escritor inglês Thomas More, é retratada uma sociedade perfeita, onde o corpo social padroniza-se pela ausência de conflitos e problemas. No entanto, o  que se observa na realidade contemporânea é o oposto do que o autor prega, visto que, o debate sobre o marco temporal apresenta barreiras, as quais dificultam a concretização dos planos de More. Esse cenário antagônico é fruto tanto pela demarcação das terras dos povos originários, quanto da repressão s manifestações que vão contra ao marco temporal. Diante disso, torna-se fundamental a discussão desses aspectos, a fim do pleno funcionamento da sociedade.', 'Primeiramente, é importante ressaltar que o marco temporal deriva da baixa atuação dos setores governamentais, no que concerne a criação de mecanismos que coíbem tais recorrências. Segundo o pensado Thomas Hobbes, o Estado é responsável pelo bem-estar da população brasileira, entretanto, isso não ocorre no Brasil. Devido à falta de atuação das autoridades, a demarcação das terras dos povos originários do Brasil vem desencadeando grandes conflitos, devido à ação do marco temporal desenvolvida pelo Supremo Tribunal Federal (STF), onde irá favorecer, principalmente, os ruralistas e as instituições ligadas ao agronegócio, por sua vez, colocará em risco uma cultura de característica milenar. Desse modo, faz-se mister a reformulação dessa postura estatal de forma urgente.', 'Ademais, é imperativo ressaltar que as repressões dos manifestantes que vão contra o marco temporal como promotor do problema. Partindo desse pressuposto, muitos dos povos originários que estão se locomovendo Brasília, de modo a lutarem por seus direitos estão sendo recebidos de forma violenta e agressiva, o que torna uma situação ainda mais complicada  para os povos originários. Tudo isso retarda a resolução do empecilho, já que as repressões dos manifestantes que vão contra o marco temporal auxilia na perpetuação desse quadro deletério.', 'Assim, é preciso defender, portanto, que empasses sociais precisam ser superados. Dessarte com o intuito de militar o marco temporal, necessita-se, urgentemente, que o Supremo Tribunal Federal (STF) retroceda com a ação do marco temporal, visto que, prejudicará várias etnias de povos originários, uma vez que, eles possuem um direito originário à terra por estarem aqui antes da criação do estado brasileiro. Diante disso, atenuar-se-à, em médio e longo prazo, o impacto nocivo do marco temporal, e a coletividade alcançará a Utopia de More.']",160,200,160,200,160,880
124,(Sem título 044),"['Atualmente o lixo é um grande problema nas cidades, principalmente na cidade de São Paulo onde o cidadão deve cumprir com a sua responsabilidade social         em         questão do lixo, pois                 gera                problemas ambientais, faz         mau a         saúde e aumenta os lixões.', 'Devido         a         quantidade excessiva de lixo produzido pela sociedade, muitas vezes                 são destinados                a lugares inadequados onde                 gera                problemas ambientais que são         prejuidiciais à         todos nós e que podem se tornar um problema maior no futuro.', 'Com a má localização do lixo onde se encontra em situação precária a contaminação toma conta de tudo ao seu redor, causando doenças          a          população inclusive aos catadores de lixo.', 'As pessoas não possuem o hábito da reciclagem, então após a coleta de lixo seu destino         será para os lixões         a céu aberto onde cada vez mais aumentam a quantidade de         residuos         e lixos que não deveriam ser despejados ali.', 'Sendo assim a sociedade deve colaborar evitando o desperdício de         materiasis         e ajudando na reciclagem, assim diminuindo a quatidade de lixo e contribuindo para um mundo melhor.']",80,80,80,0,80,320
57,,"['Não há como negar a importância do cinema em uma sociedade. Além de muito atrativo, é também uma fonte de conhecimento que marca gerações. No princípio, houve a idéia de que o cinema seria uma novidade passageira, mas, foi um mito, pois o cinema continua marcando e encantando com histórias extraordinárias. Embora o cinema seja considerado algo ""comum"" em algumas sociedades, outras nunca tiveram oportunidade de viver tal emoção.', 'Com a crescente humanização e a chegada dos shopping centers, cresce o número de cinemas nas áreas privilegiadas com melhor economia. Dessa forma a população das grandes cidades ganham o mundo alternativo do cinema, enquanto às populações das áreas menos desenvolvidas, são totalmente excluída desse privilégio.', 'Além disso a chegada das inovações tecnológicas nas áreas privilegiadas, estão gradativamente retardando o número de telespectadores ao cinema, somente 17% da população dessas cidades frequentam o cinema. Esse desenvolvimento desorganizado causa revoltas, porque: Enquanto uns tem facilidade de acesso ao cinema e as inovações tecnológicas, outros não conseguem acesso à nenhuma dessas opções. Por exemplo: população dos interior das pequenas cidades do Nordeste.', 'Portanto, é preciso ampliar o acesso nas áreas menos favorecidas. O governo deve investir em infraestrutura urbana, o ministério do desenvolvimento tecnológico por meio das secretarias de comunicações devem criar ONGs que tenham acesso à tecnologia, ao cinema e que promovam ações educativas com o propósito de atualizar as comunidades e levar conhecimento e lazer. Assim, teremos pessoas mais atualizadas, modernas e informadas. Isso influenciará de maneira positiva na redução da taxa de analfabetismo.']",120,80,80,120,80,480
70,Caminho para todos,"['Durante anos, a ideia era que AIDS atingia apenas os homosexuais, já que os primeiros casos foram reconhecidos nesses. Hoje, sabe que é uma mentira, que qualquer grupo/classe social pode acometer-se das Doenças Sexualmente Transmissíveis (DSTs).', 'No Brasil, os casos de tais doenças - principalmente AIDS (ocasionada pelo vírus HIV)- nos jovens, vêm crescendo de forma alarmante. A causa principal desse acontecimento é o sexo desprotegido, uma vez que, é transmitida pelo contato sexual sem uso de preservativo (camisinha) om uma pessoa infectada.', 'A princípio, a falta de debate sobre o assunto dificulta o contato do portador da DST com a sociedade, onde muitas vezes é descriminado. Mesmo com tanta polêmica, o cantor Cazuza ao declara que era soropositivo ajudou a ganhar maior entendimento, no que se refere À AIDS, e seus efeitos. Depois de sua morte, sua mãe criou a ONG Viva Cazuza, que é direcionada crianças e adolescentes acometidas de tal doença.', 'Dessa forma, torna-se evidente que a melhor forma para combater-se as DSTs é o uso da camisinha - não só para prevenção da AIDS, mas também da gonorreia, sífilis, HPV, entre outras. Jovens e adultos devem fazer exames anuais, como o SIDA . Mais pesquisas devem ser feitas em relação s DSTs,  para achar uma maneira mais eficaz de combatê-las. Ademais, a escola de introduzir aulas de sexualidade na grade curricular, a fim de discutir de forma clara e objetiva as consequências da não prevenção.']",120,120,120,120,120,600
49,O papel dos Influenciadores digitais,"['Atualmente a influência que a mídia proporciona é muito grande fazendo  com que as pessoas se tornem convencidas pelas outras facilmente, de modo que cada pessoa tem opiniões diferentes, porém quando bem argumentada for a opinião mais pessoas serão convencidas a pensar do mesmo jeito.', 'As pessoas que mais tem uma grande influência sobre a sociedade são os famosos, presidente ou governantes, através dessas pessoas podemos mudar nosso jeito de pensar e ver as coisas de certa forma, além de que nem sempre isso vai ser bom, pois muitas pessoas se beneficiam com sua influência pelo mundo e é através disso que vemos  o que é bom pra um nem sempre é bom para os outros, cada um tem seu jeito de pensar sobre tudo, mas quando alguém com mais superioridade se ponhe além disso e influência a população com seu modo de pensar, o argumento de muitas pessoas acabam sendo esquecidos.', 'A influência digital é bom em muitos casos e desnecessário em outros pois nem sempre o que a internet nos mostra realmente é o que precisamos  saber.']",120,80,80,80,0,360
70,A DST No Brasil,"['Apesar do assunto ser bastante falado , principalmente nas redes sociais entre os jovens , ainda há muito o que ser feito para concienticons os jovens a respeito das atas , infelizmente eles no se previnem o bastante para que isso não aconteça.', 'As doenças sexualmente transmissíveis (DST) são consideradas como um dos pronomes de saúde pública mais comum no mundo , m ambos sexos tornam o organismo mais vulnerável a outras doenças , inclusive a AIDS , além de terem relação com a mortalidade materna e infantil.', 'Com cada vez mais jovens fazendo sexo de forma desprotegida , os números de doencas sexualmente transmissíveis tem aumentado constantimente no Brasil, ara combate a doenca sexualmente transmissível ( Dst ) deve-se usar camisinha , que além de evitar  gravidez indesejada , a camisinha é uma proteção contra doenças além da dst , A aids , sífilis , e alguns tipos de epatites , Cuidar sempre da higuehi pessoal é um dos melhores segundos passos , evitar usar drigas injetáveis , faça exames , isso é uma maneira mais eficazes pata se prevenir , aça exames regularmente , tomar sempre as vacinas , las são seguras e recomendadas para prevenir.']",80,80,80,80,80,400
93,Parto humanizado,"['A constituição federal de 1988, documento jurídico mais importante do país, prevê  em seu artigo 6º, o direito saúde como inerente a todo cidadão brasileiro. Conquanto, tal prerrogativa não tem se reverberado com ênfase na prática quando se observa o parto humanizado dificultando,deste modo,a universalização desse direito social tão importante. Diante dessa perspectiva, faz-se imperiosa a análise dos fatores que favorecem esse quadro.', 'Em uma primeira análise, deve-se ressaltar a ausência de medidas governamentais para combater a falta de profissionais da saúde. Fazendo com que as gestantes não tenham a acessória adequada . Essa conjuntura, segundo as ideias do filósofo contratualista John Locke, configura-se como uma violação do “contrato social”, já que o Estado não cumpre sua função de garantir que os cidadãos desfrutem de direitos indispensáveis, como a saúde,o que infelizmente é evidente no país.', 'Ademais, é fundamental apontar a falta de unidades de saúdes , que tenhao maternidade funcionando como impulsionador do parto humanizado no Brasil .Segundo o filósofo Jiddu ""Não e sinal de saúde estar bem adaptado a uma sociedade doente"" .Diante de tal exposto a falta de maternidade locais , pode acarreta na perda do bebê ou nascimento prematuro por não terem um lugar adequado , e um profissional adequado entre outras diversas coisas . Logo, é inadmissível que esse cenário continue a perdurar.', 'Depreende-se, portanto, a necessidade de se combater esses obstáculos. Para isso, é imprescindível que o Ministério da Saúde ,  disponibilize verbas , para maternidades em hospitais locais e darem palestra para gestantes , alertando os riscos dos procedimentos invasivo. Assim, se consolidará uma sociedade mais armonioza , onde o Estado desempenha corretamente seu “contrato social”, tal como afirma John Locke.']",160,160,160,160,160,800
81,,"['Optar por seguir uma religião,  ou ser refém de ofensas? Em alguns países  já são colocados em prática métodos que proíbem o direito de expressão quando o assunto é a escolha de crença. No Brasil isso também  ocorre mesmo que de maneiras diferentes.', 'São inúmeras as denúncias de pessoas agredidas, ofendidas,    ou tratadas de formas diferentes dos demais. A todo momento acontecem atos de manifestações religiosas, sejam elas no trabalho, na escola ou em quaquer outro local. Mesmo com a lei presente no art-208 em vigor, os casos de discriminação religiosa estão presentes no dia a dia das pessoas. O problema é existente e medidas são necesárias para resolver esse impasse', 'Palestras devem ser criadas,    afim  de mostrar que todos tem  liberdade para escolher sua própria religião. A secretária de direitos humanos se mobilizar  na criação de um projeto para ajudar alunos que sofrem com esse problema. Cabe a pessoa decidir se vai ou não seguir uma determinada religião,    e deve ser respeitada ao expor isso publicamente.']",120,80,80,120,120,520
129,A evolução da família tradicional,"['Independente          da opção sexual, uma família pode sim, ser constituída por duas pessoas do mesmo sexo.                Embora isso seja visto pelos         conservadores         da família tradicional como errado ou equivocado,         mas a         sociedade         tem que entender         e aceitar a evolução social.', 'Pessoas do mesmo         sexo         que se relacionam independentemente de serem duas mulheres ou dois homens,         deveriam ter os mesmos direitos         que os heterossexuais,                 desde a adoção de uma criança ao casamento                .         Pois         assim como qualquer outro         casal         eles também têm seus sonhos de ter uma família.', 'Apesar de igrejas e                 entidades                defenderem o conceito da família tradicional, que é         constituída segundo eles         , por um homem e uma mulher, e valorizarem questões culturais,         eles  tem  que compreender         a evolução da sociedade. O que antigamente não era comum, dois casais do mesmo sexo se relacionando, hoje faz parte do cotidiano, e com o passar dos anos irá fazer parte da cultura.', 'Com isso, todos         devem respeitar         a pessoa e sua família,         independente se for         constituída por dois homens, duas mulheres ou um casal de homem e mulher.']",120,120,80,80,120,520
68,O passado recria o presente.,"['Define-se patrimônio histórico como sendo o conjunto de bens móveis, imóveis ou naturais, que possuam valor inestimável para uma população. Prédios, cidades e florestas são exemplos desse conceito. Logo, é de extrema importância que esse seja preservado, haja vista que representa um bem inestimável e serve de meio de estudo acerca das particularidades e cultura de um povo.', 'Em primeira análise, cabe pontuar que o patrimônio histórico apresenta um valor inestimável para a herança cultural e social de um povo. Isso porque esse representa os acontecimentos marcantes da história de uma sociedade, como guerras, dominações e vitórias, haja vista que esses acontecimentos ficam marcados nas obras arquitetônicas confeccionadas durante esses períodos. Isso é ratificado, por exemplo, nos restos do Muro de Berlin, o qual representa os anseios sociais do povo alemão durante uma era de dominação e divisões territoriais,  que sucedeu-se durante a Guerra Fria.', 'Em segundo plano, é importante destacar que o legado histórico é de extrema importância para o estudo das particularidades e cultura de uma população. Isso já que, através de monumentos e construções antigas, é possível encontra traços da religião, da língua e da cultura de uma sociedade. A título de exemplo, vale destacar os hieróglifos encontrados na pirâmide de Gize, os quais relatam a história, a cultura e a religião do povo egípcio e suas particularidades culturais, como o embalsamamentos das pessoas que morriam.', 'É evidente, portanto, que medidas devem ser tomadas, a fim de garantir a manutenção e proteção do patrimônio histórico. Diante disso, a ONU( Organização das Nações Unidas), em parceria com ONGs, deve, por meio do tombamentos de obras com forte valor simbólico e obras de restauração, garantir a integridade e a proteção de espaços importantes para a sociedade, a fim de garantir que o legado histórico e estudo sobre as sociedades não seja perdido ao longo dos anos.']",160,160,160,160,120,760
87,,"['A Atitude Blasé - termo proposto pelo sociólogo Georg Simmel no livro ""The Metropolis and Mental Life"" - ocorre quando o indivíduo passa a agir com indiferença em meio às situações que ele deveria ter atenção. Sob essa óptica, encontra-se a cultura da erotização infantil , a qual é negligenciada na atualidade . Diante disso, é lícito destacar o peso que o silenciamento e a insuficiência legislativa possuem sobre essa problemática.', 'Em primeiro lugar , convém enfatizar que a falta de debate sobre a erotização na infância está entre as principais causas do revés . Nesse sentido, segundo o filósofo Michel Foucault, numa sociedade pós-moderna,muitos temas são silenciados . Sob esse viés, é evidente que o problema da disseminação cultural do erotismo na infância se torna mais grave quando não há um debate sobre o prejuízo da exposição de crianças situações constrangedoras , que podem no futuro afetar o psicológico delas.', 'Ademais, vale também ressaltar a a ausência de medidas governamentais como mais um dos fatores que agravam o impasse. Segundo o filósofo Jhon Locke , o Estado viola o ""contrato social"" quando não cumpre sua função de garantir os direitos indispensáveis de todos os cidadãos. Dessa forma ,observa-se a falta de leis efeitivas , por parte do governo , para evitar a disseminação da cultural da erotização infantil.', 'Portanto, medidas são necessárias para resolver a questão. Cabe s escolas  a criação de rodas de conversas, por meio de aulas extraclasse, que visem o dabate acerca dos impactos negativos da erotização infantil. Além disso o governo deve regir leis que proíbam a cultura erótica entre crianças. Assim , o problema em questão poderá ser superado.']",160,160,120,200,160,800
110,"Com roupas ou sem roupas, ninguém merece ser estuprado.","['Pesquisas feitas no Brasil apontam que 65% das mulheres que usam roupas curtas merecem ou          deve          ser          estupradas  , desde quando         se uma mulher usar uma peça         curta         ela está pedindo para ser abusada? Vivemos em um país onde a                 ignorância alheia                não tem limite, país machista e preconceituoso. Estudos apontam que a cada 12 segundos uma mulher é estuprada. Realmente é         porque         elas querem?', 'A culpa é da mulher por         está         usando roupas sensuais, provocantes? Ou é dos psicopatas, ninfomaníacos,         pedofilos         ou tarados que acham corretos fazerem sexo         a         força com as vítimas? Boa parte dos homens         estão         vendo                 as mulheres                como apenas um pedaço de carne ou um simples objeto de prazer.                 Esquecem que também é gente, tem sentimentos e tem o direito de usarem roupas curtas para se sentirem bem e elevar          o seu          autoestima e não para serem atacadas                .', 'Algumas         vítimas         depois de serem         abusadas         ficam depressivas e com         trauma         [medo] de saírem de suas         casas, boa         parte         adquire         o         vírus do HIV         , pois o sexo é forçado e o         transmissor         não usa preservativo. A maioria desses acidentes acontece dentro         de sua         própria casa, já que 80% dos estupradores são conhecidos das vítimas.', 'Precisamos dar um basta nessa violência. É o ciclo da misoginia e da violência contra mulheres. Precisamos quebrá-lo. É de pessoas que estamos falando, de gente, de seres que sentem, se machucam, se magoam, se desesperam. Necessitamos de leis mais severas e que a punição seja         comprida         . É uma questão de humanidade.']",120,120,120,120,120,600
44,O Ideal Social,"['“A Rainha Vermelha”, da autora Victoria Aveyard, retrata um mundo dividido pelo sangue, onde os de sangue prateado estão no topo da hierarquia e os de sangue vermelho são subjugados e explorados pelos prateados, sendo isso justificado pela diferença do sangue. Na realidade, uma forma semelhante de discriminação acontece no mundo do atletismo feminino, por causa da imposição de uma determinada quantidade de testosterona no sangue para poder competir. Mesmo as mulheres que já nasceram com uma quantidade mais alta de testosterona são obrigadas a tomar medicamentos para diminuir, além de terem que passar por testes abusivos para provar que podem representar as mulheres.', 'Primeiramente é necessário discutir sobre a quantidade de testosterona vista como ideal no sangue da mulher. Sem dúvidas, quanto maior a quantidade de testosterona no sangue, mais vantagens uma atleta terá sobre as outras. Mas e quando essa quantidade é delimitada pelo próprio corpo da atleta, tendo ela já nascido com determinada disfunção? O caso da sul-africana Carter Semenya gira em torno dessa questão. A solução encontrada foi a medicação como condição para que a atleta competisse, uma medida polêmica que gerou revolta. Segundo o filósofo Immanuel Kant, a moral é uma imposição que pode não estar de acordo com a vontade geral e a ética é uma atitude individual que deve estar acima da moral. A medicação como solução, nesse caso, pode ser considerada moralmente correta, mas não eticamente, pois determina uma condição para ser mulher e se poder competir.', 'Em seguida, outro problema são os testes abusivos a que essas atletas tem que se submeter para provarem, de fato, ser mulheres. Segundo Simone de Beavoir, “Não se nasce mulher, torna-se mulher”, ou seja, a mulher, na verdade, é uma construção e uma idealização da sociedade, ela é moldada para agir e fazer o que se é esperado que faça . Da mesma forma acontece no esporte, onde a mulher que se mostra descaracterizada com tal idealização é impedida de competir. Como consequência, as mulheres que não se encaixam no padrão não são consideradas mulheres e são excluídas, impedidas de representarem suas iguais.', 'Por fim, medidas são necessárias para resolver esse impasse. A Federação Internacional de Atletismo  pode tomar medidas inclusivas e revogar as exclusivas, como no caso da medicação de Semenya. Por meio de testes menos abusivos e medidas que não impeçam nenhum tipo de mulher de competir, independente de suas características, a federação pode quebrar com tal idealização, com a finalidade de respeitar as diferenças individuais de cada mulher.']",200,160,160,200,160,880
121,Pequenas Mudanças,"['A partir do momento em que o         homem         começou a escolher representantes para os mais variados cargos         nos quais tem como objetivo lutar         em prol dos cidadãos, várias medidas de aprimoramento         deste         processo         estão sendo         tomadas para que as eleições sejam realizadas de forma         democrática, dentre elas         o horário político obrigatório, que tem como meta oferecer a oportunidade         dos         cidadãos conhecerem melhor os candidatos e possivelmente         formar         conscientemente o seu voto.', 'No entanto, não é bem isso que vem acontecendo. Durante os 45 dias destinados ao horário político, ouvimos constantemente pessoas dizendo que desligam o rádio e a TV para não ouvirem as                 “baboseiras”                dos candidatos. Pesquisa realizada pelo DataFolha revela que 64% da população acha necessário ocorrer uma mudança na propaganda eleitoral gratuita,         pois         estão cansados         da repetição diária.', 'Desta forma nos          perguntamos          o que leva as pessoas a pensar          desta          forma? O que fazer para melhorar          esta          situação? Da maneira que vem ocorrendo, quem esta se beneficiando?                Ao redor do mundo, temos exemplo de países como os Estados Unidos que neste ano realizam as eleições         presidenciais, no qual         os próprios candidatos pagam para obter seu espaço na programação, isto gera uma valorização por parte dos eleitores. Ao contrário do que acontece no Brasil em que todo o dinheiro vem dos cofres públicos, ou seja, percebemos que apenas os candidatos e os meios publicitários são quem saem ganhando.', 'O nosso país busca sim um meio democrático de realizar as eleições, mas para uma nação que tem como meta se desenvolver por completo, todo o dinheiro gasto excessivamente faz da população o grande alvo.                Todos os gastos em publicidade política deveriam ser usados para beneficiar a população com investimentos na saúde, educação, formando assim futuros eleitores presentes e conscientes em suas decisões.', 'Haja vista o que foi discutido, uma grande proposta seria reservar dia e horário específico nos meios informativos e publicitários, para que os candidatos pudessem debater em uma “mesa redonda” suas propostas e intervenções, tudo ao vivo. Assim os eleitores poderiam conhecer melhor o candidato, seu comportamento e suas metas. Com isso economizaríamos tempo, dinheiro e teríamos um benefício mútuo.']",120,160,160,120,200,760
65,"Melhor um livro em baixo do braço , do que um pistola na cintura","['O cenário brasileiro,  anda a cada ano se regredindo mais e mais, isso pela falta de desenvolvimento da população na parte educacional. Muitos largam as escola no ensino fundamental, s vezes por dificuldades e outras por falta de oportunidade em uma instituição de ensino.', 'A criminalidade no Brasil, vem tendo um aumento muito drástico , principalmente por parte de jovens que na maioria das vezes abandonaram a escola ou até mesmo não conseguiram entrar.', 'Muitas das vezes  , abandonam as escolas para ajudar os pais no financeiro , veem a criminalidade como um caminho mais rápido e fácil para poder realizarem seus sonhos , desanimam a si próprios pela falta de motivação etc.', 'Mesmo chegando ao ensino médio, ainda sem tem outra barreira  que os impedem de continuar os estudos, o SISU (sistema de seleção unificada), pelo qual concorrem por uma vaga de entrada em uma faculdade pública . Mas a desonestidade é que seus concorrentes são estudantes de redes particulares de ensino.', 'Não conseguindo entrar em uma faculdade pública, para continuarem seus estudos , optam por caminhos mais alternativos , que na maioria dos casos a criminalidade.', 'Para que haja,  um método de aumento no IDH (lindice de desenvolvimento humão) no Brasil , é preciso o estado juntamente com o ministério da educação (MEC) se unem,  para por como motivação aos alunos, uma esta básica que ajudar a família , criar uma nova regra para o SISU , como ter um limite de salário para se entrar na concorrência por uma vaga em faculdades públicas etc.']",120,80,80,120,80,480
74,,"['É incontrovertível que o feminicídio é um problema em nossa  sociedade hodierna, pois concerne a série de agressões,  físicas e psicológicas, que geram a morte da mulher pela simples condição de ser mulher. Essa situação torna-se ainda mais preocupante quando há a percepção do ódio e desprezo  ou até mesmo sentimento de propriedade que as mulheres vêm sofrendo.', 'Dentre os motivos que levaram ao feminicídio , é indubitável desprezar a convicção de superioridade do sexo masculino em relação ao sexo feminino. De acordo com o Instituto de Pesquisa Econômica Aplicada, 15 mil mulheres são assassinadas por dia no Brasil, mesmo com o feminicídio sendo considerado um crime hediondo neste.', 'Ainda convém lembrar que o feminicídio é um problema atemporal. O seu conceito surgiu na década de 70, como uma forma de reconhecer e tornar visível a desigualdade e a violência sistemática contra as mulheres, que muitas vezes sofrem tal agressão de seus próprios familiares.', 'Como disse o sociólogo Immanuel Kant,  “O ser humano é aquilo que a educação faz dele”. Portanto, é necessário que o Governo Federal invista em um sistema educacional de boa qualidade, para que assim haja a quebra de convicções errôneas de superioridade. Afinal, somos todos iguais perante a lei.']",120,120,120,120,120,600
41,"Equilíbrio é necessário, até na educação","['O Exame Nacional do Ensino Médio (ENEM), realizado anualmente, abrange alunos de escolas públicas, particulares e militares. Esta última modalidade tem se destacado cada vez mais, mostrando resultados satisfatórios, consequentes de um ensino fundamentado na disciplina e rigidez. O estudo pago - privilégio da minoria - continua liderando as melhores posições no ranking do ENEM, contrastando com a educação gerida pelo Estado e quase lado a lado com a dos militares, revelando como este método de ensino não é obrigatório para que o aluno, de fato, aprenda. Sou uma ex-aluna de colégio estadual, e afirmo que ""disciplina, ordem e autoridade"" dentro da sala de aula, definitivamente, não existia ; mesmo assim, não optaria ingressar no colégio onde este lema é levado com rigidez. Já tive experiências no ensino privado, e digo: profissionais qualificados, boa dinâmica entre professores e alunos, e demonstração de interesse genuíno - deles para estes, principalmente - foram os principais fatores que geraram ótimos resultados no fim do ano letivo. Enquanto houver esta heterogeneidade no nível de ensino entre as escolas brasileiras, a educação militar pode ser uma saída para aqueles desprovidos de recursos financeiros, mas terão que lidar com o desnecessário extremo da rigidez disciplinar.']",200,200,160,160,80,800
59,Desigualdade e fome ainda presentes no Brasil,"['Como disse o poeta e dramaturgo Bertolt Breacht,  “Para quem tem uma boa posição social, falar de comida é coisa baixa. É compreensível: eles já comeram.” Visto isso, é possível afirmar que a fome e a desigualdade social estão diretamente ligadas. No Brasil é algo muito presente e pouco discutível, pois os órgãos responsáveis não são atingíveis diretamente por essas questões.', 'É válido ressaltar que outros motivos agravam a situação, como a crise econômica que atinge o país e gera milhares de desempregados, o que resulta em famílias sem condições para se manterem, atendendo assim suas necessidades básicas . Temos  também as características climáticas, como a seca e as enchentes afetam àqueles que dependem da atividade agrícola para sua renda ou até mesmo para seu próprio sustento.', 'Outrossim, é que mesmo o governo implantando projetos sociais, como “Fome Zero” e “Bolsa Família”, criados no ano de 2014 , não foi o suficiente para uma solução definitiva. Um relatório da Organização das Nações Unidas para a Alimentação e Agricultura , mostra que no Brasil, no ano de 2017, 2,5% da população, ou seja, mais de 5 milhões de pessoas ainda passava fome ou tinha alimentação insuficiente.', 'Baseado nisto, vemos  que a fome e a desigualdade social ainda são um problema a ser discutido e solucionado no Brasil. Cabe ao governo, juntamente com órgãos competentes, tomarem medidas válidas para que todos os atingidos possam ter garantias de mão de obra valorizada, vivendo assim de forma confortável, tendo suas necessidades supridas.']",120,160,120,120,120,640
89,A conscientização mundial em meio a uma crise econômica,"['O mundo necessitou de um descanso, todos os lugares foram obrigados a parar. sociedade se enxergou dentro de suas casas limitados, é algo novo que se manifestou no meio dos países. ão se sabe o motivo e nem a origem que gerou todo esse transtorno. A humanidade nunca se limitou tanto a algo, e nem temeu tanto a algo que não conheciam.', 'A população inteira se manteve controlada durante alguns meses, os casos aumentavam, pessoas morreram em uma velocidade nunca enxergada pela física. A população chegando a vê os aumentos, e o que a quebra de isolamento social; trazia como consequências. Os jornais ajudaram e influenciaram muito no regimento para mantermos o controle social.', 'Em meio a uma crise financeira que o Brasil passou a vivenciar mesmo assim mantiveram os lockdown pelos estados, até parar o Brasil inteiro. A população parada, enxergaram que a única solução lógica era manter o distanciamento mesmo que durasse muito tempo. dê certo modo, estavam corretos. ão se dava para manter um controle com uma população a solta. Bloqueando as entradas em lugares que geram aglomeração diminuiria o fluxo de pessoas e ajudaria a ter o controle. assim a população enxergou que era melhor manter-se seguro em casa, do que se contaminar.']",120,120,80,120,0,440
83,É fundamental a pratica* esportiva,"['Percebe-se que o esporte é fundamental para todas as pessoas que buscam uma melhor qualidade de saúde, de vida e até social. E é imprescindível que os indivíduos pratiquem exercícios físicos, pois é necessário á esmerar por uma vida melhor, para a qual a saúde seja essencial.', 'No entanto, a prática esportiva, além de ser um divertimento para o público infantil e para os adultos, é importante para a prevenção de doenças como obesidade, diabetes, depressão, doenças cardiovasculares etc. Também auxilia o aumento da densidade óssea, a capacidade respiratória e a mental, além de atenuar os índices de estresse e ansiedade. Lidar com a derrota dentro do esporte é um fator importante também, pois afeta o psicológico e a auto-estima do indivíduo, e é por isso que a superação é significativa no ambiente esportivo.', 'Contudo, existe a Lei de Incentivo ao Esporte que permite que empresas e pessoas físicas invistam parte do que pagariam de impostos de renda em projetos esportivos. De acordo com o Ministério do Esporte, e por meio desses projetos , cerca de um milhão de pessoas foram beneficiadas em todo o Brasil. Que possibilita e estimula as pessoas a fazerem exercícios físicos. Com exceção de pessoas a melhorar o aprendizado de quão é fundamental é ter uma alimentação adequada e preocupação com a saúde, a socialização e também a união entre as pessoas.', 'Portanto, a prática esportiva, além de ser ótima para a saúde, ela também pode proporcionar a paz entre os povos, o conhecimento de como ter uma boa qualidade de vida e também a sapiência de outras línguas e culturas. Cabe ao Ministério do Esporte (ME)com  parceria com as escolas e imprensa a estimularem á atividade física por toda a população brasileira.']",120,120,160,200,200,800
24,A violência por um ponto de vista otimista,"['Infelizmente, no Brasil, na maioria dos lugares onde vamos notamos o alto nível da violência. Apesar de existir conflitos em solo brasileiro desde o início de nossa colonização, não podemos deixar de lutar por um país melhor e podemos conseguir através de um investimento melhor no sistema de educação.', 'Segundo Immanuel Kant, o homem não é nada alem daquilo que a educação faz dele. Partindo desse pensamento nos resta investir mais no ensino de nossas crianças, exigindo que dedique-se nos estudos, colocando-as em cursinhos ou se for o caso tomando aulas de reforço.', 'Jean Paul Sartre foi sábio em dizer: A violência independente de qual for, é furto da ignorância. Assim o Governo deve disponibilizar fundos suficientes para suprir o defasado ensino brasileiro, para que os orgãos competêntes com DRE invistam nas escolas, concomitante a violência diminuirá E a questão da maioridade penal ficaria em segundo plano.', 'Com base nos fatos mencionados, o Brasil, por sua vez , juntamente com os pais ou responsáveis devem investir mais no Estado, dando ênfase na juventude, uma vez que essa fará a diferença proprocionando bem estar e segurança para as futuras gerações. Ademais o interesse por parte dos jovens é imprescindível.']",0,0,0,0,0,0
132,O MMA,"['Atualmente o                 MMA                é         encaixado         como um esporte, mas, para         outros         uma violência que causa muita dor e sangramentos.', 'Podemos definir que o MMA tem suas regras para não causar                 algo mais grave, até a morte. Ser lutador não é só brigar, deve ter técnicas e          abilidades.', 'Pode-se          concretizar          que          esse tipo de luta          é uma profissão muito difícil,          pois para ser lutador          exige muito treino e esforço.', 'Podemos ver          a luta que          há pontos positivos e negativos, agora cada pessoa escolhe sua profissão, pois todas vão ter pontos negativos a enfrentar.', 'Para ser lutador,         deve         buscar seus sonhos e não temer         com o         que virá pela frente,         com         a cabeça levantada                romper todos os obstáculos e         barreira.']",80,80,0,0,0,160
7,"As tecnologias movem o mundo ou o mundo, as tecnologias?","['No início da civilização, a base do o comércio era realizada com realizado pela troca de mercadorias, ou seja, o escambo. E com as demandas, havia necessidade de procurar meios de garantir maior diversidade no câmbio dos produtos, criou-se criaram-se, então, as moedas. Pressupõe Pressupõe-se que, para aquela época época, tal substituição tenha enfrentado resistência por ser algo inovador. Nos dias atuais, a humanidade passa pelo mesmo dilema problema: com a criação das criptomoedas, percebe-se à a ignorância e a relutância de alguns grupos por conta desse em relação a esse novo recurso.', 'Em Por se tratar do novo, o do desconhecido, isso passa a ser alvo de preconceito e polêmica por parte de alguns indivíduos desinformados no assunto, não assunto. Eles não tirariam conclusões precipitadas e seriam mais receptivos as às inovações, se buscassem estudar e conhecer sobre as - as moedas digitais, que se propõe na propõem à substituição do dinheiro convencional, para facilitar e agilizar transações realizadas on line. Segundo Stives Steve Jobs, um dos fundadores da companhia ""apple"", ele disse: Apple disse: ""... Se você faz algo muito bom, você deveria fazer outra coisa sensacional, não se gabar da primeira coisa por muito tempo"". Assim, como as mercadorias eram as moedas da época do passado, as criptomoedas podem ser as do futuro.', 'Além do mais, é perceptível a resistência de bancos e governos, em se ao tratar da substituição da moeda convencional pela digital. Pois, com as criptomoedas dispensaria criptomoedas, seriam dispensadas as intermediações, as taxas cobradas pelas transações e movimentações e não existiria o poder financeiro centralizador do governo e facilitaria para o cidadão ter o controle de seu próprio capital. Como disse Jobs, a tecnologia move o mundo. Então, é somente questão de tempo e esclarecimento, para que a humanidade perceba que se adaptar as às novas tecnologias, não tecnologias não é dificuldade e sim facilidade. E os grupos controladores das finanças, buscarem devem buscar formas de andarem andar juntos as às inovações, pois não há como parar no tempo, a tecnologia se movimenta todos os dias.', 'Portanto, a sociedade precisa se tornar esclarecida quanto a à possibilidade de novas mudanças comerciais monetárias, e as instituições educacionais possam devem esclarecer e incentivar o estudo da importância dessas dessas inovações. E a mídia divulgar sobre os benefícios e formas de expansão, além disso, as empresas de tecnologias poderiam criar projetos e bolsas que possam ajudar mentes criativas a desenvolverem mecanismos na criação de novas formas de comércios, para para, assim, expandir a amplitude da negociação entre os povos e quebrar a barreira monetária as barreiras monetárias.']",120,120,120,120,120,600
74,Trágica herança histórica,"['A violência e os abusos sofridos pela mulher são problemas recorrentes no Brasil, que comumente estampam capas de jornais e revistas. Aspectos devem ser considerados em relação a isto: o legado histórico-cultural e o desrespeito às leis. Segundo a história  a mulher sempre foi vista como inferior, em relação ao homem. Pode-se comprovar pelo fato de elas terem direito ao voto, à escolaridade, ingressar no mercado de trabalho, entre outras coisas, muito tempo depois do seu oposto.', 'Segundo a socióloga, pesquisadora e professora da Universidade de Brasília , Lourdes Bandeira,  “O feminicídio representa a última etapa de um continuum de violência que leva à morte”. Ou seja é o abuso por parte do parceiro íntimo, em contexto da violência familliar, que, em diversas vezes acompanha o abuso sexual, psicológico, tortura e/ou mutilação da vítima, antes do assassinato. O que comprova que as mulheres foram vítimas desse contexto histórico-cultural e o machismo que foi enraizado na nossa sociedade, mesmo que de forma implícita.', 'Os parâmetros que definem a violência doméstica contra a mulher, por sua vez, estão estabelecidos pela Lei Maria da Penha desde 2006. Porém ela acaba tornando-se ineficaz, por falta de esclarecimentos. Muitas mulheres têm medo de denunciarem seus agressores e sofrerem com ainda mais violência . Os acometedores, muitas vezes, também são desinformados quanto à lei e acabam por não saberem que podem ser seriamente punidos por tais atos.', 'Com isso  e diante dos argumentos supracitados, é dever do Estado proteger as mulheres com leis e punições mais severas , campanhas de esclarecimentos sobre tais leis e principalmente um programa eficaz de proteção para as mulheres vítimas de agressão e que fazem denúncia, com direito a acompanhamento psicológico. Assim como um maior investimento em educação com o intuito de formar cidadãos conscientes e comprometidos em garantir o bem-estar do próximo, afinal de contas, desde o Iluminismo, entende-se que uma sociedade só progride quando um se mobiliza com o problema do outro.']",160,160,160,160,160,800
103,O costume brasileiro,"['O                 costume                de ir até a farmácia e comprar vários medicamentos sem orientação de um médico ou farmacêutico é                 comum                no Brasil. Essa facilidade acarreta         no         uso irracional e coloca em risco a saúde da população.', 'O Brasil, país com elevado consumo de          medicamentos          , enfrenta grande dificuldade para promoção do uso racional de          medicamentos          . Visto que, os jovens desde cedo veem o mal exemplo de seus pais e acabam se influenciando. Dessa forma, ocasiona um consumo desenfreado de fármacos no País.', 'Muitas vezes, a vida         agitada, coloca         o jovem em situações         onde         ele prefere         o meio mais rápido e fácil para automedicar-se         do que a segurança de sua saúde. Os casos de intoxicação medicamentosa não são raros e são facilitados         pelo do          livre acesso de farmácos                nas farmácias do país.', 'Portanto, para reverter essa situação, a ANVISA deve promover campanhas alertando os jovens sobre o perigo da automedicação, além de criar leis mais rígidas com relação ao                 fácil acesso e dispensação                de medicamentos.']",120,120,80,80,120,520
14,Os desafios da imigração no brasil ,"['A onda de imigrações vem crescendo constantemente a cada ano, e o Brasil entra na lista de países preferidos . Segundo dados do Comitê Nacional Para Refugiados (Conare), em 2017, o país recebeu mais de 33.866 pedidos de refúgios de imigrantes. Os motivos que levam essas pessoas a saírem do país de origem são as perseguições motivadas por raça, nacionalidade, religião e opiniões políticas. Porém, para a Acnur , agência da ONU para refugiados, a falta de acesso aos serviços básicos como saúde, educação, moradia e distribuição de renda também entram no rol de motivos que levam indivíduos a migrarem.', 'Um pacto global sobre imigração foi assinado por 152 países na ONU para acolher essas pessoas que fogem do país de origem em busca de emprego, moradia, saúde, educação e segurança. O Brasil vem sendo procurado, devido ao encurtamento de abertura dos Estados Unidos e países europeus, que ficaram de fora desse pacto. Também, leva-se em consideração a facilidade que o país dá aos pedidos de refúgio. Segundo Bernardo Laferté, coordenador-geral do Conare , em entrevista à BBC, disse que o pedido de refúgio no Brasil não exige taxas nem documentos.', 'Apesar da grande onda de imigração no Brasil, a realidade que essas pessoas encontram por aqui é de vulnerabilidade, desemprego e falta de moradia. Em 2016, a contratação de imigrantes em empregos formais caiu 13%, segundo dados do Observatório das Migrações Internacionais (ObMigra), com apoio do Conselho Nacional de Imigrações (Cenig ) e do Ministério do Trabalho. A crise que o país vem passando desde 2014, afetou não só os brasileiros como também os estrangeiros. No entanto, a lei de imigração, aprovada em maio de 2017, que garante aos imigrantes legais, refugiados e solicitantes de refúgio no Brasil os mesmos direitos que os brasileiros natos, inclusive de abrirem o próprio negócio, contribuiu para que os estrangeiros abrissem o seu próprio negócio para fugir dos problemas ocasionados pela crise econômica.', 'O Brasil deve formalizar e garantir os direitos dessas pessoas que vêm de fora, porque a imigração tem pontos positivos, pois podem aquecer a economia e enriquecer a diversidade cultural dos países buscados. Portanto, garantir emprego, documentação e dar cidadania a essas pessoas são de suma importância para que eles elas não se sintam violados e excluídos quando chegam em um local que não pertence as suas tradições. A documentação garantida, por exemplo, protege o imigrante de trabalhos irregulares e de exploração.']",160,160,160,120,120,720
43,Pré-conceito.,"['Infelizmente muitos usuários anônimos, julgam-se sábios, o suficiente ao ponto de opinar, sobre a vida de algo ou alguém,que na maioria dos casos, não se tem argumentos válidos ou concretos, sobre a situação que se ocorre ou que já ocorreu.', 'Muitos internautas deixam se levar, por fake news, historias sem começo,ou fim, sempre faltando algo,ao ponto de terem zero compreendimento do tal assunto,algo,etc. É muito compreensível, a falta de vontade de procurar ou pesquisar, para poder ter um argumento.', 'Logo,os famosos,artistas de ruas,ou até mesmo pessoas simples que ganham fama por memes,nas quais que muitas das vezes contém verdades das quais jornais,sites que informam as populações, não tem certeza do que ocorreu e mesmo assim , querem ganhar fama em cima de assuntos trágicos ou até mesmo mal interpretado,seja, a uma grande população,como São Paulo,ou de até vilas ou aldeias.', 'Nem sempre os tais influenciadores digitais ou celebridades famosas novas ou antigas, se tem total noção ou senso,ao ponto de defender ou capacidade de fala,por si só. E conforme não se tem projetos,palestras, que procuram explicar como faz e acontece,cada ano que se passa mais alguém é cancelado e não entende o motivo,mesmo que seja, muito maior os casos de tal ídolo, estar errado,talvez á pessoa em si, nunca teve uma oportunidade de que alguém á explicasse de fato oque aconteceu ou acontece, a não ser que a pessoa tenha tal experiencia de vida,ou foi pesquisar sobre oque ocorreu. para que ai sim,tenha um bom argumento,e também,não influenciar mal. aqueles quais não vão queixar-se e apenas vai atormentar outros internautas.']",120,120,120,120,0,480
150,Violência começa em casa,"['Muitas pessoas         ja          ouviram falar ou presenciaram violência          escolar  , isso         a cada dia vem se agravando bastante         em         escolas e para os estudantes é                 uma coisa                muito comum.         Porem          quando se é          criticado         percebe-se que isso é um problema tão grave quanto um assalto a um banco.', 'A cada dia que se passa as coisas vão evoluindo e mudando. Antigamente, para as pessoas, a violência não era um ato muito comum, mas com os dias passando, a violência foi se tornando mais usual e os casos de violência escolar se agravaram.                  As principais causas de violência na escola são bullying, brincadeiras e desentedimentos simples e essas simples coisas vão se tornando sérias e até casos de         policia         .         E no dia-a-dia para os brasileiros         o derespeito e violência                 são coisas básicas, mas pode-se ver que são problemas sérios e que devem ser tratados.', 'A violência usualmente começa em         casa, e         depois vai para as ruas e vai se espalhando por todos os lugares,                 então a solução seria reverter esse fato                . Que essa violência dentro de casa fosse eliminada e que os pais                 corrigissem                seus filhos de                 forma correta.          E escola deveria-se          dar apoio psicológico, moral e ético aos estudantes.']",80,80,0,0,80,240
61,Suicídio,"['A palavra originada do latim, pode ser conhecida como autocídio, é o ato de matar a si mesmo. Os motivos que levam alguém a se auto assassinar são finitos : problemas familiares,mentais, com o trabalho, depressão, autoestima, ou porque cansou de viver e não veem mais sentido em continuar. A questão é que o suícídio não é um fator que se pode ignorar,é uma realidade vivida entre nós, a qualquer momento alguém próximo pode se matar. e a pessoa que faz isso não prejudica a si somente mas também as pessoas ao seu redor que se importam com ela. Todavia o que se pode fazer para evitar?', 'Nos últimos anos tem se observado uma grande quantidade de policiais que cometem tal ato enquanto estão em serviço . Além de ser uma profissão em que se arrisca a vivência a todo momento, também tem o fato de ser um ofício que causa bastante estresse e em que eles podem tirar a existência de alguém,seja para salvar a sua em si ou para proteção de seu aís, e de seus colegas de equipe envolvidos. E o número de autoquíria só vem aumentando, o que acarreta uma alerta a todos para poder evitar, porque depois que acontece não a mais nada que se possa fazer, e é sempre de pessoas que ninguém poderia imaginar.', 'A maioria dos que tiram sua própria vida sofrem de transtornos mentais e traumas que o emprego pode trazer com o tempo e praticamente nenhum deles possuem acompanhamento profissional ou porque não querem . O problema se passa por todo o país principalmente nas regiões mais violentas como o Rio de Janeiro. Muitos são agredidos com palavras e insultos diariamente,isso causaria um grande desgaste emocional e psicológico a qualquer um, agora para um indivíduo que anda sempre armado as probabilidades de autoexterminio são bem maiores.', 'Podem existir várias formas de prevenção, mas o diálogo sempre sobressairá. Ter com quem conversar e contar como se sente,como foi o dia e por tudo o que passou,é algo muito importante e não precisa ser um profissional para poder ajudar,mas se for preciso existem muitos programas de auto ajuda como CVV.E que existam mais palestras que incentivem a estes profissionais diariamente,pois mesmo que sejam apenas palavras, elas podem ter o poder de ajudar a qualquer um em seus problemas mais difíceis quando usadas da maneira correta.']",120,80,80,120,80,480
84,Precisa-se de Paz,"['O homem com uma arma nas mãos é um bicho feroz! Mata, viola e destróis . Quantas vidas foram construídas a balas? E quantas foram destruídas? Somos feitos a prova de balas? Desde que entrou em vigor no Brasil o estatuto do desarmamento, as pessoas seguem suas vidas com mais tranquilidade. Porque antes da lei, qualquer um tinha uma arma de fogo escondida pronta para ser usada por qualquer motivo banal.  E assim, destruir famílias inteiras com uma única bala.', 'O mundo não suporta mais tanta violência, (.) Será que já não chegou a hora de desarmar o mundo? Licença pra matar? Precisamos disto? As pessoas estão perdendo o controle da vida. No Brasil o despreparo e o desrespeito com a vida humana, colocam o país em primeiro lugar, da polícia que mais mata no mundo.', 'As armas foram feitas para proteger a vida. E não para acabar com ela. O Brasil precisa urgentemente rever seus conceitos sobre violência policial. Assim, junto com toda sociedade editar novas regras e mudar essa realidade bizarra, que a todos apavora. A ganância Norte americana, está provocando a cada dia uma nova tragédia. E o congresso Norte americano por interesses próprios, deixa o povo á próprias sorte.', 'Não existe um caminho para a paz. A paz é o caminho. E na cultura da paz, não precisamos de armas para lutar,mas, de motivos para contemplar a vida. Todos sabem que um dia morreremos. Mas, antes de morrer, temos que viver! Porque a vida é o grande momento de todos nós. E temos que valorizar a vida. Fazer nossa vida valer a pena, cuidar do planeta, das pessoas, semear o amor. Cultivar a igualdade dos povos. Sem armas de fogo no Brasil! Nem polícia nem civil. Melhor que armas, são os motivos para nunca precisar usá-las. Basta de violência!']",120,120,120,120,200,680
95,A luta dos índios,"['O “marco temporal” é uma medida restritiva determinada pelo Supremo Tribunal Federal (STF) que os povos indígenas só poderão reivindicar suas terras caso estivessem presentes nela antes de 5 de outubro de 1988, data que foi aprovada a atual Constituição Federal. No entanto há uma grande contrariedade dos indígenas em relação ao marco temporal, pois isso dificulta a posse deles sobre as terras , as quais eles alegam que não estavam presentes quando a Constituição Federal foi promulgada por terem sofrido violência ,devido à expansão rural e urbana , e pelo desmatamento .', 'Em princípio consta na Constituição federal Art. 231. ” São reconhecidos aos índios sua organização social, costumes, línguas, crenças e tradições, e os direitos originários sobre as terras que tradicionalmente ocupam, competindo à União demarcá-las, proteger e fazer respeitar todos os seus bens.” Ou seja os índios estão protegidos pela atual lei para que possam viver em suas terras com respeito e segurança . Mas não é isso que ocorre,  as terras indígenas tem sido desmatadas por garimpeiros, grileiros e madeireiros para exploração ilegal de madeira e grilagem .', 'Além disso ,os índios alegam ter direito ás terras por estarem presentes nelas antes da criação dos estados brasileiros ,e as terras tem valor sagrado e sentimental para eles,é por esses motivos que atualmente eles estão unidos fazendo protestos e lutando para reivindicação de suas terras , assim como diz o artigo 1 da declaração universal de direitos humanos “ Todos os seres humanos nascem livres e iguais em dignidade e em direitos “, portanto é claro que todos esses fatos ocorridos citados acima são resultado da falta de respeito com os índios , e eles são dignos de viver sua cultura em segurança .', 'Dado isso é justo é necessário que o Supremo Tribunal Federal (STF) conceda a reivindicação das terras para os povos indígenas ,levando em consideração o artigo 231 da Constituição federal, que fala sobre proteger e respeitar os bens, e manter o direito originário de suas terras, outras medidas importantes devem ser tomadas para evitar novamente esses conflitos como,  promover ações estruturais e urgentes de fortalecimento das tribos, pelo fórum permanente da ONU , espaço construído historicamente pela atuação das organizações indígenas , além disso, o relator especial da ONU deve contatar representantes do governo brasileiro para promover demarcação , fiscalização e proteção das terras . Dessa forma as tribos indígenas poderão habitar em suas terras em segurança , sem risco de violência, expulsão e qualquer outro tipo de desrespeito.']",120,160,120,160,160,720
65,A redução da maioridade penal resolveria o problema da criminalidade jovial?,"['Muito se tem discutido, recentemente, acerca da violência no país, principalmente quando se atua como autores dos delitos os menores de idade. Nesta ótica, cogita-se com freqüência, tramitando inclusive vários projetos no Congresso Nacional a possibilidade de reduzir a maioridade penal com o intuito de diminuir o índice de criminalidade cometido por jovens menores de 18 anos.', 'Há registros históricos de que a criminalidade a cada dia que passa mais aumenta no País , e que mesmo os jovens que são responsabilizados seja por apreensão seja por prestação de serviços a comunidade resta por reincidirem. Deste modo, indaga-se se as penalidade aplicadas aos infratores são suficientes para atingir a finalidade da pena, que é a ressocialização do individuo. Neste contexto, alguns argumentam que a redução da maioridade penal seria a melhor forma de resolver o problema, pois, assim os menores que até então acreditam que podem cometer vários delitos e não sofrer qualquer contrapartida do Estado, poderiam ser presos e pagarem pelos seus crimes. Por outro lado, parte dos cidadãos acreditam que melhor seria se o Estado implementasse politicas para a execução correta das leis já existentes para menores infratores.', 'Analisando o contexto legal existentes, subentende-se que o problema não est n déficit da criação de leis, mais sim na execução destas, pois,  a lei existe, porém não é devidamente aplicada muitas vezes por falta de recursos, como por exemplo falta de centros socioeducativos no caso em questão.', 'E virtude do que foi mencionado, observando o atual estado que o país se encontra , conclui-se que a redução da maioridade penal não é a melhor opção para a diminuição da criminalidade, pois, reduzindo-a, o país esta procrastinando o problema, e não resolvendo . Vale salientar que, a finalidade da aplicação da pena é ressocializar, e não transformar o apenado em um delinquente de maior periculosidade, como ocorre atualmente.']",120,120,120,120,120,600
104,Bicicletas são o meio de transporte do futuro,"['Que o uso de bicicletas como substituta de meios de transporte mais sedentários contribui para perder peso,                saúde cardiovascular e                prevenir uma série de doenças já         esta         claro e todo mundo sabe, mas a novidade é que deixar de dirigir para         usa-la          melhora também o desempenho          metal          do ser          humano. Além          de contribuir significativamente para a diminuição do caos no trânsito e a poluição ambiental. Há países que dão exemplo e mostram que isso é possível e recompensante.                   Apesar do grande número de vantagens que cercam essa           proposta          ela não          esta          sendo colocada em          pratica         , pois assim como há         prós         existe quem leve em consideração os contras do uso de bicicletas. Há quem defenda a ideia de que         as pessoas que circulam no trânsito brasileiro         não         tem         a consciência e a responsabilidade necessária para que os ciclistas possam transitar sem problemas e acidentes.', 'Para que                 isso                possa se tornar realidade no Brasil, deve haver um grande investimento em mudanças para que seja possível o trânsito de ciclistas com segurança.                 A implantação de ciclovias em longos trechos, existem cidades que não possuem          nem um          tipo de ciclovia, a mesma é altamente necessária para que a haja a circulação de ciclistas sem problemas futuros.', 'Convenhamos que se a população se adequasse a         esta         proposta                 de novo meio de transporte         ocorreria         melhorias                 incontáveis                para todos, mas para que isso seja possível não         basta as         bicicletas, pessoas que saibam         usa-las         e ciclovias. Todos teriam que passar por uma         ""reciclagem""         para que assim soubéssemos como         se         comportar no trânsito e conviver com as bicicletas ao lado de carros, motos, caminhões e ônibus, o que não é algo impossível e                complicado de ser feito. Além, claro, do investimento em ciclovias e da motivação da                 população                para         usa-las         e com isso teríamos uma                 população                mais saudável, menos estresse e         perca         de tempo no trânsito e um país mais ecológico.']",120,120,80,80,120,520
33,Reforma ou deforma de  ensino,"['O novo governo no Brasil, vem realizando diferentes mudanças polemicas . A educação desta vez foi o alvo, a Secretaria da Educação tomou medidas provisórias no ensino médio; que as disciplinas de educação física e Artes serão facultativas. Professores e Alunos demonstram suas insatisfações diante desta decisão.', 'A disciplina de educação física é fundamental para o desenvolvimento de jovens, sendo que nesta idade a agem de maneira mais tímidos , a pratica de esporte fortalece a interação dos grupos entre eles. Além de informar os cuidados com a saúde evitando doenças futuras, pode despertar o interesse profissional por esta área.', 'Em relação a disciplina de Artes é pura expressão de sentimentos, tendo contato com a música, instrumentos, pintura, teatro e outros. Estimula um o desenvolvimento de liberdade de expressão, sensibilidade, um pensamento crítico diante da sociedade. Esta é a ligação de esperança para o futuro.', 'Portanto as disciplinas de educação física e artes tem uma função de extrema importância para o desenvolvimento de crianças e jovens em uma sociedade. Espera se que o governo reavalie sua decisão referente a reforma da educação.']",120,80,80,120,0,400
83,Esporte,"['O bordão brasileiro “esporte é saúde” é uma máxima que ajuda a resumir a importância da prática de exercícios físicos para todas as áreas, da saúde até o social. Desde a Grécia Antiga, o esporte, independente da modalidade, é aclamado pela sua capacidade de, além de garantir a saúde do corpo e da mente, desenvolver os aspectos sociais dos indivíduos. Entretanto, a rotina contemporânea, em associação com o sedentarismo e maus hábitos alimentares, diminui os efeitos do esporte na sociedade.', 'No Brasil, ainda que se valorize algumas modalidades como o futebol, o número de sedentários é quase a metade da população, o que indica que a importância do esporte precisa ser ampliada. No campo da saúde, o esporte desempenha papel fundamental: auxilia no desenvolvimento esquelético-muscular, maximiza a coordenação motora e previne doenças graves, como obesidade e pressão alta.', 'Também, o esporte funciona como elemento de transformação social ao permitir a ascensão de classes e impedir que crianças e adolescentes carentes recorram à criminalidade. Recentemente, os jogos esportivos deram mais uma prova de sua importância: a atleta Rafaela Silva, que nasceu em uma comunidade simples carioca, ganhou a medalha de ouro nos Jogos Olímpicos e mostrou ao mundo a capacidade do esporte em formar e transformar vidas.', 'Além disso, as práticas esportivas criam e reforçam o ideal de coletividade, cooperação e igualdade, de modo que todos os envolvidos sempre ganham em companheirismo e, sobretudo, humanidade.', 'Por esses motivos, a fim de garantir e proporcionar os múltiplos efeitos do esporte, é importante que os núcleos familiares incentivem, desde a primeira infância, a prática de exercícios físicos e que o governo financie projetos esportivos. Para tanto, o Estado deve criar e ampliar infraestrutura esportiva, investir em profissionais de educação física e divulgar, em parceria com a mídia, campanhas de incentivo ao esporte e combate ao sedentarismo.']",200,200,200,200,200,1000
68,Cuidados,"['É notório que o patrimônio histórico de uma nação ou civilização é fundamental para o conhecimento e continuação de uma cultura e de costumes intimamente relacionados ao passado e a grandes momentos da história. Contudo, fatores como: a falta de cuidados e as diferentes noções culturais fazem muitas obras serem esquecidas e abandonadas, levando junto a elas memórias de um povo.', 'Convém ressaltar que a manutenção de monumentos, obras de arte, museus são de suma importância para a continuação de memórias materiais de civilizações antigas, marcos e monumentos históricos do planeta. Infelizmente, diversos lugares marcados na história foram perdidos por falta de cuidados. Um exemplo é o Museu Nacional que, por negligência tanto do Estado como do órgão responsável pelos cuidados, sofreu um incêndio e, junto ao dióxido de carbono liberado, se foram milhares de obras que integravam o patrimônio histórico do Brasil.', 'Além disso, o patrimônio histórico é baseado em conceitos culturais que estão intrinsicamente ligados ao convívio com certa sociedade. Analogamente, para compreender o valor histórico exposto é necessário uma certa noção dos fatos expostos. Contudo, a falta de intimidade com este conceito leva certas pessoas a roubar, pichar e até quebrar alguns patrimônios públicos e históricos que representavam verdades e fatos de um povo.', 'Assim sendo, o patrimônio histórico representa a cultura e os costumes que contribuíram para o desenvolvimento de uma civilização, e é de suma importância a continuação da história física. Diante disso, se faz  necessário uma maior preocupação com os bens históricos por parte da população e é imprescindível um maior investimento do Estado para a manutenção de monumentos marcados na história. Além disso, é importante uma maior preocupação dos professores em ressaltar a importância do patrimônio histórico de um povo aos alunos e,  leis mais severas no combate a depravação cultural. Desse modo, o patrimônio histórico e a cultura de uma nação ou civilização permanecerá para as futuras gerações.']",120,120,120,120,120,600
72,Só a verdade é eterna,"['E conhecerdes a verdade e ela vos libertará! Disse Jesus ao mundo há mais de 2000 anos, e essas palavras são viscerais e atuais hoje e por toda eternidade. Fake news são mentiras, calunias e difamação que pessoas sem caráter usam para prejudicar outras, seja inventando ou compartilhando sem critério de julgamento e sem compromisso com a veracidade dos fatos. A vida online se tornou vital para algumas pessoas que não sabem pensar! Compartilhar, curtir, seguir, perseguir e até destruir vidas alheias virou a grande ordem dos comandados online.', 'No ano de 469/470 nasceu em Atenas na Grécia, Sócrates uma grande filsofo, que tornou-se renomado por sua contribuição no campo da ética. Ele defendia que deve-se sempre dar mais ênfase à procura do que não se sabe, do que transmitir o que se julga saber, privilegiando a investigação permanente. Ninguém pode sair por ai divulgando o que não sabe se é verdade. E se fosse com você ou com um parente seu? Iria procurar saber a veracidade ou simplesmente compartilhar? Face News não é critica, é ato covarde. E geralmente esses covardes se escondem em perfis falsos para implantar o caos na Net.', 'Precisamos de cidadão com raciocínio critico e logico, capaz de diferenciar uma informação verdadeira de uma tendenciosa.', 'O problema é que no Brasil a mídia em sua grande maioria vem manipulando as noticias a sua maneira e manuseando as pessoas para as meias verdades. E isso é crueldade! Eles jogam as pessoas principalmente políticas ao tribunal do povo! Estão demonizando políticos e partidos políticos,  Sócrates dizia, que para se acreditar em algo, era preciso verificar se aquilo realmente era verdade. O perigo que a ignorância faz correr ao saber, que o mal faz correr à virtude. Sócrates foi condenado à morte por sua maior virtude, pensar! E acreditar que nada faz sentido além da verdade. Ânito, Meleto e Lícon. o ano 399 A.C foram seus carrascos.', 'Ninguém faz o mal voluntariamente, mas por ignorância, pois a sabedoria e a virtude são inseparáveis . Pare leia e pense!  Para resolver esse problema de fake news é preciso uma lei bem severa que puna os criminosos e sua rede de apoiadores,  Quando a sentença for proibir esses infratores de terem vida online como um passe de magica os delitos acabarão . Tudo só depende de um sentido de valor e propósito cívico compartilhado por cidadãos que não se deixam seduzir por argumentos demagógicos de grupos de interesse e por identidades construídas. É mais provável que esse tipo de conscientização se desenvolva fora das redes homogêneas de comunicação que, no momento, exercem grande influência sobre os cidadãos.']",120,80,80,80,80,440
81,Os fatos da realidade religiosa no Brasil,"['A religiosidade no Brasil, que é um país laico, apresenta certas intolerâncias por parte da sociedade. Algumas religiões têm desafeto por outras, no entanto, é necessário o respeito por cada crença devido a  laicidade do Estado.', 'Cada religião tem suas características próprias, como rituais e atos periódicos. Com a posição do Estado brasileiro sobre as crenças, a necessidade de elaborar leis que combatem crimes contra o sentimento religioso foram positivas, porém, ainda não deixou de existir as discriminações. Entre crenças e descrenças, há religiões que combatem outras violentamente, como no caso registrado em que se atiraram uma pedra contra umbandistas, gerando repercussões.', 'Por outro lado, o país esta  longe de possuir religiões extremistas, como o Estado Islâmico e o Boko Haram, que empregam atos terroristas diante de quem é contra ou não segue o Islamismo, e além disso vêm ocupando territórios no Oriente Médio e na África algo desumano e que é intolerante.', 'Diante dos fatos mencionados, o Governo brasileiro deve criar um órgão que reúna as mais diversas crenças existentes, com um representante de cada, com o intuito de gerar entre elas uma relação harmônica, onde haja respeito e humanidade, a fim de combater as intolerâncias.']",120,120,120,120,120,600
78,Um problema ainda maior,"['Sancionada em fevereiro de 2017 pelo presidente Michel Temer, a Reforma do Ensino Médio tem gerado uma grande repercussão . Com o objetivo inicial de melhorar a ineficaz educação brasileira e propor mudanças no currículo escolar, tal proposta gera sérios problemas ao desvalorizar disciplinas de suma importância e ao desconsiderar a falta de investimento básico no ensino.', 'É fato que a educação brasileira passa por uma situação muito complicada . Em 2015, o país ocupou o sexagésimo lugar no ranking da educação mundial. Dessa forma, foi criado o projeto do Novo Ensino Médio. Um ponto muito criticado pelos educadores é a não obrigatoriedade das disciplinas de História e Geografia, por exemplo. Tal alteração é inaceitável, visto que essas disciplinas corroboram para o pensamento crítico e o conhecimento histórico e espacial, por meio da compreensão da realidade. Na primeira versão da proposta, disciplinas como Artes e Educação Física haviam sido excluídas, entretanto, devido às  diversas manifestações de educadores, professores e artistas, na segunda versão, elas foram incluídas como obrigatórias.', ""Ademais, a ausência de investimentos primários nas escolas prejudicará a eficácia do novo método de ensino. Muitas escolas do Rio de Janeiro e de outros estados brasileiros não forneceram em 2017 o material escolar básico para os alunos da rede pública . É inadmissível que se pense em uma educação técnica profissional, como também propõe o MEC, sem os materiais necessários e os professores especializados, já que a medida permite que profissionais com ''notório saber'' possam lecionar, o que é uma falta de respeito com os licenciados ."", 'Por conseguinte, para que a educação brasileira saia de seu atual estado de estagnação, é necessário que os sindicatos dos professores, principalmente de História e Geografia, manifestem-se diante à  decisão do Ministério da Educação, por meio de protestos, greves pacíficas e reuniões com representantes do MEC. Outrossim, o Governo Federal deve investir em meios para uma educação de qualidade, comprando materiais escolares, pagando em dia os funcionários, oferecendo a merenda. Assim,  poderá ser seguida a ideia do filósofo alemão Immanuel Kant de que as pessoas nada são sem a educação.']",120,120,120,120,120,600
50,Importância da ciência,"['O planeta erra tem enfrentando grandes problemas, mas um em especial está causando sérias preocupações, seu nome é coranavírus, sim ele é um vírus algo tão minúsculo afetando a saúde, econômia e sociedade do mundo todo. Alguns presidentes não estão levando muito a sério o covid 19, declarando ser uma simples gripe, pois os sintomas acaba sendo parecido, mas como um pequeno resfriado pode levar morte.', 'Os sintomas do Covid 19 é: tosse, dor de garganta, febre e alguns mais graves como pneumonia e dificuldade na respiração, a taxa de mortalidade ainda é pessoas que já tem alguns problemas como hipertensão e outras enfermidades, e os idosos também estão nessa taxa.', 'O coranavírus se espalha muito rápido, por isso os números de infectados são cada vez maiores o mundo todo tem sofrido . A mídias não param de dar muitas notícias, então tem fake news é preciso ficar atendo pra não cair em uma e não ficar respirando só isso, pois vão acabar com outras doencias emocionais como depressão por exemplo .', 'Enfim médicos, cientista tem estudado de mais pra conseguir a vacina, mas enquanto eles não consegue, tem que fazer a higienização que é lavar as mão com sabão, depois a passada do álcool 70, evitar levar as mãos nos olhos, a boca, quando for tossi colocar o cotovelo, e se puder ficar em casa.']",120,160,120,120,0,520
54,A picada que salva vidas.,"['A vacinação é de grande importante para a sociedade, pois devido a ela doenças graves foram erradicadas, cita-se como exemplo, a poliomielite, rubéola,caxumba, sarampo, entre outras. Com a diminuição vacinal casos destas doenças estão sendo diagnosticados novamente. Nos últimos cinco anos notou-se uma diminuição gradual do números de imunizados contra diversas doenças, que contam com vacinas disponíveis. Mediante a isso é necessário que sejam reforçadas as campanhas de conscientização da importância das mesmas.', 'Atualmente são disponibilizadas pela rede pública cerca de dez tipos de vacinas, que protegem contra aproximadamente vinte a vinte cinco tipos de doenças virais e bacterianas, destas observa-se que a única a não apresentar queda vacinal foi a de BCG, pois em sua maioria é aplicada antes da alta da criança, na própria instituição hospitalar.', 'Existem duas classes de vacinas, as produzidas com vírus/bactérias inativadas e as atenuadas, porém a função das duas é a mesma: induzir o corpo a produzir anticorpos contra a(as) doenças cobertas por ela. Entretanto notícias falsas,  estão anunciando que vacinas causam doenças e algumas podem levar a morte, aumentando assim o receio da população, principalmente a leiga com as vacinas , causando uma diminuição da adesão popular pelas mesmas e fazendo com que assim doenças já erradicas no Brasil voltem a aparecer.', 'Desde 2015 a diminuição da vacinação tem trago a tona surtos de doenças erradicadas, em 2016 pode-se citar o de Caxumba em 2018/2019 vários casos confirmados de rubéola e sarampo, e o que se pode observar,  é que a maioria dos diagnosticados com essas doenças não tinham histórico vacinal completo, como recomendado pela sociedade brasileira de imunização.', 'É necessário que as campanhas de vacinação tenham maior abrangência, combatendo as fake news e fazendo a conscientização da população sobre a importância das vacinas para a sociedade, e para impedir que doenças erradicadas voltem a aparecer no Brasil.']",120,160,80,120,80,560
3,Revolução transumanista,"['É notório que o desenvolvimento tecnológico vem crescendo muito ao longo do tempo, principalmente após a revolução industrial. Tal desenvolvimento busca sempre melhorias para a vida do ser humano, mas muitas vezes não se observa isso na pratica prática.', 'Cabe mencionar que graças ao avanço tecnológico, principalmente no ramo da biotecnologia varias biotecnologia, várias enfermidades que antes eram intratáveis torna-se tornam-se hoje tratáveis, podemos tratáveis. Podemos citar como exemplo a radiação sendo utilizada para matar as células cancerígenas, sendo assim esse procedimento procedimento que hoje é muito utilizado no tratamento de várias espécies de câncer. Podemos citar como exemplo também o HIV a Aids que é uma doença incurável, mas graças ao avanço da biotecnologia, há remédios que podem reduzir drasticamente a progressão da doença. Então, no ao que tudo indica, a revolução do transumanismo é só questão de tempo.', 'Entretanto a de Entretanto, há de se pensar qual será o preço dessa tecnologia, em que a ciência garantira garantirá a saúde, a juventude e a imortalidade. Será que todos terão condições financeiras para adquirir tal tecnologia ou vai ser algo onde só os ricos viveram viverão para sempre, enquanto os pobres pobres, que não tem têm condições para adquirirem adquiri-la, viverão mendigando cada segundo por algo que não poderão ter. o ter? O filme ""O preço do amanhã"" daria dá uma boa ideia de como possa poderia ser essa nova sociedade futurista, onde e a sociedade é bem dividida entre os pobres, que trabalham, e os ricos, dominantes, sendo que só os ricos teriam viva eterna em que os pobres trabalham e os ricos têm a vida eterna.', 'Feitas as devidas reflexões, percebe-se que o avanço da tecnologia é indispensável para a melhoria de vida da humanidade. mas Mas o ponto chave é torna tau tornar tal tecnologia acessível a todos. Para isso isso, precisa-se que os governos invistam mais no desenvolvimento tecnológico e não apenas os grandes capitalistas que só visam o ao lucro. Para Para, quem sabe assim, o governo possa através de suas políticas torna tau tornar tal tecnologia acessível a todas as classes sociais.']",120,120,120,120,120,600
41,O método eficaz de melhorar a educação,"['Nos dias atuais, a falta de respeito, a indisciplina e outras inúmeros problemas tem feito parte da rotina nas escolas. Muito se discute se o ensino visando a autoridade e disciplina colabora para melhoramento na educação, formação de cidadãos mais responsáveis e se o ensino militar, que visa ao máximo essas características, favorece uma melhor educação. Atualmente a preguiça e a falta de respeito estão fazendo parte nada vida escolar de muitos estudantes, que podem variar de um simples fato de não fazer suas tarefas avaliativas, até o desrespeito e agressões contra seus professores. Os problemas citados, ocorre muitas vezes por falta de cobrança e rigidez nas escolas, logo, gerando estudantes com baixos desempenhos e sem perspectivas para o futuro. Inúmeras pesquisas vem apresentando que escolas militares que visam cumprimento rigoroso das regras e disciplina excessiva, geram estudantes com ótimos desempenhos escolares e boas notas em concursos e vestibulares. Além disso, também mostra que o ensino militar contribui para decisão na escolha de profissões na vida futura dos estudantes. Pode-se concluir que a junção de disciplina e responsabilidade dentro da educação colabora para a mesma , formando estudantes mais responsáveis, educados, e com melhores desempenhos . Por todos esses aspectos seria beneficioso que a educação brasileira se objetivasse em inserir a disciplina e responsabilidade dentro das escolas.']",120,160,120,160,120,680
63,,"['Acredito que a única maneira de combatermos  os impactos ambientais é quando nos esforçamos para sermos a mudança de alguma forma . Evitando que o impacto comece por nos . Como por exemplo, quando nos desfazemos de uma garrafa pet a jogando na rua, entre outras variadas coisas que cometemos no nosso dia a dia.', 'Para evitarmos uma catastatrofe ambiental pior do que a de Marina e Brumadinho que ocorreram em Minas gerais, que causou muita dor e sofrimento a todos os brasileiros e comoveu até outros países. Foi por total descuido do governo e da cidade, pois não chegaram a fazer um trabalho limpo e certo no local. As barragens que se partiram poderiam ter sido evitadas , e assim teríamos menos noticias ruins na midia. Mas a verdade é que tudo que se precisa gastar demais, o governo foge e nos entrega qualquer coisa.', 'Então, para que possamos  mudar nosso planeta, nossa vida ambiental, solucionar todos os problemas causados,seria lutando por nossos direitos, acredito na possibilidade de uma nova revolução no Brasil. At porque, se o brasileiro não procurar seus direitos? Ninguém vai.']",120,80,80,80,80,440
137,"Transgênicos, uma questão de ética","['A transgenia alimentar engloba diversos aspectos, tais como ambientais, éticos e de saúde. Enquanto uns acreditam que nela         esta         a solução, outros divergem, afirmando que ela acarreta ainda mais problemas. A gama de possibilidades que os transgênicos nos         oferecem, é         realmente grande, mas até que ponto o homem pode interferir no curso da natureza? Até que ponto a transgenia pode ser favorável e até que ponto ela pode ser letal?', 'Aí esta o grande         empasse         dos alimentos transgênicos. Os favoráveis a esse tipo de tecnologia afirmam que ela pode acabar com a fome no mundo, uma vez que                 a mesma, aumenta                em até 80% a produção de alimentos. Porém é sabido que o problema da fome não está na                 sua produção, mas sim em sua distribuição, que é feita de forma irregular                .', 'Há ainda os que dizem que esses alimentos não fazem mal nenhum         a         saúde e que as pesquisas comprovam isso. Mas se analisarmos, vemos que as pesquisas são feitas a curto prazo, de até no máximo 90 dias. No         entanto         um grupo de pesquisadores da         Europa, realizou         uma pesquisa em ratos de laboratório, durante         2         anos, que é um tempo considerável, e as cobaias apresentaram câncer e tumores.', 'Ao levarmos esses aspectos em consideração, vemos que a transgenia é um desconhecido e que é preciso calma e muitas análises antes de utilizá-la. Mas infelizmente o ser humano é escravo da ganância e somente visa lucros e mais         lucros, cabe         a nós, consumidores, exigir que esses alimentos sejam rotulados, para que possamos escolher se queremos ou não correr esse risco.']",160,120,160,160,160,760
16,A nova hegemonia política do Brasil,"['A maioria dos países da América do Sul passaram para o lado conservador. Paralelamente a isso, o Brasil presenciou na última eleição presidencial uma dicotomia política: direita e esquerda. O primeiro é conservador; o segundo, socialista. Em uma disputa à presidência acirrada entre esses dois polos opostos, o país decidiu democraticamente pelo conservadorismo. Mas afinal, o que mudará daqui pra frente no país com a nova “onda conservadora”?', 'Há muito assunto em discussão, mas o principal é de que o país entraria em uma ditadura militar. Antes de tudo, o presidente deve honrar a Constituição Brasileira de 1988 – CF/88 , ou seja, não pode desrespeitar a lei maior por ser presidente. Além disso, tal questão feriria as cláusulas pétreas: princípios fundamentais que regem o país, guiando-o juntamente com a democracia.', 'Com o Jair Bolsonaro no comando do país, o exposto acima poderia não ser seguido, já que é ultraconservador, e também porque a metade das cadeiras do Congresso Nacional estão ocupadas por direitistas. Dessa forma, se dependesse desses líderes para trazer o período militar, tal iniciativa até que se confirmaria, mas a questão é que não depende, há outros coadjuvantes que analisariam essa atitude contraia à democracia, como o Supremo Tribunal Federal – STF –, guardião da CF/88. E também porque a população brasileira não aceitaria apagar sua história democrática em ascensão para regredir ao passado ditatorial.', 'Além disso, fala-se também na legalização do porte de arma para o brasileiro e, devido a isso, poderia ser o holocausto dos homossexuais. Não é bem assim. Nas redes sociais circulam muitas notícias falsas a respeito dessa ideia. Não é porque o país mudou de esquerda-liberal para direita-extremista que isso vai acontecer. Pode ser que ocorra em alguns casos isolados visto que o país ainda é muito homofóbico.', 'Conclui-se, portanto, que há muito em jogo em ralação a um novo período com um presidente conversador. Este, caso seja contrário à democracia, temos o impeachment para tirá-lo. Seja de direta ou de esquerda, isso não importa mais, o importante é que o Brasil precisa de mudanças políticas e socias positivas e efetivas antes de qualquer opinião precipitada sobre essa nova hegemonia.']",160,160,120,120,120,680
88,,"['No filme ""Se Enlouquecer, Não Se Apaixone"", o protagonista passa por problemas mentais que ele não conhece, e resolve ir em busca de ajuda, logo, descobre que está com depressão. Fora da ficção, essa cena é persistente e estigmatizada na realidade brasileira, porém, pelas pessoas acreditarem que é frescura ,não procuram ajuda e não sabem lidar. Isso deve-se a criação de um ambiente não real nas redes sociais e negligência estatal.', 'Em primeira análise, o descuido por parte das autoridades públicas com a saúde mental dos brasileiros, é prejudicial. Segundo a OMS (Organização Mundial da Saúde), em 2017,uma média de quase 12 milhões de brasilianos,  têm depressão. Isso explica o quanto é necessário que o Estado intervenha a solucionar doenças mentais que afetam a maioria dos cidadãos. O governo deve-se preocupar, pois, não só os atuais empregados, mas também os futuros trabalhadores (que são os estudantes) podem ter ou tem problema mental, consequentemente, gerando óbces administrativos e financeiros.', 'Além disso, a popularidade nas redes sociais mostram uma face cruel do que é verdadeiro. Muitos digitais influencers postam o que eles querem que as pessoas vejam, por isso o público é influenciado por algo inexistente, como a perfeição, lenvando graves transtornos mentais com problemas de enfrentar as dificuldades da vida cotidiana.', 'Fica evidente, portanto, que o estigma, na sociedade brasileira, associado a doenças mentais, deve ser combatido. Urge que o ministério da Educação (MEC) construa, por meio da mídia, televisão e instituições de ensino, campanhas publicitárias, afim de que promovam consciência em procurar ajuda, como também, reforçar a importância do programa CVV (Centro de Valorização a Vida), e um projeto de acompanhamento terapêutico gratuito através do SUS (Sistema Único de Saúde). Assim, o estigma de doenças mentais no Brasil, será, a médio e longo prazo, superado.']",160,160,160,160,160,800
87,Infância Roubada,"['""É típica a conduta de fotografar cenas pornográfica e de armazenar fotografias de conteúdo pornográfico envolvendo criança ou adolescente na hipótese em que restar incontroversa a finalidade sexual e libidinosa das fotografias, com enfoque nos órgãos genitais das vítimas - ainda que cobertos por peças de roupas - e de poses nitidamente sensuais, em que é explorada sua sexualidade."" apresenta-se no artigo 6° do ECA (Estatuto da Criança e do Adolescente) sendo punível tal feito.', 'De acordo com Freud, a sexualidade está presente em todas as épocas da vida humana, inclusive na infância. A polêmica gerada em 2020 pelo filme da companhia Netflix  de título original Mignonnes (Lindinhas, traduzindo do Francês)  trás tona situações passíveis de punição caso a origem do longa-metragem fosse brasileira. O enfoque sexual nas crianças se dá pela ""infantilização"" de práticas sexuais ""simuladoras"" de pedofilia. A obra exibe dançarinas de 11 anos utilizando seus corpos como forma de entretenimento, situação não comum.', 'O julgamento deste ocorrido é por conta da exploração do corpo infantil, onde se deveria manter a pureza e a inocência, a infantilidade dos menores. Campanhas de educação sexual e da apresentação da sexualidade de forma educativa e segura e cuidado com a imagem tanto real quanto virtual devem ser mais espalhadas pelas escolas e em casa, um educamento dos responsáveis para que o indivíduo decida o que é melhor pra si, decida seu caminho e não ser forçado por pressão social ou midiática a se submeter a padrões adultos.']",160,120,120,120,160,680
48,A crise como instrumento de mudança na saúde pública brasileira.,"['O Sistema Único de Saúde é a principal ferramenta de combate a epidemias e crises sanitárias ligadas saúde, com a vida de 210 milhôes de habitantes em suas mãos, assegurado plea Lei n° 8.080/1990, portanto a responsabilidade e a eficiência devem ser encarados como dever daqueles que gerenciam essa grande companhia estatal .', 'Com a crise causado pelo COVID-19 os velhos problemas de gestão como: excesso de burocracias, demora para atendimentos, falta de recursos e etc, devem ser encarados como uma questão de segurança nacional, sendo colocados como prioridades para o bom funcionamento do país e da saúde de milhões de brasileiros, cabe a população a cobrança de seus direitos regulamentados legalmente e aos gestores, manobras e estratégias benéficas e que visem a resolução dos problemas encontrados e o funcionamento ideal desse sistema.', 'Essa crise pode se tornar uma grande colaboradora para avanço e superação de problemas de burocracia, logística , protocolos e etc, utilizados pelo SUS, este problema deve ser visto com seriedade e como oportunidade para o avanço do atendimento das necessidades do país, e o avanço dessa grande nação.']",160,120,80,120,0,480
51,o comprometimento com a educação,"['Brasil esta entre os países com maior índice de ma formação acadêmica do mundo , que advêm desde a lei áurea de 1888, pois muitos indivíduos acabaram não tendo uma forma de ensino pois não tinhão condições financeiras , advindo disto muitos brasileiros também não possui uma forma de estudo , por não ter verba para frequentar a escola , onde mesmo sendo uma unidade publica ainda sim gera muitos gastos para os alunos.', 'Muitas pessoas que são analfabetas nos dias hodiernos , tem origem pobre que não teve condição de se manter no colégio , segundo uma pesquisa feita pelo jornal OGLOBO 40% dos alonos que começão o ensino fundamental , não fazem o ensino médio por conta de condições financeiras ,e acabam abandonado os estudos para procurar trabalho ,para solucionar este problema o governo criou a lei do menor aprendiz que entrou em vigor em 2005, que permitem que alguns alunos a partir de determinada idade,poção trabalhar contanto que mantem sua media escolar sem um nível aceitável .', 'm decorrência deste fato  a media de alunos que começarão a frequentar o ensino médio foi elevada ,porem ainda a negligencia com a educação brasileira , pois as verbas investida pelas entidades governamentais ainda são ma destribadas ,ou em alguns casos nem chegam ou destino ,para resolver este problema o governo deve investir com mais sabedoria o dinheiro da população , e gerar melhores condições de estudos para os alunos .', 'as entidades governamentais de fato tomarão providencia para resolver os problemas da educação , entre tanto não o bastando , deve-se investir mas na educação da população em todas as áreas  visando que, se torne o um abito brasileiro , pois como dizia Gustave Flaubert no conceito de defunto ´´ a vida deve se uma costante educação´´.']",80,80,80,80,40,360
14,A situação atual do Brasil e a imigração,"['Um dos temas mais debatidos atualmente, a migração é um fenômeno que vem crescendo à medida que povos tentam fugir de crises humanitárias como as que assolam a Síria e a Venezuela. Se, por um lado, há aqueles que defendem o acolhimento das pessoas que tentam obter residência em outros países; existem grupos cada vez maiores de indivíduos contrários a políticas mais brandas de imigração, devido à atual fragilidade da econômica mundial.', 'A movimentação de povos em todo o mundo é um processo inerente à raça humana e é responsável por mudanças que contribuíram para a existência do homem no planeta Terra. Porém, o que antes era usado como meio de busca por locais com melhores condições naturais, como regiões com água potável, passou, após o início dos conflitos entre povos, a servir como fuga das mazelas geradas por conflitos. Um exemplo disso é a vinda, para o Brasil, de europeus, que fugiam das consequências da segunda guerra mundial , responsável pela destruição de grande parte do velho continente.', 'Conquanto a crise migratória na Europa recebeu , nos últimos anos, um destaque nas discussões entre as autoridades mundiais, o que mais tem preocupado os brasileiros é o fluxo de venezuelanos que vem imigrando para o Brasil. Isso porque o maior país da America do Sul, historicamente um lugar que sempre recebeu bem imigrantes, uma das características que contribuíram para que o país se tornasse uma das maiores potências mundiais, não está preparado para receber muitas pessoas. Um exemplo disso é a precariedade dos serviços públicos, como na área da saúde, que já prejudica milhares de brasileiros e poderia piorar com um aumento populacional repentino, como aconteceu em Roraima, onde foi declarado estado de calamidade devido à grande concentração de estrangeiros.', 'Dessa forma, fica claro que o governo brasileiro deve assumir uma posição de cautela em relação à entrada de imigrantes no país, sejam vindos de países vizinhos ou de outras regiões como o norte do continente Africano . Uma vez que o Brasil enfrenta uma crise sem precedentes, que reduziu a arrecadação dos governos e, consequentemente, prejudicou os serviços públicos, permitir a entrada de imigrantes pode significar colocar essas pessoas sob o risco de enfrentarem condições desumanas de vida aqui também.']",160,160,120,160,120,720
72,O pensamento crítico e o combate às Fake News,"['A polaridade da sociedade em relação aos partidos políticos, e seu consequente caráter competitivo, principalmente após escândalos de corrupção, lavagem de dinheiro e a vulnerabilidade das urnas eletrônicas frente a fraudes eleitorais, tomaram conta dos noticiários brasileiros e internacionais nos últimos anos, tanto formais quanto informais, e abriram espaço para notícias cada vez mais polarizadas e tendenciosas, afim de moldar a opinião pública e favorecer o partido em questão  ou disseminar supostas medidas necessárias para que o Brasil entre nos eixos. Essas medidas são, em grande parte, soluções rápidas para problemas enfrentados há anos , e que faz do Brasil, embora rico em recursos naturais, pobre em civilidade e qualidade de vida.', 'O problema não está no fato de o cidadão comum pensar com mais frequência em soluções para os problemas dos quais enfrenta diariamente, como a violência crescente, baixos salários e altos impostos, mas sim no fato de que, ao formarem suas opiniões, não busquem a veracidade em relação aos fatos que lhe foram informados, as fontes e a credibilidade dos meios de comunicação que emitem informações. Tendo em vista que a população brasileira apresenta baixos níveis de escolaridade , este problema constitui uma grande ameaça à soberania popular, uma vez que notícias falsas são aceitas com facilidade e moldam a opinião não só de quem exige por mudanças, mas também dos que mais necessitam delas.', 'O combate às ake ews não deve ser exclusividade dos meios de comunicação de pequeno ou grande porte, nem mesmo deve ser restrito as grandes emissoras, responsáveis pelas principais notícias de interesse nacional. A leitura e pensamento crítico são poderosos meios para a supressão das ake ews e ela deve ser exercida por cidadãos comuns consumidores de notícias .', 'O sensacionalismo é uma característica marcante de informações falsas e tendenciosas. Seu reconhecimento possibilita o combate às ake ews , pois o leitor buscará outras fontes e autores, logo, poderá analisar as divergências entre a versão do que está sendo dito e o que foi, de fato, dito. A circulação de notícias falsas nos aplicativos populares de mensagem instantânea são recorrentes e o seu repasse para outras pessoas é quase inevitável, uma vez que tais notícias são motivos para insatisfação popular e demanda por mudanças, fatores que favorecem o repasse e a optação por soluções rápidas e eficazes em relação ao governo, órgãos institucionais ou entidades públicas. O pensamento crítico, atrelado com a leitura na recepção de informações, contribui para a conscientização e decisão na hora do voto. Posicionar-se sobre quais as mudanças são viáveis e necessárias ao bem comum é importante para uma sociedade que almeja por melhores condições de vida.']",120,120,120,120,80,560
59,,"['O romance ""idas secas"", do escritor brasileiro, Graciliano Ramos, retrata problemas, como a fome, vividas por uma família de retirantes. Embora o livro seja uma ficção, a fome no Brasil é um enorme problema, uma vez que, essa atinge grande parcela da população, seja,  pela falta de acesso aos alimentos ou por questões socioeconômicas. Nesse contexto, evidencia-se a necessidade de mobilização das autoridades competentes a fim de reduzir essa problemática.', 'Em primeiro plano, a dificuldade do acesso ao alimento é um impulsionador da fome no Brasil. Mesmo o país sendo um grande produtor de alimento a fome ainda é um problema, visto que, a concentração de terra, originadas as capitanias hereditárias, apresenta no cenário atual uma questão de desigualdade social. Como resultado disso, a população em extrema pobreza fica impossibilitada, de adquirir o básico necessário para alimentação humana, haja vista, que a utilização das propriedades latifundiárias estão destinadas a produção em grande escala para a comercialização.', 'Em segundo plano, a questão socioeconômica impossibilita a retificação da fome no país. O sociólogo Adam Smith, diz que a pobreza extrema não pode ser admitida, pois isso gera uma carência no mercado consumidor. Nessa analogia, nota-se que a fome no Brasil é uma consequência da baixa renda, pois, no mercado consumidor atual, o dinheiro é o único meio de adquirir algo, apresentando um cenário de fome para aquele que não possui uma renda necessária para compra de comida.', 'Em suma, são necessárias medidas que minimizem a fome no Brasil. Deste modo, cabe ao Ministério do Desenvolvimento Social e Combate à Fome, proporcionar uma parceria com empresas de grande porte, de maneira que os impostos sejam arrecadados em forma de cestas básicas a fim de distribuir s famílias carentes. Além disso, cabe ao Poder Legislativo,  ampliar as políticas públicas destinadas a população de baixa renda com o intuito de diminuir a desigualdade social existentes. Só assim, o país poderá democratizar o alimento, e a fome estará presente apenas na ficção.']",120,160,120,160,120,680
139,Será que dessa  vez vai?,"['Que atire a primeira pedra                quem nunca ficou com medo que                 esses tais ""fins de mundo""                se concretizassem.                 Essas                teorias não são de hoje, elas vêm desde a virada de 999 para o ano 1000 e a agonia voltou em 2000, e um ano depois na passagem do século XX para XXI. E em 2012, mais uma data foi marcada, o temido 21 de dezembro, que é quando - segundo os maias - esse planeta habitado por sete bilhões de pessoas chegaria ao seu fim.', 'Desde que o alerta foi dado, esse assunto atraiu várias atenções. Rendeu muitos comentários, documentários, filmes e boas piadas.         Teve         quem levou isso à risca, recorrendo a qualquer tipo de reza e simpatia para ficar longe do fim do mundo; já outros ficaram sossegados quanto a esse possível evento.         Mas mesmo para quem desacredita,         esse assunto instiga a atenção da maioria, podendo ser comparado com fantasmas,         que         por mais que         tenha         os que acreditam e os que desacreditam, é algo intrigante que divide opiniões e         deixam         até os mais descrentes na dúvida da existência de vida pós a morte ou coisas como tal. Tudo que vem do desconhecido interessa às pessoas e as faz perder uns bons minutos pensando, tentando criar hipóteses         do         porquê da existência de algo que não é natural do nosso cotidiano, do nosso mundo. O que aconteceu desta vez foi a falta de conhecimento da parte da população, porque não é qualquer um que está totalmente familiarizado com uma civilização tão antiga como os maias, por isso é difícil saber que o calendário         dos mesmos não é         como o nosso. Ele         é         em formato         circular e é         dividido em ciclos, e curiosamente o ciclo acabava em vinte um de dezembro de 2012,                 o que deixou pessoas de cabelos em pé.', 'Após o dia vinte um ter passado e nenhum desastre natural ter ocorrido, os mais medrosos puderam pensar ?ufa, sobrevivi!? e fazer piadas mil sobre mais um fim de mundo que falhou. Mas embora não concretizado, esse não vai ser o último fim do mundo anunciado, é indiscutível que muitos mais virão pela frente e cada um vindo de uma civilização mais remota ou até mesmo de um cidadão que consiga pensar em infinitas hipóteses para convencer os mais desinformados de que o fim está cada vez mais próximo.']",160,120,80,120,0,480
63,Início do impacto e as possíveis soluções para o impacto ambiental,"['A partir do século XVIII, a ciência ingressou em acelerado processo de evolução industrial, tecnologia, rapidez através de máquinas à vapor, antes tudo era feito de forma artesanal, chamada de revolução industrial, vários benefícios e positividade para o ser humano, a energia do carvão como fonte para mover máquinas, locomotivas, transportes, produção têxtil e a oportunidade de trabalho para o homem que trabalhava na área rural . A essas descobertas, iniciamos  uma fase de matéria prima, distribuição de mercadorias a dinâmica de produtividade, grandes processos positivos ocorreram nesse primeiro período.', 'crescimento imenso nos centros urbanos, triplicando o número da população, surgindo os bairros mais pobres e marginalizados. No decorrer desse salto negativo da população o homem começou a utilizar recursos naturais acelerando o processo de devastação da natureza isso já no século XX, sem preocupar-se com a própria preservação.', 'A poluição do ar, dos rios, o desmatamento desenfreado, as empresas jogando seus detritos em rios, na natureza, colaboraram e muito para a crise ambiental que vivemos  nos dias atuais. Tempestades, terremotos, e outros desequilíbrios são os resultados dessa falta de responsabilidade ambiental, essa displicência em cuidar do nosso planeta, a nossa casa, o capitalismo a ganância exacerbada em consumir para produzir vice e versa.', 'Várias pesquisas estão sendo feitas através dos cientistas para solucionar os problemas  mas,  está longe o prazo e ainda vamos  sentir muito os impactos ambientais, mas nada como solução efetiva  e sim como hipóteses para salvar nosso planeta, algumas de ação rápida, mas não garantida  e outras a um período muito maior, mas a opinião de vários cientistas tem se confrontado alguns positivamente outros de forma negativa , veja a ganância novamente, cada qual quer impor seu propósito e as devidas práticas em discussão contínua, sem resoluções.', 'Algumas das hipóteses; seria o controle da natalidade em alguns países que sofrem com a grande população, China, Índia, África e outro países. A educação ambiental desde o indivduo em tenra idade escolar, para que cresça com o senso e o respeito ambiental, economia de água, luz, eliminar o máximo de dejetos formados em nossos lares, lixo reciclável, mais verde, diminuição de poluentes e reutilização de alimentos e itens em nossos lares fazendo mais doações, as grandes empresas, também muito responsáveis pelo nosso  ambiente e outros fatores que podemos e devemos ter como normativa em nossas  vidas para a salvação de nosso planeta.']",120,120,120,120,120,600
46,A população privada do saneamento básico.,"['A Revolução Industrial fomentou a economia mundial e revolucionou a produção e comercialização de bens, contribuindo para o enriquecimento de uma elite no Brasil e, consequentemente, para o aumento da desigualdade no país. Um dos maiores exemplos é a falta de acesso, por grande parte da população, a um saneamento básico de qualidade. Frente à falta de atenção e investimentos do Estado, discute-se a privatização do setor, que atrairia diversas empresas a melhorar o acesso e padrão do saneamento recebido por milhares de cidadãos brasileiros.', 'Em primeira análise, além do saneamento básico, o Governo Federal é responsável por gerenciar múltiplos setores no país, como educação, saúde,', 'economia e comércio, o que resulta na má gestão da maioria destes. Desta forma, a administração do saneamento realizada por empresas privadas proporcionará maior enfoco e investimentos neste âmbito, gerando eficiência, qualidade e acesso à população que hoje encontra-se em situação crítica.', 'Destarte, a lei da oferta e da demanda instiga os investimentos do mercado e conduz empresas privadas a estenderem seu recurso aos que não o possuem, viabilizando, desta maneira, o acesso ao saneamento de qualidade às periferias e atraindo acionistas, fator que proporciona maior lucro e investimentos voltadas', 'às mesmas . De acordo com o filósofo Platão, o chamado mundo das ideias - perfeito e imutável - é alcançado pelos sábios por meio da razão. Analogamente, espera-se do Governo a sábia atitude para alcançar e proporcionar o saneamento ideal para todos os brasileiros.', 'Depreende-se, portanto, que medidas são necessárias para mitigar a problemática e superar o impasse. Urge que o Ministério da Saúde , em conjunto a empresas privadas, promova pesquisas a fim de catalogar os locais em que as famílias não têm acesso ao saneamento básico, realizando, assim, a gradativa privatização do setor através da concessão do recurso outras empresas e avaliando um sistema funcional para, desta forma, promover o acesso e efetivar a qualidade do saneamento básico – um direito de cidadania - para toda a população brasileira.']",160,160,160,200,160,840
94,oportunidades e inclusão,"['A série de televisão “O bom doutor” tem como protagonista o personagem Shawn, um médico que convive com o Transtorno do Espectro Autista (TEA), uma alteração neurológica que o faz enfrentar uma negação por parte de outros médicos e pacientes. No programa, quando oportunidades e apoio são oferecidos, o personagem se vê capaz de mostrar seu valor e alcançar suas metas apesar das dificuldades que inicialmente enfrentou. Além da ficção, muitas pessoas do espectro autista ainda sofrem por não serem devidamente incluídas em seus ciclos sociais, consequência da falta de oportunidades justas e a ausência de apoio.', 'A princípio, é possível analisar a frase “Todos são gênios, mas se você analisar um peixe por sua capacidade de subir em árvores, ele passara a vida toda se achando estúpido”, dita pelo cientista e filósofo Albert Einstein, defendendo a ideia de que é impossível julgar pessoas diferentes sem lhes dar as mesmas condições, já que seria algo injusto. Quando relacionamos essa tese com a realidade dos autistas, entende-se que os problemas de inclusão ocorrem quando se espera os mesmos resultados da população com TEA e outros tipos de pessoas, não levando em consideração o fato de que os autistas enfrentam impasses diferentes e que necessitam de auxílio especial em determinadas situações.', 'Outrossim, é necessário entender que apesar de alguns lugares, como escolas e ambientes de trabalho, afirmarem seu apoio sociedade autista, muitos não conseguem diferenciar os conceitos de igualdade e equidade, tendo em vista que igualdade é a ideia de dar as mesmas chances a pessoas semelhantes, porém equidade é dar chances justas para a realidade de pessoas diferentes, conceito esse que deveria se aplicar para facilitar a inclusão dos autistas, mas que na prática não ocorre.', 'Portanto, medidas são necessárias para resolver o dilema. Segundo o filósofo Paulo Freire, “Quando a educação não é libertadora, o sonho do oprimido é ser o opressor”. Evidencia-se então que as mudanças devem ocorrer no aspecto educacional. O Ministério da Educação em conjunto com as escolas públicas devem trabalhar em um projeto que apresente a maneira e a importância de incluir pessoas com TEA no cenário escolar e social, por meio de palestras, vídeos, entrevistas e oficinas didáticas, voltada para as crianças, para que aqueles do espectro autistas possam ter justiça e mostrar seu valor, assim como Shawn foi capaz de fazer.']",160,200,160,200,160,880
43,Sociedade do espetáculo,"['Barão de Itacaré,um dos criadores do jornalismo alternativo na época da ditadura no país,estava certo ao dizer:""o Brasil é feito por nós, só falta desatar os nós"".Nesse sentido a cultura do cancelamento se configura como um dos nós a serem desatados no contexto midiático atual .Diante dessa perspectiva cabe avaliar os fatores que impulsionam esse quadro,o qual ocorre, infelizmente,devido não só a má influência midiática,mas também pela crianção de uma sociedade padronizada.', 'Mormente, é fulcral ressaltar que devido ao avanço tecnológico, os meios de comunicação, estão cada vez mais presentes no cotidiano dos indivíduos,embora seja uma ferramenta de democratização a mídia acaba transformando em algo negativo e equivocado .De acordo com o teórico francês Pierre Bourdieu,aquilo que foi criado como objeto de democracia não deve ser convertida em um mecanismo de opressão. Hodiernamente, é inaceitável que essa tecnologia ainda seja utilizada para a propagação do ódio e isolamento,como vem ocorrendo nos cancelamentos virtuais.', 'Ademais, é válido considerar o conceito proposto pelo marxista Guy Debord , sobre uma sociedade do espetáculo,que segundo ele séria a necessidade dos indivíduos perfomarem uma realidade perfeita,para serem aceitas, e tendem mostrar um espetáculo para entreter outras pessoas .Essa teoria se prova concreta, já que há cada vez mais a necessidade de se enquadrar em um padrão social nas mídias,e quando os indivíduos não entregam esse espetáculo são excluídas e até ridicularizadas.', 'Portanto,fica evidente a importância de se combater a cultura dos cancelamentos nas redes sociais. Nesse âmbito cabe ao ministério da ciência, tecnologia e infraestrutura ,em parcerias com empresas privadas,desenvolverem aplicativos para filtragem esses ataques virtuais,e devem ser disponibilizados em plataformas gratuitas. A fim de evitar que esses cancelamentos ocorra, para que assim os usuários sejam protegidos. Desse modo, não será mais necessário a criação de uma realidade performada.']",160,160,160,200,160,840
83,A prática de esportes como poderosa ferramenta de inclusão social,"['É evidente que o esporte é um poderoso meio de inclusão social, capaz de transformar vidas. Dentre tantos motivos relevantes, deve-se destacar o seu papel na formação ética dos indivíduos  e o poder de educar que essa prática possui.', 'Primeiramente, é válido lembrar que o esporte tem um enorme poder de transmitir bons valores, normas e conduta. Dessa forma, qualquer atividade praticada com algum objetivo exige ordem, paciência, coragem, perseverança, dentre outros, uma série de virtudes éticas que são pressupostas no esporte e que, por isso mesmo, são desenvolvidas naqueles que se põem a praticá-lo. Assim, aprendemos com a prática do esporte a sermos seres sociáveis, e de boa conduta. É válido destacar ainda, que a prática constante de atividade física é a melhor ferramenta de manutenção da saúde e da qualidade de vida.', 'Além disso, não se pode negar o poder de educar que o esporte tem. Em um país onde a educação é defasada, a prática de  esportes, principalmente no ensino fundamental, é indispensável para a formação escolar do aluno, uma vez que trabalha e faz desenvolver  habilidades, por exemplo , o futebol desenvolve o trabalho em grupo, disciplina, foco e  agilidade, características  estas, que não somente são essenciais no bom desenvolvimento escolar, mas que também é cada vez mais, valorizadas no mercado de trabalho. Logo, percebe-se que a prática do esporte ajuda também, na formação de bons profissionais.', 'Por todos esses aspectos, não é difícil notar que a prática esportiva é uma poderosa ferramenta que auxilia na manutenção da saúde, na formação ética, escolar e profissional dos indivíduos. Para que essa ferramenta de inclusão social seja mais bem utilizada no Brasil, medidas, como o governo criar programas de incentivo e desenvolvimento do esporte por parte do governo, assim como a  criação de clubes de esportes públicos em todo país além de ensinar os alunos  por meio do professor  importância da disciplina de educação física não somente como mero meio de recreação, mas sim como forte ferramenta  das políticas de ação social, mostram –se como tentativas cabíveis para solucionar o problema.']",120,160,160,160,200,800
73,Igualdade para quem?,"['A questão do negro no Brasil ainda deve ser muito discutida devido a tamanhas desigualdades que essas pessoas encontram em meio à sociedade. Ainda que no Brasil, segundo o Instituto Brasileiro de Geografia e Estatística - IBGE, 55% da população brasileira seja composta por negros ou pardos, a marginalização que estes sofrem, trazem tona a necessidade de inserção e garantia de direitos se comparado a pessoas brancas.', 'A constituição brasileira determina que todos os brasileiros e estrangeiros residentes no país,  devem ser tratados com total igualdade, porém, não observamos o cumprimento dessa lei no nosso cotidiano. Um fato que comprova isso, é que a cada 23 minutos, um jovem negro é assassinado no Brasil, segundo o Mapa da Violência, um rapaz negro possui 12 vezes mais chance de morrer que um jovem branco.', 'A história do Brasil é manchada pela exploração do negro, e ainda que existam leis de garantia de equiparação aos brancos, isso ainda é muito distante da realidade. Pesquisas revelam que os salários dessas pessoas são menores, e pode-se ainda inferir, que esse salário é menor quando existe emprego , visto que muitos negros encontram dificuldades na entrada do mercado de trabalho, tudo isso devido a cor da pele.', 'Por mais que grande parte da população afirme não ter nenhum preconceito com pessoas negras, por que ainda existe tanta diferença com as pessoas brancas? Muitas pessoas ao se aproximarem de pessoas negras, por mais que não assumam abertamente, sentem medo de serem roubadas, devido ao estereótipo criada em relação do negro no país.  São, muitas vezes, pessoas vistas como ladras e criminosas, apenas devido a cor de sua pele.', 'Portanto, torna-se necessário o debate em relação à causa negra na sociedade brasileira e mundial. Por mais que restringimos esta questão ao nosso país, é uma causa de interesse no mundo inteiro. É preciso endurecer leis e multas relacionadas ao racismo, a criação de projetos de discussão da causa nas escolas desde os primeiros anos, o acesso dessas pessoas universidades e garantia de melhores oportunidades. É um caminho longo a ser percorrido e superado, mas só assim podemos causar o impacto necessário.']",120,120,120,120,120,600
15,Sobrepeso e obesidade,"['A obesidade é uma realidade enfrentada por cerca de 20% da população brasileira, e o sobrepeso atingiu mais de 54% da população, ou seja, mais da metade dos brasileiros sofrem com peso inadequado para seu biótipo. A cada cinco brasileiros, um é obeso. Segundo pesquisas realizadas pelo Ministério da Saúde, nos últimos 10 anos a prevalência da obesidade no Brasil aumentou em 60%. Isto são números preocupantes já que o acúmulo de gordura elevado interfere na saúde e no bem-estar dos seres humanos.', 'O sobrepeso e a obesidade estão ligados diretamente à economia. Muitas empresas e comércios investem em alimentos com alto teor de gordura e açúcar, porque são alimentos altamente consumidos e com preços menos elevados, já que alguns alimentos da área ""fitness\'\' possuem valores altos e sabores desagradáveis. Com esses preços elevados, alguns alimentos se tornam inacessíveis para a população mais pobre, fazendo com que os mesmos se alimentem de produtos industrializados e com pouco índice nutritivo por serem mais baratos e mais saborosos.', 'A maioria dos brasileiros são sedentários, isto é, não fazem nenhum tipo de atividade física, facilitando o aumento de peso e problemas de saúde, como índice de gordura alto , pressão alta, colesterol alto, e outros fatores que surgem devido ao peso alto e a falta de praticar esportes. Também é comum a falta de acompanhamento médico para as pessoas que são acima do peso, dificultando o emagrecimento e a reeducação alimentar.', 'Portanto, medidas devem ser tomadas para reduzir o número de pessoas acima do peso. As indústrias devem mexer o mínimo possível no alimento que chega das fazendas para que se mantenha os valores nutritivos conservados; os comércios podem reduzir os preços dos produtos para que se tornem acessíveis à toda população e as prefeituras devem fornecer atividades físicas em áreas públicas e também devem oferecer acompanhamento médico aos cidadãos uma vez por mês, gratuitamente, para garantir a saúde de todos.']",160,120,80,120,80,560
119,A ditadura da beleza,"['A vida contemporânea         traz consigo         diversas características                , por exemplo, a difusão das redes sociais, o consumismo exacerbado, a busca por uma vida saudável e o modo como as pessoas veem os padrões de beleza. Esses fatores moldam a sociedade atual e em alguns casos têm se tornado um problema, pois algumas pessoas estão         distorcendo          conceitos importantes como, por exemplo, o de saúde com o de corpo esteticamente perfeito.', 'Ultimamente,         têm         se tornado febre na         sociedade, a         utilização, principalmente por celebridades, das redes sociais (facebook, twiter                ) para exibir os padrões atuais de beleza, que na verdade se confundem com um corpo                 musculoso                . Essa busca incessante por esse padrão de beleza atual tem levado as pessoas, principalmente aqueles                 mais abastados financeiramente                , a utilizarem métodos e recursos perigosos, como por exemplo, cirurgias estéticas sem necessidade e o uso de esteroides anabolizantes, que no futuro podem trazer graves danos à saúde.', 'Ademais, a indústria viu nessa ditadura da beleza uma maneira de lucrar milhões. Dessa forma, ela acaba incentivando as pessoas a se valerem desse padrão de consumo através de investimentos expressivos em publicidade e na criação de diversos novos produtos como é o caso dos suplementos         alimentares         os quais são consumidos maciçamente, muitas vezes, sem qualquer acompanhamento de nutricionistas ou médicos.', 'Logo, pois,         a sociedade precisa deixar de lado esse         estereótipo criado de padrão de beleza criado         . Essa idealização de corpo escultural é mera invenção da mídia e da indústria, que estão mais interessadas em fazer com que as pessoas consumam produtos voltados         a esse gênero e, por conseguinte         ,                nem sempre ter um corpo “sarado”, livre de gorduras, é sinônimo de saúde.']",160,200,160,200,120,840
63,Luta pela sobrevivência,"['Para Karl Marx  a história da sociedade até os dias atuais é a história da luta de classes. É inegável a hegemonia da classe dominante que, por meio de seu discurso, explora o proletário e esse acredita que essa relação hierárquica é “natural”. Os danos ambientais estão cada vez mais recorrentes no Brasil , em decorrência da exploração desordenada do meio ambiente e da negligência do poder legislativo em punir devidamente os responsáveis.', 'Sob esse viés, o movimento migratório da área rural para a urbana, que no Brasil ocorreu a partir de 1930, fruto da Revolução Industrial, contribuiu para as alterações do espaço natural. Ademais, o processo de urbanização e o uso irresponsável dos recursos naturais e a exploração do meio ambiente pelo homem, ocasionou danos negativos ao ambiente, como mudanças na composição físico-química do solo, biológica dos ecossistemas , poluição de rios, desmatamento de florestas e a extinção de várias espécies. Por conseguinte, tais ações afetam a qualidade de vida da população resultando, por exemplo, no aumento do número de doenças.', 'Por analogia, recentemente vivenciamos  impactos ambientais de proporções colossais provocados por grandes corporações. Isso é nítido nos desastres ocorridos em Mariana pela Samarco e em Brumadinho pela Companhia Vale do Rio Doce. É inegável a falta de respeito aos direitos humanos, tendo que em vista que muitas vidas foram interrompidas em prol do acúmulo de capital. Além disso, a destruição de florestas, rios e animais assolados pela lama, elucida a urgência do Governo Federal para deliberar sobre ações que envolvem essas questões, pois esses impactos ambientais prejudicam diretamente a vida no planeta.', 'Assim sendo, para solucionar os impactos ambientais é necessário que o Governo Federal faça uma fiscalização mais assídua das barragens, por meio de acompanhamento dos relatórios de equipes especializadas e elabore leis rígidas e efetivas condizentes com o nível dos danos ambientais, com o intuito de punir devidamente os responsáveis. Ademais, é preciso conscientizar a população de um modo geral sobre a preservação do meio ambiente, por meio de palestras e campanhas publicitárias. Dessa forma, estaremos caminhando rumo a uma sociedade igualitária como a defendida por Marx, e resguardando o planeta para as futuras gerações.']",120,160,120,120,120,640
60,O bem necessário para o Cidadão,"['Muito tem se discutido acerca do futuro previdenciário do país e dos problemas que vêm surgindo ao longo dos anos,entretanto ,será que as mudanças realmente são necessárias?', 'A previdência social nada mais é, do que um seguro público que tem como atribuição garantir que a fonte de renda do contribuinte seja mantida quando sua capacidade laboral estiver comprometida, temporária ou permanente e quando os trabalhadores cumprirem o tempo estabelecido para aposentadoria. Durante o seu tempo de serviço,o trabalhador fornece ao sistema uma porcentagem do seu salário,no qual é utilizado para financiar aposentadoria das pessoas que já se encontram neste período, chegando a conclusão que um trabalhador depende do outro para manter o sistema ativo.', 'Todavia alguns fatores vêm demostrando que alterações são necessárias, devido a expectativa de vida que antigamente era bem menor,e hoje, ultrapassa aos 73 anos, fazendo com que a máquina do governo tenha mais despesas do que receitas para poder manter o salário desta classe de pessoas..', 'Outro fator seria a redução da taxa de fecundidade,demonstrando que as pessoas na atualidade tem menos filhos do que antigamente,concluindo para que as contas dos indivíduos que encontram ativos no mercado de trabalho seja menor do que os reformados.', 'Em virtude dos fatos mencionados ,fica visível que a reforma da previdência é uma solução para futuros problemas que poderão surgirem , caso não seja feito uma revisão nas normas atuais.']",120,120,80,120,80,520
118,Passado presente,"['A busca frenética pela beleza e perfeição é acompanhada por inovações em cosméticos, tratamentos estéticos, até produtos com possíveis danos à saúde. Entretanto, antes de                 chegarem                ao cotidiano da população                 passam                por testes                 , e                infelizmente em animais.', 'O uso de ""espécies inferiores"" marca esse mercado, bichos são sujeitos a inúmeros                 agentes                para melhora da vida humana,                 recebem substâncias pela pele, via oral e venosa, ações abomináveis.', 'Recentemente,         o Instituto Royal em São Paulo, recebeu          denúncias                sobre esses procedimentos e em consequência tiveram suas cobaias roubadas por ativistas e instalações         depravadas pelo         Black blocs, um procedimento violento com grande                 repercussão e atentado contra policiais militares, analisada por muitos como desnecessária.', 'Contudo, a vaidade         esta         tão presente na sociedade,                 que a crueldade que a acompanha é quase justificável                , o homem esquece que         esta         lidando com vidas, e o fato de                 não falarem                , não                 os         tornam         inferiores, e sim mais puros e dependentes.                 Os feitos antrópicos os classificam como bárbaros e animais irracionais, inferiorizando-os cada vez mais. Trazendo para o século XXI o passado                  que tentam fugir a todo instante.']",80,120,80,80,0,360
112,Diminuição da maioridade penal é mesmo a solução?,"['Atualmente, uma das notícias                que mais ouvimos         falar, são de         delitos cometidos por menores de idade.                 A polêmica fica acerca do aumento abusivo desses crimes, sem que haja uma punição severa para os mesmos. Além de roubos, estão partindo para a violência                , chegando algumas vezes         à         matar.', 'Se pararmos para pensar, são apenas ""crianças"". Frutos de uma educação de baixa qualidade. Sendo na maioria deles, garotos de baixa renda. O que leva a crer, que talvez nunca tenham frequentado uma escola, ou terem tido uma educação deplorável. Querendo melhorar de vida e pensando no dinheiro, são influenciados por mais velhos a praticar crimes.', 'Prendê-los, só         fará com que a situação se agrave. A justiça no Brasil é         falha,         ficarão presos por pouco tempo, haverá mais superlotação nas cadeias e o problema não será resolvido. Somente                 deixará eles                com raiva, querendo vingança e aprendendo mais coisas ruins. Sairão pior do que entraram.', 'Crianças e adolescentes são facilmente influenciáveis. Ninguém nasce sabendo roubar ou matar, nós aprendemos. Se esses adolescentes tivessem tido uma educação de qualidade e um incentivo maior para ir         a         escola, a situação não estaria nesse ponto. Elas aprenderiam a ter educação, respeito e, principalmente, uma perspectiva diferente para a vida.', 'Com os adolescentes que já estão nessa situação, uma solução viável seria colocá-         las         em internatos escolares, não em cadeias. Para que aprendam a ler, escrever, ter valores. Crescerem com tranquilidade, ter uma adolescência digna de adolescentes. Seria um trabalho social muito forte,         no qual         mobilizaria a todos, mas que, com certeza,         haveriam         melhores resultados.']",80,80,120,120,120,520
87,Criança tem que ser Criança,"['Em um futuro pós-apocalíptico, as mulheres se encontram estéreis e há poucas crianças no que restou da Terra. Essas poucas crianças, especialmente as meninas, são hipersexualizadas e obrigadas a cumprir seu “destino biológico” o mais rápido possível. Conforme retratado em “Brilho”, da autora Amy Kathleen Ryan, essas questões estão presentes na atualidade, onde as crianças são erotizadas cada dia mais cedo. Os problemas que acarretam a cultura da erotização infantil estão relacionados tanto à falta de monitoramento dos pais, quanto ao próprio incentivo à preconização das crianças.', 'O primeiro ponto a se analisar é a falta de atenção dos pais com relação ao que os filhos assistem na internet. Isso é um problema, pois deixa a criança à mercê de conteúdos inadequados, como pornografia, fazendo com que elas interiorizem as atitudes que veem e passem a agir de maneira semelhante. Segundo Simone de Beavoir, a figura da mulher é uma construção social, isto é, aquilo que a sociedade deseja ver. Por isso, quando uma criança imita comportamentos eróticos, ela está se desconstruindo e pondo em risco sua identidade.', 'Em seguida, outro ponto a ser analisado é a preconização imposta pelos pais e pela sociedade. Em “Quarto de Despejo”, da autora Carolina Maria de Jesus, as crianças da favela são incentivadas, por comportamento, a agirem e se vestirem de maneira sexualizada, sendo muitas, abusadas por seus próprios familiares . Torna-se claro, portanto, de como a imposição precoce da sexualização nas crianças é um dos fatores que as tornam vulneráveis a abusos.', 'Por fim, medidas devem ser tomadas para destruir a cultura da erotização infantil. O Ministério da Educação (MEC) – principal órgão responsável pela educação no país –  deve, por meio de subsídios cedidos pelo governo federal, adotar campanhas que incentivem os pais a monitorarem a vida virtual dos filhos, assim como educar sobre os prejuízos da preconização, com a finalidade de evitar o acesso a conteúdos inadequados e a absorção de comportamentos prejudiciais. Apenas através de tais medidas as crianças poderão desfrutar de uma fase tão importante que é a infância.']",160,160,160,200,200,880
87,Ingenuidade tomada,"['Embora o Estatuto da Criança estabeleça os deveres da família à vida.  ao lazer e educação às crianças, ainda presenciamos casos acerca da cultura da erotização infantil, dos quais impossibilitam que uma parcela dessas crianças, vítimas dessa problemática, desfrutem desses direitos na prática. Neste sentido, a adultização e a má influência midiática se tornam fatores predominantes nesse cenário antagônico.', ""Nesta perspectiva, convém enfatizar a adultização provocada por terceiros que, infelizmente, algumas crianças são levadas; geralmente por parentes ou indivíduos próximos, onde elas adotam comportamentos adultos pelos quais tiram a infância mais cedo . Em decorrência de um caso que se pode mencionar, pertence à excantora de funk que tinha 8 anos, conhecida como ''MC Melody'' que era influenciada pelo pai -também atuante no ramo- da qual se vestia com roupas mais sensuais e se comportava como uma menina adulta. Sol tal óptica, é inaceitável que crianças sejam submetidas a essas situações, já que estão em desenvolvimento e tudo as influencia."", 'Paralelo a isso, destaca-se a má influência midiática que colabora para esse agravamento, visto que crianças são sujeitas ao acesso de conteúdo da comunicação, mediante televisão, redes socias, entre outros. De acordo com Kant que dizia que o homem é aquilo que a educação faz dele, isso implica na educação infantil e como os responsáveis precisam fiscalizar tudo aquilo que as crianças assistem e buscam na mídia. Em outras palavras, podem encontrar conotação sexuais, apologia pedofilia e filmes que sexualizam os menores de idade. Desse modo, é necessário que medidas sejam tomadas para erradicar esse problema.', 'Entende-se, portanto, o problema da adultização infantil e a má influência da mídia no processo de fases da vida dos pequenos são prejudiciais e que  assim, é necessário que o Estado promova conteúdos e atividades educacionais que estimulem a infância das crianças  além da responsabilidade do Estatuto da Criança e Adolescente (ECA)  em criar campanhas para conscientizar os pais afim de fiscalizar os conteúdos que seus filhos acompanham. Dessa forma, será possível a execução do pleno direito aos deveres familiares e ao lazer e educação às crianças.']",160,200,160,200,160,880
88,Os esquecidos,"['A Declaração Universal dos Direitos Humanos-promulgada pelas Nações Unidas em 1948-assegura a todo indivíduo o direito à igualdade e ao bem-estar. No entanto, o estigma associado às doenças mentais no Brasil, seja pela ineficiência estatal, seja pelo preconceito da sociedade, vai em oposição a esses direitos. Assim, hão de ser analisados tais fatores.', 'Em primeira análise, cabe pontuar a ineficiência estatal como um dos principais fatores relacionados a essa problemática. Nesse sentido, um exemplo disso é a oferta limitada, em regiões rurais e periferias, de centros públicos de acolhimento e tratamento para indivíduos portadores de doenças mentais, como depressão . Essa conjuntura, segundo as ideias do filósofo contratualista John Locke, representa uma violação ao ""Contrato Social"", já que o Estado falha em garantir direitos indispensáveis, como a igualdade, o que, infelizmente, ocorre no país.', 'Ademais, vale ressaltar o preconceito da sociedade como outro importante agente causador desse quadro. Conforme pesquisa divulgada pelo Estadão, jornal brasileiro, 33% dos portadores de doenças mentais afirmaram serem vítimas de preconceito por parte de amigos e parentes, em virtude de suas patologias . Diante de tal exposto, é indubitável, lamentavelmente, o valor de tal revés, uma vez que não só perpetua a desigualdade, mas também atua na manutenção de esterótipos acerca das doenças mentais.', 'É evidente, portanto, a necessidade de se combater o estigma associado às doenças mentais na sociedade brasileira. Sendo assim, o Legislativo, responsável pelo bem da população, deve, por intermédio de verbas federais e alterações na Constituição federal, expandir, em regiões rurais e periféricas, a oferta de centro públicos de acolhimento e tratamentos de doenças mentais e o preconceito, com a participação do Ministério da Saúde e empresas privadas. Espera-se, com isso, o pleno cumprimento dos direitos assegurados pelas Nações Unidas.']",200,200,160,200,160,920
95,Demarcação é a justiça,"['O Brasil não foi descoberto, ele foi invadido. Esse país não tem 521 anos, não se pode invisibilizar os nossos ancestrais que nos legaram este país. A história conta que, quando as caravelas portuguesas aportaram em águas tupiniquim em 22 abril de 1500, cá estavam os índios, que, eles logo, trataram de denominar de selvagens. E assim nasceu o Brasil. Do coração dos indígenas inocentes e das mãos de europeus exploradores, escravizadores e assassinos. Essas terras tinham donos! A nação indígena brasileira. E ninguém poderá contestar.', 'A nossa Constituição federal reconheceu direitos originários sobre as terras que tradicionalmente ocupam os índios, Demarcar consiste em atestar a ocupação dos índios como circunstância anterior à demarcação. Por que mudar agora? Que tipo de direito se dá e se toma? Segundo o código penal, a lei não retroage. Por interesse espúrio de quem, querem tomar um direito dado por Deus e pela Constituição dos homens? Esses cidadãos são agredidos, violados, invadidos, mortos e roubados por garimpeiros, fazendeiros, grileiros etc. Eles não são os carrascos são as vítimas. Onde está a justiça que não responde?', 'O governo Jair Bolsonaro é favorável à tese do “marco temporal” e, desde que assumiu o poder, estacionou os processos de demarcação de terras. Os indígenas são contra a tese e argumentam que o critério pode levar, inclusive, à revogação de demarcações que já existem. Não se faz justiça com injustiça. As terras são deles, não se pode tomar. 521 anos de violações, desrespeito e negligencia. Não está na hora de parar?', 'Diante do exposto, fica evidente que nessa guerra desproporcional e desumana quem mais perde é o Brasil. Porque a natureza é o bem mais valioso do planeta. E os guardiões da natureza sabem cuidar, amar e acima de tudo preservar. Será o maior erro da justiça tirar das mãos de quem protege para colocar nas de quem degrada, destrói e mata a natureza. O Brasil é enorme! Que as pessoas que querem se apropriar indevidamente das terras sagradas. Que procurem outras. As terras indígenas de ser. Inegociável, intransferível e inviolável. Deixar as terras com os indígenas é um direito e um dever do Brasil.']",120,80,80,120,40,440
43,Opiniões dissimuladas nas redes sociais,"['A cultura do cancelamento nas redes sociais é uma questão que divide diferentes opiniões no Brasil e ao redor do mundo. Uma prática recente que vem se propagando cada vez mais, principalmente com o avanço da tecnologia. Tal cultura começou como uma forma de trazer a atenção do público para causas sociais, judiciais e ambientais e amplificar a voz de grupos reprimidos, além de forçar ações políticas de marcas ou figuras públicas.', 'Vale mencionar que essa cultura ocorre quando uma marca, artista ou pessoa é ejetado de sua posição de influência ou fama, depois de uma ação questionável como a injúria, o preconceito ou só pelo fato de possuir uma opinião diferente da maioria . Segundo o site de notícias da Uol, os boicotes virtuais estão se descolando de atos concretos e alimentando a intolerância, na maior parte só por causa de uma opinião diferente. Quem mais sofre com isso são os famosos e super famosos, pois perdem patrocinadores e parte dos fãs. Bem como afirmou o político e sociólogo americano Daniel Patrick Moynihan: “Todos têm direito à própria opinião, mas não aos seus próprios fatos”.', 'Além do mais o Brasil já vem sofrendo muito com as famosas “fake news”, notícias falsas que são amplamente transmitidas . Pessoas influentes ou marcas podem ser vítimas delas, se posicionarem equivocadamente e assim gerar maiores complicações para si mesmo e para seus seguidores. Sem dúvidas também pode acontecer isso em eleições, candidatos ou partidos manifestarem opiniões opostas ou terem atitudes ilegais e serem duramente combatidos com um possível cancelamento em suas redes sociais.', 'Em virtude de tudo que foi mencionado, é certo que medidas devem ser feitas para a resolução desse problema. Havendo uma fiscalização em redes sociais para detectar possíveis crimes, ou opiniões que possam gerar grandes discórdias na população, identificando e aplicando uma punição exemplar. Mas primeiro seria necessário o MP Ministério Público,  criar um órgão para desenvolver  esse papel e que também poderia atuar no combate às fake news . Isso sendo feito acabaria evitando assim a cultura de cancelamento nas redes sociais.']",160,160,120,120,160,720
146,(Sem título 060),"['Ao longo dos anos a humanidade tenta acabar com o preconceito racial. Este que serviu como justificativa para a morte de milhares de judeus, no Nazismo, e africanos, no Apartheid; vem sendo tema nos principais jornais do mundo.', 'Por incrível que pareça, em pleno século XXI, ainda é possível encontrar pessoas que insistem em                 ramificar                pensamentos e atitudes racista .', 'Nos últimos anos os jogadores de futebol viraram alvo dessas         atitudes. Os mesmos sendo         hostilizados por um povo aprisionado a pensamentos considerados ultrapassados.', 'Esse fato acaba retomando um tema         que pensou-se         já estar resolvido. Porém percebe-se a ignorância         daqueles, que         se jugam superiores, perpetuando de geração em geração a mentalidade egoísta.', 'Portanto não há dúvida que o preconceito racial                 persiste em existir meio a um mundo com grandes adversidades étnicas.                Todavia,                 o mesmo                poderá ser combatido através de uma reeducação. Não apenas dentro dos campos de futebol, mas na sociedade existente fora dele.']",120,80,80,80,80,440
94,A importância da Educação Especial contra os desafios de inclusão para autistas,"['A série sul-coreana ""It\'s okay to not be okay"" expõe os desafios de inclusão enfrentados por um jovem cuidador de seu irmão  portador do espectro autista. Semelhantemente, muitas famílias brasileiras encaram as mesmas adversidades. Isso evidencia a desatenção do Estado com relação a essa temática, notabilizando a necessidade de aprimorar e ampliar a implantação da Educação Especial no Brasil.', 'De acordo com a Constituição federal brasileira de 1988, a educação é um direito de todos e dever do Estado. Visto isso, a Educação Especial compromete-se a garantir a educação para deficientes, incluindo autistas, além de usar a escola para promover a inclusão social, salientando a importância da sua implementação nas escolas de todo o Brasil.', 'Apesar disso, um dos maiores desafios para capacitar a inserção da Educação Especial e, por consequência, a integração de autistas, é a formação de profissionais adequados e qualificados para cuidar das diversas necessidades de um portador do espectro autista. Ademais, é indispensável a colaboração entre responsáveis, professores e gestores escolares, além de alunos, para que possam proporcionar apoio ao aluno especial, ressaltando a ideia de equidade.', 'Portanto, nota-se que medidas são necessárias para solucionar o impasse. Dessa forma, cabe ao governo federal, por meio do Ministério da Educação, expandir e aprimorar a Educação Especial, qualificando profissionais e sua metodologia, e desse modo assegurar o direito à educação para todos, acabando com os desafios de inclusão do autismo, além de construir um Brasil mais justo e solidário.']",160,120,120,160,120,680
90,Como combater a transfobia no Brasil,"['A constituição federal de 1988, documento jurídico mais importante do país, prevê  em seu artigo 6°, o direito segurança como inerente a todo cidadão brasileiro.', 'Conquanto, tal prerrogativa não tem se reverberado com ênfase na prática quando se observa a transfobia no Brasil, dificultando, deste modo, a universalização desse direito social tão importante. Diante dessa perspectiva, faz-se imperiosa a análise dos fatores que favorecem esse quadro.', 'Em uma primeira análise, deve-se ressaltar a ausência de medidas governamentais para combater a transfobia no Brasil. Nesse sentido, causa consequência para sociedade se continuar sem fazer nada . Essa conjuntura, segundo as ideias do filósofo contratualista John Locke, configura-se como uma violação do "" contrato social "", já que o estado não cumpre sua função de garantir que os cidadãos desfrutem de direitos indispensáveis, como a transfobia no Brasil, o que infelizmente que é evidente no nosso país.', 'Ademais, é fundamental apontar a transfobia como impulsionador da segurança e dos direitos no Brasil . Segundo CNN Brasil 75%  não tem funcionários trans e pretos. Diante de tal exposto, é notório que enquanto não passar muitas dessas informações nas redes sociais, escolas ou tv infelizmente vai continuar acontecendo. Logo, é inadmissível que esse cenário continue a perdurar.', 'Depreende-se, portanto, a necessidade de se combater esses obstáculos. Para isso, é imprescindível que nesse âmbito, cabe ao ministério da educação e da cultura e sociedade,  promover um maior acesso ao conhecimento, por meio de segurança nas áreas urbanas mais periféricas para sociedade  a fim de evitar a situação de alienação e insuficiência intelectual presente nos membros das classes mais baixas. Assim, se consolidará uma sociedade mais humana, onde o estado desempenha corretamente seu "" contrato social "", tal como afirmar John Locke.']",160,120,120,160,120,680
122,De quem é o reino dos céus?,"['“Macumba é coisa do diabo”. “Macumbeiro vai pro inferno”. “Não existe mesa branca, é tudo preto”. Essas e outras frases, recorrentes no cotidiano religioso brasileiro, mostram que,                 embora de uma forma velada                , a intolerância religiosa existe e precisa ser combatida.', 'O Brasil é um país essencialmente cristão, cristianismo esse que se divide entre o catolicismo, protestantismo e seitas que surgem a cada minuto, mas, embora seja um país que, constitucionalmente, assegura a liberdade religiosa, são comuns atos de intolerância religiosa que chocam a população.', 'Em 14 de junho uma criança de 11 anos foi agredida com uma pedrada na cabeça pelo fato de pertencer ao candomblé, além de um bispo já ter chutado uma santa católica em rede         televisiva         numa mistura de provocações e agressões verbais. Atos como esses são comumente         manifestos         por seitas cristãs que, no Brasil, têm se multiplicado como larvas no esterco. A influência de tais seitas é tão grande que                 abrange                o         congresso nacional         e                 consequentemente a formulação de nossas leis.', 'O dispositivo constitucional que assegura a liberdade religiosa no Brasil, talvez seja o maior fator que impeça atos extremos, como os citados, de pipocarem em diversas regiões do         país, por         isso é necessário que a população esteja atenta à influência religiosa dessas seitas na formulação de nossas leis, para que nossa                 democracia não se transforme numa ditadura religiosa.', 'É necessária também uma conscientização cultural, para estabelecimento de um respeito mútuo entre os praticantes da fé, seja ela em quem for. Afinal, a laicidade do Estado nos permite escolher o Deus a ser adorado e o céu a ser habitado, e bem aventurados sejam os que isso compreendem, porque deles é o reino dos céus.']",160,200,160,160,200,880
78,Reforma do ensino médio,"['A reforma do Ensino Médio tem gerado bastante polêmica devido as suas proposta de ensino para os próximos anos. Mas nem todos estão satisfeito com essa mudança .', 'Muitos alunos são contra, devido á carga horária que irá aumentar, disciplinas que não serão mais obrigatória. Já outros aprovam principalmente por causa dos cursos técnicos.', 'Um ponto muito interessante dessa reforma é o oferecimento de cursos técnicos , agora quem concluir o ensino médio, já sairá com um curso técnico, e antes alguns alunos terminavam o ensino médio primeiro para depois fazer um curso técnico .', 'Mas outro ponto que gera muita dúvida e discordância é sobre as disciplinas que não serão mais obrigatória. Todos nós sabemos que o ensino em redes públicas é muito fraco comparado ao de escolas privadas, e colocando algumas disciplinas como não obrigatória, acabar prejudicando ainda mais o aprendizado dos alunos .', 'Todas disciplinas devem ser obrigatória, porque na hora de fazer o Enem, vestibulares, elas serão todas cobradas.', 'Há muita coisa  ainda para ser analisada,  o governo tem que se preocupar em reforçar mais o conteúdo das disciplinas, a maioria dos alunos terminam o ensino médio sem ter aprendido metade do conteúdo, e isso acaba o prejudicando no futuro .']",80,80,80,80,80,400
13,As consequências de uma lei,"['A posse de arma tem essa tese em que trará mas segurança para a sociedade, porque a maioria da população influenciada pelo presidente, que e um ex-militar bem trenado a usar uma arma e tem psicologico para o mesmo, mas por outro lado não vêem as pessoas de diferentes personalidades com a posse de arma, como por exemplo; uma briga de vizinhos, um aluno que sofreu buling na escola e sabe que a unica forma de se defender é a arma que seu pai tem em casa, ou um comerciante qu estar pra ser assaltado e tem frações de segundos para reagir e matar um ladrão, como consequência o comerciante não terá o prazer de viver no mesmo ambiente por conta das ameaças de outros bandidos.', 'ao inves de dá armas, poque não dar livros, um educação mas apropriada com qualidade, mas investimentos nos esportes, no lazer da família.  O presidente junto com o ministerio da educação, poderiam assinar leis em que os professores sejam mais beneficiados, espelhando nas salas de aulas com um ensino melhor, com tudo teremos um futuro com mais educação e menos armas.']",80,40,40,0,40,200
50,O Passado remete ao Presente.,"['No que se concerne a importância da ciência para a sociedade, quando trata-se do coronavírus, não é a primeira vez que acontece uma pandemia . a sociedade não está preparada para a doença ,  por afetar a economia, a saúde pública e o cotidiano do ser humano.', 'Em 1918, urge uma pandemia chamada de gripe espanhola ,  De acordo com a Organização Mundial da saúde , estima-se que 50% da população foi contaminada, existiam poucos medicamentos e vacinas antivirais que agora podem ajudar a conter sua propagação e promover uma recuperação mais rápida dos doentes. O assado remete ao presente,  quando se trata de pandemia, De forma indireta, a gripe espanhola contribuiu para o surgimento em 1930  dos ministério dos negócios da saúde e da educação pública quanto a do sistema único de saúde, em 1988.', 'O ano é 2020 , e devido ao cortes de verbas na ciência, segundo mandato da presidente Dilma Rouseff, seguiram na gestão de Michel Temer e se acentuaram com Jair Bolsonaro, travaram o andamento do processo .""""com 5 milhões de reais, seriamos capazes de realizar os testes em humanos,mas está tudo parado por falta de verba.""""afirma, o ioquímico Paulo Ivo Homem de Bittencourt Junior, professor na universidade federal do Rio Grande Do Sul.', 'Em suma, o governo deverá liberar verbas na ciência, para que os estudos possam ser realizadas, e para que busquem a cura com maior facilidade. além da ciência, liberar verbas na educação é importante para a sociedade como todo, assim todos ficaram ciente de que a doença não é brincadeira.']",120,120,80,120,80,520
93,,"['É indiscutível que no Brasil a taxa de partos mediante cesária é altíssimo e é incontestável que, várias brasileiras sofrem no processo de parto selvagem, ntretanto, a questão que quero levantar é a seguinte: parto humanizado é uma questão de saúde pública?', 'A questão do parto humanizado não está no processo em si mas,  também na forma com que a mãe, bem como, o seu companheiro e familiares são atendidos pela rede pública. Vejamos desta forma: mãe dá entrada na rede pública e o médico ou enfermeiro não a examina e quase que imediatamente a manda voltar para casa;  Em outro exemplo, se esta mesma mãe é recebida pelo mesmo médico ou enfermeiro, entretanto, a entrada de seu cônjuge é negada para assistir ao parto, logo, eu lhe afirmo que se os profissionais a tivessem examinado no primeiro caso e se fosse permitida a entrada do seu companheiro para assistir ao parto esse seria o início de um parto humanizado na rede pública.', 'Desta forma, respondendo à questão da introdução, sim, a humanização é uma questão de saúde pública, pois, para que isso ocorra, por certo, ´é imprescindível a criação de novas santas casas acompanhadas de contratação de pessoal especializado em municípios com altas taxas de cesáreas.']",160,80,80,120,40,480
47,Tecnologia como solução e desafio na Educação Remota,"['Apesar da evolução Técnico-Científica, a partir de 1970, ter possibilitado o rompimento das barreiras físicas e a interligação social através da tecnologia, o acesso internet no Brasil ainda é excludente. Atualmente, no entanto, em meio a propagação do coronavírus e o necessário isolamento social, a educação a distância tem sido o único meio possível de ensino. Nesse contexto, o processo de educação remota no país é desafiador, visto as dificuldades de adaptação e acesso de estudantes ao novo sistema, o que pode resultar em oportunidades desiguais de aprendizagem.', 'De antemão, cabe ressaltar que a educação online é uma experiência ainda pouco vivenciada no Brasil. Dessarte, os investimentos em equipamentos pedagógicos para o meio digital são precários, vista a alta demanda atual . Nesse âmbito, muitos estudantes da rede pública e do EJA estão sem acesso s aulas, devido a falta de aparelhos apropriados tanto em casa quanto nas escolas para o uso dos professores que, por sua vez, possuem poucas ou nenhuma habilidade com o sistema técnico. Assim, o ensino online necessita de aprimoramento, capacitação e aplicação de recursos estatais para sua democratização.', 'Por conseguinte, devido as diferentes realidades socioeconômicas e regionais no país, a educação remota pode resultar em oportunidades desiguais de acesso para os alunos. Esse fato se confirma ao compararmos os díspares espaços estruturais de uma mesma região ou cidade, nota- se carência de acesso a serviços básicos como água potável e energia elétrica em algumas áreas . Essas populações, até então excluídas do desenvolvimento nacional, também não tem ao alcance serviços secundários como a internet, o que impossibilita a proposta de uma pedagogia emancipadora, no qual o aluno é um participante ativo, em defesa do bem comum, segundo Paulo Freire.', 'Dessarte, a educação remota não deixa de ser uma viável solução,contudo, necessita de democratização para que seja eficaz. Nesse propósito, cabe ao Ministério da Educação  responsável por organizar o sistema de ensino -- investir na distribuição de redes gratuitas de internet e de equipamentos para o ensino e aprendizagem online, por meio de recursos públicos cedidos pelo Tribunal de Contas da União, os educadores devem se autoatualizar para o bom uso do programa. Idem, poderá ser possível fazer uma pedagogia engajada à distância.']",160,160,120,200,160,800
57,Camila Carminati - A DEMOCRATIZAÇÃO DO ACESSO AO CINEMA NO BRASIL,"['No atual cenário brasileiro, o cinema vem perdendo espaço, seja pelo elevado custo dos ingressos frente a renda média do trabalhador ou pelo crescimento de novas tecnologias “streaming”, como Netflix e Telecine, no entanto, poder ir ao cinema constitui ato de acesso à cultura que não se pode desvalorizar diante de novas maneiras de exibição de filmes.', 'Os filmes exibidos nas grandes telas reproduzem aspectos importantes para a reflexão da sociedade. “Matrix”, por exemplo, apresentou ao público as angústias do homem contemporâneo, bem como uma perspectiva futurística. Mais recentemente, Joaquim Phoenix interpretou o personagem “Coringa” que permitiu o debate sobre a problematização das doenças mentais e suas consequências, tema que ainda carece de discussão em nossa sociedade.', 'No Brasil, a Agência Nacional de Cinema (ANCINE), em regra, dispõe de poucos recursos financeiros no fomento a produções nacionais, entretanto, os baixos investimentos não prejudicam a qualidade cinematográfica nacional, visto que Orfeu e Central do Brasil foram premiados internacionalmente. Contudo, grande parte dos brasileiros não tem acesso aos locais de exibição, em especial as cidades interioranas.', 'Para alterar essa realidade, empresas do setor devem criar campanhas de popularização do cinema, com oferta de ingressos mais acessíveis em diversos períodos do ano. Em paralelo, prefeitos de cidades menores devem buscar parcerias para o financiamento de espaços de exibição. As mídias, por sua vez, devem garantir a divulgação das campanhas e estimular a convivência social para a construção de uma sociedade mais reflexiva e crítica.']",120,120,80,120,40,480
58,,"['"" olha  que floresta  vê que vida há no céu  vê que vida há nos ninhos "" Publicado em 1904, o poema ""A Pátria"", de Olavo Bilac, exaltava o privilégio dos brasileiros, por possuírem ambientes naturais amplamente diversificados, que, segundo o poeta, eram capazes, até mesmo, de transmitir sentimentos. Infelizmente, pouco mais de cem anos depois, o desejo de obter cada vez mais capital, aliado ao crescimento da sociedade consumista, tem tornado práticas ilegais como o desmatamento e a queima dos solos cada vez mais recorrentes.', 'De acordo com o IPAM, Instituto de Pesquisas Ambientais da Amazônia, somente no ano de 2019,  já foram registrados mais de trinta mil focos de calor. O ato criminoso de atear fogo em matas, florestas e afins, visa, mormente, aumentar as áreas de plantio e criação de animais, que buscam promover incrementos nos campos da pecuária e da agricultura. Todavia, esse meio ilícito de aumentar a receita econômica prejudica os ecossistemas e reduz a biodiversidade, interrompendo pesquisas que, segundo a revista ""Veja"", poderiam contribuir para o avanço das ciências biológicas.', 'Em seu poema, Olavo Bilac também revelou "" Criança  não verás país nenhum como este "", referência à grande biodiversidade e à sensação de ""vida"" que estar em contato direto com a natureza proporciona. Entretanto, de acordo com o site Brasil Escola, a ausência de cuidado com a Amazônia, verificada no Brasil hodierno, pode acarretar em sua total extinção ainda nos próximos quarenta anos.', 'Diante desse panorama, cabe ao Ministério do Meio Ambiente promover ações efetivas no combate ao desmatamento e às queimadas, que devem figurar, na parceria com bombeiros e equipe necessária para apagar atuais incêndios e preservar a ocorrência de futuros. Ademais, em conjunto com o poder Legislativo, devem ser criadas (ou modificadas) leis coerentes a esse tipo de infração, garantindo a punição dos envolvidos. Além disso, o Ministério da Educação  pode auxiliar através de palestras e debates a garantir que a nova geração aprenda, ainda na escola, a importância de preservar a floresta amazônica.']",120,120,120,120,120,600
115,A simplificação da linguagem de clássicos e o hábito brasileiro de lê ,"['Certa         pesquisa realizada pelo instituto Pró-Livro mostrou que                 o hábito da leitura no Brasil caiu de 55% para 50%                . O que anda acontecendo com os brasileiros? A modernidade da tecnologia afetou o bom hábito de         lê         ? Ou a                 forma linguística                vem desanimando os leitores?', 'O foco principal do tema         desta redação é ""A simplificação da linguagem de clássicos"", entretanto é preciso entender o porquê da simplificação da linguagem, ou seja,                 uma visão mais clara de livros interessantes e difíceis de ser          interpretado         .', 'Cada escritor tem sua forma linguística de se         expressar, e          mesmo                não mudando o sentido ou significado das palavras         escrita          pelos mesmo, estará alterando consideravelmente a obra.', 'Porém, se visarmos a ""simplificação"" de palavras para motivação da leitura, será uma ótima ideia.         Muitas vezes o leitor deixa de ler clássicos da literatura pelo fato de se entediar com a forma                que a linguagem se         apresenta,         acaba passando mais tempo         com o dicionario ao lado         , do que aproveitando a história.', 'Com o avanço tecnológico as pessoas começaram a deixar de lado o prazer de abrir um livro e entrar em um outro mundo, o mundo literário, para passar                maior parte do seu tempo em rede sociais. Não será de uma hora para outra que         resgatarão, ou         criarão esse prazer na vida dos jovens,         mais          mostrará          que          fora da          tecnologia existe          páginas que trazem histórias emocionantes, histórias essas que antes não eram consideradas.']",80,120,120,80,80,480
84,Armas,"['Atualmente, a violência, independente da área que intervém, é uma realidade comum que tem crescido de forma descontrolada tendo como consequência desse ato o desejo de muitas pessoas por possuírem uma arma como meio de defesa, seja ela de fogo ou branca. Tal fato causa um certo desconforto na população devido a pouca ou quase nenhuma experiência dos que as possuem, para o manuseamento do objeto.', 'É importante ressaltar que esse problema não é composto por apenas um fator, mas sim por vários, como por exemplo: a falta de segurança, a fome, o ausência do Estado, a expansão do tráfico de drogas, a política, o desemprego, entre outros. A venda ilegal desse produto é algo que encontramos em qualquer esquina ou beco, sendo vendido pelos mais variados preços.', 'De acordo com pesquisas realizadas pela UNESCO nos anos entre (os anos) 1980 e 2003, o número de vítimas de armas chegou a mais de 500 mil, seja em situações de homicídios ou suicídios. Porém, não são esses números que surpreendem , mas sim que, enquanto o percentual de mortes por armamentos  é de mais de 400%, o percentual do crescimento da população chegou a pouco mais de 51%.', 'A posse de um armamento nos dias de hoje é tido como poder por muitos, pois quanto maior a quantidade e o nível de potência de tal objeto, mais poderoso você se torna. Desta forma, os policiais procuram deter e até mesmo acabar com essa venda de armas que não possuem nenhuma documentação legal.', 'Deste modo, o mais importante a se cumprir é o apanhamento de tais armas e a prisão dos indivíduos que as portam,  feitos pelo Estado juntamente com a Secretaria de Segurança e também o aumento da segurança nas grandes metrópoles. Assim, a população poderá descansar e a porcentagem de mortes por armamentos diminuirá significantemente.']",160,160,160,200,200,880
95,DEBATE SOBRE O MARCO TEMPORAL,"['Recentemente, ocorreu uma das maiores manifestações indígenas do Brasil, os protestantes se reuniram em Brasília para defender seus direitos às terras, expondo assim o descaso contra os povos originários e começando um debate acerca do ""marco temporal"" em todo o país. A problemática está intrinsecamente ligada à cultura e à pobreza de informações sobre o tema.', 'Em primeira análise, o filme ""Pocahontas"" retrata o encontro entre os colonos e os indígenas, de forma a mostrar o ""choque"" de realidade entre ambos e  posteriormente, os maustratos sofridos pelos povos nativos. De forma semelhante, muitos indígenas continuam a sofrer maustratos na forma de preconceitos e tendo seus direitos negados . A utilização do ""marco temporal"" para predeterminar os direitos de povos indígenas às terras, tem se tornado cada vez mais um fator de segregação, já que muitos agropecuaristas utilizam-se desse decreto para benefícios próprios. Com isso, torna-se urgente uma mudança nesse cenário.', 'Em segunda análise, o descaso e a desinformação da população tem suas raízes no período colonial, no qual surgiram as práticas negativas com os os povos originários e também originou-se a segregação da informação. De tal forma, parte da população atual não tem conhecimento acerca dos povos indígenas, mantendo uma visão esteriótipada proposta pelo período colonial e consequentemente, dificultando o debate acerca dos direitos desses povos. Dito isso, é imprescindível melhorar a educação popular, afim de erradicar a problemática.', 'Infere-se portanto que, dois grandes causadores do descaso à população indígena são as raízes culturais colonialistas e a desinformação da população. Para que o debate do ""Março temporal"" torne-se positivo para os povos nativos, é necessário que, o Ministério da Educação, através das aulas sociológicas nas escolas, proponha um estudo mais aprofundado do período colonial e da cultura indígena, e que o Ministério da Tecnologia e informação, a partir das redes sociais, divulgue um maior número de informações sobre a problemática.  Culminando assim, em um cenário no qual os indígenas têm seus direitos garantidos.']",120,160,160,160,160,760
52,Gravidez precoce,"['A GRAVIDEZ NA ADOLESCÊNCIA ESTÁ PRESENTE NA VIDA DE UMA ADOLESCENTE A UMA GRANDE PORCENTAGEM DE JOVENS MENINAS QUE IGNORAM A EXISTÊNCIA DE MÉTODOS CONTRACEPTIVOS OU, SIMPLESMENTE CONHECE-OS MAS NÃO OS ADOTA. E A CADA DIA MAIS AUMENTA A DOENÇAS SEXUALMENTE TRANSMISSÍVEIS, ALEM DA GRAVIDEZ INDESEJADA NESSA FAIXA ETÁRIA.', 'A GRAVIDEZ NA ADOLESCÊNCIA PODE TER MUITAS CAUSAS ALGUMAS MENINAS DIZEM QUE A GRAVIDEZ DELAS FOI DESEJADA ENTRETANTO INDEPENDENTEMENTE DAS CAUSAS E DESEJOS DE CADA ADOLESCENTE, MAS O FATO É QUE NA GRAVIDEZ PRECOCE É UM PROBLEMA PARA A SAÚDE PÚBLICA UMA VEZ QUE CAUSA RISCOS A SAÚDE DA MÃE DO BEBÊ E TEM IMPACTO SOCIOECONÔMICO POIS MUITAS MENINAS GRÁVIDAS ABANDONAM OS ESTUDOS E APRESENTAM MAIOR DIFICULDADE DE CONSEGUIR EMPREGO PARA TRABALHAR.', 'APESAR DE TUDO OS ADOLESCENTE NO DIAS DE HOJE ELES POSSUI INFORMAÇÕES SOBRE O CONHECIMENTO QUE SÃO FORNECIDOS EM ESCOLAS TELEVISÃO E ATÉ MESMO PELA INTERNET MAS A MAIORIA DELES NÃO SABE SE PREVINIR.', 'Quando uma adolescente fica grávida, muda radicalmente seu presente e seu futuro, e em raríssimas ocasiões essas mudanças são para o bem .Segundo o relatório , a taxa de natalidade das adolescentes brasileiras entre 15 e 19 anos foi de 71 em cada mil, não tão distante assim do Afeganistão, de 90 em cada mil, país muçulmano onde ainda é tradição casar cedo as meninas. Na França, o número ficou em 12 para cada mil. Apesar de a taxa de fecundidade no Brasil estar abaixo da média mundial, na faixa etária entre 10 a 19 anos de idade essa média é elevada, diz Anna Cunha, oficial das Nações Unidas.', 'A gravidez precoce tem consequências sérias para a vida das jovens e para o país. Segundo especialistas, além de riscos para a mãe e o bebê, a gestação precoce leva as jovens a enfrentar conflitos psicológicos e familiares, abandonar os estudos e ter maior dificuldade para se encaixar no mercado de trabalho .A situação ainda é mais dramática nas regiões Norte e Nordeste. O percentual de mães adolescentes que não concluíram o Ensino Fundamental passa dos 35% A gravidez precoce tem consequências sérias para a vida das jovens e para o país.', 'Muitas mulheres afirmam não utilizar a camisinha por objeção do parceiro ou, ainda, por terem um relacionamento estável com um único homem Dados de 2011  mostram que o país teve 2.913.160 nascimentos, sendo 533.103 nascidos de meninas com idade entre 15 e 19 anos e 27.785 nascidos de meninas de 10 e 14 anos. Vale salientar ainda que cerca de 30% das meninas que engravidam na adolescência acabam tendo outro filho no primeiro ano pós-parto.']",80,80,40,80,0,280
89,,"['É de fundamental importância salientar,  que devido pandemia do coronavírus, a sociedade teve que lidar com o isolamento social, mas muitos se preocupam com a crise econômica e deixam de ficar em casa. Dessa forma, fica evidente que através dos casos de mortes por COVID-19 e de depoimentos do governo, a população vai entender a importância do isolamento social.', 'Em primeira análise, vale ressaltar que são 2.538.681 pessoas mortas por COVID-19, segundo dados dos Ministérios de Saúde, do The New York Times. Dessa maneira, vale expor que com o isolamento social o número de casos de mortes diminuem, portanto, o ideal é seguir as atitudes tomadas pelo Ministério da Saúde e ficar de quarentena em casa para impedir que várias pessoas sejam contaminadas por essa doença.', 'Outro fator existente, é que o governo deve alertar a população através de depoimentos e disponibilizar meios para ajudar todos que precisam e conscientizá-los sobre a importância do isolamento social. Desse modo, todos irão seguir o isolamento e se manterem com ajuda governamental, para que a pandemia termine logo.', 'Dado o exposto, para que todos tenham consciência da importância do isolamento social, o governo, por meio de depoimentos e de verbas, deve alertá-los sobre a consequência da aglomeração e disponibilizar recursos para que todos sobrevivam a essa pandemia. Além disso, a mídia  juntamente com as instituições de ensino, por meio de campanhas publicitárias, deve conscientizar a sociedade a cuidarem de seus familiares ficando em casa e se mantendo seguros, visto que é a melhor opção para que o número de mortes não tenha continuidade.']",160,120,120,200,160,760
43,Em prol das comunidades,"['Notícias falsas .Calúnias e difamação. Atitudes antidemocráticas. Tais situações negativas são fatos os quais acontecem no interior das sociedades contemporâneas, potencializadas pelo uso das redes sociais e uma crise de valores éticos e morais .Assim, ações de suspensão dessas ferramentas digitais são uma realidade, sobretudo por razões políticas e societárias .Medidas coercitivas são necessárias e urgentes.', 'Primeiramente, o setor politico que sofre com a propagação de noticiários inverídicos e comentários ofensivos e desrespeitosos entre membros da própria classe mas também de cidadãos externo ao segmento. Esse fato muito das vezes utiliza-se das plataformas digitais ,por exemplo facebook e twuiter, como veículos de transmissão dessas informações ilegais e criminosas .Como reflexo disso órgãos jurídicos solicitam o bloqueio das redes sociais de alguns indivíduos pelo uso indevido.', 'Outro fator que leva ao cancelamento dos canais digitas coletivos é a violação de direitos sociais, visto que essas ferramentas eletrônicas são instrumentos de divulgação de grupos antissociais os quais incitam práticas homofóbicas e racistas somada a atitudes contrárias à democrática por meio dessas redes na sociedade . Segundo disse Martin Luther King,"" A injustiça em qualquer lugar é uma ameaça à justiça em todo lugar."" Nesse contexto, os entes públicos e governamentais necessitam reprimir essas ilegalidades, com isso a desativação das mídias comunitárias é fundamental para a ordem geral.', 'Percebe-se, portanto ,que a sociedade moderna enfrenta o dilema do cancelamento das redes sociais, seja por causas políticas ou seja por causas coletivas. Dessa maneira, é importante o cidadão compreende que embora as mídias digitais apresentem a sensação de ilimitação, elas estão sujeitas às fronteiras de justiça e da cidadania em prol do bem comum.']",160,120,80,200,80,640
49,Marketing,"['Recebemos  todos os dias mensagens, e-mails e chamadas de pessoas que sequer conhecemos, e estas nos oferecem produtos e serviços que podemos , ou não, estar precisando . São esses, os influenciadores digitais. Isso tem sido algo muito comum nesse século regido pela tecnologia e, consequentemente, pela globalização.', 'Os digitais influencers têm o difícil trabalho de “influenciar” a opinião e as escolhas das demais pessoas quando estas vão fazer uma compra de determinado produto. De forma mais clara, se uma pessoa estiver à procura de certo produto, é o trabalho dele usar sua persuasão para induzir tal pessoa a fazer a compra desse produto de uma marca “X”, sua opinião deve favorecer a marca que ele está a propagar e também pesar na escolha do consumidor.', 'Por usarem as redes sociais como meio de trabalho, essas pessoas podem também estar cumprindo sua carga horária mesmo sem sair de casa, o que tem sido até benéfico para a economia durante esse ano de 2020, já que o COVID19 quase parou a economia, não só do Brasil, mas do mundo. Em outras palavras, neste momento onde a economia está debilitada, o papel desses profissionais se tornou indispensável, já que eles têm influenciado as pessoas a comprarem produtos pela internet, seja oferecendo promoções, insistindo na compra, ou simplesmente usando seu carisma e educação, o que é sem dúvida essencial nesse ramo.', 'Embora seja uma profissão a qual não damos dado muita atenção , ela é severamente importante nos dias de hoje e no futuro que se segue, portanto é necessário compreender e valorizar esses profissionais: socialmente, apoiando o trabalho desenvolvido por eles; e individualmente,  respeitando-os assim como somos  respeitados por eles, não tratá-los de maneira arrogante, e, obviamente  comprando  os produtos por eles oferecidos. Enfim, o trabalho desses profissionais é, mesmo que mal valorizado, importante, e devido a isso devemos  reconhecer a importância dos influenciadores digitais.']",160,160,120,120,120,680
91,Negacionismo Cientifíco em pleno século XXI,"['Na obra ""Utopia"" de Thomas More, é retratada uma sociedade perfeita, na qual o corpo social é livre de conflitos e problemas. No Brasil, contudo, o que se observa na realidade contemporânea é o oposto do que o autor prega, visto que, os efeitos do negacionismo científico é um problema presente na sociedade. Nesse sentido, convém analisar as principais causas e consequências desse impasse.', 'Com efeito, entre os principais motivadores do escapismo científico por parcela da população, está a falta de conhecimentos mais amplos sobre a ciência. Ora, durante a Primeira República no país, houve a Revolta da vacina, uma rebelião popular contra a vacina anti-varíola. Tal episódio, marcado pelo negacionismo à ciência, se deu entre outras causas, pela falta de esclarecimentos sobre a importância da vacina. Logo, é inaceitável que em pleno século XXI, mesmo diante de diversos veículos de informação, o escapimo cientifíco esteja presente no corpo social brasileiro.', 'Ademais, as consequências do problema em questão inclui a vulnerabilidade da saúde dos cidadãos. Para Sócrates, a vida sem ciência é uma espécie de morte, todavia, essa concepção precisa reforçada hodiernamente, uma vez, que pessoas negam a ciência mesmo quando essa é usada em prol da saúde humana. Um exemplo disso são os movimentos antivacinas que propiciam o reaparecimento de doenças quase ou totalmente erradicadas, bem como, as dificuldades maiores no enfrentamento de uma pandemia. Sendo assim, intervenções devem ser aplicadas de modo a conter os maiores impactos provocados pelas questões supracitadas.', 'Diante do exposto, medidas são necessárias para resolver o impasse. Logo, cabe mídia, responsável por disseminar informacão e por moldar a opinião do grande público, promover campanhas que visem mobilizar os indivíduos sobre a relevância da ciência na preservação da saúde e sobre os efeitos prejudiciais provocados pelo negacionismo cientifíco.']",160,200,160,200,160,880
124,Lixo,"['O Brasil vem vivendo há anos com problemas         do         destino do lixo. São milhares de toneladas por dias recolhidas         por         cada cidade,         mas nem toda cidade o lixo é recolhido         ou nem sempre o destino dele é o correto.         Mas para         reverter situações como estas, devemos nos concientizar.', 'Cidades brasileiras com falta de coleta de         lixo, tem         sido um dos principais problemas. Não há                 destino e são jogados                em terrenos baldios                 com lixo acumulado e visivelmente feio                . Isso acontece         pois         não há conscientização dos         cidadães         , nem das autoridades responsáveis.', 'Muitos         cidadões         brasileiros não separam seu lixo doméstico,                 restos de comida com papéis                que poderiam ser separados adequadamente. Muitos fazem isso por falta de informação e outros por simplesmente falta de vontade.', 'Mas é isso que devemos levar aos outros, conscientização.         Faze-los         com que cada um cumpra suas partes,         separa-los         seu         lixos, recicla-los. Pois         são de nossa responsabilidade.', 'E assim sendo, a melhor forma de garantirmos um país sem problemas com         lixo, é         agindo de forma correta e com responsabilidade.']",80,120,80,120,80,480
81,Livre Arbítrio,"['No Brasil, religião é um direito que a pessoa tem de ter ou não. Não é obrigado a nenhum cidadão brasileiro a imposição de uma. É do livre arbítrio de cada um ter ou não. E cabe aos demais respeitar a escolha do outro. Não há um ser aqui nesta Terra capaz de dizer se essa ou aquela é a certa. Cabe a cada um escolher a que para si é a melhor. A religião é uma coisa séria. É um compromisso com Deus. É devoção, amor e respeito, ela serve para nos ligar a Deus.  E prega amor, justiça, caridade e ética, fortalece a fé e a irmandade. Pelo menos é isso o que elas pregam, mas  hoje, estar  havendo no país muita intolerância religiosa,   algumas religiões estão usando como comercio  e não como filantropia, assim a ganância impera e o dinheiro torna-se o primeiro objetivo de alguns pastores, que ficam disputando os fieis  no laço e pregando a intolerância religiosa, oprimindo os seguidores caso se desviem do caminho da salvação. Religião e dinheiro não combinam, não foi isso o que Jesus nos ensinou, ou religião alguma. Assim, para que a paz reine entre as religiões  é preciso que o governo interfira nas diretrizes das organizações religiosas   dando limites e direção para como prosseguir com as outras.   E cobrando resultados,   caso eles não cumpram   perderão as credenciais para doutrinar. E as escolas,   também terão um papel fundamental para ensinar o respeito a  religião alheia. O respeito é o pai e a mãe da ordem do mundo. Sem ele, a desordem e a baderna prevalecem. Só com ele, a escolha e a prática da religião se tornarão um ato de fé, amor e escolha novamente livre.']",80,80,80,80,120,440
83,Esporte é saúde.*,"['A prática de esportes é uma atividade essencial ao ser humano e está ao alcance de todos. O esporte traz diversos benefícios à saúde física e mental das pessoas, além de contribuir para a socialização e integração de diferentes povos e nações. Contudo, com o advento de tecnologias, a sociedade pode se tornar sedentária e menos ativa em relação a realização de atividades físicas.', 'Atualmente é comprovado por diversos estudiosos que o uso constante de atividades físicas, relacionadas ao esporte ou não, pode reduzir consideravelmente os riscos de doenças cardíacas e enfermidades relacionadas ao sistema circulatório. Além de melhorar a autoestima das pessoas, o esporte contribui para uma socialização de indivíduos, na qual crianças com dificuldades de comportamento, acabam aprendendo com o esporte a serem mais ativas e participativas nas escolas e no ambiente familiar. Além disso, o esporte tem mostrado ao mundo, através das olimpíadas que hoje acontecem na cidade do Rio de Janeiro, que é possível alcançar seus objetivos e seus sonhos, onde atletas de origem pobre que conquistaram medalhas olímpicas, são um incentivo para milhões de pessoas no Brasil e no mundo.', 'Entretanto, resultados divulgados pelo Ministério da Saúde apontam que em média 80% da população brasileira está sedentária, as pessoas hoje preferem manusear celulares e jogar vídeo game do que fazer uma caminhada ou corrida nas ruas. Muitos culpam esse sedentarismo pela associação de uma vida corrida com estudos e trabalhos, mas é necessário saber conciliar trabalho com a prática de esportes. No início é difícil a escolha de uma modalidade esportiva pela maioria das pessoas, mas depois de adquirido o hábito, fica bem mais fácil.', 'Cabe, portanto, ao governo, à família e aos demais segmentos sociais estimularem ainda nas escolas a prática do esporte e atividade física.  Com campanhas e palestras educativas de incentivo a prática do esporte nas escolas, e através da mídia divulgar os benefícios à saúde que o esporte pode trazer para a população, como a redução de diversas doenças. Pois com a educação aliada ao esporte, teremos um país campeão e vencedor.']",160,160,160,200,200,880
93,Protagonismo ou antagonismo às gestantes?,"['É notório que, no Brasil, o parto humanizado vem ganhando forças como uma forma de dar mais protagonismo e liberdade às gestantes. Acresce que, tal procedimento vem se impulsionando devido prevalência da violência obstétrica, que varia entre 18,3% e 44,3%, de acordo com estudos de base populacional. Dessa forma, é possível perceber que tal parto tem sido a principal escolha entre as grávidas que desejam um nascimento sem intervenções médicas desnecessárias e que deve ser tratado como uma questão de saúde pública para o bemestar de todos os pacientes.', 'Ademais, segundo a OMS ( Organização Mundial de Saúde),""Saúde não é apenas ausência de doenças, mas bem estar físico e psicológico"". Bem como, um parto realmente saudável é aquele em que a gestante se sinta confortável e tenha suas escolhas preservadas. Em suma, é essencial que a mesma tenha seus direitos respeitados para garantir a saúde que a OMS afirma.', 'Além disso, em relação violência obstétrica, de acordo com a Câmara Municipal de São Paulo, os maustratos podem ocorrer como violência física ou psicológica. Ou seja, tal impetuosidade está nos abusos sofridos pela grávida que não é tratada da forma saudável que a OMS propõe. Dessa forma, é de suma importância que a Resolução nº 2.232 seja abonada para os pacientes de redes públicas e privadas.', 'Portanto, cabe à OMS aplicar multas aos hospitais ou profissionais da saúde que forem desrespeitosos com seus pacientes , descumprindo a Resolução nº 2,232. Bem como, tais multas serão capazes de reduzir os índices de violência obstétrica no Brasil e assim as gestantes terão suas opções respeitadas. Dessa forma, o protagonismo do parto estará todo voltado para as grávidas, garantindo assim um nascimento mais natural, sem intervenções médicas supérfluas.']",160,160,160,160,120,760
82,,"['A dor , em geral , é sinal de que há algo de errado com nosso organismo . Alivá-la ou atenuá-la torna-se essencial para se obter o bem-estar ;  por isso , a maioria das pessoas possuem o hábito de automedicar-se . Essa prática , tida por muitos como  banal e não-perigosa  , tem gerado discussões , principalmente no que tange as conseqüências  – que são muitas , desde intoxicação , alergias à morte – da ingestão  de medicamentos por conta própria . Mas diante desse problema de saúde pública , é preciso que , além de posições extremadas ( contra ou a favor ) , exista uma real proposta de atenuação desse problema .', 'A comunidade médica , em sua maioria , condena a prática da automedicação , enfatizando os riscos que essas substâncias podem causar no organismo das pessoas . De fato , o acompanhamento médico e a obtenção de receita para comprar os medicamentos é essencial em muitos casos , principalmente quando os pacientes possuem alguma doença grave ou crônica . Porém , é um tanto utópico imaginar que  num  país com uma saúde pública deficitária , que se mostra por vezes incapaz de atender a demanda de pacientes já existentes , exista essa ação de procurar antes uma assistência médica.  O que acontece é justamente o contrário :  maioria das pessoas evitam ir ao médico por conta de uma dor , por exemplo, justamente por conta da dificuldade de se conseguir atendimento .', 'Tanto nos hospitais públicos quanto nos privados , o problema da superlotação já faz parte do cotidiano de quem precisa de um atendimento , e isso viria a aumentar com a maior ida das pessoas ao médico , ocasionando mais caos ao sistema de saúde . Então , posições extremadas de demonização da automedicação geram muitas conseqüências negativas , já que a própria OMS ( Organização Mundial de Saúde ) julga essa prática como necessária .', 'O aumento da cultura da automedicação se deu , principalmente , pelo avanço da indústria farmacêutica , que oferece uma variedade absurda de medicamentos , e , junto a isso , a maior facilidade de comercialização de medicamentos . Comprar remédio se tornou  cada vez mais fácil ; o alívio da dor tem um preço e a maioria das pessoas está disposta a pagar por isso .', 'Isso posto , é preciso que exista uma maior fiscalização da indústria farmacêutica e principalmente na comercialização  dos medicamentos ,  e que exista um maior controle sobre alguns remédios , antibióticos  por exemplo . É essencial também que seja  veiculadas através da  mídia campanhas de conscientização das pessoas ; a automedicação não precisa ser vista como vilã , mas deve-se evitar excessos na ingestão de medicamentos sem orientação médica ; junto a isso , deve  existir campanhas que incentivem às pessoas a   procurar mais frequentemente o médico , pois existe um certo temor por parte da população . O Estado também deve melhorar o sistema público de saúde ,  para que se torne mais viável e menos demorado  o acesso à saúde , fazendo como que essa assistência médica ocorra mais vezes .']",160,160,200,160,200,880
44,“Padronização do que é ser mulher”,"['A testosterona concede diversos efeitos no corpo humano, como o fortalecimento da musculatura. Na atual realidade, sua taxa metabólica serve de padrão para decidir que atletas estão aptos a competir, sobretudo nas mulheres, que não podem ultrapassar o limite de produção considerado “normal” pela Federação Internacional de Atletismo. Entretanto, esses aspectos biológicos não deveriam afetar o que é ser mulher socialmente, e que tipo de mulher deveria representar as outras, pensamentos que advém de raízes históricas e causando assim, uma padronização.', 'Em primeiro lugar, é imperativo postular pensamentos de tipificação feminina- historicamente ditados- como agravantes da problemática supracitada. A idealização de uma mulher delicada e frágil não é recente, para os atenienses, apreciadores do intelecto, eram consideradas fisicamente e intelectualmente frágeis. Nessa perspectiva, estipulou-se uma imagem feminina indefesa, e quando uma mulher mostra, sem o uso de medicamentos, um excesso de traços tipicamente masculinos- como a bicampeã olímpica Caster Semenya, que possui nível de testosterona acima do padrão- é condicionada a provar que é realmente mulher, e representa-las, através do uso de medicamentos para reduzir seu nível de hormônio testosterona.', 'Por conseguinte, as mulheres se encontram cada vez mais desvalorizadas na sociedade- nos esportes são padronizadas e recebem menos, em cargos de presidência são submetidas ao mesmo trabalho de homens e recebem menor salário . Logo, essas medidas são provas de que o quadro das mulheres atualmente, é tratado como uma experiência a ser provada sempre.', 'Torna-se imprescindível, portanto, a tomada de atitudes que mitiguem o problema. Para isso, é papel das federações de esportes promover a aceitação natural das mulheres, sem rotula-las para as competições, através da proibição de uso de medicamentos para encaixar as mulheres nos jogos, pois isso cria um modelo do feminino, no intuito de erradicar a necessidade da mulher sempre ter que provar que é um espelho do que a população espera. Dessa forma, teremos desprendido sua idealização.']",160,160,160,200,160,840
45,Estamentos sociais,"['"" Você sabe com quem está falando?\' , argumento muito usado por quem quer se sobrepor pela sua distinção social. Nota-se na sociedade contemporânea brasileira traços de um período colonial em que havia estamentos sociais muito bem definidos em que o mais rico, com mais poder ou detentor de maior conhecimento  se categorizava equivocadamente como superior.', 'Abusos de poder ou autoridade ocorrem nos mais diversos níveis de poder, contrariando a ideia de igualdade do pensamento iluminista que defendia a tese da igualdade humana, além de fugir de concepções da democracia direta. Em sua mundo em que a desigualdade social é prevalente, a conquista de funções consideradas elevadas se torna distante da realidade da maioria dos indivíduos, causando naqueles que estão em patamares elevados falsa impressão de poderio total.', 'Desta maneira, nota-se envolver uma problemática social de diferentes esferas, como distinção de pessoas pela sua ocupação, ocorrência de excessos e preconceitos, que gera de alguma maneira alusão ao Nazismo, em que a raça ariana era superior demais. Dado os fatos e todas suas consequências inconcebiveís fez se necessário a criação da Lei de Abuso de Autoridade no Brasil que começou a vigorar no início do ano de 2020, entretanto, mesmo com sua efetivação casos estão surgindo como do desembargador que se recusou a usar a máscara e desacatou guardas municipais, como da engenheira que deferiu ofensas a um fiscal da Vigilância Sanitária', ""Assim sendo, fica evidente a existência em muitas pessoas de um sentimento de superioridade que causa muitas vezes o abuso de poder e autoridade, Buscar alternativas que trabalhem essa temática, levando o individuo a refletir e repensar suas atitudes, por meio de abordagens em escolas, programas de tevê e palestras se fazem necessárias, efetivando de fato a Lei de Abuso de Autoridade e caso tenha ocorrido episódio de abuso, penas mais rígidas e cumprimento destas se fazem necessárias , porque como colocou Montesquieu ' Existem boas leis, mas não existem bons executores' , elucidando a importância da executação das leis""]",160,160,120,160,80,680
54,vacinação um preparo para o amanhã,"['Em relação a importância da vacina em nossa sociedade, é possível afirmar que não só tem contribuído para erradicar doenças como a febre amarela,rubéola e o sarampo, como também prepara o sistema biológico do corpo para eficácia da vacina.', 'Relativo a erradicação das doenças tríplice viral. A Organização Pan-Americana de Saúde(OPAS) havia dado ao Brasil, o certificado de erradicação da doença.. Contudo nesse ano de dois mil e dezenove o aís perdeu este certificado pela volta da doença nos estados de São Paulo, Rio de janeiro, e Paraná. Contudo rapidamente o governo tomou providencias cabíveis, como estender os horários dos postos de saúde para atender uma maior demanda de pacientes e fazendo campanhas de vacinação, principalmente em crianças, gestantes e idosos, visto que possuem uma imunidade mais frágil, e somente a vacinação pode fazer tais doenças a serem consideravelmente extintas outra vez , pois nas pessoas vacinadas demostrarão um sistema imunológico mais preparado segundo o criador da vacina. Edward Jenner.', 'Em referencia ao preparo do sistema biológico para eficacia da vacina, a Organização Mundial da Saúde(OMS) se mostrou a favor da vacina, tendo em vista que o sistema do corpo aceita as doses sem causar mau ao paciente e reagindo muito bem contra as alterações do estado de saúde do ser humano . Nos anos de dois mil e dezessete, ouve uma redução de mortes em oitenta por cento em nosso aís ,fenômeno ocasionado pela eficacia da vacina.', 'Bom seria se, portanto, o governos juntamente com a comunidade elaborasse mais campanhas de vacinais, para todas as classes sociais tendo em vista que muitas comunidades ainda são carente deste oficio, e a comunidade aceitasse a proposta do governo e forcem a os hospitais e incentivassem outro a irem somente assim voltaremos a um patamar aceitável novamente.']",120,120,80,120,80,520
97,A (in)segurança pública.,"['A polícia, em um estado democrático como é o caso do Brasil, desempenha um papel muito importante: o controle         social. Na qual         busca manter a ordem pública e zelar pela propriedade, liberdade e segurança individual e coletiva. Todavia, várias situações ocorridas nos últimos dias         ínsita         o questionamento:         Esta         corporação é sinônimo de segurança ou insegurança pública?', 'No transcorrer do ano de 2013 e início de 2014, a população brasileira foi às ruas mostrar suas insatisfações diante de várias situações e realidades.                 Neste aspecto                cabe         a essa corporativa          prezar                pela liberdade de manifestação, bem como proteger o patrimônio público e privado, que na maioria das vezes é danificado por vândalos que se aproveitam do grande número de pessoas para cometerem crimes.', 'O grande número de manifestantes dificulta o trabalho de polícia, que em situações extremas opta por atitudes que são mal vistas pela         sociedade. Mas que         para a         situação         são cabíveis e necessárias, ainda que         vá          contra a legitimidade do movimento.', 'Apesar de frequentemente vermos em meios de comunicação casos de policiais que se excedem na         repreensão         ,         estes         fatos ainda são exceções         e, os         infratores devem ser punidos. Entretanto isso não é motivo para desmoralizar todo o papel da         junta         policial.', 'Por mais que a atuação da polícia seja muito contestada, esta ainda deve ser vista como sinônimo de segurança pública. No caso das manifestações é necessário um melhor treinamento da corporação         de         como agir em meio a um grande número de pessoas e saber identificar e conter e punir os         causadores da baderna         .']",160,200,120,200,200,880
48,Carlos Oliveira,"['Promulgada pela ONU  em 1948, a Declaração Universal dos Direitos Humanos garante a todos os indivíduos o direito à saúde e ao bemestar social (dentre outros). Conquanto, alguns dos desafios enfrentados cotidianamente pelo SUS impossibilitam que parte da população desfrute desse direito universal na prática. Nessa perspectiva, tais desafios  devem ser superados de imediato para que uma sociedade integrada seja alcançada.', 'A saúde é um dos fatores principais no desenvolvimento de um país. Hodiernamente , ocupando a nona posição na economia mundial, seria racional acreditar que o Brasil possui um sistema público de saúde eficiente . Contudo, a realidade é justamente o oposto e o resultado desse contraste é claramente refletido nos desafios enfrentados pela saúde pública brasileira. Diante do exposto, urge repensar os investimentos públicos em saúde no Brasil.', 'Faz-se mister, ainda, salientar a presença ou falta de unidades de atendimento em dadas regiões brasileiras como impulso, ao mesmo tempo, dos desafios que o SUS enfrenta e da importância de sua existência. De acordo com Zygmunt Bauman, sociólogo polonês, a falta de solidez nas relações sociais, políticas e econômicas é a característica da ""modernidade líquida"" vivida no século XXI. Diante de tal contexto, governantes precisam romper a barreira que os tranca em brasília e solidificar as relações com o povo brasileiro, a fim de descortinarem a visão de Brasil e de saúde brasileira que possuem, provavelmente formada por aquilo que a mídia revela.', 'Infere-se, portanto, que ainda há entraves para garantir a solidificação de políticas que visem à construção de um mundo melhor. Dessa maneira, urge que o Ministério da Saúde , bem como as Secretarias de Saúde estaduais e municipais, e seus agentes, se entrelacem formando um só corpo, sólido e conciso, capaz de unificar as verbas públicas oriundas de seus respectivos níveis hierárquicos na evolução e manutenção do atendimento de saúde gratuito. Essa articulação extingue as esferas municipais, estaduais e federais em nome de um Sistema Único de Saúde, de fato, capaz de construir os hospitais e unidades necessárias, deslocar médicos e enfermeiros quando necessário, ampliar o número de ambulâncias, criar e reger uma plataforma online de acompanhamento médico dos pacientes, melhorar o atendimento médico por videoconferência em comunidades isoladas, dentre outras ações, confluindo num caixa maior, com maior número de profissionais e relações mais estreitas e integradas da rede SUS por todo o Brasil. Dessa forma, o país poderia superar os desafios de sua saúde pública.']",160,160,120,200,120,760
14,Solidariedade brasileira,"['O século XX foi marcado por crises humanitárias, guerras de grandes proporções e, consequentemente, pelo elevado número de imigrantes. Atualmente, os fatores que motivaram migrações no passado, como, por exemplo, as perseguições políticas e as crises econômicas, ainda estão presentes no mundo , o que mantém o fluxo migratório constante. É evidente que os problemas dos povos que buscam moradia em outros países aumentam cada vez mais, uma vez que existem países que negam auxílio a essas pessoas.', 'Em 1948, a Organização das Nações Unidas criou a Declaração Universal dos Direitos Humanos, um dos documentos mais importantes sobre os direitos fundamentais de todos, que se opunha, dentre outros, à tortura e ao desrespeito contra a dignidade da pessoa humana. Apesar da existência de tal documento, muitos países colocam-se contra esses direitos inaliáveis quando optam por não atender, de qualquer maneira, pedidos de abrigo. Seja pela perspectiva nacionalista ou pela aversão ao multiculturalismo, decisões do tipo caracterizam-se como tortura indireta, pois vulnerabilizam ainda mais alguns grupos, expondo-os, por exemplo, à doenças e atos de violência militar.', 'Tal como outras nações, o presidente do Brasil, Jair Bolsonaro, mostra-se contrario à decisão de aceitar imigrantes no país. Uma decisão contraditória para um país cujo a Constituição Federal prega a construção de uma sociedade solidária.', 'Portanto, o Governo Federal do Brasil deve continuar a auxiliar imigrantes, visando garantir seus direitos e seguir a Constituição Federal, e integrá-los ao mercado de trabalho para, em uma relação de mutualismo, colaborarem no desenvolvimento da economia.']",200,200,160,200,160,920
47,As problemáticas do ensino a distância,"['O “Telecurso 2000” foi uma iniciativa da “Rede Globo” para ensinar conteúdos do ensino básico e médio, tendo como principal veículo a televisão. O projeto auxiliou a certificar milhares de pessoas no país, entretanto não deve ser considerado um exemplo de ferramenta para educar e formar crianças; jovens e adultos, visto que,nem todos poderão usufruir de forma adequada de um mecanismo que demanda uma estrutura adequada e que nem mesmo algumas escolas conseguem disponibilizar – livros, cadernos, ambiente apropriado, televisão ou computador. O Ministério da Educação se mostra conivente com tais ações, não criar um projeto que ampare as escolas públicas e particulares é apoiar um crescente índice na desigualdade da educação.', 'A priori, observa-se que o país historicamente não possui interesse público em construir um projeto para acomodar um plano de democratização da educação. Haja vista que, desde que o Brasil colonial, o ensino presencial de excelência é reservado à elite. Em contraste com a contemporaneidade, a República brasiliense evoluiu muito ao ofertar uma aprendizagem presencial para mais de 90% das crianças e jovens, em todas as faixas etárias, segundo o Ministério da Educação. Contudo, identificar as disparidades do ensino público do particular é saber diferenças estratosféricas e estas se acentuam mais quando falamos do ensino remoto. Portanto, é inviável (no momento) discutir uma educação a distância sem ao menos sanar os déficits da estrutura presencial.', 'Em segunda análise, o país apresenta normas de como deve ser utilizado a ferramenta de ensino a distância, contudo o Ministério da Educação não edita regras de acessibilidade aos estudantes que não podem comprar e manter um ensino remoto. Causando uma diversidade de denúncias ao Ministério Público sobre os abusos praticados por escolas que forçam os responsáveis a comprarem utensílios, visando uma didática virtual.', 'Em virtude dos fatos mencionados, conclui-se que o Brasil ainda não está preparado para iniciar um projeto de ensino a distância, mas sim utilizar em casos específicos como um instrumento de auxílio, amparando todos os estudantes. O Ministério da Educação deve, portanto, iniciar um plano de democratização do ensino presencial, dar aos estudantes da rede pública uma didática que se equipara ao particular, por meio de estudos dirigidos pelo próprio, visando identificar as falhas e acertos dos últimos anos para assim traçar um futuro, seguindo o Projeto Nacional de Educação (PNE). O ensino a distância ainda se mostra uma utopia para um país que sofre com as desigualdades, com o analfabetismo e com o abandono escolar.']",160,160,160,200,160,840
54,A importância das vacinas,"['Conhecida como a Revolta das Vacinas, o movimento a favor da vacinação em massa da população brasileira em 1904, liderada pelo então pesquisador Oswaldo cruz, oportunizou a imunização contra a varíola, doença epidêmica no Rio de Janeiro. Todavia, obstante a recusa contra a obrigatoriedade e descrença da sociedade pelos benefícios do procedimento, instaurou-se o manifesto que posteriormente culminou com a suspensão da obrigatoriedade.', 'Hoje, é notória a relevância das campanhas de vacinação que inclusive vieram a erradicar várias doenças no Brasil, como por exemplo a Poliomielite em 1979. Mas porquê tem diminuído a porcentagem de cobertura vacinal?', 'Em meados de 2018, fakenews divulgaram falsas pesquisas que indicavam que o autismo, doença de causa idiopática, poderia provavelmente ser decorrente de imunobiológicos. Isso fez com que pais deixassem de vacinar seus filhos, gerando uma quebra do círculo de proteção somado ao desafio atual de abarcar os grandes deslocamentos humanos como o êxodo venezuelano, que trouxe consigo o sarampo – doença controlada no Brasil.', 'Portanto, entende-se que o primeiro passo é desacreditar as fakenews através de campanhas em veículos de comunicação em massa, dirigidas pelo Ministério da Saúde. Posteriormente, faz-se necessário, através dos agentes de saúde acompanhados de profissionais de enfermagem dos centros de saúde regionais, visitarem os lares, principalmente os com baixo índice de desenvolvimento humano, para orientação e aplicação de vacinas. É válido também desenvolver e distribuir cartilhas, junto as secretarias de educação dos Estados, favorecendo a prática da imunização.', 'Enfim, proporcionar o alcance a vacinação e intensificar as propostas de prevenção. Pois, segundo Sócrates, filósofo, “existe apenas um bem, o saber, e apenas um mal, a ignorância”.']",120,160,80,120,80,560
56,Negligência governamental a respeito dos presídios brasileiros,"['Não é novidade que a situação carcerária do Brasil é de calamidade pública; são prisões precárias e superlotadas, o que resulta em revoltas, fugas e até mesmo processos judiciais, que acabam soltando detentos com a justificativa de violação dos direitos humanos.', 'De acordo com a ONG Human Rights Watch, o país em 2018 possuía mais de 840 mil presos, sendo que o sistema carcerário nacional detém menos de 400 mil vagas disponíveis. Dentre os principais motivos que corroboram para a problemática está a deficiência do ensino, bem como a desigualdade social e o preconceito.', 'Todavia esta circunstância pode ser revertida, como é o caso do estado de Santa Catarina, que promove a reabilitação do recluso. Com o auxílio de empresas instaladas dentro de penitenciárias, os condenados trabalham e, em troca, recebem um salrio juntamente com a diminuição da pena. Através desta iniciativa,  os reclusos dificilmente voltam à vida do crime e, consequentemente, ainda aprendem uma profissão.', 'Diante da condição apresentada, o Estado deve intervir por meio de investimentos nas penitenciárias, como também construir mais presídios, a fim de evitar a superlotação. Ademais, podem-se criar iniciativas de contratação de ex-presidiários para trabalharem e contribuírem com a sociedade, inclusive promovendo palestras e propagandas para que a comunidade ajude na reeducação dos prisioneiros.']",120,120,80,120,80,520
8,A ciência pode ser questionada?,"['A ciência ciência, que é o paradigma na produção do conhecimento da era moderna Era moderna, está sendo continuamente questionada por grupo de pessoas nas redes sociais, sendo este esse fenômeno denominado de pós verdade pós-verdade, conforme se explicará a seguir.', 'Primeiramente, é salutar importante demonstrar que que, ao longo da história História, nem sempre a ciência era foi o paradigma de produção de conhecimento. Este lugar Essa posição era ocupado pela religião, que manipulava seus interesses sociais e políticos através de seus dogmas. A ciência assumiu o paradigma da produção de conhecimento por adotar um método de estudo, testes e observação, e por defender que estava livre de ideologias.', 'No entanto, a filosofia e as ciências humanas demonstraram que a ciência pode ser utilizada para defender ideologias e interesses políticos e econômicos, tal como ocorreu no século XIX, com a teoria evolucionista evolucionista, de cunho racista, assim como ocorre, atualmente, com o uso indiscriminado de cirurgias estéticas e remédios antidepressivos, em benefício do lucro das indústrias farmacêuticas e da comunidade médica.', 'Nesse sentido, é importante a existência de pessoas que questionem os argumentos científicos, a fim de promover a evolução da sociedade e bem estar bem-estar social. A ciência fez isso outrora, quando Galileu provou matematicamente que a terra Terra não era plana, ocasionando uma revolução em toda forma de pensar e estudar o mundo.', 'Porém, os movimentos de pós verdade pós-verdade também podem ocasionar consequências negativas para sociedade. Para evitar isso isso, os movimentos devem ser feito feitos com responsabilidade, apontando evidências concretas e se possível que suas premissas sejam testadas pelo método científico. Caso contrário, pode ocasionar sérios danos, a exemplo do movimento dos movimentos antivacinas, no quais as pessoas não vacinadas colocam em risco a vida de outras pessoas.', 'Por fim, se defende é possível defender o direito de liberdade de questionar as verdades científicas, se isto for feito com responsabilidade e com o intuito de promover a evolução e bem estar o progresso e o bem-estar social. Afinal de contas, a sociedade humana está em constante evolução pelo desejo do de o homem descobrir coisas novas e questionar o que está posto.']",160,200,160,200,160,880
17,Patrimônios destruídos pelo governo,"['Quando falamos em cultura cultura, logo pensamos em museus ou teatros, é o que mantém nossa história viva, que fazem lembrar-se da extrema importância de seus acontecimentos pelo país, e país e, quando algo destrói esses monumentos, parte do país se decepciona, por lembrar da alegria que trazia as às pessoas saberem que nossa história estava viva de certo modo. E o motivo é o governo, por investir em outros projetos ao invés de focar na cultura do país.', 'A história do país deveria ser uma das coisas com a qual o governo mais deveria se importar, pelo motivo de sempre deixar as pessoas mais informadas e lembradas, porém isso não existe, eles preferem investir em estádios ao invés de manter histórias de décadas viva. Como o museu nacional Museu Nacional, com seus milhões de visitantes anualmente, e nem isso foi um motivo para o governo dar a atenção necessária, é como se tudo isso fosse uma brincadeira para eles, e acabam deixando de lado algo revolucionário.', 'Agora com o inicio início das reformas do museu, não só do nacional como outros destruídos também por incêndios, o governo deveria pensar em investir nos patrimônios culturais, como os próprios viram como isso abalou os brasileiros, e os mesmos pedem que eles sejam cuidados e preservados, e isso só pode acontecer com a colaboração, principalmente daqueles que estão acima de nós, começando pela parte da valorização e terminando com a ajuda que ela precisa.']",0,0,0,0,0,0
59,,"['A grilagem foi amplamente utilizada por proprietários de grandes terras no Brasil.A concentração de terras pelos latifundiários é um dos grandes agravadores da fome e da desigualdade social no Brasil, especialmente no campo, pois restringe o acesso terra- para pequenos produtores - e a alimentos com preços acessíveis. A fome pode ser combatida através de mobilizações de âmbito federal, municipal e comunitário.', 'Segundo o senso de 2006, o mais recente, os latifundiários representam 0,91% do total de proprietários rurais e concentram 45% de todas as terras cultiváveis brasileiras. Tal fato expressa uma ampla desigualdade no meio agrário, que dificulta o acesso e o mantimento de terras para pequenos produtores que vivem e alimentam suas famílias do que provem da terra . Entretanto é possível amenizar tal disparidade por meio da distribuição de terras obsoletas, confiscadas e distribuídas pelo ministério da agricultura, para famílias que vivem em regiões de extrema pobreza, sendo essas terras um lugar onde possam viver e produzir seu próprio alimento.', 'Os latifúndios afetam também muito o acesso a comida no meio urbano, pois, produzem, quase que, apenas para a exportação de alimentos que servem como matéria-prima para a produção de outros alimentos, como a soja, e ao manda-los para o exterior, onde são industrializados retornam ao pais superfaturados, ou seja, o preço aumenta e fica de difícil acesso as pessoas de baixa renda que acabam por passar fome, que no meio urbano pode ser reduzida por meio da criação de hortas comunitárias, onde caberia as prefeituras cederem os espaços e as hortaliças, já a comunidade caberia mobilizar-se para planejar e fazer a horta, além de mante-las, visando o consumo próprio e não mercantil.']",120,120,80,120,80,520
107,(Sem título 007),"['Esse problema                já vem acontecendo         á         algum tempo, sendo que                 muitos deles                nem são divulgados. Mas o pouco que se divulga nos deixa ainda mas preocupados com as crianças e         dolesente         da nossa sociedade.', 'Quando vejo alguns                 desses relatos                sinto que cada vez mas a sociedade         esta         contribuindo para o aumento da criminalidade infantil.', 'È         os pais que         muitas das vezes         não educam                 seus filhos                de forma adequada, sem violência, dando o direito         a         educação, saúde e o principal de tudo amor e carinho . Portanto         muitas das vezes         agridem sem causa ou razão fazendo com que                 essa criança                se revolte e acabe sendo tão violento ao ponto de destruir sua vida ou até mesmo o seu próximo. Quando                 esses menores                agem com tanta violência muita das vezes é tentando chamar         a tenção         dos seus familiares e até mesmo da sociedade para o que         esta         acontecendo com eles         pra         de alguma forma isso venha mudar.', 'No nosso         pais         algumas das leis contribuem com esses fatos, por deixarem que esses menores saiam impunes de seus delitos. Se esse menores fossem rigorosamente punidos tendo que estudar, prestar serviços         a         sua comunidade e o governo         dar mas          estrutura familiar                muita coisa ia melhorar.', 'Infelizmente os nossos políticos não fazem nada para pelo menos melhorar a situação desses         menores, se         eles investissem         mas         educação,                 estrutura familiar                , combate         as         drogas muita coisa ia melhorar não só para esses menores mas também para nossa sociedade.', 'Se isso mudasse a história de vida de muitos menores ia mudar         também, nós a sociedade desse país que muitas das vezes         contribuímos para esse fatos devemos mudar alguns de nossos conceitos e tentarmos fazer de nosso menores adultos         mas         preparados para lidar com seus filhos, com as adversidades, com os conflitos da vida                 tentando não refletir neles o que foram no passado.']",120,120,120,80,80,520
68,,"['A noção da palavra patrimônio é diversificada para cada pessoa, mas a importância que ela tem é inegável a sociedade.', 'O Patrimônio histórico é rico em conhecimento e história , buscando mostrar cientificamente o que ocorreu ao longo dos anos.', 'Para poder passar de geração pra geração deve ser valorizado e preservado para que todos desfrutem desse bem material da nossa cultura.', 'Entretanto, para que isso ocorra precisa -se da colaboração de todo um povo para que permaneça nossa identidade cultural .']",120,40,40,40,0,240
146,Medidas enérgicas,"['Em pleno século XXI, infelizmente, ainda presenciamos atitudes impregnadas de racismo que nos fazem lembrar de episódios da história da humanidade          como: a          escravidão, o          Apartayd          , e até mesmo o Nazismo de Hitler.                  Não é de surpreender o fato de que ainda existem pessoas          que, julgam          e discriminam outros de sua própria espécie simplesmente pela cor de sua pele.', 'O racismo não pode e não deve ser         ignorado, assim         como o jogador Daniel Alves respondeu a agressão comendo a banana jogada em campo por um torcedor do time adversário, a sociedade também deve dar uma resposta         a         altura desses agressores.', 'As pessoas de pele negra não são inferiores         as         de pele branca, pelo contrário, elas são tão capazes quanto. E isso podemos contatar com as histórias de vida de Joaquim Barbosa, Pelé e vários outros ilustres que gravaram seus nomes na história.', 'De acordo com a Constituição Federal do Brasil de 1988, o racismo é crime. Seu artigo 5º (quinto) prevê que todo cidadão é igual perante a lei, em direitos e deveres, independente de cor, sexo ou religião.', 'É preciso que nossas autoridades tomem atitudes enérgicas em relação a comportamentos racistas. As penas relacionadas ao crime de racismo devem ser mais severas, de forma         que as mesmas punam         com mais rigor os transgressores e         sirvam de caráter pedagógico         aos demais da sociedade.']",160,160,160,120,120,720
52,"Gravidez precoce, um problema estrutural","['Segundo o psicoterapeuta Ivan Capellato “o autoconhecimento juvenil adequa o indivíduo aos diversos impasses da vida, mas a informação é imprescindível”. Partindo dessa premissa, debater sobre gravidez precoce é enfatizar temáticas como: relação familiar, base educacional e, acima de tudo, discussão sociocultural. Posto isto, a problematização no que tange famílias desestruturadas pode influenciar esse cenário negativo e a falta de informação adequada , seja pela evasão escolar ou ensino “capenga” torna a situação agravante.', 'Diante disso, o tema gravidez na adolescência é ficcionado no seriado Sex Education no qual o enredo mostra a importância do diálogo entre pais e filhos. No entanto, a realidade nem sempre é assim, muitos jovens não conversam com seus progenitores, seja pela ausência deles devido o trabalho, seja pelo medo ou acanhamento em abordar assuntos íntimos . Logo, tal resistência é oriundo da cultura matriarcal cuja mulher foi ensinada a não inferir certos assuntos e, consequentemente, a atualidade absorveu e construiu esses percalços familiares. Além disso, a cenário brasileiro piora quando famílias desestruturadas pela violência doméstica e drogas resistem e perpetuam-se todos os anos.', 'Por conseguinte, a informação é crucial para engendrar autoconhecimento do corpo, da sociedade e dos impasses diante da vida. Mas,  uma parcela considerável do público infantojuvenil não detém essas oportunidades e, tampouco, vivem em um país referência em educação. Para tanto, mediante os dados da Pesquisa Nacional por Amostra de Domicílios – PNAD – mais da metade dos adolescentes que estudaram em escolas públicas não tiveram educação sexual pertinente, fora os altos índices de evasão os quais colaboram no défice dessas informações essenciais na formação do cidadão. Portanto, a gravidez precoce é um problema estrutural e de alcance nacional e precisa de orientação qualitativa e participação conjuntural – familiar, docentes, direção escolar e força política dos representantes.', 'Com base nessas considerações, a preconização da gravidez é questão social. Então, soluções precisam fomentar melhorias. As entidades educacionais, por intermédio do Ministério da Educação , podem elaborar uma diretriz obrigatório na nova base curricular de ensino na qual inclua educação sexual com participação dos pais.  Essa proposta traria debates e diálogos entre alunos, pais e professores. Além disso, feiras educacionais seriam integradas para levar conhecimentos comunidade em geral. Assim, um país mais instruído diminuiria problemas de gravidez precoces.']",120,160,120,160,120,680
105,Valor da biografia,"['O confronto entre personagens e autores         esta         gerando uma grande         poêmica         na                 mídia                brasileira,         pois. os         autores estão invadindo a privacidade criando biografias de cantores,         musicos         e                 artistas de programas                e, além do mais, os biografados estão querendo porcentagens nos lucros das obras.', 'Autores e jornalistas estão cada vez mais avançando e                aprofundando em         vida         particulares de pessoas         famosas         criando                 até biografias através de filmes, teatros e blogs de notícias da infância até a velhice                . Tais atitudes contribuem para que a                 vida particular dos invadidos sejam expostas e publicamente aberta ao público                .', 'Além do mais, a maioria         do lucro         não está sendo direcionada corretamente, biagrafados estão em busca dos seus direitos que         é         uma porcentagem no dinheiro arrecadado com as vendas das obras e         publicações, com         isso, os autores vão pensar antes de repassar os detalhes da vida de cada         individo         .', 'Em virtude dos fatos mencionados,                 gera-se uma grande          repercusão          entre autores e famosos                . Entende-se que                 o direito         esta         sendo violado. Para         muda         essa         ação         o governo deve coibir esses atos,                 criando leis mais severas para priorizar o respeito e particularidade do atingido.']",80,80,80,80,80,400
91,,"['O livro a ""Sociedade do Espetáculo"" apresenta um meio termo sobre o negacionismo e as fake news, de não condizerem com a realidade, ele mostra que nem tudo que vemos perfeição, que existe defeitos por trás das câmeras, que tudo que você vê apesar de parecer real pode ser fake ou uma notícia falsa como a fake news.', 'Nota-se que em plena pandemia do Covid-19 apesar de tantas perdas, ainda sofremos com tais notícias, por muita das vezes enviadas pela mídia social o facebook, instagram entre outros meios de comunicação que estão sendo usados para compartilhar e divulgar essa notícia mentirosa.', 'Entretanto a negação da atual sintuação do mundo vem prejudicando cientificamente a sociedade, e os meios de comunicação vem servindo para dar visualizações para tantos sites e noticiários falsos para serem repassadas em aplicativos de grande audiência e ganharem dinheiro.', 'Contudo a falta de informações gera uma alta disseminação no meio social atual, pelas informações serem de tão facil acesso, a falta de perspectiva da vida gera cidadões que negam a realidade por sempre terem acreditado em um mundo tão fácil, criado pelo seu ensinamento na infância. gerando escapes e dificuldade de enfrentar a realidade.', 'Portanto medidas são necessárias para resolver o impasse. Por meio das escolas com a conscientização a sociedade deve apresentar palestras falando sobre o negacionismo e os ensinamentos por parte dos familiares a mostrar a realidade, e abrindo um material de explicação de como indentificar uma fake news pode acabar dimuindo a disseminação. ministério da educação deve apresentar mais propostas para os familiares de como apresentar tais sintuações no seu dia a dia. Objetivo e efeito na sociedade de diminuir o negacionismo que no caso a negação da realidade por parte da família e de saber indentificar as fake news gera uma alta ajuda em diversos fatores da sociedade.']",160,120,80,160,120,640
62,,"['Discurso de ódio se define como mensagens que promovem o ódio, incitam a discriminação, hostilidade e violência como justificativa a intolerância às diferenças sociais, de gênero, raça e religião.', 'De fato, desde a Segunda Guerra Mundial, a perseguição aos judeus caracterizava a disseminação do discurso do ódio. Assim como há um ano, as manifestações populares nas últimas eleições presidenciais evidenciaram a troca de xingamentos de caráter ofensivo e discursos rasos entre opositores e defensores de candidatos, com o agravante de que as manifestações de 2018, contaram com as redes sociais, de alcance e velocidades surpreendentes.', 'Promulgada em 1988, a Constituição Federal, cidadã, garantiu a igualdade dos indivíduos, exercendo sua proteção legal, e em 2012 novas leis reforçaram a luta contra ações de ódio e alteraram o Código Penal para tratar de crimes cibernéticos  afim de punir sua exteriorização e proteger os indivíduos que dela sejam alvo.', 'Evidencia-se, portanto, que o direito à liberdade de expressão não é absoluto.', 'Portanto, medidas são necessárias para resolver essa questão. Ações educativas dentro das escolas para conscientização e redução da intolerância entre os internautas; incentivo ao acompanhamento conjunto de família e escola para propiciar um debate e a expressão dos sentimentos; divulgação de informações sobre internet para que as pessoas entendam a falsa impressão de anonimato; exclusão imediata, pelas empresas de redes sociais, de comentários ofensivos denunciados, sem que a justiça seja acionada, afim de agilizar o processo.', 'Enfim, dar voz a frase, sem autor definido, que diz: “a ofensa é virtual, mas a dor é real. ”']",120,120,80,120,80,520
71,Suicídio entre jovens,"['Automutilação; salto de prédios; uso de drogas . Os últimos anos vêm sendo marcados por jovens que atentam contra a própria vida, a ponto de o número de incidências dessa natureza se tornar tamanho que, segundo a Organização Mundial da Saúde , já é a segunda maior causa de morte de adolescentes no planeta. Os motivos que os levam ao suicídio, por sua vez, são diversos, mas é estimado que o elevado sofrimento é um fato pertinente a isso. Nesse intuito, ao se observar as causas desse sofrimento, muitas dessas estão relacionadas à excessiva pressão social sobre tais indivíduos, os quais têm buscado o atentado contra a própria vida como fuga de seus desafios.', 'Hoje, observa-se que a sociedade impõe inúmeras exigências aos jovens, tais como a aprovação no vestibular de uma universidade renomada, o não uso de inúmeros produtos e serviços destinados aos juvenis, ou até mesmo atribuição de responsabilidades não condizentes com essa fase da vida, obrigando-os a um verdadeiro salto da infância à vida adulta. Dessa forma, muitos jovens, por não conseguirem atender às “suas obrigações”, frustram-se e julgam-se inúteis ao meio em que vivem, sofrendo, posteriormente, com problemas depressivos. Seus responsáveis, ainda, são despreparados em tais ocasiões, na maioria das vezes, vendo-os apenas como seres preguiçosos ou “cheios de frescura” .', 'Ademais, muitos jovens também são julgados por suas escolhas divergirem de padrões estabelecidos como dignos/corretos no meio social, como se observa com estilo de vestuário, estilo de alimentação e a homossexualidade. Nos dois primeiros exemplos, os estilos de vestuário e de alimentação, muitos jovens sofrem bullying por optarem por vestimentas consideradas não sociais, como o dito estilo gótico, ou simplesmente por aderirem a uma alimentação mais saudável, como a vegana, sofrendo, conseguintemente, ataques preconceituosos. No terceiro e último exemplo, também o mais polêmico, a homossexualidade, é onde são observados inúmeros jovens depressivos, devido aos bombardeios preconceituosos provenientes desde familiares até de colegas de estudo/trabalho, depreciando-lhes a força mental e impulsionando-os ao suicídio, afinal a pressão psicológica se torna tamanha, além de raramente possuírem algum apoio amigo, que não enxergam outra solução.', 'Pode-se inferir, dessa forma, que a contínua pressão social/psicológica sobre os jovens tem elevado seu nível de sofrimento/depressão e, não raro, de suicídio. Isso é reflexo de uma barreira cultural insustentável nos dias atuais, a qual precisa ser derrubada, seja por meio de um maior diálogo entre jovens e seus responsáveis, seja pela maior preparação destes para lidar  com tais situações, seja, também, pelo estímulo ao respeito/compreensão com o próximo, a fim de impulsionar os indivíduos a valorizarem não só a própria vida, como também a daquele ao seu alcance.']",160,120,160,160,120,720
88,o estigma associados às doenças mentais no Brasil,"['As doenças mentais são constantemente associadas estigmas negativos na sociedade brasileira. Segundo dados da Organização Mundial da Saúde, em 2017, mais de 11,5 milhões de brasileiros possuíam depressão. Este fato evidencia a precariedade e a falta do atendimento médico disposto para a saúde mental, e, principalmente, ao preconceito atribuído pela própria população, que relaciona as doenças mentais ""frescuras"".', 'Com isso, torna-se evidente que, as doenças mentais são ignoradas pela população, resultando, eventualmente, em diversos impactos para a sociedade.', 'Além disso, deve-se realçar que a falta de condições financeiras, que impedem os indivíduos a buscar tratamentos especializados á doenças mentais, como a depressão, a ansiedade e entre outros transtornos que geram malefícios para a sociedade, como a reclusão social, o suicídio e comportamentos violentos.', 'Portanto, medidas são necessárias para resolver o impasse e exterminar os estigmas negativos associados as doenças mentais na sociedade brasileira. É essencial que haja a conscientização da população, ocorrendo campanhas e discussões nos ambientes familiares e escolares. Outro fator necessário, é a ampliação do acesso à atendimentos médicos de qualidade elaborados pelo Ministério da Saúde para toda a população brasileira.']",160,120,120,160,120,680
54,,"['O início do século XX foi marcado pela obrigatoriedade da vacinação em massa dos brasileiros, especialmente a população carioca . Por conseguinte, doenças como a poliomielite e a febre amarela foram erradicadas ainda no fim do século. Todavia com o advento das plataformas virtuais e as ""fake news"", campanhas antivacinação tornaram-se o gargalo dos programas de saúde no Brasil.', 'Ademais, é inegável que a insuficiência de estratégias estatais contribui com o problema. Visto que, a política nacional que garante a população o progresso em direitos sociais e econômicos não tem sido o suficiente, já que, o desabastecimento de vacinas essenciais nos postos de saúde e a falta de recursos municipais para a gestão de programas de vacinação,  influenciam a queda no número de imunizações no país. Somado a isso, o problema é agravado pelo sucateamento do SUS , bem como desvios, má gestão e centralização de recursos . Em decorrência disso, as doenças que haviam sido erradicadas no século XX são possibilitadas de tornarem-se recorrentes outra vez. Haja vista que o Brasil tem sido referência mundial na produção de vacinas, regidos por grande pesquisas na Fundação Osvaldo Cruz (FIOCRUZ), a não imunização representa retrocesso e impossibilidade do governo de zelar pela saúde pública de sua nação.', 'Portanto é fundamental eliminar os problemas na implementação da imunização dos brasileiros. Em suma, os Ministérios da Educação e da Saúde devem criar matérias desmitificando algumas crenças e medos por meio de campanhas com o objetivo de elucidar alguns pontos e dúvidas sobre a vacinação, garantindo assim o bem a todos. Além disso, à sociedade brasileira de imunização pode buscar evidenciar os riscos e as principais doenças, através de campanhas de publicidade, a fim de mostrar a importância de se prevenir, e consequentemente combater o tal desinteresse da população em relação ao tema . A partir dessas ações garantir o bem-estar dos brasileiros.']",120,160,80,120,80,560
80,,"['Algumas pessoas possuem dificuldade de conviver com as diferenças e com os diferentes. Agem de maneira discriminatória e ofensiva contra aqueles que julgam inferiores. No Brasil o racismo baseado na cor da pele é uma herança ruim que deve ser combatida.', 'Desde os tempos de colônia os negros foram considerados inferiores capturados em tribos africanas  eram vendidos e forçados ao trabalho escravo nas lavouras de cana e depois de café em solo brasileiro. Mesmo após anos de abolição  o que vemos são menores salários, menor escolaridade e maior criminalidade entre os representantes desta  etnia.', 'É lamentável que em pleno século XXI ainda tenhamos casos de jogadores de futebol, jornalistas, cantoras e até filhas de atores sendo alvo de injúria racial. Precisamos ter cuidado para não cometermos erros do passado de outras sociedades  como o “apartheid” sul africano  ou o nazismo alemão.', 'A sociedade precisa debater este  assunto exaustivamente, pois o preconceito velado é mais difícil de ser eliminado. A vida moderna prevê competição que só será justa se os envolvidos tiverem as mesmas oportunidades, a mesma condição. As autoridades devem punir os intolerantes, pois o convívio em harmonia depende do respeito às diferenças.']",120,120,120,120,120,600
56,A hodierna precariedade carcerária.,"['Segundo a concepção determinista, que se deu início no século XIX, o homem é fruto de seu meio. Ou seja, suas ações são determinadas por acontecimentos anteriores. No entanto, pelas suas condutas e crimes cometidos, os prisioneiros(as) são tratados de forma desumana e opressora dentro das celas, vivendo sem boas condições oferecidas pelo governo e apresentando um mal convívio no âmbito carcerário. Desse modo, é indispensável que sejam encontrados subterfúgios a fim de findar este quadro, visando melhoria ao sistema prisional brasileiro.', 'Em primeira instância, vale salientar a má infraestrutura dentro dos presídios brasileiros. De acordo com o Ministério da Justiça, o Brasil teve um aumento de 267% na população carcerária nos últimos quatorze anos. Percebe-se assim, a superlotação nas celas e a falta de recursos à saúde do indivíduo. Em diversos aspectos pode-se perceber que a maneira em que são tratados socialmente são totalmente insensíveis. Dentro outros problemas relacionados à infraestrutura e ao convívio social está a falta de água potável, o não tratamento especial à mulher e a ausência de boa alimentação.', 'Ademais, faz-se mister ainda,  relacionar as causas das prisões e julgamentos realizados pelo Ministério Público. Em um documentário “Justiça” de Maria Ramos (2004), é retratado diversos acontecimentos em relação ao processo de admissão a uma penitenciária. Pode-se, portanto, perceber a grande quantidade de detentos que cometeram roubo, furto e fizeram uso de drogas, realizando também tráfico em comunidades do Rio de Janeiro. E durante suas jornadas no cárcere,  são tratados como iguais mesmo se houver um entre eles que seja inocente. Sobretudo, são vistos e tratados de forma horrenda, sem pena e compreensão das autoridades.', 'Portanto, faz-se necessário a atuação do Governo Federal para que sejam feitas reivindicações e sejam tomadas providências a fim de melhorar a infraestrutura. Através de investimentos em maiores construções de cadeias, tratando este assunto como prioridade. E também, que sejam elaboradas formas de extensão aos presídios já existentes através de palestras e reuniões como forma de organização e planejamento para um benigno sistema carcerário. Assim, findaríamos as torturas e opressões dentro das cadeias, formando um excelente e agradável convívio social de forma humana.']",120,160,160,160,120,720
54,A Prevenção que Caiu no Esquecimento,"['As vacinas são o meio do homem de se proteger de doenças infecciosas e virais, contudo, o véu do esquecimento tem recaído sobre o mesmo levando-o a deixar de lado o extinto de prevenção. A escolha de não tomar as vacinas pode acarretar serias consequências, podendo levar indivíduos a óbito.', 'Segundo dados organizados pela OMS (Organização Mundial da Saúde), desde 2014 as vacinas contra sarampo e caxumba, por exemplo, tem caído demasiadamente no Brasil. Se esvaindo de 100% para 84%, o que é inaceitável . A população brasileira está tão acomodada em sua bolha de falsa segurança, que estão optando por não se precaver contra doenças, por assim dizer, fatais. Estão colocando suas próprias vidas em risco.', 'Ano passado, em 2018, até o início deste ano, 2019, o governo brasileiro se mobilizou contra a epidemia do sarampo que havia voltado com tudo, usufruindo de campanhas e movimentos, onde o intuito era vacinar o máximo de brasileiros possível. Foi disponibilizado vacinas gratuitas nas estações da CPTM do Estado de São Paulo. Porém, nem todos quiseram parar para tomar o antivírus.', 'Portanto, em virtude do que foi mencionado, a prevenção de doenças com o auxílio das vacinas tem sido posicionado o máximo possível na vida dos brasileiros, no entanto, a comodidade e a falta de censo preventivo é o que vem afetado essa área da saúde, fazendo com que os números caiam. A solução para tal problema, seria um enfoque mais intenso na prevenção. Fazendo mais mobilizações para que assim uma quantidade maior de indivíduos seja atingida.']",120,120,80,120,80,520
72,,"['É de conhecimento geral que as notícias são recursos de grande importância para a sociedade, logo mantém a humanidade atualizada, embora a meios de comunicações em que  divulgam noticias falsas no qual ocorre de forma intensa gerando impactos dentro da população , e acordo com o instituto de tecnologia de Massachusetts as chamadas fake news viralizam de maneira volumosa e mais fácil do que as noticias verídicas.', 'Por exemplo, em 2014 surgiu boatos em que ocorreria o fim do bolsa família na qual é um programa social cujo auxilia pessoas em situações de pobreza, em que a mídia dizia no qual foi estimulados por discursos de representantes do PT favorecendo os candidatos da oposição, porém foi apenas mais uma mentira dentre outras circulando em meios de comunicações.', 'Ainda convém lembrar , durante a segunda guerra mundial os alemães foram alvos de noticias falsas,  jornalista britânico Sefton Delmer administrou rádios e impressos que misturavam relatos reais com alegações mentirosas, como a de que soldados alemães estariam sendo injetados com sífilis pelas autoridades militares do País. Uma das estações dos rádios era apresentada por um homem que se passava por oficial usando a transmissão para criticar o regime nazista.', 'Por todos, esses aspectos é necessário que a sociedade se conscientize para não divulgarem noticias falsas  em redes sociais minimizando essa prática, programas devem ser criados para identificar noticias reais, sendo assim distinguindo o verdadeiro e o falso, abe ao governo criar leis severas para os indivíduos em que exercem esses atos.']",120,120,120,120,80,560
49,Os formadores de opinião na era digital,"['Com o desenvolvimento e popularização das mídias sociais, uma nova profissão surgiu: influenciadores digitais, que tm como principal ofício de vender e divulgar produtos ou ideias por meio do marketing, influenciando , desse modo, seus seguidores adquirirem o que está sendo vendido. Ademais estes ""influencers"", como também são chamados, agem como formadores de opinião, exercendo  um papel de grande responsabilidade ao expor seu ponto de vista para quem os acompanha, e, além disso, conseguem moldar comportamentos, aproximando-se de forma espontânea com o intuito de despertar o interesse do público.', 'Recentemente, a influenciadora Gabriela Pugliesi, que já havia se contaminado com o coronavírus foi duramente criticada ao descumprir o isolamento social recomendado pelos órgãos de saúde, demonstrando  incoerência em suas falas por ter defendido a necessidade da quarentena expondo , de tal modo, uma atitude irresponsável, influenciando de maneira negativa em meio ao caos da saúde pública, tal qual uma pandemia.', 'Devido à capacidade de influenciar quem os seguem, moldar comportamentos pode ser muito simples, especialmente quando há predominância do público infantojuvenil, que ainda estão em um processo de construção de caráter, podendo , desse modo, prejudicar os valores e visão de mundo do seu público.', 'Portanto, torna-se necessário que os pais e responsáveis estejam sempre cientes do conteúdo que seus filhos consomem, e através do diálogo, orientar sobre a existência da manipulação das mídias sociais, a fim de evitar o controle das noções e o consumo em massa , tal como dizem Adorno e Horkheimer sobre a indústria Cultural , que tem exatamente como objetivo o lucro e a manutenção do pensamento dominante . Dessa forma, será assegurado a construção dos ideais sem interferências que possam prejudicar']",160,160,120,160,120,720
55,Emancipação Indígena,"['Como caracteriza Gilberto Freyre  “Com a intrusão europeia desorganiza-se entre os indígenas da América a vida social e econômica”. É notório, como afirma o autor que o contato dos povos indígenas com os portugueses foi extremamente prejudicial para os primeiros. Assim, é necessário medidas a fim de promover a emancipação dos povos originários, incitando um diálogo entre a sociedade e o Poder Público.', 'Em primeiro plano, é pertinente elencar que a invasão e exploração do território brasileiro pelos portugueses se configuraram como elementos determinantes para as transformações em que a população indígena passa no decorrer de cinco séculos. Para corroborar com essa asserção, o período da colonização ressalta que a cultura e a tradição dos nativos,  foram menosprezadas em detrimento da supremacia portuguesa. Todavia ainda é nítido o subjulgamento dos índios, o que deve, pois, ser repudiado, a fim de promover a reafirmação dessa etnia.', 'Posteriormente, o direito dos nativos foi incorporado à carta magma do país. Nesse panorama, a FUNAI é o órgão responsável por promover e proteger o direito desses povos sobre o território nacional. De acordo com o artigo 6º da lei 6001/73, que preserva a jurisdição dos índios  “serão respeitados os usos, costumes e tradições das comunidades indígenas”. Contudo, apesar de terem seus direitos previstos em lei, ainda é perceptível o pensamento evolucionista de integrar os nativos ao modo de vida capitalista. Assim, esse cenário urge para ações efetivas com o intuito de propiciar a emancipação dessa parcela da população.', 'Fica evidente, portanto que estratégias profiláticas entre a sociedade e o Poder Público são imprescindíveis para a manutenção dos direitos indígenas. Cabe aos cidadãos se conscientizarem da importância dos nativos para a constituição do país, por meio de debates nas instituições formadoras de opinião e nos veículos de comunicação em massa. Ao Ministério Público compete promover ações jurídicas pertinentes contra atitudes contrárias a legislação em prol dos indígenas, a fim de assegurar o direito desses. Em suma, essas intervenções conjuntas possibilitarão alcançar o Estado Democrático de Direito.']",120,160,120,120,120,640
140,A cascata econômica mundial,"['A crise econômica europeia foi originada         da         imprudência política-administrativa de países europeus como a Grécia, que gastavam mais do que arrecadavam, criando um déficit público. Esta crise com certeza acarretará em más consequências mundiais na economia, por esta se encontrar no ápice de globalização.', 'O mau momento europeu, evidenciado pela desconfiança generalizada dos investidores, pode gerar uma queda nas importações da União europeia, afetando outras nações, que por sua vez também afetarão outras, criando uma espécie de efeito cascata.', 'Especificamente no Brasil, a economia tem os seus pilares nas commodities agrícolas e petrolíferas, que são exportadas para diversos países. Assim se houver queda das importações europeias, o país pode sofrer uma depressão econômica, alastrando o desemprego rapidamente.', 'Contudo                os países dependentes de exportações, incluindo o Brasil, podem amenizar o baque da crise financeira, aumentando e modernizando as indústrias brasileiras, como o petróleo que pode ser beneficiado e vendido refinado, ao invés de         vende-lo         bruto, agregando maior valor econômico.']",200,120,160,160,160,800
28,"Um por todos, todos por um","['Recentemente, o Brasil parou em manifestações, as quais expressam o desejo da sociedade em um país mais eficiente e menos corrupto.', 'Entretanto, esses movimentos vieram a se calar, dando isso,  ao fato que na maioria das vezes ocorrem violência generalizada, expondo a população em riscos constante .', 'As cenas lamentáveis que se presencia nas grandes maiorias das manifestações são de total repúdio. As quais são promovidas por vândalos. No entanto vale ressaltar que nem todos estão ali com o mesmo ideal.', 'Portanto, carros são incendiados, estabelecimento comerciais são furtados, pessoas são feridas. Contudo, a violência passa a ser o foco da manifestação. Com o ato de vandalismo, a polícia passar a repreender, muitas das vezes de forma abusiva e cruel, usando gás lacrimogêneo, spray de pimenta, etc, sujeitando a população a sofrer graves consequências.', 'Diante disso, espera-se que medidas sejam tomadas, que os vândalos sejam devidamente punidos, e que a Secretária de Segurança Pública, de acordo com seus preceitos reveja a forma correta de agir no patrulhamento das massas populares que necessitam se expressar em liberdade.']",120,80,80,80,80,440
46,Privatização do saneamento básico,"['Na idade média, o saneamento básico era precário e isso fazia com que a população ficasse sempre doente . Na atualidade, o serviço apresentou melhoras, no entanto, é carente nas regiões periféricas das grandes cidades. Nesse sentido, o governo brasileiro resolveu discutir sua privatização com a justificativa de melhoria da qualidade dos serviços e estimulo da economia após a pandemia de coronavírus. Entretanto, questiona-se se essa opção é de fato a melhor escolha.', 'Primeiramente, as empresas públicas universalizam o acesso ao saneamento básico, ao contrário do setor privado, que oferecem o serviço por meio da relação custo benefício. Nesse sentido, as periferias correm o risco de ficar sem esse acesso, pois são regiões habitadas por pessoas de baixa renda e que geralmente não conseguem pagar as contas de água e esgoto, e isso não gera lucro para a iniciativa privada . Além disso, a privatização encarece ainda mais o valor das taxas por causa da necessidade de investir nos encanamentos, em geral, antigos e com uma série de problemas.', 'Em segundo lugar, verifica-se que a privatização apresenta vantagens como a melhoria da qualidade do serviço tal qual a empresa de telefonia Telebrás e crescimento da produção, por meio do aumento do investimento estrangeiro e de impostos ao governo . Por outro lado, a busca incessante pelo lucro pode resultar em impactos ambienta e socioeconômicos, a exemplo do rompimento de barragem de mineração de Mariana, Minas Gerais, é operada pela empresa Vale, principal extratora e exportadora de ferro gusa. Além disso, o episódio também resultou na morte de 19 pessoas e na destruição das atividades econômicas dos residentes e que até hoje lutam na justiça pelos seus direitos.', 'Diante dos argumentos expostos, percebe-se a privatização apresenta problemas, se não for bem planejada para cada situação. Nesse sentido, infere-se que o Governo  deve, em vez de privatizar, realizar consórcios para auxiliar na manutenção e melhoria dos serviços de saneamento. Nesse caso, os contratos deverão conter cláusulas que estipulam contrapartida a fim de garantir serviço de qualidade para a sociedade. Além disso, também deverá criar órgãos reguladores para fiscalizar a execução da concessão e propor punições em caso de descumprimento. Com isso, espera-se garantir o bemestar da população através da menor incidência de doenças.']",160,200,160,200,160,880
55,,"['Consoante a Declaração Universal dos Direitos Humanos- ratificada pela Organização das Nações Unidas  em 1948- todos os indivíduos devem gozar dos mesmos direitos e liberdades independente de sua raça, cor, religião, entre outros. Todavia, ao analisar a questão indígena no Brasil, vê-se que esse direito encontra-se apenas no papel e não desejavelmente na prática, já que não é dada a devida importância da valorização e da garantia de direitos  minoria indígena, seja pela questão constitucional seja questão educacional. Nesse sentido, convém analisar os subterfúgios que impedem a problemática de ser resolvida.', 'Em primeira análise, é notório que a questão constitucional e sua aplicação estão entre as causas do impasse. Conforme o filósofo grego Aristóteles, a política deve ser efetuada através da justiça, com o fito de alcançar o equilíbrio na sociedade. Contudo, quando se observa o desdenho à garantia e reconhecimento dos direitos dos indígenas, percebe que a questão vai de encontro ao pensamento aristotélico, posto que mesmo com leis que dão garantias a esse grupo, sua aplicação irrisória impede que os indígenas consigam exercer de fato sua cidadania plena , o que configura em um desrespeito colossal a essa minoria, algo que urge ser transposto do tecido social brasileiro.', 'Outrossim, cabe salientar que a questão educacional impulsiona o problema. Segundo Nelson Mandela, a educação é a maior arma para mudar o mundo. Entretanto, ao observar a conjuntura brasileira, vê-se que a educação não está sendo usada como ferramenta para alterar a questão da valorização e garantia de direito dos índios, dado que ainda há dificuldades para fomentar o ensino das questões indígenas nas escolas, o que impossibilita um entendimento e debate amplo acerca da importância e proteção dos direitos desse grupo. Sendo assim, uma mudança nesse panorama é imprescindível para suplantar impasse.', 'É indubitável, portanto, que ainda há entraves que dificultam a resolução do problema, sendo necessário medidas para solucioná-los. Nessa perspectiva, é mister que o Ministério da Educação e Cultura amplie, nas escolas, projetos acerca da questão indígena através de palestras, debates e oficinas a fim de que se que  formem cidadãos que valorizem os nativos de seu país, compreendendo a importância da garantia dos direitos desses povos, e que, assim, possam exigir que os direitos dessa minoria sejam assegurados e aplicados para que esses povos possam exercer sua cidadania plena. Somente assim, a estrutura social brasileira se desprenderá do impasse, saindo da caverna proposta na alegoria de Platão.']",120,200,160,160,160,800
75,,"['No Brasil, o debate sobre o livre porte de armas de fogo voltou a ganhar notoriedade após a popularização do possível candidato a presidência em 2018, Jair Bolsonaro, que defende essa e outras ideias polêmicas. O bom cidadão precisa ter acesso às armas para defender-se ou isso seria um retrocesso?', 'Muitos são favoráveis a essa ideia e creem que seria um avanço para a sociedade brasileira, pois tal medida inibiria a ação de malfeitores. Acredita-se que seria uma solução para a violência principalmente contra as mulheres porque uma arma igualaria as forças entre agressores e vítimas. Segundo estatísticas nacionais, nos últimos sete anos os latrocínios aumentaram em mais de cinquenta por cento e qualquer medida que possa inibir isso seria bem-vinda.', 'Esse discurso porém é ingênuo e muito otimista visto que o cidadão de bem possivelmente não saberia manusear tal instrumento com a destreza dos maus cidadãos, podendo resultar em acidentes ou numa maior violência do bandido. Um exemplo disso é o país dos Estados Unidos que apesar da liberação do porte, ainda sofre muito com atendados e mortes por arma de fogo.', 'Diante disso, é possível perceber que querer a liberação de aramas de fogo é um ""grito"" de uma sociedade desesperada em meio a violência. Dessa forma, uma solução seria o Estado fiscalizar com maior rigor as fronteias do país para evitar que os marginais consigam munição e artilharia, assim a ação da polícia militar contra os transgressores da ordem seria muito mais eficaz e a violência diminuiria.']",120,120,120,120,120,600
24,Violência e drogas,"['Nos dias de hoje o tráfico de drogas vem aumentando drasticamente no Brasil, como mostra os dados levantados pelo jornal G1, da Rede Globo de Telecomunicações . Com a lei de drogas, percentual de presos que respondem pelo crime de tráfico de drogas aumentou de 8,7% para 32,6%. Mas afinal o que torna o tráfico de drogas um dos crimes mais rentáveis do país? Como o usuário participa desse crime organizado?', 'Primeiramente vale ressaltar que as leis impostas sobre o tráfico de drogas no país tornaram essa atividade um crime e ao mesmo tempo um meio lucrativo . A maioria dos jovens entre 20 a 29 anos com família de classe média buscam maneiras ou para conseguir dinheiro por meio de compra e venda de entorpecentes ou para o uso recreativo. As várias barreiras entre a procura e a compra de entorpecentes tornam o tráfico caro e ao mesmo tempo perigoso, incitando os usuários a conseguirem por meios ilícitos, as drogas.', 'Também é de importância destacar que o usuário de drogas se mostra apto a realizar o comércio da mesma para manter o ciclo de compra-uso-venda, podendo até mesmo recorrer a criminalidade como um caminho alternativo para seus objetivos com a droga.', 'Por fim, para que os problemas com as drogas sejam resolvidos é necessário o apelo populacional para que o governo estadual das regiões mais afetadas realize medidas para reduzir o número alarmante do tráfico de drogas que está relacionado com a intensa criminalidade por meio de leis e programas sociais visando a segurança populacional e o bem-estar.']",80,120,120,80,80,480
121,"Por trás do horário político ""gratuito"".","['Em ano de eleição é comum, além das obras de última hora, o contestado ""horário político gratuito"" exposto na televisão como forma dos candidatos apresentarem suas propostas de governo, na tentativa de induzir os votos dos         expectadores,         muitas vezes até com falsas promessas.', 'Esse recurso utilizado pelos          candidatos,          é                obrigatório, gratuito e garantido pela lei brasileira, para que         os próprios         sejam vistos e ouvidos pelos eleitores. Mas o quanto isso                 é                benéfico para a população? Um argumento utilizado                 é                a constatação de que                 é                necessário para o povo ter o conhecimento de todos os candidatos e suas respectivas propostas, para, assim, analisarem e definirem seus votos. Entretanto, o horário não é tão gratuito assim, as emissoras de televisão recebem uma boa quantia para reservarem esse horário aos candidatos, quantia         essa, que não saem         do dinheiro arrecado pelas campanhas políticas, mas sim dos cofres públicos.', 'Já não bastando a grande quantidade de desvio de verba pública, uma parte dessa verba é utilizada como pagamento a emissoras.                O horário político         de pouco         ajuda o eleitorado a escolher em quem votar, pois é preciso tempo para conhecer os candidatos e seus históricos políticos, portanto, não será uma apresentação de alguns minutos que influenciará o voto do eleitor. Além do mais, não são todos que têm tempo de assistir         a         programação e os que         tem         muitas vezes desligam a TV ou rádio, cansados de tanta bobagem, pois são muitos os políticos que levam suas propagandas na brincadeira.', 'Com as informações citadas é notório que o horário político gratuito não pode continuar como está, ele precisa ser extinguido ou ao menos ter grandes transformações,         transformações essas, como o seu pagamento, que deve ser efetuado         com dinheiro dos partidos políticos e não pelos cofres públicos,         outra forma de melhorar, é trocar         as apresentações de propostas por um debate, assim alguns políticos         levaram         o horário com mais seriedade, podendo         tornar um meio         muito mais informativo.']",120,160,120,120,160,680
48,SUS,"['O Sistema Único de Saúde (SUS) é um dos maiores e mais complexos sistemas de saúde pública do Brasil. Além disso, o SUS vem oferecendo serviços de qualidade para a população, um direito de todos os cidadãos, mas acontece que o sistema público foi deixado de lado e passou a gerar grandes desafios.', 'Sendo assim, o SUS garantiu o acesso universal, visando a promoção e prevenção da saúde. Como também vale ressaltar , a população brasileira reclama do mal atendimento do SUS, a demora em filas de hospitais, a espera pela marcação de exame ou até mesmo o atendimento precário dos profissionais de saúde. Com o programa mais médicos teve a chegada dos médicos cubanos no Brasil cujo objetivo é suprir a carência de médicos nos municípios do interior e nas periferias das grandes cidades do Brasil, dando a atenção necessária ao seu paciente.', 'Outrossim, o sistema de saúde brasileiro também fornece vacinas e remédios gratuitamente para pessoas com diversas doenças  (como diabetes, pressão alta, asma, HIV e Alzheimer), pois mesmo com grandes dificuldades tem em vista a melhoria e segurança de todos. Do mesmo modo, o SUS atualmente está passando por uma grande mudança diante a pandemia, sendo que diversas pessoas estão ficando sem fazer exames de rotina ou até mesmo deixando de seguir tratamento do câncer.', 'Em suma, mesmo diante aos desafios o SUS é de grande importância a população, atendendo desde a atenção primária até procedimentos mais complexos . Paulo Freire diz: “Se a educação sozinha não transforma a sociedade, sem ela tampouco a sociedade muda” então cabe a saúde pública investir na melhor qualidade de vida, dentre meios para uma boa alimentação, exercícios físicos incentivando a população a ter hábitos saudáveis  principalmente a população idosa, tendo em vista campanhas nas comunidades em PSF que traga informações para aqueles que pouco tem acesso ao meio digital, fazendo assim que todos tenha uma saúde estável.']",160,160,120,160,120,720
83,Saúde em primeiro lugar,"['Vive-se no Brasil um momento de esportes: “Olimpíadas do Rio de Janeiro 2016’, atletas de todos os países competem em busca de um único objetivo: conquistar uma medalha de ouro para seu país de origem. Mas e qual o “custo” desse objetivo? Vale a pena acabar com a saúde por uma medalha que lhe trará dores ao invés de felicidade?', 'O valor pago pode ser alto. Adulteração nos exames feitos antes dos jogos é o que mais acontece. Muitos atletas não aguentam as dores e acabam tomando hormônios para não decepcionar a delegação de seu país. Foi o que aconteceu com a delegação da Rússia, parte de seus atletas foram impossibilitados de participar das olímpiadas no Rio por burlarem os testes de doping. Com certeza, isso deve-se ao fato da pressão sofrida pelos seus técnicos, que buscam na “marra” ganhar medalhas e ser um colecionador de ouros e não de saúde dos atletas.', '“As pessoas veem o momento de Jogos Olímpicos só de ganhar a medalha, mas não sabem o que o atleta passa para conquistar essa medalha. O risco de doenças do trabalho pode inabilitar o profissional. Nós não entendemos que o atleta é um profissional como nós. É quase como se colocássemos no mundo do herói, o corpo quebra, a cabeça sofre com pressão. Eles vivem as mesmas emoções que nós, a dimensão humana do atleta é esquecida”, diz a Psicóloga do esporte Luciana Ângelo.', 'Com o grande acervo de informações apresentado, toma-se por conta que os treinadores devem ter mais compaixão com atletas buscando dar estímulo para vencer, mas dentro de certos limites médicos. Com a prática esportiva, aprende-se que a saúde é a atriz principal de todo o treino e também da apresentação, sem ela não há nada para ser feito. E como diria Ivan Teorilang “O Prêmio é a consequência lógica e natural da superação, quer seja ele em valores materiais ou não.”']",120,80,160,160,200,720
51,A carência de uma educação eficaz,"['Promulgada pela ONU , em 1948, à declaração universal dos direitos humanos garante a todos os indivíduos o direito à educação. Conquanto, o analfabetismo funcional mostra que,  nem todos desfrutam desse direito universal na prática. Diante da problemática, esses desafios devem ser superados para que uma sociedade integrada seja alcançada.', 'A educação é o fator principal do desenvolvimento de um país . Hodiernamente , ocupando a nona posição na economia mundial, seria racional acreditar que o país possui um sistema de ensino eficiente. Contudo, a realidade é justamente o oposto, o que é claramente refletido no índice de analfabetismo funcional do país. Segundo o IBGE (Instituto brasileiro de geografia e estatística) o Brasil possui pelo menos 11,3 milhões de pessoas com mais de 15 anos analfabetas. Diante dos fatos apresentados, torna-se clara a necessidade de combater esses dados a fim de promover um ensino mais eficaz à população.', 'Faz-se mister, ainda, salientar o desinteresse juvenil pelo ensino, acompanhado da falta de incentivo por parte da comunidade adulta como impulsionadora do problema . De acordo com o filósofo Paulo Freire ""se a educação sozinha não transforma a sociedade, sem ela tampouco a sociedade muda"" . Diante de tal contexto, é preciso que os jovens sejam conscientizados sobre a importância do ensino.', 'Infere-se, portanto, que ainda há entraves para garantir a solidificação de política que visem a construção de um mundo melhor. Dessa maneira é necessário que o MEC (ministério da educação) promova, por meio de verbas governamentais, campanhas destinadas à alfabetização de jovens e adultos que, por algum motivo, não frequentaram a escola e, também, palestras destinadas à combater o analfabetismo funcional para pais e filhos . Assim, o Brasil poderia combater o problema e garantir a população seu direito universal.']",160,160,120,160,120,720
92,A conduta xenofóbica perante a atualidade,"['Na telenovela “Malhação: viva a diferença”, é apresentada a personagem Tina, uma estudante de descendência asiática que sofre constantemente com estereótipos populares, devido sua etnia. Nesse sentido, é possível observar que a ficção se aproxima da realidade brasileira, visto que a sociedade persiste em propagar a ignorância e o desconhecimento em frente às diferentes etnias. Infere-se, portanto, que infelizmente a xenofobia contra pessoas amarelas ainda persiste na atualidade.', 'A priori, o ódio disseminado contra os asiáticos não são atual, mas se agravou exponencialmente após a pandemia do Covid-19. Entretanto, apesar da doença ter se disseminado na Europa e nos Estados Unidos, a imagem dos chineses continua sendo associada ao vírus. De acordo com o site Carta Capital, até o começo de abril de 2020, os Estados Unidos haviam registrado mais de 1.100 denúncias de racismo contra asiático-americanos. Segundo o site supracitado, as denúncias no Brasil mantem-se na média global.', 'Congruente à jornalista Flávia Gasi: “Não é o coronavírus que traz estigma a pessoas asiáticas, é nosso tratamento a elas que revela o estigma e o racismo que sempre tivemos. O coronavírus é só uma maneira débil e bizarra que usamos para tentar legitimar nossos preconceitos”. Assim, é possível compreender que a xenofobia e o preconceito contra os asiáticos sempre existiram, mas estavam velados. Ademais, apesar da Organização Mundial da Saúde (OMS) ter confirmado que o vírus não se originou na China, a sociedade expressa seu preconceito contra amarelos perversamente.', 'Portanto, medidas são necessárias para resolver o impasse. De modo democrático e congruente à constituição de 1988, o governo federal e o Instituto Sociocultural Brasil-China (Ibrachina) devem garantir que a Lei n° 7.716, responsável pela asseguração de direitos sobre vítimas de preconceito, seja cumprida, através de denúncias realizadas nas mídias sociais do Ibrachina  e nas delegacias. Outrossim, alternativamente, é necessário que as competências supracitadas divulguem, em escolas e meios de comunicação, a relevância da representatividade e que os asiáticos não são um vírus. Espera-se com essas medidas um Brasil respeitoso às diversidades e um país onde pessoas amarelas sintam-se acolhidas.']",160,160,160,200,200,880
49,O papel dos influenciadores digitais,"['No poema, Vou-me embora pra Pasárgada, de Manuel Bandeira, o escritor brasileiro idealiza um mundo perfeito onde tudo é possível se realizar. Saindo do contexto literário, identifica-se que, assim como a ideia do poema é retratada pelo autor, a ideia de uma vida perfeita é vendida pelos influenciadores digitais, através das redes sociais aos seguidores desses. Dessa forma, é necessário analisar acerca dos papeis exercidos por esses indivíduos na construção da sociedade.', 'É preciso compreender, inicialmente, que as redes sociais são hoje uma das formas mais eficazes de direcionar comportamentos para fins específicos. Isso porque, aqueles que divulgam os produtos e marcas, influenciadores digitais, são seguidos por milhares de internautas por meio dos canais digitais. Prova disso, foi uma campanha realizada por Mark Zuckermam, em 2015, através do facebook, para ajudar vítimas de um terremoto ocorrido no Nepal. Com essa ação, foram arrecadados cerca de 10 milhões de dólares em apenas dois dias. Incentivando , desta forma, um comportamento positivo replicado pelos seguidores através das redes.', 'Em um segundo momento, faz-se necessário analisar, criteriosamente, o teor das mensagens repassadas por esses indivíduos. Na última década, devido ao crescimento das redes sociais, muitos, até então desconhecidos, adquiriram status de celebridade, exercendo assim papel fundamental no comportamento dos que o seguem e o imitam, já que, se for negativo, tendem a ser repetidos provocando maus exemplos que causam danos à sociedade em que estão inseridos. Como exemplo, a atitude da influencer Gabriela Pugliesi, ao publicar fotos, na companhia de amigas, de uma festa particular, contrariando as recomendações da OMS no que se trata do isolamento social devido ao COVID – 19.', 'Dessa forma, cabe à escola, através das aulas ministradas, orientar os alunos a formarem pensamentos críticos ao que lhes é repassado, formando uma sociedade que utiliza a internet como sua aliada e não as tornando  vítimas. Ademais, a família deverá fiscalizar os jovens que estão sob sua responsabilidade no intuito de observar o que eles acompanham pelas redes sociais. Logo, será possível obter resultados mais efetivos no combate a ilusão da vida perfeita vendida pelos influenciadores digitais e idealizada pelo escritor do poema supracitado.']",160,160,160,160,160,800
92,A educação para o fim do preconceito amarelo,"['O preconceito de acordo com o dicionário  é o sentimento hostil, assumido em consequência da generalização apressada de uma experiência pessoal ou imposta pelo meio, intolerância. Logo, podemos entender que o preconceito amarelo está no fato da agressividade contra a etnia asiática. Além disso, com a pandemia do COVID19, que foi descoberta na cidade de Wuhan, na China, o preconceito amarelo aumentou, por causa do relacionamento do vírus com os países asiáticos. Todavia, o preconceito amarelo sempre existiu, podemos ver um exemplo disso no quadrinho brasileiro “Criança amarela”, pelo artista Monge Han, no qual relata a experiência de viver em um país onde a sua identidade e individualidade não é respeitada, com piadas e brincadeiras que tiram sua individualidade, o colocando como “mais um” asiático que está no país.', 'Em primeira análise, com a pandemia houve o aumento do preconceito, por consequência houve o aumento da discussão sobre o preconceito amarelo, de maneira que a extinção da individualidade nas piadas e brincadeiras com pessoas amarelas começou a ser criticada, dando espaço para falas amarelas e relatos de preconceitos, que a partir disso se tornou um movimento global o “#Iamnotavirus” e “#stopasianhate” que leva a importância da identidade amarela.', 'Em segunda análise, o preconceito é criado por uma fonte de desinformação e discurso de ódio, logo, só pode ser combatido por educação e informação, para que esse ciclo de preconceito se acabe. Entretanto, com a falta de interesse na educação do país e a falta de verbas para as escolas, podemos ver um aumento de crimes e preconceitos quando isso ocorre.', 'Portanto, cabe ao governo e às unidade escola, desenvolver a ética e o respeito na educação dos jovens para que não aceitem atitudes preconceituosas, por meio de campanhas de informação sobre o que é o preconceito amarelo e vários outros e educação de qualidade , com a finalidade de ter jovens e crianças éticos que respeitem, sem preconceito e discurso de ódio, para que assim a sociedade se torne mais saudável para todos os tipos de etnias e pessoas.']",160,160,120,200,160,800
120,A liberdade sem limite é errônea,"['No dia 7 do mês de janeiro,         um ato terrorista foi efetuado         na Redação do jornal Charlie Hebdo, em Paris. Terroristas islâmicos mataram doze pessoas e várias outras foram feridas.                 Justificaram-se                pelo fato de que o jornal satírico tinha como alvo frequente o profeta Maomé.                 No entanto,                levantou-se a polêmica sobre liberdade de         expressão. Quais são, ou mesmo se existem limites.', 'A liberdade         tem sim limite         . Cada um exerce suas atitudes da forma         a qual         desejar,         porém         a partir do momento                que a liberdade de expressão é usada         como         maneira prejudicial ao outro,         surge como efeito errôneo         .', 'Portanto         , existem as leis, para equilibrar, dar os devidos marcos da                 expressividade                . Se imaginarmos um mundo sem leis, poderíamos ver                 a zona                ; a liberdade geral faria com que não houvesse respeito mútuo.', 'No caso da ação terrorista sucedida, seria aceitável entrar em um consenso e expor uma denúncia ao Órgão de Defesa, fazendo o jornal retirar as charges sarcásticas. Assim, a liberdade teria vigor.', 'Logo, cabe a cada um a decidir o que faz, sem         acometer         ninguém. Certamente, o         livre arbítrio         está ligado ao bom senso.         Use-o e abuse-o!']",120,160,160,160,80,680
82,Por que ir ao médico?,"['O Brasil é um país que não prioriza muito a área da saúde, onde  a maioria da população é pobre e dependem  da saúde pública   que não é muito boa por falta de investimento da parte do governo, e isso acaba levando muitas pessoas a se automedicarem , por isso   é necessário combater a automedicação.', 'Uma pessoa doente pensa duas vezes antes de ir ao médico, pois sabe que   ao chegar lá   terá que enfrentar fila e ficar horas esperando para ser atendida,  agora se a pessoa tiver dinheiro   ela vai para o hospital particular, mas quem não tem condições financeiras se encontra em uma situação complicada.', 'Esse é um dos motivos que as pessoas usam para não irem ao médico e   por isso   acabam tomando remédios comprados pela internet no mercado negro,  como afirma a pesquisa do Jornal Nacional   72% dos brasileiros se automedicam e desses que se automedicam 40% pesquisam remédios na internet.', 'Portanto, é necessário conscientizar as pessoas para não se automedicarem , pois   quando tomam remédios sem prescrições médicas   elas não saberão se é o remédio certo para a doença em questão e também não terão certeza sobre seus efeitos colaterais e isso poderá leva-las à morte.']",120,80,80,120,120,520
55,,"['O filme de animação “Pocahontas”, da Walt Disney, retrata a vinda de estrangeiros para o continente americano no século XVI . Saindo da ficção, essa situação não tem sido diferente em nossa  sociedade hodierna , com uma exceção; os colonos são, agora, naturais do próprio país colonizado. Além disso, vê-se a falta de direitos e o não cumprimento das leis defensoras desses indivíduos, como as demarcações de terras. Dessa forma, é essencial que esses povos sejam valorizados para o bom funcionamento social.', 'Nessa conjuntura, sob a perspectiva filosófica de São Tomás de Aquino, todos os indivíduos de uma sociedade democrática possuem a mesma importância, além dos mesmos direitos e deveres. Entretanto, os direitos das comunidades indígenas não têm sido garantidos , embora formalizados, não são efetivados. Ademais, a rica cultura indígena é considerada patrimônio cultural imaterial, portanto, é imprescindível o abandono da perspectiva que entendia os índios como categoria social transitória, fadada ao desaparecimento. Ainda, é inegável o sofrimento dos indígenas para que suas ideologias perdurem, já que constantemente eles precisam conviver com outras culturas.', 'Outrossim, de acordo com a Constituição Cidadã de 1988, os direitos que os indígenas possuem sobre as terras que ocupam são de natureza originária, ou seja, anterior ao Estado. Por isso, é de extrema importância que a comunidade valorize esses povos, pois os mesmos  contribuem para o equilíbrio ecológico do país, visto que sua cultura trás como princípio a preservação do meio ambiente. Sendo assim, importantes para o retardamento do assolamento da natureza.', 'Destarte, é mister que medidas sejam tomadas para solucionar esse impasse. Logo, o Ministério Público, em parceria com o Poder Executivo, deve fazer valer as leis já existentes que preservam os direitos territoriais indígenas. Também, o Poder Legislativo deve formular leis de repreensão para os indivíduos que deturpam a isonomia conquistada por essa comunidade. Para mais, é vital que as ONGs , juntamente com a Fundação Nacional do Índio (FUNAI), promovam a mobilização social, por meio de palestras que mostrem as dificuldades da perpetuação dessa cultura para as próximas gerações sofridas por esse povo. Desse modo, com a diversidade de culturas, faz-se uma sociedade completa.']",120,160,120,120,120,640
55,Primeiros Povos,"['Antes da chegada dos europeus ao Brasil,  os povos indígenas já habitavam e cultivava as terras brasileiras, com a vinda dos portugueses em 1500 emergiu um grande luta pela igualdade entre indígenas e ``brancos``,  presente até hoje em nossa  sociedade.', 'Vale ressaltar os alimentos, os artesanatos e ervas medicinais presentes em nosso cotidiano são advindas do trabalho, do plantio e dos cuidados de tribos indígenas, as quais merecem reconhecimento e agradecimento pois além de contribuir para formação de nossa cultura a torna mais diversificada. Também são merecedores de destaque pela belíssima conservação do meio ambiente e notável influência do tupi guarani na língua portuguesa.', 'De acordo com o IBGE  801.156 pessoas são indígenas no Brasil e para ajudar no cumprimento da lei que assegura direito a esses indivíduos estabelecidos pela Constituição de 1988 foi criado a FUNAI (Fundação Nacional do Índio) que fiscaliza direitos  saúde, educação, terras e protege as tradições de sua cultura, mesmo assim atualmente esses povos não gozam de seus benefícios, principalmente de terras ocasionando reivindicações pacificas e não pacificas a qual resulta em morte de muitas pessoas.', 'Referente aos argumentos expostos deve-se intensificar o reconhecimento dessas tribos com palestras sobre sua história, seu cotidiano, seus costumes e desafios enfrentados no mundo contemporâneo, realizadas em escolas e universidades. Outra medida que poderia ser tomada seria a agilidade pelo Ministério da Justiça na posse de terras, dessa forma viabilizando melhores condições de vida e garantindo benefícios que são determinados por lei.']",120,120,120,120,80,560
118,Protestos justos acompanhados de vandalismo,"['Este ano podemos dizer que foi de muitos protestos como:          contra o governo          por          altos gastos com os preparativos da copa          2014,          professores exigindo          seu reajuste no piso salárial          e o mais chocante de todos que acompanhei foi          o de          uso de cães da raça beagle          para teste de laboratório, por sua vez revoltante          . Como um ser racional possui coragem de          compartilhar          atos ou          testes          como eles ousam dizer, com esses animais, que          por sua vez tem          sentimentos, dor e sofrimento, quando usados dessa maneira.                  Utilizam-os                como se fossem objetos sem         valor, não [valor. Não] é em vão         o         protesto gerado pelos ativistas         , onde                invadiram o Instituto Royal e libertaram os cães,         destinados         para novos lares e adoção, visando uma vida melhor para                 esses guerreiros sobreviventes                . Por outro lado houve a polêmica, pelo fato         de         junto aos ativistas, mascarados se         infiltraram         [infiltrarem] no meio do protesto gerando confusões,         dentre         não pensam no protesto como um meio de lutar pelo que         acha         certo e sim         para         cometerem atos de vandalismo.', 'Portanto         há pessoas lutando pela democracia e o melhor         para nós e para o próximo         , enquanto outros querem gerar confusão e danificar o patrimônio alheio e         público, por         isso deve haver uma                 segurança mais severa nos protestos, mas para isso ocorrer o governo deve apoiar aos policiais e assegurar aos mesmos que possam usar seus treinamentos para isso, assim podemos protestar sem medo de atos crueis                  como esses vistos.']",80,120,80,80,80,440
56,,"['Uma prisão, em teória, teria como objetivo privar de convívio social um indivíduo que cometeu um crime e apartir daí, promover a ressocialização dele. No entanto,a realidade das prisões brasileiras é muito diferente. Os presídios são lugares nos quais os detentos convivem em celas superlotadas e onde facções criminosas ainda comandam violentas rebeliões, como a que ocorreu no Estado de Manaus em maio 2019. Logo, é notório que precisamos refletir sobre maneiras de reverter a atual situação sistema carcerário brasileiro.', 'Em primeiro plano, é importante salientar que um grande fator que faz com que mudanças positivas não aconteçam no setor carcerário é a crença popular de que o delinquente não merece ter diretos. Assim, os brasileiros acabam deixando que os presidirios passem por situações desumanas, esquecendo de que eles também são gente e que por não terem acesso a medidas de ressocialização podem contribuir no futuro para o aumento da violência urbana no país.', 'Além disso, parte dessa culpa vem do setor político que trata a questão com descaso e só se pronuncia para lamentar situações trágicas depois que elas ocorrem como, por exemplo,as rebeliões. Dessa modo, de acordo com Michel Foucault, importante filósofo do século XX e estudioso do setor carcerário, o atual sistema não funciona, pois a prisão deveria transformar criminoso em um cidadão de bem oferecendo educação e o reinserindo na sociedade mas acaba piorando a questão da criminalidade.', 'Portanto, é preciso que haja uma mudança nesse sistema. Dessa forma,primeiramente,é nessesario que as mídias promovam debates em programas  tv, devido ao grande potencial que estes têm de influenciar as massas, sobre a questão dos diretos humanos e o real objetivo das prisões. Ademais,os governos estaduais devem promover a construção de novos presídios para solucionar a questão da super lotação. E ainda, promover a educação básica dos dententos juntamente com o ensino de filosofia ética,visto o poder transformador dessa disciplina, e cursos que ensinem atividades econômicas como, a título de exemplo, panificação e mecânica. É importante também, melhorar a segurança interna desses locais para proibir que a influência de facção penetrem seus muros, evitando motins. Dessa maneira, fazendo o sistema prisional ser na prática como é na teoria, um dia, talvez os presídios nem sejam mais tão necessarios neste país.']",120,160,120,160,120,680
81,Desafios para dissolver a intolerância,"['A intolerância religiosa é o exercício de uma agressão - verbal e/ou física - comandada por diferentes grupos. A prática da intolerância religiosa no Brasil é mais predominante contra os grupos de religião  de matriz-africana , e esse é um problema potencializado pelas falas de líderes religiosos.', 'O que comanda a intolerância religiosa são os diferentes tipos de pensamento, e o que a descreve são os valores inseridos nele . Dentre  diversas religiões, as que mais sofrem com a prática da intolerância religiosa no Brasil são as de matriz africana. Desde o período colonial, que os cristãos – católicos – tentam uma iniciativa de evangelização, e isso não foi diferente, por exemplo, no período da escravidão no Brasil, que os escravos eram impedidos de manifestar a sua religião, e por isso, foram  desde sempre, disciplinados a acreditar na fé católica: Se casando; não trabalhando no dia de domingo; e até mesmo, se batizando.', 'Sendo assim, a intolerância religiosa nada mais é do que a falta de informação sobre as diferentes religiões, e o preconceito é apenas um ingrediente intrínseco. Nem sempre quem pratica a intolerância religiosa está agindo sozinho,  muitas vezes essas ideias vêm de um grupo como um todo. Fieis  que escutam seus líderes religiosos falarem mal de outras religiões, constrói  – junto com ele - um pensamento repulsivo quanto a  diversidade de pensamentos.', 'Algumas vezes partem da fala para ações, como invadir terreiros; quebrar imagens sagradas,  e, até mesmo, expurgar possíveis demônios através  da oração a  força ou pela agressão física. Dessa forma, dentro de um templo religioso  é complicado estabelecer a diferença entre crítica e intolerância, visto que a crítica leva as pessoas a interpretarem mal os diferentes valores religiosos! Portanto, a raiz do problema é histórica,  e transmite um pensamento de dominação, muitas vezes caracterizada pelo preconceito e pela distinta posição religiosa. Independentemente de como a prática se origina, intolerância é intolerância, e o primeiro caminho para acabar com essa prática,  é promovendo o conhecimento sobre as diversas religiões, oferecendo um lugar na TV aberta,  e  ainda, estabelecendo um limite para as falas de líderes religiosos, principalmente para aqueles que atingem maior parte da população. A tolerância é o principal ingrediente para uma boa convivência!']",120,120,120,80,120,560
51,O por que do analfabetismo persistir,"['Analfabetismo são pessoas que conhece as letras, mas não sabe interpretar o texto. No Brasil os números são super altos, principalmente no Norte do país, as pessoas lá tem muitas desigualdade, pois tem escolas porém a distância é longa, alguns jovens caminham quilômetros, e outros estudantes desistem por conta da dificuldades.', 'A falta da interpretação textual também se dá por ensinos de baixa qualidades, infelizmente é um fato existente, professores não combram ou estimulam seus alunos a lerem mais livros e como irão detectar as dificuldades.', 'Crianças e adolescentes de 15 a 16 anos, abandonando os estudos, algumas tem complicação não só de interpretar os textos, mas de lerem e também tem aquelas que nem sabem.', 'Contudo, os planos do governo nesse sentindo é muitos benigno, mas deveriam ter mais fiscalização nas salas de aulas, direitos iguais a todos e dar condições de um ensino de qualidade aos estudantes.']",120,80,120,80,80,480
98,"Modernidade, um prejuízo à saúde","['Os jovens          da geração mais moderna          estão suscetíveis a qualquer novidade que se lança. Pode se citar a tecnologia, a moda, a música e a comida. Apesar de ser um item estranho de ser relacionado aos jovens,                a comida         afetou-lhes         negativamente. Isto pode ser percebido         nas matérias de reportagem         mostradas pela mídia. O que acontece é o fato de as crianças e os jovens adquirirem péssimo estado de saúde por conta de hábitos alimentares irregulares, como a frequência costumeria de se alimentar em lanchonetes de fast-food. Tal situação está se tornando cada vez mais preocupante.', 'As soluções mais viáveis para amenizar esse acontecimento         alarmante, seriam         a criação de mais programas educativos para informar aos pais e aos responsáveis pela alimentação das crianças e dos jovens, a modificação de ingredientes utilizados na fabricação de alimentos pelas lanchonetes de fast-food e a redução de propagandas de produtos alimentares, pois         este último         geralmente         atinge         em larga escala as crianças e os jovens. Dessa forma, percebe-se que são atitudes para amenizar a escandalosa situação que se encontram essas jovens vítimas, e não de erradicar os prazeres delas.', 'Portanto, é preciso de muito esforço por parte dos responsáveis da alimentação da população jovem, a fim de tornar a sociedade mais saudável e menos vulnerável.']",120,80,80,80,80,440
59,Fome de direitos,"['""A tontura da fome é pior do que a do álcool. A tontura do álcool nos impele a cantar. Mas a da fome nos faz tremer. Percebi que é horrível ter só ar dentro do estômago."" Esse trecho pertence ao livro ""Quarto de Despejo: Diário de uma Favelada"" — escrito por Carolina Maria de Jesus —, o qual aborda temas como a fome e a miséria, infelizmente ainda recorrentes na atualidade. Esse cenário é mantido no Brasil pela desigualdade social, pelo constante desperdício de alimentos e pela falta de conscientização e instrução da população.', 'Em primeira análise, pode-se citar o relatório ""O Estado da Segurança Alimentar e Nutrição no Mundo 2018"", elaborado pela FAO  — agência vinculada à ONU —, o qual revelou que 5,2 milhões de brasileiros passaram fome em 2017. Essa situação decorre não da falta de alimentos em si, mas sim da dificuldade de acesso a produtos de qualidade e baratos, além da grande quantidade de comida simplesmente jogada no lixo. Segundo uma pesquisa da Embrapa, em parceria com a FGV , 41,6 quilos de alimento são desperdiçados por pessoa a cada ano, no Brasil. Essa informação sugere que, mudando hábitos de consumo e atitudes, o que atualmente é descartado poderia servir para alimentar outros indivíduos, garantindo segurança e qualidade de vida a todos.', 'Em outra análise, destacam-se exemplos internacionais, entre os quais o da Alemanha. O país europeu, por meio do projeto ""Bom demais para o lixo"" — criado pelo Ministério da Alimentação e Agricultura —, promoveu em 2017 uma premiação, visando a reconhecer iniciativas inovadoras acerca de sustentabilidade no setor alimentício. Casos como o da Knödelkult, empresa que prepara tradicionais bolinhos alemães com pães que não foram vendidos nas padarias locais, comprovam que,com um pouco de criatividade, consegue-se reduzir o desperdício — o que é um grande passo rumo ao combate à fome.', 'Conclui-se, portanto, que essa é uma questão urgente no Brasil. Para que haja uma melhora nos atuais indicadores, é preciso — entre outras resoluções — que a sociedade incorpore atitudes simples, mas efetivas, no cotidiano — por exemplo, evitar compras por impulso, reaproveitar as sobras e apoiar ONGs  como a ""Amigos da Sopa"" em Florianópolis, que distribui alimento a pessoas em situação de rua. Assim, torna-se concebível um cenário no qual todos os brasileiros têm acesso à alimentação de qualidade, garantindo a concretização dos direitos presentes na Constituição.']",160,200,160,160,160,840
54,As vacinas e as fake news,"['As vacinas são essenciais na prevenção de diversas doenças, pois', 'estimulam a produção de anticorpos e células de memória, sendo,', 'portanto, imunização ativa. Entretanto, ao longo dos anos, surgiram', 'alguns pensamentos contrapostos a respeito desse assunto, visto', 'que resultou na volta de doenças já erradicadas no Brasil, como por', 'exemplo, o sarampo.', 'Em primeira análise, a vacinação iniciou no país no século XIX contra varíola, uma doença infecto-contagiosa; por meio dessa prevenção a enfermidade foi extinguida em 1980 pela Organização Mundial de Saúde (OMS). Nesse viés, de forma similar, observa-se a evolução', 'da medicina e a importância desse método na sociedade, não somente nos anos anteriores, mas atualmente,  no combate aos problemas', 'de saúde.', 'Sob outra perspectiva, em 1940  com o crescimento dessa mesma', 'enfermidade, no Rio de Janeiro, o governo brasileiro juntamente com', 'o médico sanitarista Oswaldo Cruz impuseram a Lei da Vacina Obrigatória; todavia, surgiu a Reforma contra o uso dela por causa de notícias falsas . De forma análoga, nos dias atuais, há movimento antivacina,', 'através de fake news; assim, absurdamente, muitas pessoas ficam sem', 'vacinar por medo de adquirir efeitos negativos e não atentam na ausência de comprovações científicas na informação recebida.', 'Assim sendo, cabe ao governo investir em campanhas provisórias nos', 'meios de comunicações até que obtenha-se redução nessa problemática . Realizadas por especialistas da área de saúde, com debates esclarecedores e incentivadores, a fim de que a população compreenda o real', 'propósito da vacina na saúde, como também tenha-se aumento de pessoas vacinadas no Brasil.']",120,160,80,120,40,520
89,Como Conscientizar a População acerca do Isolamento Social em meio a Crise Econômica?,"['O isolamento social vigorou,no Brasil ,durante a crise econômica,apresentando como uma única estratégia para evitar a proliferação do vírus. Tal isolamento,conhecido como ""Distanciamento Social"",embora obrigasse a população geral a obedecer a ordem, não obteve êxito na sociedade,haja vista aos que não usaram máscara e promoveram festas clandestinas. A A conscientização do isolamento social em meio a crise econômica é de grande diretriz,mas algo que exige do cidadão. É preciso empatia, para reconstruir a economia e a sociedade,reerguendo-se os comércios que permaneceram de portas fechadas em meio a crise.', 'Desde março de 2020, vive-se um cenário assustador ,envolvendo a pandemia do covid-19 e a crise econômica. Para amenizar a situação,foi criado o auxílio emergencial,que jaz será devolvido pelos cidadãos ao governo federal elação entre a Gripe Espanhola e o coronavírus, nos mostra que foram um dos piores cenários já vistos na história,como por exemplo,o fechamento de comércios e escolas,o cancelamento de eventos,e o aumento de mortalidade e superlotação nos hospitais. A conscientização em meio a crise econômica,acerca do isolamento, exige muito do emocional do trabalhador,pois muitos que fecharam as portas apresentaram sintomas de depressão.', 'O fechamento dos comércios afetou o PIB e o Dólar,como por exemplo,a falta de produção têxtil em grandes indústrias. Enxerga-se a falta de empatia nos governos estaduais,por esse motivo:manter estádios de futebol abertos com aglomerações de jogadores,e a venda de bebidas alcoólicas nos supermercados .A venda desse produto,em meio a pandemia,influenciou a realização de festas clandestinas,com pessoas aglomeradas e sem máscara. O dever do governo estadual,agora,é ressarcir cada comércio que fechou suas portas,assim,a economia volta a crescer,o PIB melhora,e os comerciantes voltam a trabalhar no seu setor de serviço.', 'Em Relação disso,podemos afirmar que,além da reconstrução econômica do Brasil,deve-se criar uma nova era digital,que possibilite o funcionamento do serviço em home-office. É preciso que as instituições governamentais, estruturem um novo paradigma e uma nova ferramenta, para gerar mais empregos e amenizar o déficit econômico.']",160,160,120,160,120,720
75,Sistema legal,"['Diante dos crescentes números da violência no Brasil chega-se à conclusão da incapacidade estatal no controle da criminalidade, iso se dá por questões históricas, geográficas e locais. Será, no entanto, formando instantaneamente um elo armado uma forma real de sanar esta problemática?', 'Têm-se por certo, do ponto de vista humanitário, que a campanha do desarmamento foi positiva e propiciou um novo período na história brasileira. Além diso, por dados obstantes, a liberação da posse de armas não está diretamente ligada a diminuição da violência, trata-se de uma questão mais jurídica; locais cujas leis para crimes são severas e o sistema legal trabalha em consonância com o “monopólio de violência legítima” apresentam números, em relação às infrações cometidas, menores; países em que a política desarmamentista é extremamente rígida, tais como: Escócia, Inglaterra, Noruega, e Dinamarca; mas que possuem um sistema jurídico vigoroso e incisivo, os números da violência são notavelmente reduzidos.', 'É deveras comum, por partes dos defensores da posse de armas, o exemplo da legislação estadunidense, desconsidera-se, contudo, os fatores históricos e culturais imanentes . A política norte americana não está associada intrinsecamente a diminuição da criminalidade, cabe salientar que o país ostenta a maior população carcerária do planeta , ligar a redução da criminalidade a posse de armas é um equívoco conceitual.', 'Nesa perspectiva, o determinante para a real diminuição dos números da violência está mais diretamente ligado ao aparato legal  bem como o sistema prisional; para tanto, leis advindas do poder legislativo com o objetivo de endurecer as normas legais e reformular a concepção prisional é uma forma realmente mais eficiente de lidar com a violência. Da óptica da política pública, a posse de armas no Brasil seria um inerente retrocesso.']",120,160,120,120,120,640
125,"Maconha, um mal irreversível","['Há tempos         vêm         se discutindo         sobre a         [a] legalização da maconha e manter a         proibição, seria         uma das melhores escolhas,                 já          que, não          acabaria com o tráfico de drogas e mais pessoas usariam a droga, consequentemente aumentaria os problemas de saúde.', 'É de se         notar, que         mesmo com a legalização da         maconha         o tráfico de drogas continuaria a                 ""todo vapor""                com outros tipos,         como por exemplo: a         cocaína, o crack, as drogas sintéticas e até mesmo a                maconha                 (traficantes continuariam vendendo com uma lucratividade menor)                .', 'Um evidente                 negativismo                da legalização da         droga, seria         um grande aumento no         numero         de seus usuários, já que teriam mais fácil acesso,                 vale também destacar que a droga traz um mal irreversível à saúde, nos pulmões e neurônios.', 'É notório que a legalização da droga não iria trazer benefícios à sociedade,                 é visto                que um problema de tal relevância seria         resolvida         com um tratamento mais adequado e com mais                 investimento na área da educação                ,         assim conscientizando         os jovens do mal que a droga traz.']",120,120,80,80,80,480
82,Automedicação é uma solução?,"['Quem nunca tomou um remédio sem prescrição para alivio de uma dor de cabeça? Quem nunca ouviu o conselho da sua mãe sobre um remédio que combate alguns sintomas e que não têm problema algum tomar? A automedicação,  muitas vezes vista como alívio imediato, no entanto, pode gerar consequências graves para a saúde.', 'O uso incorreto de um medicamento pode acarretar o agravamento de uma doença, tendo em vista, que este pode esconder determinados sintomas, como:  o uso indiscriminado de medicamentos à base de um analgésio-antitérmico como a dipirona pode abaixar os níveis de células de defesa encontrados no sangue.', 'Quanto o uso de antibióticos deve-se ter  muita cautela , pois estes são usados para o controle de infecções bacterianas, a dosagem, o periodo, deve-ser respeitado religiosamenta para que não venha ocorrer o desenvolvimentos de cepas bacterianas resistentes a antibióticos, desta forma, impossibilitando um tratamento eficaz.', 'Outro problema relacionado a automedicação é a famosa interação medicamentosa, ela pode interagir de três formas: um pode potencializar  a ação do outro,  pode ocorrer também a perda de efeitos por ações opostas ou ainda a ação de um medicamento alterando a absorção, transformação no organismo ou a excreção de outro fármaco']",40,40,80,40,80,280
63,Natureza vs. Extração de minério,"['Ao longo dos últimos anos, o Brasil, vem sofrendo uma grave falta de responsabilidade com o nosso meio ambiente. A prova disso são os rompimentos, cada vez mais frequentes, das barragens de rejeitos que causam inúmeros danos tanto a fauna e flora quanto aos seres humanos.', 'A segurança do meio ambiente não precisa ser tratada como inimiga da extração de minério. As empresas podem optar por uma maneira mais segura de se trabalhar, como a tecnologia de mineração a seco, que apesar de mais cara, evitaria desastres como os de Mariana e Brumadinho. Além de descartar os rejeitos de forma consciente e fazer projetos em prol do meio ambiente, como reflorestamentos e recuperação de rios poluídos.', 'A devastação na natureza é sempre imensa quando se trata de desastres envolvendo mineradoras, e normalmente continuara a causar danos por décadas e décadas. Nenhum cuidado é demais e nenhuma segurança a mais é muito cara.']",120,80,80,120,0,400
60,Deliberações incorretas comprometendo o futuro,"['A canção “Construção”, composta por um dos maiores nomes da música popular brasileira, Chico Buarque, aborda hipoteticamente a exploração laboral e interpela as mudanças nas relações e no trabalho nacional. Diante disso, é possível abordar uma estreita relação da obra musical com os supostos projetos de aperfeiçoamento no ramo trabalhista tal como a restauração Previdenciária, asserção governamental de Jair Bolsonaro. Logo, mediante situações de concordâncias e protestos, a presumida reforma pode resultar em objeções maiores, visto que o aumento do tempo mínimo de contribuição e o advento de óbices à aposentadoria são agruras ao colaborador.', 'Em consequência disso, afirma-se que a reforma trabalhista se torna um remédio amargo aos paladares lógicos . Os setores públicos e privados certamente, serão extremamente afetados, logo, que para a esfera transparente os homens se aposentarão cinco anos a mais e as mulheres sete, em relação aos princípios contemporâneos . Agora, em cenário privativo as normas são muitas, contudo, a partir do inicio do ano de 2020, os homens podem se aposentar aos 61 e as mulheres com 56, no entanto, o gênero feminino será acrescentado a cada ano a idade mínima de 6 meses até chegar aos 62 anos, em um determinado ano. Ainda assim, o estabelecimento de um tempo mínimo de contribuição de 20 anos laborais se torna algo fajuto.', 'Da mesma forma, outra preocupação frequente em respeito às transformações da previdência social, são os empecilhos para o acesso à aposentadoria, o aumento do período de contribuição e a redução nos valores, pode resultar em muitos problemas sociais, logo que a pobreza crescerá em larga escala, enquanto a saúde do indivíduo se degradará no seu processo de contribuição laboral.', 'Em virtude dos aspectos observados, a obra musical de Chico Buarque retratou o liar da exploração trabalhista por meio de mutações . Mediante o exposto, é necessário procurar caminhos para atenuar o problema de modificações drásticas no ramo laboral, e cabe aos âmbitos estatais, juntamente com o Ministério da Educação , elaborar palestras educativas políticas acerca das decisões governamentais, e a reflexão sobre os impactos que causam nos vereditos para “melhora” de uma minoria. Enquanto,  é papel da sociedade ligadamente com a mídia influenciar no processo de participação social, com suas opiniões e discordâncias, pois, uma deliberação incorreta pode comprometer o futuro de uma sociedade inteira.']",120,200,120,160,160,760
50,O esquecido incentivo à ciência brasileira.,"['Com a vinda da Princesa Maria Leopoldina para o Brasil foram trazidos em sua comitiva diversos cientistas, pintores e médicos . Como resultado, a Nação avançou em pesquisas científicas realizadas em todo o território. Contudo, atualmente, esse incentivo à ciência não é vivenciado. Nesse sentido, convém analisar as principais causas, consequências e possíveis soluções para esse impasse.', 'Primeiramente, o mundo inteiro enfrenta uma pandemia, denominada coronavírus (COVID-19). Com isso, foi necessário acionar pesquisadores em todo o planeta,  para buscar uma vacina ou remédio contra a doença. Entretanto, as universidades e institutos federais, que são polos dos estudos científicos brasileiros, sofrem com o contingenciamento de verbas . Logo, os especialistas possuem um fraco auxílio para trabalhar e desenvolver projetos.', 'Apesar de investir apenas 1,3% do seu PIB anual em pesquisas e desenvolvimento, ainda se faz ciência no país. De acordo com o site Hypeness, pesquisadoras do Instituto Adolfo Lutz da Universidade de São Paulo, foram capazes de sequenciar o genoma do novo coronavírus em 48 horas . Por conseguinte, é possível compreender como o vírus se modifica e como produzir uma vacina. Desse modo, a produção científica Nacional mostra quão importante é para a sociedade.', 'Portanto, é preciso apoiar a ciência no Brasil. Sendo assim, compete em uma ação conjunta ao Ministério da Economia (ME), Ministério da Ciência, Tecnologia e Comunicações (MCTIC) e ao Ministério da Educação (MEC), investirem uma parcela fixa do PIB, comparado com países desenvolvidos, em programas como Capes e CNPq . Outrossim, cabe ao governo federal incentivar empresas privadas e multinacionais apoiarem financeiramente estudos científicos nas universidades e institutos públicos,  em troca de incentivos fiscais . Assim, será colocado em prática os exemplos da valorização da ciência, pesquisa e estudos deixados pela Imperatriz Maria Leopoldina do Brasil.']",160,160,120,160,160,760
83,O poder do esporte,"['Desde a pré-história, o homem sempre precisou de habilidades para sobreviver, como, por exemplo, correr, nadar, saltar e lançar objetos à distância. No entanto, foram os gregos que desenvolveram o esporte através das guerras, visto que, perceberam d a importância e d a necessidade de preparar seus soldados, através de exercícios físicos, para contínuas e duradouras batalhas. Atualmente em nossa sociedade, a prática esportiva vem ganhando mais espaço, tendo em vista que, não é apenas um meio de formar cidadãos e de educação, como também uma forma para melhorar a saúde e qualidade de vida.', 'Através do esporte, pode-se aprender a prática da disciplina, da honra, da valorização, da coletividade, da superação, do respeito, que são uma das características essenciais para viver numa sociedade. Além disso, o esporte é uma excelente arma para transformar pessoas através da educação, garantindo uma ótima formação intelectual, profissional e social, possibilitando, dando oportunidade e base para que o indivíduo possa escolher ingressar em qualquer área.', 'Convém lembrar, ainda, que os benefícios da prática esportiva não são apenas estéticos, mas também em busca de uma maior qualidade de vida, pois possibilita melhores condições de saúde física e mental. Somado a isso, sua prática evita o sedentarismo, a obesidade, estimulando o indivíduo a se alimentar melhor; a depressão, que é o mal desse século; doenças crônicas, como, por exemplo, doenças cardiovasculares, diabetes, câncer; e até mesmo o envelhecimento precoce.', 'O governo, portanto, precisa cada vez mais investir no esporte, criando programas de capacitação para profissionais desta área, no intuito de oferecer um melhor aprendizado das pessoas interessadas, visando não apenas formá-las no caminho do esporte, mas também no da educação, para que se tornem cidadãos de conduta ilibada. Além disso, as instituições esportivas e seus patrocinadores devem utilizar atletas famosos para influenciar, de maneira educativa, as pessoas, através das propagandas na televisão e internet, para mostrar os benefícios de aprender algum esporte.']",120,160,200,160,200,840
60,OS DESAFIO DA REFORMA DA PREVIDÊNCIA NO BRASIL,"['Dados disponíveis na Relação Anual de Informações Sociais (Rais),o número de pessoas com 65 anos ou mais em vagas com carteira assinada aumentou,saindo de 484 mil em 2013 para 649,4 mil em 2017 .A reforma da previdência se faz necessária a partir do momento que temos  mais pessoas recendo do que contribuindo com a previdência social. Não há como negar que,mesmo com a elevação de vagas de carteira assinada para a terceira idade no país,não o suficiente para suprir sua população que vem envelhecendo rapidamente. E esse desgaste que traz novos desafios,problemas e oportunidades para os governos e sociedade.', 'De acordo com dados do (IBGE),Instituto Brasileiro de Geografia e Estatística, a expectativa de vida dos brasileiros vem aumentando ano a ano. A expectativa de vida ão nascer,em 2019,é de 80 anos para mulheres e 73 anos para os homens. Nesse contexto,podemos analisar a necessidade de uma reformulação no país ,adaptando-se a sua nova realidade. Em uma primeira análise, é preciso mudar ideia de que o Brasil um país de jovens,como já foi reconhecido. Ter mais anos de vida uma conquista ,mas também um desafio,uma vez que traz mudanças não só relacionada a previdência social,mas também, na organização da sociedade.', 'Além disso,nossos governantes juntamente com a sociedade tem a oportunidade de terem uma visão diferenciada sobre pessoas idosas. Ou seja,isso implica na necessidade e na urgência que as políticas públicas também se preparem para responder às carências da população idosa.', 'Em virtude dos fatos mencionados,faz-se necessário que a nossos governante juntamente com a sociedade mudem seus conceitos sobre a importância e os valores dos idosos no país. Os políticos garantindo seus direitos e nossos empresários dando a eles a oportunidade de continuarem exercendo suas profissões na terceira idade,isso ajudará na economia do país e nossos  idosos a terem uma velhice ativa. Enfim competência não tem idade.']",120,160,80,120,80,560
52,Juventude Abreviada,"['Na telenovela Amor de Mãe, a personagem Vitória Amorim entrega seu filho para ser vendido por uma traficante de crianças ao enxergar sua gravidez precoce como uma possível ameaça ao seu objetivo de tornar-se uma advogada de renome . Já fora das telas, a gravidez na adolescência é uma realidade no Brasil, sendo oportuno analisar seus impactos na vida das jovens brasileiras.', 'De acordo com o ex-embaixador americano Benjamin Franklin, o talento sem a educação é como a prata na mina. Evidenciando a veracidade de tais palavras, nota-se que as adolescentes em situação de gestação precoce não alcançam uma bem-sucedida carreira profissional, devido ao abandono escolar ocasionado pelas novas responsabilidades advindas da maternidade . Ademais, a iniciação cada vez mais cedo da atividade sexual aliada à resistência aos meios de prevenção, torna a população juvenil feminina propensa a contrair doenças sexualmente transmissíveis.', 'Todavia, há entraves que dificultam a resolução do impasse. Grande parte das jovens com bebês recém-nascidos não dispõem de creches onde possam deixar seus filhos e dar continuidade aos estudos . Além disso, a desinformação acerca dos métodos contraceptivos e o contato íntimo sem o uso de preservativo,  têm aumentado a incidência de gravidez indesejada e as taxas de jovens acometidas por doenças sexuais.', 'É mister, portanto, o emprego de medidas que atenuem o problema. Cabe ao Ministério da Saúde divulgar amplamente, mediante os meios de comunicação, sobre as formas de prevenção e os riscos da gravidez na menoridade. Paralelamente, o Ministério da Educação, em parceria com os governos estaduais, deve destinar uma parte dos recursos cedidos pela Receita Federal para a construção de creches que atendam a demanda. Dessa forma, a população juvenil feminina terá a perspectiva de um futuro melhor, pois, conforme declarou William Shakespeare, ""os homens às vezes são donos do seu próprio destino.""']",120,120,80,120,120,560
82,,"['A automedicação é uma prática bastante difundida,  e um problema de saúde pública no Brasil e no mundo. Apresenta sérios riscos a  saúde, além de acarretar o desenvolvimento de micro-organismos resistentes, devido ao uso indiscriminado de antibióticos, por exemplo. Um dos fatores que contribuem para a manutenção desse problema é a propaganda desenfreada de determinados medicamentos, e a falta de fiscalização nas farmácias.', 'Uma pesquisa do ICTQ (Instituto de Ciência Tecnologia e Qualidade), feita em 12 capitais do país, mostrou que a automedicação é praticada por 76,4% dos brasileiros. Esse valor exorbitante demonstra o quanto a questão é delicada e a sua prática precisa ser enfraquecida. É notório observar que,  o uso indiscriminado de medicamentos pode ocasionar sérios riscos aos seres humanos. De acordo com o Sistema Nacional de Informações Tóxicos-Farmacológicas (SINITOX), o Brasil tem como principal agente tóxico os medicamentos, atingindo aproximadamente 28% dos casos de intoxicação humana no país.', 'Apesar disso, nota-se o interesse crescente da indústria farmacêutica na continuação dessa prática maximizando a sua fonte de lucro através  do incentivo a automedicação. Em tese, a farmácia deveria zelar pela saúde dos clientes que a procuram e defender o seu bem-estar, e não interesses próprios. As tímidas campanhas que tentam esclarecer os perigos da automedicação não são suficientes,  frente a  propaganda desenfreada e massiva de determinados medicamentos. No entanto, observa-se que  depois das propagandas de remédios na TV  é declarado que “ao persistirem os sintomas o médico deverá ser consultado”, deixando claro e evidente os perigos que essa prática pode ocasionar ao ser humano.', 'A dificuldade de se conseguir um atendimento médico é uma das justificativas para a manutenção da prática da automedicação. No entanto, algo pode ser feito para defender a saúde do indivíduo, como aumentar a regulamentação e a fiscalização de remédios daqueles que vendem,  através  da Agência Nacional de Vigilância Sanitária ( ANVISA) e de outros órgãos públicos. Promover programas educativos, seja através da mídia, seja através das escolas, contribuirá para uma conscientização e posteriormente o uso racional de medicamentos.']",160,160,160,160,160,800
72,,"['Desde o começo dos tempos, o homem busca formas de se expressar e de obter informações muitas vezes  se baseando em conhecimento de outras pessoas. E, atualmente  temos as redes sociais e inúmeros sites como principais meios de obtê-las. Mas quando devemos perceber que essa grande ajuda, pode se tornar um grande problema?', 'No século 21, nos encontramos frequentemente ativos nestas redes, seja para compartilhar experiências, ler notícias ou somente passar o tempo, mas por mais simples que esses hábitos pareçam, apenas ler e confiar em algo que não buscamos conhecer a fundo podem gerar consequências significativas em determinadas ocasiões , pois essa fácil acessibilidade é aproveitada por indivíduos que se oportunam para promover as denominadas ""fake ews"".', 'Este termo, literalmente traduzido do Inglês como ""notícias falsas"" é usado para polemizar ou denegrir a imagem de algum indivíduo, e , em épocas importantes como as eleições, se torna ainda mais perigoso . Buscando orientar eleitores a favor ou contra determinados candidatos presidência, esses indivíduos publicam as fakes news, e , sem conhecimento sobre a veracidade dos fatos, esses eleitores se deixam basear em boatos, podendo gerar votos incongruentes, refletindo nas urnas de votação.', 'Em suma, é necessário que o poder legislativo juntamente com o Ministério da Comunicação, busque elaborar leis que punam e consequentemente multem criadores de Fake News, e alertem os usuários das redes sociais sobre a existência de falsa repercussão, os orientando a checar a veracidade das notícias lidas. Não se deve permitir que causas fúteis interfiram no futuro de um país.']",120,120,120,120,0,480
138,Os efeitos da covardia e da coragem sobre a sociedade,"['O comandante Francesco Schettino já começou errando, pelo fato de não assumir seu posto durante o trabalho.', 'O comandante Gregorio Di Falco, da Capitania dos Portos de Livorno agiu muito bem,                 ao esquecer-se de si mesmo e se preocupar com as milhares de vidas que estavam no barco, o que além de ser muito bom e gratificante para a sociedade que ainda existam pessoas como ele, acovarda mais ainda Francesco Schettino                , capitão do Costa Concordia, que         ao invés         de cumprir seu trabalho, como capitão, ajudando e buscando socorro para as pessoas que estavam no barco, decidiu abandonar, junto com o navio, a própria         ética         que jamais estará e acordo com essa atitude.', 'Francesco Schettino preferiu fugir e encontrar logo um lugar seguro para si mesmo         do que         exercer seu trabalho no barco ajudando a socorrer quem realmente precisava de sua ajuda.', 'Será que algum dia Francesco Schettino se arrependerá do que fez, assumindo o erro e pagando sua dívida com a sociedade? É o que muitos querem saber!', 'Quase como que em                 histórias infantis                , esta história mostra realmente o tipo de                 pessoas que devemos mesmo confiar, e dar valor.']",80,80,0,0,0,160
44,A qualidade natural sendo discriminada,"['Durante a Grécia Antiga, a Olimpíada era uma competição entre os guerreiros, com o objetivo de promover a paz e a amizade entre os inimigos. As mulheres eram impedidas de participar das competições, pois não participavam da guerra. Hoje, em uma Era Moderna, depois de muitas lutas foram aceitas, mas estão sendo banidas por algo natural do corpo humano, uma disfunção hormonal da testosterona, colocando prova o seu gênero. Nessa perspectiva, é urgente levar em consideração que a atleta não se dopou e sobre as regras as quais colocam que, o atleta com excesso hormonal deve fazer uso de medicamentos.', 'Em tempos antigos, não se levavam em consideração a quantidade de hormônio produzido por competidoras do atletismo, mas era feito o teste em tocar nas partes intimas das mulheres, hoje o método mudou para teste hormonal, mas com a mesma finalidade, provar que é mulher. A Federação Internacional de Atletismo, coloca que a atleta com quantidade acima do permitido de testosterona, não seria representativa da classe das mulheres em geral, fazendo com que isso gere uma ação discriminatória e podendo acarretar em danos psicológicos a competidora.', 'O doping é quando um atleta faz o uso de substncias que podem alterar o corpo frente a um estimulo. A esportista fazendo o uso de medicamentos que diminuam a testosterona, remete ao doping positivo, pois altera o resultado da competição e faz com que a sua qualidade natural seja diminuída, mas a IAA não considera isso. Somente coloca que para poder participar, a desportista devera estar dentro da regra de que sua testosterona deve ser menor que cinco nmol/L.', 'Depreende-se então, que é necessário incentivar as mulheres ao esporte e que a Federação Internacional de Atletismo, não deveria fazer o uso de testes abusivos em mulheres, tendo em vista o quão radical, humilhante e preconceituoso se torna o uso dele quando se trata de algo normal do corpo feminino. Deixa a mulher ser mulher, deixa ela correr.']",160,160,120,120,0,560
59,Fome,"['Desde o iluminismo, entende-se que uma sociedade que propéra, é uma sociedade que se preocupa com o problema do próximo. No Brasil esse ideal consta na teoria, mas não na pratica, um reflexo disso é a má distribuição de renda, enquanto uns acumulam fortunas, outros não conseguem nem o suficiente para se alimentar . Nessa perspectiva, esses desafios devem ser superados de imediato para que uma sociedade mais integrada seja alcançada.', 'Hodiernamente, seria racional acreditar que, ocupando a nona posição na economia mundial, o Brasil não sofreria com este problema. Mas a realidade é justamente o oposto. Segundo o portal de notícias G1, só em Fortaleza existem cerca de 204.177 famílias na extrema pobreza. Diante do exposto é lamentável a postura do estado,  que não promove políticas visando mudar a realidade desta parcela da população.', 'Faz-se mister, ainda salientar o sistema no qual estamos  inseridos, o capitalismo, como impulsionador do problema. Segundo Zygmunt Bauman, sociólogo polonês, a falta de solidez nas relações sociais, políticas e economicas é característica da ""modernidade liquida"" vivida no século XXI. Nesse contexto, o acúmulo de riquezas se torna possível , consequentemente ampliando a desigualdade, além de promover o individualismo e a falta de empatia com quem passa por alguma necessidade.', 'Infere-se, portanto, que ainda há entraves na construção de políticas que busquem um mundo melhor. Dessa forma, urge que o estado, por meio de reformas, promova políticas de redistribuição de renda, estipulando um teto salarial geral, para qualquer profissão, assim os efeitos do capitalismo podem ser amenizados. Dessa maneira, o Brasil pode superar a fome e desigualdade.']",120,160,120,120,40,560
21,A recente paralisação dos caminhoneiros,"['A recente paralisação dos caminhoneiros mostrou as fragilidades que o Brasil ainda tem quanto à garantia de direitos sociais. Muito graças ao descaso do governo, bem como aos seus descuidos econômicos, a greve da classe que faz a economia funcionar acendeu uma luz também sobre a adequação do país à posição de potência global e deixou clara a insatisfação latente da população quanto a situação vigente da sociedade. Nesse sentido , convém analisar alguns aspectos desse movimento.', 'É evidente que o estado foi peça fundamental para a eclosão da greve dos caminhoneiros. Visto que a instituição governamental foi forçada a retirar seus subsídios de algumas áreas da máquina pública, após anos de práticas econômicas danosas – como a expansão irracional de crédito – que culminaram com a crise financeira. O setor de combustíveis, afetado por essa retração, serviu como pretexto para a insurreição da classe dos caminhoneiros. A população, por sua vez, apesar de afetada negativamente, manteve, em grande parte, apoio ao movimento, evidenciando a verdadeira profundidade do desagrado social para com o estado atual da nação.', 'Paralelo a isso, a crise de desabastecimento decorrente da paralisação trouxe à tona a discussão sobre a dependência da economia nacional no sistema de transporte rodoviário, cuja escala de utilização tem raízes históricas, vindas do governo de JK, nos anos cinquenta . A sujeição a esse meio de funcionamento logístico não é compatível com um país das proporções do Brasil e que almeja atingir níveis de desenvolvimento cada vez maiores. Dado que o trasporte rodoviário é ineficiente se comparado ao ferroviário ou hidroviário, padrões em países de primeiro mundo. O Brasil possui hoje uma malha ferroviária de trinta mil quilômetros, tão grande quanto a que os Estados Unidos tinham já em 1860.', 'Logo, fica claro que a greve que parou o país foi um sintoma de uma sociedade cansada e desgastada pelas condições atuais, também relacionadas a questões históricas. É necessário, portanto, que o Estado invista na ampliação e modernização dos sistemas de transporte de mercadorias alternativos ao rodoviário, para assim garantir o acesso a produtos, bem como o barateamento dos mesmos. É importante que sejam revisadas as diretrizes econômicas tomadas pelo país. Políticas de austeridade e fiscalização por parte de órgãos como o TCU são essenciais para se garantir o bom funcionamento dos serviços públicos e a manutenção dos direitos civis, consequentemente, da qualidade de vida da população.']",120,160,160,160,120,720
83,,"['Nos últimos anos vem aumentando, cada vez mais, o estímulo a prática de esportes. Um dos principais motivos é o sedentarismo que afetam jovens e crianças, a famosa geração cabeça baixa, que trocaram as brincadeiras de rua com os amigos, para olhar a vida social nos smartphones e tablets. Assim, o principal método de estímulo a pratica de esporte é a mídia, com propagandas direcionadas especialmente aos pais para mostrar os benefícios do esporte.', 'A prática ao esporte ajuda na manutenção do nosso organismo, reduzindo riscos de doenças cardíacas, uma dos principais casos de morte nos jovens. Também ajuda a  elevar a autoestima, que é considerado uma das principais causas de depressão, e a diminuir o estresse e a ansiedade provocada na maioria das vezes pelocaús da cidade grande; trânsito, faculdade, escola, emprego, etc.', 'Seja praticado na academia, na escola ou em outros campeonatos, o esporte ajuda a formar pessoas de bom caráter e boas qualidades, ajuda a descobrir talentos para os famosos jogos olímpicos e a quebrar barreiras para os deficientes, que hoje podem praticar modalidades adaptadas.', 'Contudo, o esporte ensina as pessoas a trabalhar em equipe, a assumir responsábilidades , a buscar seus objetivos através do próprio esforço, a aprender com as vitórias e também com as perdas. O esporte deve ser estimulado pela mídia, pelos pais, pelos médicos e pelo governo e utilizado como instrumento de integração de uma juventude mais ética.']",120,160,120,160,200,760
16,O conservadorismo no Brasil,"['A onda conservadora no Brasil alcançou um elevado nível após a eleição de Jair Bolsonáro na presidência , pois temos a frente um homem que usou de bases históricas para alcançar a sua vitória.', 'Além disso, não podemos ignorar que Jair Bolsonáro obteve aceitação da maior parte da população, pelo fato de que suas propostas estão diretamente ligadas ao conservadorismo.', 'Tendo em vista que os brasileiros que tem posições tradicionais com relação a legalização do aborto, casamento de pessoas do mesmo sexo, à pena de morte e à maioridade penal cresceu nos últimos anos.', 'Sendo assim, o Brasil nos próximos anos, será apenas o reflexo da própria opinião de grande parte da sociedade, com base em suas próprias ações e manifestações.']",120,80,80,80,40,400
62,O Espetáculo de Horrores de discurso de ódio  nas Redes Sociais,"['Redes Sociais para se socializar, conhecer novas pessoas, amigos, namorado ou namorada , compra e venda , e até talvez seu futuro chefe , em busca de um emprego .', 'Tem se tornado um circulo de ódio palavras de baixo calão , discurso de ódio.', 'Muitas pessoas tem usado as redes sociais para fazer ataque racistas,cor de pele ,palavras ofensivas as crenças religiosas, comentários maldoso sobre opção sexual, diminuindo a capacidade de um deficiente físico.', 'Tem se tornado comum e vem invadindo as redes sociais insultos , palavras de baixo nível.', 'As pessoas acabam esquecendo a boa e velha ética para fazer xingamento, insultos ,desmoralizar , porque alguém fez algo que pessoa não gostou , tem suas diferenças, sua opinião , características físicas não igual, criticas palavras censuradas no nosso vocabulário a qualquer um desses seres humanos citados pela minha pessoa anteriormente, virou discurso de ódio nas redes sociais , diga-se de passagem um espetáculo de horrores virou uma guerra.', 'Um lugar que era para socializar , entreter, para expor sua idéias sadias.', 'Devemos nos mobilizar fazer uma campanha alguém artistas famosos  , empresas, meios de comunicação , youtube e até a própia redes sociais para acabar com isso ou talvez compartilhar boas ética.', 'Eu sou formado em Técnico em informática muito se falou no nosso curso sobre todo tipo de ética que devemos usá –la e compartilhar , estudamos segurança da informação que devemos  ter cuidado no que falamos  algo bom ou ruim uma informação seja do tipo que for pode repercurtir para o mal seja em qual meio que ela for usada .', 'Eu tenho uma opinião os grandes donos de empresas de aplicativos de redes sociais deveriam propor uma melhoriar já que há cada vez mais tecnologia nos aparelhos celulares , os aplicativos se atualizam a cada se meses ou até mesmo em semana, o usuário que não quiser ver ou ler algo desagradável , fizesse um botão em configuração do aplicativo de restrições', 'Bloqueasse ou deletar antes de chegar a você , usuário ou visitante que não quer ter presenciar mais isso , Bom essa foi minha opinião. Ética nas Redes Sociais.']",80,40,40,40,0,200
55,,"['Desde o descobrimento do Brasil, os indígenas sempre foram tratados como seres inferiores desprovidos de direitos. De maneira análoga a isso, na sociedade rasileira atual, mesmo com o advento da Constituição Cidadã e a assinatura da Convenção nº 169 da OIT, que trata dos direitos dos indígenas, muitos direitos continuam sendo tolhidos . Nesse prisma, destacam-se dois aspectos importantes: a falta de politicas públicas garantistas e o preconceito que grande parte da sociedade tem em relação aos silvícolas.', 'Primeiramente, é indubitável que a terra é de fundamental importância para o indígena, pois esta tem um grande valor para  sobrevivência física e cultural dos mesmos . Segundo o IBGE  886 mil pessoas se declaram indígenas e desse total, 517 mil moram em terras oficialmente demarcadas, isso demonstra que ainda existe déficit de terras demarcadas muito grande. Conquanto, a consolidação desse direito vem se arrastando no congresso por longos anos, pois atinge interesse de setores poderosos da sociedade, que tem interesse nessas terras que são ricas em minério, madeira e apresentam uma grande biodiversidade de riquezas naturais. Isso tem gerado vários conflitos entre silvícolas e esses grupos.', 'Outrossim, é notório que a questão do preconceito é outro fator determinante, pois o índio é tido como uma figura preguiçosa e que apenas quer gozar das benesse do Estado e isso gera uma opressão em relação aos mesmo . Dessa forma, segundo o sociólogo Pierre Boordieu, quando traz a balia, o conceito de opressão simbólica, no qual afirma que a violação dos Direitos Humanos não consiste somente no embate físico, o desrespeito está na perpetuação de preconceitos que atentem contra a dignidade da pessoa humana ou de um grupo social. Sendo assim, essa imagem negativa contribui para uma desvalorização da cultura indígena e de seus costumes, além de contribuir para que muitos direitos dos silvícolas sejam negados.', 'Portanto, é mister que o Estado tome providências para amenizar o quadro atual. Para a conscientização da população a respeito do problema, urge que o Ministério da Agricultura, acelere as demarcações de terras, por meio de estudos de identificação e delimitação para demarcar e regularizar o registro dessas terras, assim garantindo a reprodução física e cultural desses povos, além de ajudar na conservação do meio ambiente e da biodiversidade. Em adição a aprovação do Projeto de Lei do Senado nº 169, de 2016 que irá regularizar a situação jurídica dos índios. O MMFDH  em pareceria com o MEC  realize campanhas nas mídias sociais, televisivas e nas escolas a respeito da importância do indígena e como este contribui de maneira significativa para a sociedade. Somente assim,  ocorrerá a valorização do indígena e os seus direitos serão respeitados.']",120,160,120,160,120,680
57,,"['No filme ""Tempos modernos"", o protagonista vive em uma realidade na qual procura promover críticas as formas de trabalho, questões como saúde e respeito. O mais incrível é que ele consegue expor suas ideias em uma obra sem recursos tecnológicos como : áudio e cores. Apesar de ter sido produzido sem esses recursos, o filme ainda atrai milhões de espectadores, pela mensagem que procura passar. Outros filmes são produzidos na atualidade e arrecadam milhões em bilheteria, principalmente pelas tecnologias empregadas na edição, o elenco e o marketing na sua divulgação, atraindo principalmente públicos de alta renda, um triste realidade já que públicos de baixa renda ou que moram longe dos centros urbanos não tem acesso.', 'Segundo o jornal O globo, em uma publicação em 2018, o desemprego bateu recorde e chegou a mais de 12 milhões de pessoas, gerado principalmente por mudanças no cenário político e econômico. A esperança de um novo governo, questões relacionadas à reforma da previdência, aumento do dólar, a mudança de fabricas para outras regiões e a saída de fabricas como a da Volkswagen do ABC, afetou grandemente a vida financeira das pessoas e dificultou o acesso à lazeres como o cinema, devido a inflação.', 'O problema da renda agrava-se mais ainda, quando essas populações vivem em regiões distantes dos centros urbanos. Segundo o site ""Cinema perto de você"", em julho de 2019 foi publicado um artigo, no qual mais de 120 milhões de pessoas migraram para as grandes cidades, se considerarmos que há no país mais de 200 milhões de habitantes, isso representa 60% da população, ou seja, 40% das pessoas moram nessas regiões do interior, dados do IBGE de 2011. Projetos como o da empresa Ultragaz procuram levar a arte do cinema a essas regiões, dentro de salas montadas ou caminhões adaptados, promovendo a inclusão social dessas pessoas nesse novo universo.', 'Portanto, cabe às empresas exibidoras agregar valor ao cinema voltado para o viés social ao invés do lucrativo , investindo seus milhões de bilheteria em infraestrutura nessas regiões, com a criação de espaços para exibição de forma gratuita, com salas. veículos adequados para este tipo de lazer, espaços abertos para a visualização ao ar livre para que as pessoas que moram longe desses centros urbanos e pessoas com baixa renda possam ser integradas e tenham a oportunidade de assistir filmes, peças teatrais, musicais no cinema, e por fim isso possibilitará aquisição de novos públicos, atraindo investimentos governamentais.', 'Desta forma, filmes como ""Tempos modernos"" serão transmitidos à essas pessoas e questões como valores sociais, saúde e respeito serão ensinados.']",120,40,40,80,40,320
95,O direito indígena à terra,"['No dia 5 de outubro  de 1988, foi promulgada a Constituição federal brasileira, que, dentre tantas garantias, reconhecia aos povos indígenas o direito originário às terras que ocupavam. Atualmente, entretanto, esse privilégio está sendo contestado por parlamentares e defensores do agronegócio sob a tese do ""marco temporal"", cuja deliberação representa uma grande ameaça à integridade dos nativos. Nesse contexto, é importante analisar as alegações ruralistas e os riscos à vida indígena como elementos conflitantes dessa ação.', 'Em primeiro plano, destaca-se a insegurança jurídica como argumento principal em relação a demarcação de terras aborígenes. Segundo a Frente Parlamentar da Agropecuária (FPA), a falta de normas objetivas capazes de regulamentar a criação de erras indígenas e indenizar adequadamente o proprietário pode prejudicar a economia agrícola. Todavia, ao observar-se a imensa disparidade na concentração territorial entre agricultores e indígenas, fica claro quem realmente sofre com a vulnerabilidade jurídica . Devido inadimplência estatal acerca da proteção dos nativos, a invasão de proprietários rurais às terras desses povos torna-se recorrente, sem qualquer ressarcimento por parte do governo.', 'Por conseguinte, a execução do marco temporal será determinante para uma possível extinção dos povoados originários. De acordo com a tese, a demarcação de terras só poderia ser solicitada caso as tribos residissem na região antes da promulgação da Constituição de 1988. Dessa forma, quaisquer povos indígenas que vieram a instalar-se em territórios após esse período ou foram expulsos anteriormente, não têm direito sob essas terras. Sendo assim, muitos indígenas seriam forçados a abandonar seus lares e, consequentemente, perderiam seus meios de subsistência, o que ocasionaria o lento desaparecimento da cultura nativa brasileira.', 'Portanto, diante o problema apresentado, faz-se inadiável a execução de medidas estratégicas capazes de desestimular o marco temporal. Para tal, é papel do Estado promover a regulamentação apropriada da demarcação de terras indígenas e proteger tais territórios contra invasões, por meio de alterações legislativas e apoio militar, a fim de que haja plena segurança tanto aos proprietários rurais quanto aos povos originários. Somente assim, preservando o preciosíssimo direito indígena à terra.']",160,200,120,200,120,800
54,Arãosófones,"['De acordo com o filósofo grego Aristóteles, a pólis, espécie de cidade que vivenciou uma das primeiras experiências de democracia na história, objetiva alcançar o bem coletivo. Todos os atos de seus cidadãos e instituições, nessa perspectiva, seriam fundamentados na expectativa de se lograr o bem de majoritária parcela da sociedade, tal como ocorre em países e cidades atuais. Desse ponto de vista, as vacinas mostram-se de suma importância para manutenção da ordem social, uma vez que tencionam um bem comum aos seus membros e auxiliam na perpetuação de uma característica intrínseca a quaisquer agrupamentos humanos.', 'Como ressaltaram pensadores contratualistas, tal como Thomas Hobbes, a sociedade civil se estabeleceu através da concessão da liberdade natural de todos os indivíduos ao soberano, que detém, em contrapartida, o dever de protegê-los. Assim, a vacinação dos indivíduos que convinvem em uma sociedade democrática, por exemplo, é um dever das instituições desta, tendo em vista que sem elas patologias mortais podem afligir seus constituintes, engendrando, devido à ineficiência do Estado em auxiliá-los, a ruptura com os direitos e deveres oriundos do contrato social, isto é, valores conhecidos como válidos pelo Estado e pelos indivíduos.', 'Além disso, as condições de qualidade de vida dos cidadão propiciadas pela vacinação é uma de suas características. Com as vacinas é possível atenuar a incidência ou erradicar enfermidades em determinada localidade , fomentando melhorias na saúde populacional e, por conseguinte, atingindo uma necessidade comum a todos seus membros, condições de saúde que propiciem modos de vida aptos à realização de suas atividades. Logo, campanhas de vacinação são importantes para sociedade à medida que garantem a égide da população e que estimulem a possibilidade das instituições sociais lograrem a satisfação de uma necessidade comum a seus integrantes.', 'As campanhas de vacinação devem, portanto, ser ampliadas, tanto para atingir o bem comum quanto para garantir a legitimidade da relação entre a sociedade civil e o Estado. O Ministério da Saúde deve, desse modo, mitigar, por intermédio de propagandas em redes de comunicação, crenças infundadas acerca das vacinas , tencionando impedir que tanto os indivíduos que desconhecem seu funcionamento e se negam a utilizá-las quanto os seus órgãos garantam a validade dos valores originários da sociedade. Por conseguinte, será possível atingir um desejo comum à sociedade e manter sua ordem.']",160,160,160,160,120,760
90,*** ***,"['Como Combater a Transfobia no Brasil', 'Não foi por acaso que a escritora Glória Perez abordou o tema trans na novela “A Força do Querer”, exibida no horário nobre na rede Globo em 2017 e reprisada com o final em março de 2021 . É muito triste saber que em pleno século XXI o preconceito ainda prevalece, e mais que este é pelo simples fato de pessoas terem nascido com diferentes tipos de orientações sexuais.', 'Segundo Associação Nacional de Travesti e Transexuais (ANTRA), o número de pessoas que são covardemente assassinadas simplesmente por ter nascido fora do considerado “padrão”, que seria masculino e feminino são assustadores. Ao que se sabe somente no semestre de 2020 quase 90 pessoas perderam a vida, se comparado com o mesmo período de 2019 percebe-se um aumento exorbitante. A novela “A Força do Querer"" mostrou na pele dos artistas vivido pela atriz Carol Duarte como Ivana e o ator Silvero Pereira como o Nonato o quão é difícil sobreviver em meio a sociedade preconceituosa e ao mesmo tempo covarde . Vale lembrar que as dificuldades muitas vezes começam em casa, na própria família muitos pais não entendem, uns por falta de conhecimento e outros por ignorância, acabam até expulsando seus filhos de casa. Devido o preconceito, torna-se difícil conseguir empregos dignos, por falta de opção muitos acabam se prostituindo colocando suas vidas em vulnerabilidade até que passam a fazer parte desta triste estatística.', 'Com tudo, observa-se a necessidade de uma mudança de paradigma. É necessário que o Ministério da mulher, família e direito humanos (MMFDH) intensifique  campanhas de conscientização a cerca da diversidade de gêneros no país em meios de comunicação e promova palestras em instituições de ensino. Além disso é imprescindível que o cidadão cumpra seu dever de denunciar qualquer caso de abuso que venha sofrer ou presenciar, sendo assim torna-se possível punir estas pessoas que se julgue no direito de desrespeitar os demais.']",160,120,120,160,160,720
62,O ódio que semeamos,"['Com o advento da Internet no final do século XX, as relações interpessoais sofreram inúmeras mudanças. A comunicação passou a ser mais veloz através de mensagens e e-mails  e as redes sociais surgiram para dar lugar à diversas formas de liberdade de expressão. Entretanto, com essa facilidade de expor ideias, alguns usuários se veem cada vez mais livres para atacar e ofender a quem quiserem por meio do anonimato.', 'De acordo com o sociólogo francês Zygmunt Bauman, estamos vivendo em uma modernidade líquida onde a tecnologia ultrapassa a nossa humanidade a cada dia. Sendo assim, a tese de Bauman se mostra cada vez mais verídica quando observamos os incontáveis casos de ataques contra algumas minorias como negros, homossexuais e mulheres. Eventualmente, tais atos cruéis podem causar danos permanentes na vida daqueles que os recebem, sejam eles psicológicos ou até mesmo físicos.', 'Todavia, ONGs como a Safernet Brasil, por exemplo, já foram criadas afim de receberem denúncias de crimes de ódio na Internet, vindas principalmente do Twitter, Facebook e Instagram. Porém, mesmo com a existência de uma ONG capacitada para lidar com o problema, os casos de páginas apologéticas à discriminação, comentários racistas, homofóbicos e machistas não param de crescer nas redes sociais e, para piorar o quadro da situação, as pessoas estão começando a não se chocar mais quando eles acontecem', 'Portanto, medidas são necessárias para resolver o impasse. Logo, as redes sociais devem começam a alertar seus usuários através de anúncios e propagandas a respeito das consequências de comentários odiosos e das punições aos responsáveis. Ademais, o Ministério da Educação deve criar palestras e debates nas escolas afim de conscientizar as crianças e adolescentes sobre o uso saudável das redes sociais e da empatia junto com a liberdade de expressão. Dessa forma, através da educação e conscientização, criaremos uma sociedade respeitosa e empática.']",120,160,120,160,120,680
22,Vantagens e Desvantagens do Foro Privilégiado ,"['Foro privilégiado é quando um indivíduo ocupa algum cargo público importante e recebe um tratamento diferenciado da justiça após cometer atos ilícitos.', 'Nós temos algumas vantagens e desvantagens quanto a este assunto;', 'A grande desvantagem que temos é a demora no julgamento, com isso o processo acaba caducando e por muitas vezes são ""esquecidos"" porque os políticos com determinados cargos não são julgados em primeira instância e sim pelo Supremo Tribunal Federal.', 'Diminui as instancias a que se podem recorrer e não é permitida a apresentação de novas provas, apenas é permitido uma nova interpretação do que já foi apresentado.', 'A grande vantagem é o fato de não haver prisão preventiva ou temporária e se houver a perda do cargo ele não terá o foro privilegiado, no entanto seu julgamento sera em primeira instância. Podendo recorrer.', 'Em conclusão, vê-se que os políticos não estão sendo julgados como deveriam, é necessário que esses privilégios tenham um fim, pois só assim o Brasil terá a chance de se reergui com dignidade e com governantes justos em que possamos ter pelo menos 70% de confiança para que o nosso país se recupere dessa crise e que os verdadeiros culpados paguem pelos erros que estão cometendo a anos.']",80,80,80,80,80,400
45,"Nem por força, nem por Violência","['Por que um diploma ou um concurso público pode fazer algumas pessoas pensarem que de alguma forma são melhores que as outras? Talvez por morarem num bairro mais nobre ou possuírem algum tipo de carrão ou quem sabe algum plano de saúde bem amplo, pra algumas pessoas é como se elas tivessem uma capa de super-herói ou até mesmo super poderes. Quando o policial militar João Paulo Servato pisou no pescoço de uma mulher negra na capital paulista no mês de maio ele estava não só humilhando uma mulher negra, mas estava ali no chão sendo representada toda a classe feminina por se tratar de uma mulher, ( negra ) por fazer parte da história do nosso país, de classe pobre como á maioria de nós brasileiros por que se fosse rica com certeza não teria o mesmo tratamento, e estava ali também representado o machismo que talvez ele pode ter aprendido desde de criança nessa mesma nossa sociedade, deveria não só ser afastado do cargo mas punido de forma mais severa como por exemplo perder a farda . A partir daí então deveríamos ascender uma luzinha vermelha na ""Educação"" não só escolar mas também do lar, penso que todos os saberes e poderes como por exemplo: A Psicologia e a área Jurídica devem dar as mãos para não só diminuir esse tipo de caso mas erradicar da nossa sociedade esse tipo de conduta. E o que dizer então do caso desembargador Eduardo Almeida Prado Rocha de Siqueira que se recusou a usar máscara de proteção em uma praia de Santos ( SP ) deveria não só ser afastado do cargo mas punido de uma forma mais severa  como por exemplo: responder judicialmente por abuso de poder principalmente por ter conhecimento jurídico, casos como estes e tantos outros os quais não chegam ao conhecimento da população se não for através da mídia, redes sociais, internet e meios de comunicação como TV e Rádio dão força e voz população brasileira, quando isso acontece e as pessoas saem impunes reforça ainda mais que as pessoas ""poderosas"" desse país podem fazer o que quiserem, quando quiserem, e da forma que quiserem, sem jamais serem punidas ou responsabilizadas por suas ações, ao meu ver precisamos de mais políticas públicas e leis mais severas não aquele tipo de lei que prende e se paga uma fiança qualquer e no outro dia já está souto ""tirando onda"" mas leis que tenha mais fundamentos e que funcionem não somente com pobres mas também com ricos, brancos, concursado, com diploma ou não, o símbolo da justiça é uma mulher com a balança na mão simbolizando a justiça praticada todos em suas ações e uma faixa nos olhos mostrando imparcialidade . as s vezes parece que a faixa simboliza que a justiça é cega principalmente em nosso país com o jeitinho brasileiro onde tudo acaba em pizza.', 'Como diria o compositor Renato Russo ""Que País é esse?"" e o que dizer da música de outro compositor conhecido Cazuza ""Brasil mostra a sua cara"" essas músicas são atemporais e mostra a realidade de um país que insiste em não querer mudar, pelo ao menos pra melhor. ""Acorda Brasil"".']",120,40,120,80,0,360
95,Debate sobre o marco temporal ,"['O arco temporal consiste que só as terras que estavam em uso pelos povos indígenas deste 5 de outubro de 1988 poderá ter um dono, Vale ressaltar que muitos indígenas são contra a Constituição brasileira pois impede a posse das terras, perdendo o direito às áreas em processo de demarcação. Povos indígenas fazem manifestação em Brasília para mudar a realidade de muitos indígenas.', 'No entanto, os povos indígenas perderam suas terras e ficaram sem moradia, ma pesquisa do IBGE  realizada em 2019 afirma que muitos indígenas que perdem suas terras vão para a cidade e não conseguem se adaptar. No mundo em que vivemos, onde o governo não se importa com os direitos dos indígenas e faz menos caso, fez com que milhares de indígenas procurassem outro lugares para viver.', 'Porém, as manifestações em Brasília não tiveram resultado pelo menos não oficialmente, as terras que não são mais deles vão para as mãos de outro dono com outras perspectivas. O marco temporal não foi só uma troca de donos de terras, foi uma crueldade, pois a constituição fez com que houvesse mudanças na vida de cada indígena.', 'Conclui -se o debate que fixa os direitos dos indígenas. Por fim o governo necessita avaliar o artigo 231 da Constituição para reiniciar uma nova etapa priorizando terras que já tem um dono antes ou depois dos estados brasileiros para iniciarmos um novo recomeço ou até mesmo uma nova Constituição.']",120,120,120,120,120,600
3,Revolução Transumanista,"['No século XXI, após os expressivos avanços tecnológicos decorrentes da corrida armamentista e espacial da guerra fria Guerra Fria, os seres humanos detêm de certos certos conhecimentos que possibilitarão às próximas gerações viverem em uma sociedade transumanista. Apesar de, em um primeiro momento, esta essa nova configuração da sociedade parecer benéfica benéfica, em virtude do aprimoramento das habilidades fisiológicas e cognitivas do corpo humano, esta essa nova configuração, na verdade, acarretaria não só na a perpetuação da disparidade social como também promoveria o aparecimento e manutenção de regimes totalitários.', 'Primeiramente, os avanços tecnológicos provenientes da revolução transumanista estariam restritos as às elites econômicas. Isso ocorreria pois ocorreria, pois, além desta dessa elite possuir renda para financiar as pesquisas que resultariam na revolução transumanista, esta, por auxiliar monetariamente na criação dos aparatos transumanicos , deteria do o monopólio comercial destas inovações. Uma vez detido o monopólio comercial pela elite, esta, segundo o conceito da mais-valia postulado por Karl Marx, deixaria o preço das inovações relativamente alto para poder lucrar o máximo possível. Nesse sentido, em virtude dos elevados preços, as classes populares não teriam acesso as às inovações tecnológicas provenientes da revolução transumanista.', 'Em segundo lugar, a revolução transumanista impediria que o povo rompesse com governos ditatoriais. Tal situação aconteceria porque, devido aos governantes estarem intimamente associados com os polos de poder econômico, esses teriam acesso aos aparatos tecnológicos provenientes da revolução. Sendo assim, o povo, sem o mesmo poderio militar tecnológico militar-tecnológico do governo, não conseguiria, de forma alguma, depor o governo ditatorial.', 'Em suma, a revolução atenderia exclusivamente os polos de poder, impedindo que o povo se rebelasse contra a estrutura governamental vigente. Portanto, para que a revolução transumanista não seja tão desastrosa para as camadas populares, cabe ao povo, no momento atual, romper com a elite política e econômica, recusando-se a consumir produtos que não são essenciais para a subsistência.']",120,160,120,160,120,680
95,Debate sobre o Marco Temporal,"['O debate sobre o marco temporal é um assunto que está trazendo uma grande discordância, por um lado estão os povos indígenas que buscam defender suas terras e sua cultura e por outro lado está a bancada ruralista e instituições ligadas agropecuária que defendem o movimento. O chamado marco temporal teve início em 2009, quando o STF (Supremo Tribunal Federal) teve que tomar uma decisão em relação a um conflito por terras que estava ocorrendo entre indígenas e produtores de arroz. A decisão tomada foi a favor dos povos indígenas e seu motivo foi o fato de que os povos originários se encontravam na região em 5 de outubro 1988, data em que foi promulgada a Constituição brasileira. Porém esta iniciativa deu abertura para que outros conflitos fossem resolvidos com o mesmo raciocínio.', 'Esta ação se deu pelo Supremo Tribunal Federal, que defende que os povos indígenas podem reivindicar somente as terras ocupadas por eles em 5 de outubro de 1988, com base no artigo 231 da Constituição, onde temos como responsabilidades dos indígenas demarcá-las, protege-las e fazer respeitar todos os seus bens, e como direitos reconhecimento de sua organização social, costumes, línguas, crenças e tradições. Porém esta ação pode ser arbitrária, pois não defende as terras que estes povos perderam para a urbanização, expansão da agricultura, em conflitos ou em morte por doenças da época. Essas terras são uma forma de sobrevivência destes povos diante da vida urbana e rural, sem comentar o fato de que são uma forma de conexão com antepassados e proteção de sua cultura.', 'Uma forma de resolver estes conflitos seria a criação de uma nova lei que apoiasse a permanência e demarcação dos povos nestas terras. O marco temporal é uma demonstração de uso da interpretação da constituição para resolução de conflitos. Caso o Supremo Tribunal Federal aprovasse uma nova lei que fosse capaz de especificar a demarcação das terras indígenas, a discordância em relação ao marco temporal teria fim e os conflitos seriam resolvidos com maior confiabilidade.']",160,120,120,120,80,600
129,Família dinâmica,"['Após o primeiro capítulo da novela          babilônia          na rede Globo, uma onda de manifestações a favor e contra o beijo gay mostrado nas cenas tomou a internet. Os contrários insistem em dizer que relacionamento se faz entre homem e mulher. Essas pessoas não consideram, no entanto, que o conceito de família é dinâmico e muda com o tempo.', 'O conceito de família tradicional está baseado em princípios religiosos. No Brasil, grande parte da população professa a religião cristã, que não aceita o casamento entre pessoas do mesmo sexo. Todavia, a Constituição Federal afirma que o Brasil é um país laico. Dessa forma, é incoerente estender o conceito de família tradicional a toda a população. Assim, o conceito legal de família não só pode como deve mudar para que a população que não concorda com o modelo tradicional tenha seus direitos garantidos e seja atendida pelo         estado         .', 'O conceito de família é dinâmico. Esse conceito pode variar em decorrência de                 vários fatores, como a religião: A religião católica                concorda com a definição da proposta de lei intitulada “Estatuto da Família”, segundo a qual família seria a união apenas entre um homem e uma mulher e seus filhos. Já o Budismo não faz distinção de sexo e vê a família como a união entre duas pessoas.                 É importante                destacar também que família é um conceito que ultrapassa o legal:         Está         mais ligado a sentimentos do que a regimentos, assim essa ideia deve ser flexível. Na medida em que duas pessoas têm afeto entre si,         essas tem         o direito de         serem         tratadas como família,                 tendo todos os direitos de                  matrimônio, e de registrarem sua união.', 'Dessa forma, é visível que a definição de família não deve ficar restrita à união entre homem e mulher, um modelo religioso que equivocadamente foi transmitido à sociedade. Esse conceito deve mudar para respeitar as diferentes orientações sexuais. Cabe, portanto ao         legislativo         brasileiro não aprovar o atual “Estatuto da Família” e modificar seu texto para que englobe as diferentes instituições familiares. A sociedade tem o dever de aceitar e respeitar toda forma de família.']",160,200,160,200,200,920
81,"Busca de mais liberdade, igualdade e fraternidade às religiões","['Desde o período colonial até os dias atuais, o Brasil destaca-se como um país diverso, ou seja, possui diferentes culturas, etnias e religiões. Todavia, atualmente com a conturbação do mundo globalizado, por exemplo, é cada vez mais comum  cenas de intolerância religiosa. Sendo assim, o Estado e a sociedade civil organizada devem intervir para que não se torne descaso social.', 'Um dos principais problemas da intolerância religiosa é que grande parte da população brasileira caminha para uma sociedade fundamentalista, a  proporção  que o respeito às outras religiões é mínimo e o sentimento de individualista é crescente.', 'Segundo dados da Secretária de Direitos Humanos, os casos mais evidentes são com religiões afro-brasileiras e evangélicas. Enquanto aquela sofre com os reflexos do período escravista  a outra se ver  em uma sociedade com ascensão do capitalismo  bem como do desenvolvimento de preconceitos e estereótipos. Então, enquanto não houver mudança a situação tenderá a piorar, nas palavras do filósofo iluminista, Jean Jacques  Rousseau, ‘’ o homem nasce bom, mas a sociedade o corrompe’’.', 'Portanto, tornam-se cabíveis medidas ao combate a  intolerância religiosa. através   as   Pois, somente assim será possível viver em ‘’Liberdade, Igualdade e Fraternidade’’ como no discurso da Revolução Francesa.']",160,160,160,120,160,760
22,Injustiça,"['Atualmente, um dos assuntos que está sendo muito discutido é a questão do direito ao foro privilegiado que se trata da maneira como as autoridades são julgadas, é oferecido um tratamento diferente dos outros cidadãos comuns .', 'Sendo assim, porque ser diferente o tratamento ? Se somos todos iguais perante a lei? É o mesmo crime, então todos tem que cumprir a pena igualmente, sem restrição. Querem acabar com a desigualdade, mas fica difícil.', 'No entanto, o ideal seria independente de quem seja, cumprir a devida pena do crime, a pena tem que ser a mesma para todos, mesmo ambiente, mesma comida.', 'Seria uma injustiça com os outros, sem contar que nuncam iria parar os crimes, já iriam estar ciente que o tratamento seria diferente, e para eles isso é bom.', 'A sociedade deveria protestar, se imobilizar para manter os direitos iguais, as escolas poderiam fazer campanhas de conscientização para alertar a população da desigualdade que está havendo.']",80,80,80,80,80,400
13,Cidadão armado e combate a  violência,"['A flexibilização da posse de armas de fogo é um tema bastante polêmico. Existem dois posicionamentos, o dos que acreditam que o armamento inibirá a prática de crimes e o dos que entendem que a violência irá aumentar. Estes últimos parecem ter argumentos mais sólidos para demonstrar que o armamento da população não resolverá a questão da segurança pública.', 'Em primeiro lugar, apesar de as pessoas terem que cumprir uma série de requisitos para adquirir a posse da arma, elas não terão a preparação técnica e psicológica que um policial tem para manusear uma arma, a consequência é que a existência de armas de fogo em casa aumentará a ocorrência de crimes passionais e por motivos banais e também acidentes (principalmente envolvendo crianças). Por mais que seja necessário manter essas armas em cofres, haverá uma grande dificuldade de fiscalizar se essa exigência está sendo cumprida.', 'Ademais, pesquisa mostram que grande parte das armas apreendidas com criminosos forma adquiridas legalmente e depois extraviadas, furtadas ou roubadas. O resultado será o aumento do armamento dos delinquentes, deixando a população ainda mais vulnerável.', 'Além disso, percebe-se a transferência para a sociedade de uma obrigação estatal, que é a segurança pública, demonstrando a ineficiência do Governo em cumprir com suas competências.', 'Por todos esses motivos, vislumbra-se que a flexibilização da posse de armas de fogo não diminuirá a criminalidade, pelo contrário, poderá aumentar os crimes passionais e mortes acidentais, além de facilitar o acesso de armas pelos criminosos e mostra que o Estado tenta com essa medida se desvencilhar de suas obrigações com a população.']",160,160,160,200,120,800
47,....,"['A educação a distancia no Brasil esta em alta nos últimos anos, isso deve-se, ao avanço tecnológico que se modifica cada vez mais. Nesse sentido,o desafio ainda é enorme, pois a edução virtual não possui a mesma qualidade comparada a educação presencial.', 'Segundo, dados no instituto nacional de pesquisas educacionais Anísio Teixeira a edução a distancia cresceu cerda de 17,6% de 2016 a 2017 . Sob essa ótica, é evidente que esse crescimento deve-se aos alunos procurarem uma maneira mais acessível de estudar. Contudo, a educação a distancia enfrenta muitos desafios no Brasil, pelo fato de muitas pessoas não possuírem acesso internet ou preferem o ensino tradicional.', 'Outrossim, os desafios que os professores sofrem graças esse novo modelo de educação é eminente. Ademais, muitos professores ainda concordam que o método de ensino tradicional, pelo fato de alguns não possuírem domínio na tecnologia. Com isso, é necessário a adaptação dos profissionais nesse novo método de ensino.', 'Em resumo, é evidente que a educação a distancia será o principal modelo de ensino no país , é necessário que a população se adapte ao ensino a distancia. Paralelamente, o Ministério da Cincia e Tecnologia invista em institutos tecnológicos, para que pessoas de baixa renda e professores que não possuem domínio a tecnologia podem se acostumar a esse novo método de ensino, assim o Brasil seguirá em frente.']",160,160,120,160,120,720
101,A polícia que nos acuda,"['Não importa se         organizado         ou         não         os grupos criminosos que atuam no Brasil devem ser combatidos. Os cidadãos percebem no dia a dia o que as pesquisas têm informado. A violência vem crescendo de forma exponencial. Só uma polícia eficiente para restabelecer a sensação de segurança da população.', 'A região sudeste, como de costume, está mais presente na mídia. Porém o agravamento da violência é um fenômeno nacional. Recentemente                 a onda de ataques a policiais chegou          em          Santa Catarina. Não sabemos se causa ou efeito, o consumo de drogas e contrabando de armas também está                  aumentando.', 'Outro fato comum a todas as regiões é a desvalorização da profissão policial. Ela é mal remunerada e extremamente perigosa. Não atrai profissionais qualificados e algumas vezes pessoas com objetivos escusos entram na corporação já com o intuito de se corromper.', 'Em São Paulo         têm          -se percebido que a reação dos grupos criminosos se deu devido          à          excessos cometidos pelos policiais.                A polícia deve agir dentro da         legalidade. Respeitando         os direitos humanos e deixando que o judiciário cumpra sua tarefa de fazer justiça.', 'Na situação em que se encontra a segurança pública no Brasil, só uma polícia valorizada pode restabelecer a sensação de segurança que a sociedade tanto almeja. Isso se dá com salário digno e uma estrutura moderna. E os policiais                 devem fazer o seu trabalho respeitando a dignidade da pessoa humana.']",200,160,160,160,200,880
90,,"['Segundo as Organizações das Nações Unidas (ONU), todos os países têm obrigação de combater a transfobia. Não obstante, o Brasil é o primeiro no ranking mundial de países que mais matam transexuais e travestis. Hodiernamente, a transfobia no Brasil tem se tornado cada vez mais violenta, mesmo com a existência da lei 7.716/1889, que a configura como crime. Assim, mostra-se relevante pensar no combate a esse preconceito, uma vez que o afastamento social e a violência configuram as maiores problemáticas desse pernicioso cenário de preconceitos.', 'De início é notório destacar que a exclusão gerada pela transfobia causa graves problemas à transgêneros. Por conseguinte, a população trangênero têm maiores dificuldades em concluir a vida escolar e ingressar no mercado de trabalho, gerando maior fragilidade desses grupos. Prova disso recai na falta de emprego, tornando-os mais vulneráveis a prostituição, abusos psicológicos, discriminações e violência sexual, além das agressões que podem sofrer no ambiente de trabalho. Ademais, cabe ressaltar a opressão imposta sobre a comunidade transexual. Esse contexto envolve várias causas como a questão estrutural, desinformação, questões religiosas e de estereótipo. Sendo assim, torna-se urgente reconhecer a suma importância de ações para o combate a essa aversão.', 'Com o objetivo de minimizar a transfobia é dever dos órgãos governamentais realizarem a criação de medidas públicas eficazes. Outrossim, são necessárias leis que garantam segurança e direitos transgêneros, apoio psicológico e pedagógico, afim de erradicar a taxa de evasão escolar deste grupo, inclusão desse assunto em aulas de biologia, para evitar a desinformação, bem como campanhas de apoio a importância dos estudos. E uma maior taxa de contratação de transgêneros abrindo o espaço de trabalho de forma significativa. Somente assim deixarão de estar à margem da sociedade.']",200,160,160,200,160,880
73,De D. Pedro II à Tv,"['O preconceito sempre existiu! Basta estudar um pouco de história para perceber que os negros sempre foram sinônimos de mão de obra e, por sua vez, não eram recompensados pelos esforços oferecidos à população. E quando achavam que a situação melhoraria, percebiam que haviam sido enganados.', 'Em primeiro lugar, o Brasil demorou muito para abolir a escravidão. A Inglaterra previonava-o no século XVIII e XIX devido seu processo de industrialização e queria aumentar o público consumidor em todo o mundo e como o escravo não tinha dinheiro ele não podia comprar os produtos ingleses. O Brasil deveria ter abolido a escravidão neste período, porém foi criando leis principalmente no II Reinado, como a Lei do Ventre Livre, Lei Eusébio de Queiroz e Lei dps Sexagenários.', 'No entanto, essas leis eram ineficazes, pois, respectivamente, as crianças consideradas livres continuavam com suas mães trabalhando . A proibição do tráfico fez com que os escravos fossem mais caros. E por fim, nenhum escravo chegava aos 60 anos. Quando hove a abolição em 1888 o Estado não ofereceu suporte para essas pessoas e ninguém queria contratar ex escravos, fazendo com que eles continuassem sem teto e alimento.', 'Atualmente  é possível observar os negros  enfrentando tantas dificuldades quanto os seus antepassados. Dificuldades para arranjar emprego, criticas em relação a cotas nas universidades, pois muitos falam que elas tiram a vaga de alguém, provavelmente um branco, além de apelidos ofensivos em referência a cor da pele.', 'Portanto, é preciso que principalmente a mídia ajude a diminuir o preconceito até que ele não eista mais. Por que não colocar o galã da ""novela das 9"" como sendo uma pessoa negra e não o classico loirinho de olhos claros? Por que acostumar as pessoas a ver somente brancos quando na verdade a maior parte da população é negra? Quando as pessoas refletirem sobre essas perguntas haverá um país com mais respeito. E as escolas com auxílio do Ministério da Educação devem ensinar que todos são iguais e que a cor não define a capacidade  ninguém.']",120,120,120,120,80,560
89,Isolamento,"['O Covid-19, vírus surgido, em 2019, na China, espalhou-se por todo mundo, configurando uma pandemia, que gerou uma crise na saúde global.  Neste contexto de transformações bruscas da sociedade, o povo brasileiro, já marcado por uma eminente desigualdade social, passou a enfrentar uma ferrenha crise econômica, gerada pelo isolamento em massa das pessoas, que perderam, em grande parte, seu poder de compra e deixaram de impulsionar setores da economia, como o turismo. Por conseguinte, as medidas restritivas passaram a ser amplamente desrespeitadas, resultando em um agravamento no quadro pandêmico brasileiro. Desse modo, é imprescindível a conscientização das pessoas  sobre o isolamento social, cuja promoção está sendo prejudicada por fatores de cunho social e pela desinformação em relação a esse novo vírus.', 'Primeiramente, é relevante pontuar que um número significativo de brasileiros saem às ruas por uma questão de subsistência, já que cerca 52 milhões de brasileiros, de acordo dados de 2020 do Instituto Brasileiro de Geografia e Estatística, vivem na pobreza, não tendo acesso aos itens que satisfazem as suas necidades básicas. Assim, a permanência desses cidadãos em seus lares também representa um risco às suas vidas, já que sem o dinheiro conquistado diariamente, poderão morrer de fome. Logo, deve haver medidas que não somente determinem o isolamento social, mas que também criem condições para que os cidadãos de classe baixa permaneçam em seus lares, sem estarem sujeitos aos riscos que vão além do coronavírus.', 'Por outro lado, a propagação de informações falsas sobre a pandemia faz com os indivíduos reneguem o cenário caótico da saúde e deixem de tomar cuidados essenciais para evitar uma possível contaminação. Segundo a escritora Hannah Arendt, o mal pode apresentar-se como algo banal. Tal perspetiva pode ser associada à tentativa irresponsável de pessoas que disseminam, principalmente através das redes sociais, a ideia  de que o Covid-19 é algo normal, que deve ser aceito e irrelevado no cotidiano, pois uma crise econômica seria mais cruel do que o proprio vírus. Então, constitui-se a necessidade do combate à desinformação associada à pandemia.', 'Portanto, cabe ao governo federal do Brasil , cujo papel é realizar ações que visem o bem de toda a nação, criar um site no qual estejam unificadas as informações atuais da pandemia e das medidas restritivas presentes em todo o território brasileiro, o que deve ser realizado por meio da cooperação das Secretárias Estaduais de Saúde, a fim de conscientizar a população acerca da disseminação do coronavírus e, consequentemente, aumentar o índice de isolamento social. Além disso, os governadores dos estados do Brasil devem garantir que cidadãos carentes, que geralmente são trabalharadores informais, tenham acesso à alimentação, por meio da distribuição mensal de cestas básicas, a fim de evitar que famílias passem fome e tenham que, obrigatoriamente, sair de suas casas para trabalhar nas ruas, onde estarão potencialmente expostos ao Covid-19. A partir dessas ações, a conscientização das pessoas sobre o isolamento social alcançará sucesso e a sociedade brasileira estará mais próxima do retorno do ""verdadeiro normal"".']",160,200,160,200,200,920
93,Mães no Preto e Branco,"['Em muitas produções cinematográficas é representado o parto humanizado de uma forma dolorosa e difícil para a mãe, bem como para os ali presente; este era o único método em tempos passados, e não havia outra alternativa senão aquela, muitas mães morriam durante o parto, justamente por não suportar a dor momentânea, que é comparada a quebra de todos seus ossos de uma vez. Mas isto mudou nos dias atuais, hoje,  se contém uma equipe medica especializada em partos naturais, bem como na segurança da mãe e da criança, métodos e técnicas que traz confiança e conforto na hora do parto.', 'Deve- se pontuar que a escolha pelo parto humanizado é estritamente da mãe, onde a mesma toma a decisão de como receberá seu filho, a assistência medica irá interferir apenas em casos de urgência, quando visto a saúde da mãe e do bebe em estado de risco. Por seguinte, a gestante terá livre controle do seu corpo para realizar o parto, o que muitos concordam,  ser uma decisão benéfica tanto para a mãe, quanto para a criança, que não terão seus corpos “invadidos”, será um processo natural -bem como lento- de conexão na primeira vez entre os dois e ainda livra a mãe de dores prolongadas e da recuperação da cirurgia.', 'No entanto, deve-se levar em conta a saúde da mãe e da criança, tal como, especialização medica presente e estrutura emocional da gravida, sabendo que será demorado e hostil;  o que não significa ser menos seguro, pelo contrário, pesquisas científicas apontam que o parto normal é mais seguro para mãe e o bebê. O que, de fato, faz 80% das mulheres gravidas decidirem fazer cesariana, é o medo posto encima das mesmas referentes a partos normais, com relatos exagerados e terríveis, o que s faz ficar repreensiva em relação à vontade que tinha.', 'Portanto, concluísse que a vontade de realizar partos humanizados é do natural da mãe, no entanto, muitas vezes, o sistema,  decide por ela e dizem não ser o correto e seguro, realizando um procedimento cirúrgico e perigoso que deveria ser usado apenas em casos realmente necessários. Por isso, deve-se predominar a vontade da mãe sempre, e ainda dar confiança para elas; não deve haver pressão encima da gestante na hora, e ainda, assegurar da importância de partos humanizados, tanto pessoalmente como na mídia, a fim de garantir uma enorme visibilidade e mostrar ser uma opção segura e de grande conexão materna.']",120,120,120,160,120,640
92,1AA,"['""Discriminação por causa de sua classe, sua cor"", trecho da música ""Faroeste Caboclo"" da banda Legião Urbana, descreve o que parcela da população de ascendência asiática sofre por causa do preconceito e desinformação. Nesse sentido, é necessário o debate acerca do exposto, bem como ações que revertam esse quadro.', 'A priori, é válido ressaltar que preconceito é uma ideia generalizada sobre determinada coisa ou pessoa. Sob essa lógica, observa-se o estereótipo como consequência do senso comum, a qual se manifesta através de atitudes preconceituosas, por exemplo, xingamentos contra pessoas asiáticas, como ""olho puxado"" ou ""japa"" sem levar em consideração seu lugar de origem. Assim, de acordo com o imperativo categórico kantiano, discriminar alguém por causa de traços físicos não pode ser considerado uma norma universal por ferir a dignidade humana garantida pela Constituição federal.', 'Em segundo lugar, as práticas preconceituosas resultam da falta de informação e por conseguinte, da ignorância. Para comprovação dessa assertiva, diante da pandemia causada pelo covid2019 viralizaram casos de discriminação contra asiáticos na internet com a suposição de que esse grupo, em especial os chineses, são os causadores dessa doença. Dessa maneira, cria-se uma norma segregacionista contra essa população mesmo não havendo provas oficiais que comprovem essa afirmativa. Consequentemente, pelo desconhecimento de alguns uma parcela da população é afligida incoerentemente.', 'Depreende-se , dessa maneira, a urgência de medidas que atenuem a problemática. Para isso, é necessário que as grandes corporações midiáticas como Twiter e Facebook - visto que hodiernamente o preconceito amarelo, em grande parte  acontece nessas redes sociais-, promova em suas plataformas medidas que restrijam ações desse tipo, como a inibição de mensagens preconceituosas e logo em seguida  com o direcionamento à central de denúncias através do número 100, para que a dignidade humana seja respeitada.']",160,160,160,200,160,840
83,Esporte como instrumento de manutenção social,"['Aprendizado. Esse conceito, se refere ao objetivo de grande parte das experiências humanas. Para tanto, desde a Grécia antiga, filósofos buscam entender quais ações trazem verdadeiro conhecimento ao ser humano. Hoje, entendemos que as práticas esportivas, que antes eram vistas somente como prática de lazer ou com finalidade competitiva, são capazes de transmitir valores como disciplina e honestidade.', 'Em primeiro lugar, nota-se que, a prática esportiva pode contribuir de maneira significativa para a manutenção da saúde mental e física do ser humano, principalmente quando iniciada desde a primeira infância, quando estão sendo desenvolvidos metabolismo e cognição do indivíduo. Porém, um fato pouco explorado no Brasil, é a potencialidade do esporte como forma de educação. Por desenvolver disciplina, respeito ao próximo, espírito competitivo e responsabilidade, o esporte é um importante pilar para a manutenção social.', 'Outra questão a ser tratada, é a eficiência demonstrada pelo esporte no combate à criminalidade. O fato é que, quando o jovem tem contado com atividades esportivas, em conjunto com outros indivíduos, recebe orientação para a prática social, além de aprenderem a respeitar o outro, assim, integrando-se. Diante disso, ONGs Brasileiras, como o Instituto Bola pra Frente no Rio de Janeiro, resgatam crianças e jovens das ruas e através do esporte, afastando-os do tráfico de drogas, e das milícias que comandam áreas pobres das cidades brasileiras.', 'Entende-se, portanto, que o ser humano apresenta grande potencialidade para desenvolver habilidades e valores através de atividades e experiências. Então, é dever do Governo Federal, prover verba para a disponibilizar espaços destinados à prática de atividades esportivas, esses, devem apresentar acessibilidade para cidadãos com deficiência, e estrutura para atender indivíduos de todas as idades. Outrossim, é dever do Ministério da Educação investir na realização de atividades físicas dentro das escolas, diante da supervisão de profissionais de educação física.']",160,200,160,200,200,920
88,Tentativa Número 1 (KMQ),"['Durante o século XXI o número de casos de pessoas com problemas mentias só vem aumentando - principalmente no Brasil - e, infelizmente, existe um grande estigma da sociedade em relação aos mesmos, que deve ser combatido o mais rápido possível . Esse preconceito se dá, seja pela falta de conhecimento da população em relação às doença mentais, além,  da ineficiência do Estado se tratando da problemática.', 'Primeiramente, é imprescindível salientar como a falta de entendimento dos brasileiros sobre o panorama supracitado agrava a situação. Segundo a narrativa do filósofo Platão denominada ""O Mito da Caverna"", haviam três prisioneiros acorrentados desde o nascimento em uma caverna, onde possuíam apenas como informação as sombras e sons que apareciam no local, tendo uma visão totalmente turva sobre a realidade. Analogamente a essa história, percebe-se como a visão errada sobre determinado assunto causa estranheza e afeta a forma de compreensão sobre um problema, e isso, infelizmente é o que ocorre em relação a essas doenças.', 'Segundamente, vale ressaltar a ineficiência do governo no tratamento de tais problemas, que assola grande parte do povo brasileiro. De acordo com Thomas Hobbes, o Estado deve arcar com o bemestar da população. Entretanto, no Brasil, tal pensamento é realizado com pouca eficiência, quando se trata do enfrentamento baixa saúde mental. Tendo em vista que o país é o primeiro com mais casos de depressão na população em relação a América Latina, dado divulgado em 2017 pela Organização Mundial da Saúde (OMS). Certamente, isso não pode ficar assim, é uma incidência muito alta e deve ser combatida.', 'Portanto, fica evidente a necessidade de medidas para amenizar essa situação. O Ministério da Saúde deve, por meio de palestras em escolas e universidades, conscientizar a população acerca das doenças mentais, evidenciando ao máximo que elas são realmente um problema e não um motivo para satirizar as pessoas, com o objetivo de findar o preconceito dos cidadãos sobre o tema. Ademais, o governo federal deve construir campanhas de tratamento psicológico, por intermédio de verbas públicas, com o intuito de amenizar a quantidade de brasileiros em estado de depressão no país. Fazendo isso, o estigma associado às doenças mentais na sociedade brasileira terá seu fim.']",160,160,160,200,200,880
141,Eurozona,"['Os países da         zona do euro vem         sofrendo há alguns anos uma crise financeira que atravessa as fronteiras europeias e afeta diversos países no mundo, inclusive o Brasil. Esse atual cenário pode afetar as exportações e os investimentos estrangeiros em nosso país.', 'A Europa é o maior continente comercial do planeta e sua atual crise pode romper as estruturas de exportação mundial. Países europeus deixam de importar do Brasil e         o mesmo         sem o capital oriundo das         exportações         deixa de importar de outros países, criando um cíclico efeito dominó.', ""O                 Bric's                recebe diversos investimentos do exterior, grande parte vem de países da         eurozona.         Em decorrer da situação financeira atual nesses territórios, os investimento feitos em países emergentes podem passar a ser feitos em zonas de maior estabilidade e segurança econômica, como EUA e China. Essa mudança de cenário acaba prejudicando o desenvolvimento dessas novas potências mundiais."", 'A crise econômica europeia não se restringe somente a este continente, ela ultrapassa os oceanos e afeta diversas partes do globo. A situação financeira na Europa precisa ser logo solucionada para acabar com esta terrível reação em cadeia que abala o mundo.']",160,160,120,160,160,760
51,Analfabetismo funcional no Brasil,"['Não há como negar que ,  a falta de oportunidade é um dos maiores inimigos dos iletrados, e aliado ao aumento de desigualdade no Brasil. Segundo o Inef , em 2009, 27% dos brasileiros eram considerados analfabetos funcionais - e o índice se repetiu em 2011 diante.', 'É importante ressaltar, em primeiro plano, de que forma o governo tenta ajudar essas pessoas necessitas de informações. Nesse sentido, a gestão pública, prefeito/governador interessam-se muito mais na educação tecnicista dos jovens, pois é uma parcela pequena, esquecendo-se de milhares de brasileiros que tem dificuldade de compreender textos simples. Sob esse âmbito, há extrema necessidade de acometer na educação, pois à riqueza e o poder de um país como um todo, são prejudicads quando pessoas comuns são iletradas.', 'Outro aspecto a ser abordado,  é a falta de interesse dos próprios desconhecedores . Segundo pesquisas, os analfabetos funcionais são usuários frequentes das redes sociais, no que concerne na falta de estímulo para deixar de ser iletrado, por esses indivíduos acharem que são capazes de navegar em redes sociais diariamente, não se libertam da situação na qual se encontram sujeitados - neste caso o analfabetismo funcional.', 'Portanto, a falta de investimento juntamente com a falta de interesse, são os pilares para ainda existir analfabetos no Brasil. Mediante isso, o Ministério da Educação em conjunto com uma empresa de aplicativos, deveriam desenvolver programas que incluísse pessoas de meia e terceira idade, com funções de voz, compreensão de texto, entre outros. Com o propósito de erradicar de vez o analfabetismo funcional do Brasil.']",120,160,80,160,80,600
148,Brasil,"['Ultimamente, no                 Brasil                , o                 número de violência                tem aumentado.                 Sabendo-se         que, iremos         sediar eventos grandiosos, com repercussão internacional,                 nos perguntamos:                será que o                 Brasil                está preparado para tais eventos? Será que nossas autoridades estão preparadas?', 'O Brasil receberá milhões de pessoas devido          a copa do mundo          , o que será um teste para o Brasil, e, pelo fato de nunca ter acontecido nenhum atentado terrorista ou algo parecido no país, as autoridades não estão tão preocupadas          de que aconteça uma coisa desse tipo          , porém é necessário prevenir, já que sabemos que a violência no Brasil é crescente e que receberemos milhares de pessoas.                A possibilidade de um atentado terrorista não está fora de cogitação.', 'Por tanto         sabemos o quanto será indispensável ter no país                 polícias e guardas                extremamente preparados e capacitados para todo e qualquer tipo de situação, entre elas a de um ataque terrorista.']",120,80,80,80,0,360
40,O desinteresse da beleza moderna,"['É possível definir um padrão para a beleza? Seria um padrão universal? A diversidade é uma das principais características do mundo moderno, mas vem sendo ameaçada pela “ditadura da beleza”, onde o belo é estipulado e deve ser seguido para se viver bem na sociedade. Kant diz que o belo é subjetivo, podendo ser mudado de acordo com cada perspectiva, ou seja, o que é considerado belo para um indivíduo poder não ser para outro. Levando em conta também Platão, outro grande filósofo, que acreditava que o belo, em sua plenitude, nunca poderia atingido em plano físico. Porém, nada muda a situação atual, vive-se uma corrida sem fim para alcançar a beleza física. O Brasil é o segundo país onde mais são realizadas cirurgias plásticas no mundo, perdendo apenas para os Estados Unidos, mas nem sempre os resultados são como o esperado. Além de poder afetar o físico do paciente, a cirurgia plástica ameaça, também, o psicológico em casos de resultados ruins. Nem sempre existiram cirurgias para que se pudesse mudar o que lhe é insatisfatório, não seria possível continuar vivendo sem tais usos? O número de cirurgias realizadas por ano aumenta cada vez mais e, agora, atingindo ainda mais número de jovens. Aceitar-se e amar-se são as maiores armas contra a “ditadura da beleza”, que domina a sociedade atual. “O belo, é tudo quanto agrada desinteressadamente.” A saúde mental e física vem à frente de qualquer outra coisa, se cuidar é se amar.']",120,200,160,160,160,800
86,,"['É notório que ouso das redes sociais vem crescendo a cada dia, e como milhares de pessoas utilizam redes como o Instagram, que possibilita a exposição de fotos e vídeos, essas publicações podem vir a alcançar milhares de pessoas de uma forma negativa. problemas surgem. A fácil influencia e a depressão são males que podem vir surgir quando se usa as redes sociais.', 'A priori, o uso de redes sociais constantemente para visualização de influenciadores digitais e blogueiros, causa uma tendência a seguir opiniões, é como um cantor em um palco ordenando as pessoas, todos seguem cegamente pois ele é o portador da voz que todos escutam. escritora J.K. Rowling disse “influenciamos as pessoas somente por existir” muitas vezes os visualizadores de determinado influenciador obtém uma opinião formada por ele e a espalha pelo mundo, formando assim uma corrente que pode ou não ser maléfica, mas que causa problemas de diferentes maneiras.', 'Segundamente, a depressão é causada pelo uso das redes sociais, além de outros fatores externos, é como uma bola de neve, vários problemas em seguida podem causar a depressão . O ato de comparação seja físico ou financeiro com outras pessoas que postam uma vida cheia de filtros e mentiras, assim enganando as pessoas que faz nascer um sentimento de inveja ou ódio pratica o cyberbullying que é o bullying pela internet . É comprovado por neuro cirurgiões que a luz azul emitida por aparelhos eletro eletrônicos pode piorar o quadro de depressão.', 'Tendo em vista os argumentos citados, fica evidente os impactos do uso das redes sociais na saúde mental. É preciso que o cidadão comum filtre o que vê na internet, e juntamente com os desenvolvedores dos aplicativos, devem criar filtros para comentários maldosos e depreciativos, com a finalidade de diminuir casos como depressão e a má influencia nas redes sociais.']",160,160,120,160,160,760
103,Auto Medicação ,"['Populações de países                , do jovem ao         idoso         estão aderindo         a auto medicação sem preocupar-se         com as consequências. O que fazer para que as pessoas         se alertem         e preocupem-se com esse                 método                de medicação?', 'Dos jovens aos maduros                , como Michael Jackson, atormentados por problemas         diversos         procuram a fuga por meio de medicamentos controlados, calmantes e anestésicos,                 que por sua vez, a overdose acaba por ser seu final.', 'Não apenas esses          medicamentos como também,          remédios que          alteram também          o funcionamento de hormônios e órgãos, como anticoncepcionais, remédios para o coração ou fígado e antibióticos.', 'Entretanto, o tratamento médico não         estar         ao alcance de         todos, além         disso, se pessoas com problemas variados         for ir a         procura dos hospitais e clínicas, haverá um provável colapso,                 congestionando os mais necessitados pelos casos fúteis ou menos          grave         .', 'Logo, folhetos e propagandas que alertem                o perigo dos medicamentos utilizados de maneira errônea, para que todos tenham                 conhecimento, consciência e preocupação ao ingerir certas químicas                que podem ser letais,         seria         uma medida para a prevenção das piores consequências.']",80,80,0,0,80,240
98,É tempo dá reeducação alimentar.,[],120,120,160,160,80,640
71,Suicídio entre os jovens,"['A série de televisão americana, 13 Reasons Why,  relata a história de uma adolescente que vivenciava a angústia do bullying no colégio diariamente, fora diversos outros problemas pessoais que carregava sozinha, até que um dia cometeu suicídio.', 'Como relatado acima, é multicausal os porquês de um suicídio . Nem sempre a pessoa quer tirar a própria vida, mas sim acabar com o tormento que leva consigo.', 'A maior parte das pessoas que põe fim à própria vida sofre de algum tipo de transtorno mental, abalo emocional ou traumático, passando-se por despercebido dos familiares e amigos. O assunto vai além do caráter pessoal, é interesse social quebrar o silêncio e amenizar o índice que chega a 60% de mortos, segundo a Organização Mundial da Saúde .', 'É imprescindível a intervenção do Ministério da Educação  nas escolas, fornecendo palestras e apoio psquiátrico. A mídia também deve divulgar entrevistas com psiquiatras, informar sobre CVV- Centro de Valorização da Vida-, é importante ressaltar que a família deve estar em alerta e apoiar o jovem, para evitar uma possível tragédia. Dessa forma, o Brasil estará mais distante de 13 Reasons Why e mais próximo de um futuro consolidado.']",120,120,120,120,120,600
46,Privatização do saneamento básico a.a.x,"['Segundo o 25° artigo da Declaração Universal dos Direitos Humanos, toda pessoa tem direito a um padrão de vida adequado. Visto isso, como os demais membros da ONU(Organização das Nações Unidas), o estado brasileiro tem o dever de cuidar das questões higienistas. Entretanto a desestatização dos serviços de limpeza aprovada pelo senado, a qual objetiva transferir tais atividades para o setor privado, desrespeita o compromisso firmado com as Nações Unidas em 1945, no pós-guerra. Isso favorece a minoria mais rica em detrimento da maioria mais pobre; além de demonstrar descaso do governo para com a sociedade. Logo essa realidade constitui um desafio a ser resolvido não somente pelos poderes públicos, mas também por toda a sociedade.', 'Primeiramente, é importante salientar a relação da venda das empresas estatais responsáveis pelo saneamento adequado com o fortalecimento da elite econômica e das desigualdades. Quando o Reino Unido privatizou a área mencionada, o valor das contas de água aumentaram de 100 a 200%, enquanto os valores das ações dos empresários aumentaram cerca de 1000%;  o que levou o governo britânico a reestatizar o setor. Fatos como o supracitado ocorrem porque o objetivo do meio empresarial, na maioria das vezes, é o lucro; e como a limpeza tráz grandes custos, ele aumenta as taxas para não ter prejuízos com a lucratividade. Destarte, levando em consideração que o Brasil possui 13,5 milhões de miseráveis, de acordo com o site UOL; a privatização representa um retrocesso, enorme, no combate a miséria, pois como tais cidadãos não têm condições de pagar pelo serviço, as empresas irão procurar os grandes centros urbanos e deixar as favelas e cidades do interior sem investimentos.', 'Outrossim, convém lembrar ainda a negligência do governo mediante as questões sociais, como as de saúde e de saneamento básico, por exemplo. Isso configura violência simbólica, haja vista que os representantes políticos têm procurado, cada vez mais, acabar com as suas responsabilidades e transferi-las à população, algo paradoxal à democracia, que apesar de ser um regime no qual o poder emana do povo, os governantes têm atuado contra ele. Um exemplo disso é o fato de os investimentos em saúde estarem ""abaixo do ideal"", segundo a Confederação Federal de Medicina; e essa área também inclui o saneamento básico - visto que saúde refere - se qualidade de vida e não apenas ausência, ou não, de doenças.', 'Portanto, nota-se que privatizar o saneamento favorece a elite econômica, prejudica os pobres, demonstra descaso governamental e suscita intervenções. Para atenuar a problemática, a sociedade  deve ir às ruas para se manifestar pacificamente contra a privatização desse setor; e para isso deve se organizar em movimentos sociais - porque foi através deles que as mulheres conquistaram o direito ao voto e de poder representar políticos - por exemplo. Assim, pretende-se pressionar os governos estaduais e federal não privatizarem a higieni.']",160,160,160,200,160,840
92,preconceito amarelo  jujuba 0042,"['Desde a descoberta do corona vírus pessoas asiáticas e descendentes estão sendo atacadas preconceituosamente pelo fato do vírus corona ter aparecido na hina em Wuhan 2019 ,esse foi o primeiro passo do preconceito hoje presente entre asiáticos no mundo todo podendo acontecer entre fisicamente e verbalmente.', 'Antes mesmo do vírus aparecer ataques já eram presentes verbalmente como; se tem japa na sala já pode desistir da vaga, mas com a aparição e confirmação do vírus passou a ser físico podendo levar a vitima para o hospital , os ataques começaram a ser mais frequentes em 2020 com a descoberta e confirmação.', 'Esse assunto deve ter mais clareza e ser debatido mostra a todos que ele esta presente e que deve ser combatido para não haver problemas psicologicamente podendo causar a depressão ou ate mesmo a podendo levar a suicídio']",160,120,80,120,80,560
43,O aumento dos discursos de ódio e cancelamentos nas redes sociais,"['O surgimento da internet, durante o período de conflitos ideológicos caracterizado como Guerra Fria, se deu por meio da evolução da tecnologia, situação que possibilitou drásticas mudanças nas relações de comunicação. Todavia, hoje as famigeradas redes de informação propiciaram um ambiente conflituoso, através da multiplicação de notícias falsas. Além disso, a atribuição de posicionamentos irrestritos traz o reflexo de uma sociedade condenadora.', 'No âmbito da discussão, é importante ressaltar que a disseminação de inverdades, conhecidas popularmente como ""Fake News"", pode ser qualificada como um ato de ignorância, visto que ao propagar mentiras sobre um indivíduo, pode favorecer discursos agressivos e difamações desnecessárias. Dessa maneira, é estritamente necessário posicionar a obra cinematográfica ""Rede de Ódio"", Jan Kamasa, que em seu enredo aborda cenários de notícias falsas, com o intuito de destruir reputações alheias e causar caos, assim como ocorre na realidade. Continuamente, os tendenciosos discursos de ódio ploriferados na internet, são em suma maioria anônimos, ao que a falta de identificação dos agressores é um fator de influência à impunidade.', 'Ademais, fora da ficção, para a escritora Evelyn B. Hall, independente do posicionamento individual de uma pessoa, é dever da sociedade defender o direito de opinar, caracterizando a liberdade de expressão-defendida pela Declaração Universal dos Direitos Humanos. Contudo, hodiernamente, essa forma de expressão tem sido utilizada de modo contraditório, ao promover o julgamento constante e hipócrita de pautas interpretadas erroneamente, prejudicando os afetados. Desse modo, se torna visto a polêmica ""Cultura do Cancelamento"", em que diversas pessoas se apropriam de ocorridos e atuam de maneira incorreta e desrespeitosa, ao tentarem, falhamente, buscar justiça para o que creem ser politicamente correto, ocasionando mais desavenças e acessos agressivos nas redes.', 'Portanto, torna-se evidente a necessidade de providências para alterar o cenário conflituoso. Assim, é mister que o Poder Legislativo , com o ideal de suscitar a amenização dos discursos agressivos, promova a elaboração de uma Lei Complementar Constitucional - com aprovação da maioria absoluta dos membros do Senado - por meio de medidas protetivas para apaziguar a adversidade. Somente assim, a liberdade de expressão será utilizada de modo correto, sem a hipocrisia e ataques desnecessários em redes de comunicação.']",160,120,120,200,160,760
3,Pré-Conceito,"['Desde a pré-história, o homem sempre se utilizou do conhecimento inovador para evoluir. O fogo, a faca, a escrita, os meios de transporte, de comunicação (rádio, tv, internet), entre outros, foram marcos tecnológicos, cada qual a na sua época, que facilitaram o processo de evolução da espécie humana. Portanto, é inegável que essas tecnologias trouxeram benefícios à humanidade e, nesse contexto linear, tendem a progredir infinitamente. Entretanto, sempre houve e ainda há pessoas que fizeram e fazem mau uso de tais instrumentos, o que alimenta o medo e a insegurança de parte da sociedade diante do novo.', 'Aqueles que são contrários ao desenvolvimento tecnológico sustentam suas crenças com base em fatos negativos que afetaram profundamente a humanidade, como, por exemplo, as consequências nefastas do regime nazista na Alemanha. Não se pode desprezar a possibilidade de um revés no uso da ciência e da tecnologia, visto que, em última instância, têm o poder de causar o extermínio da própria humanidade, assim como ocorreu, em menor proporção, com a bomba atômica em Hiroshima. Todavia, prender-se a isso seria ter uma visão pessimista do progresso, tal qual teve a personagem do episódio ""O velho do Restelo"", do livro ""Os Lusíadas"", de Camões.', 'Já os que defendem o uso da ciência e tecnologia, em uma visão mais otimista, encaram-no como meio de superação dos limites humanos. Esse olhar encontra respaldo no fato de que todos os avanços tecnológicos promovidos pela ciência, em qualquer área, sempre contribuíram para que o ser humano transpusesse suas barreiras pessoais ou do meio em que vive. Como exemplo mais antigo, tem-se a elementar descoberta do fogo, e, na sociedade atual, a utilização da Inteligência Artificial (IA). Prova disso é o uso da IA nas escolas para melhoria do processo de ensino-aprendizagem, na medicina para diagnósticos mais rápidos e eficazes, entre outras áreas, conforme recente matéria publicada no portal de notícias ""G1"".', 'Portanto, a evolução da humanidade por meio da ciência e tecnologia, atualmente denominada de revolução transumanista, ainda que utopicamente, é algo inerente a sua condição, faz parte da história da sociedade e é um ""caminho sem volta"". Apesar da possibilidade de ser empregada com finalidade diversa, ela (a revolução transumanista) não deve ser vista pelo lado negativo da teoria darwinista, em que só os mais fortes sobrevivem, mas sim pelo lado positivo, científico, que denota a evolução da espécie humana. Será que a humanidade teria sobrevivido se o homem, à época, tivesse se prendido unicamente nos malefícios do fogo?']",200,200,200,200,200,1000
94,Autismo,"['The good doctor, typical. Esses são exemplos de seriados que abordam desafios diários de pessoas com autismo, comprometimento da interação social, da comunicação verbal e não verbal e comportamento repetitivo, essas são características do transtorno do espectro do autismo. Isso, infelizmente, gera consequências nefastas, mostrando a necessidade de soluções.', 'O número de pessoas com autismo, que têm acesso à escola aumenta gradualmente, mas a educação especial ainda passa por desafios na qualidade de atendimento. Deficiências comportamentais e cognitivas e a falta de preparo das escolas dificultam ainda mais o processo de inclusão, e como consequência pessoas com autismo acabam não tendo o acesso necessário à educação e ao lazer.', 'Para que pessoas com esse tipo de problema mental tenham acesso a uma boa educação escolar, é preciso atenção especial, infraestrutura adequada para atender as necessidades de cada estudante, os professores devem ter acesso ao desenvolvimento do aluno, e fazer com que o mesmo se sinta confortável no ambiente escolar.', 'O ministério da educação em parceria com ongs sociais, devem criar campanhas educacionais sobre inclusão na escola, para professores e alunos sem problemas mentais. Isso deve ser feito por meio das mídias televisivas, nas escolas e em plataformas de “streaming”: por exemplo, instagram, youtube.']",120,160,120,160,120,680
57,,"['No livro ""A dialética do esclarecimento"" de Theodor Adorno, o autor faz uma crítica a cultura de massas. Após sair da Alemanha nazista, Adorno encontra-se nos Estados Unidos, no período em que o capitalismo estava em ascensão. O consumo exarcebado dos meios audiovisuais, desencadeiam uma Anomia Social, citada por Emile Durkein , a qual a sociedade acredita estar vivendo de maneira homogênea no meio cinematográfico, quando na verdade, isso é apenas uma utopia por boa parte da sociedade. É exatamente nesse ponto que o autor introduz sua obra.', 'É indubitável que o surgimento da globalização desencadeou pontos negativos na sociedade brasileira . Ademais, a esfera tecnológica não alcança boa parte do país, salvo os grandes centros urbanos e turísticos que recebem mais investimentos na área cinematográfica. Mesmo após cem anos desde a criação do cinema em París, essa problemática persiste. Nesta perspectiva, cabe as empresas valorizarem e investirem mais capital nas pequenas cidades brasileiras, afim de obter mais lucro para assim expandir seus negócios.', 'Outrossim, pode-se fazer menção das grandes emissoras de televisão, as quais tem o seu crescimento elevado, desfavorecendo as grandes empresas capitalistas cinematrográfica. Tais emissoras detém maior percentual do público por oferecer de maneira democrática e acessível boa parte de seus conteúdos. Apesar da qualidade audiovisual das grandes empresas do cinema, elas perdem na parte quantitativa péla dificuldade e burocratização em sua acessibilidade.', 'Diante do exposto, a melhor forma de atenuar essa problemática é com investimento em infraestrutura urbana, tendo o Estado como principal agente. Além disso, as grandes empresas privadas deverão investir mais capital nos subúrbios e nas pequenas cidades do interior brasileiro, a fim democratizar a acessibilidade a todos os cidadãos brasileiros. Dessa forma, o consumo citado por Adorno é descentralizado e toda a população terá seu direito alcançado.']",120,80,40,120,40,400
81,Intolerância,"['A Constituição brasileira nos assegura a liberdade religiosa. É direito,portanto,de todo cidadão aderir a qualquer crença e ser respeitado por sua escolha.? Mas,na prática ? não é o que ocorre. A intolerância religiosa,infelizmente,só vem ganhando espaço.', 'O Brasil, ?  apresenta um enorme sincretismo religioso. Desde 1500,com a chegada do português ,dos escravos africanos e imigrantes ?  trouxerão  consigo a sua crença. Com isso,a diversidade cultural e religiosa foi enorme.  ? Mas,  ? a intolerância com as diferenças só aumentam .', 'Dados da Secretária dos Direitos Humanos evidenciam que a crença religiosa que sofre com maior discriminação é a afro-brasileira. Esse fato se deve ao preconceito por parte da população,principalmente no tocante a  questão racial e a   falta de conhecimento. Segundo Voltaire,preconceito é opinião sem conhecimento e é isso que etá acontecendo em nossa sociedade.', 'O Estado Islâmico é uma grande referência em relação a  intolerância religiosa. Utiliza da violência para conseguir mais adeptos a sua crença. Um bom exemplo,  ? foi o ataque à revista Charlie Hebdo  ?  que matou jornalistas e cartunistas devido a uma charge sobre o líder do Estado Islâmico. Portanto,o governo deve promover palestras e debates sobre as diferentes religiões afim de diminuir a intolerância.']",120,120,120,120,120,600
57,,"['Relativo democratização do acesso ao cinema no Brasil é correto afirmar que a massa brasileira se encontra nas periferias, possuem baixa renda e com isso surge a dificuldade de frequentar o cinema . Porém com toda dificuldade podemos ver a falta de conhecimento sobre o assunto.', 'Com isso a população não consegue se expressar em relação ao contexto cinematográfico. Por todavia também seria viável que uma base superior pudesse fornecer palestras e eventos com conteúdos históricos em comunidades relacionados ao cinema.', 'A maior parte da periferia brasileira é leiga em determinados conceitos, assim a falta de disponibilidade de acesso s redes sociais, livros e entre outros, acabam dificultando a aprendizagem.', 'Sendo assim deverá ser alcançado mediante de ações que possam  resolver esse problema a ideia é fornecer programas que envolve a sociedade em um meio de aprendizagem e conhecimento sobre assuntos cinematográficos. Dessa forma, as pessoas que não conseguem ter acesso ao cinema com facilidade, o cinema vai até elas de forma divertida e didática.']",80,40,40,80,40,280
32,Entre direitos individuais e escândalos políticos,"['Os direitos fundamentais contidos na Constituição Federal não são absolutos, salvo algumas exceções conflitantes entre especialistas, o que abre margem para discussões em casos em que há convergência de direitos. Esse é o caso da decisão judiciária aplicada aos jornais para a remoção das publicações que fizeram sobre o caso de Marcela Temer e do hacker, cuja repercussão se estabeleceu no impasse sobre quais direitos teriam prioridade: liberdade de expressão ou inviolabilidade da intimidade.', 'Em uma primeira análise a inviolabilidade da intimidade teria prioridade sobre a liberdade de expressão, pois as formas midiáticas, a atividade artística, a música, etc. não necessitam de autorização para exercerem suas atividades, desde que não interfiram nos direitos de terceiros. Entretanto, quem é contra a decisão judiciária afirma que a ordem se trata de uma forma de censura, pois as imagens divulgadas do caso foram retiradas do processo judiciário público – isto é, qualquer pessoa tem o direito de acessar – e abordam tema de interesse social.', 'Nessa disputa de censura ou violação da intimidade, observa-se que há interesse político, pois as informações atingem diretamente o atual presidente do Brasil, Michel Temer, o que prejudicaria sua reputação. Então chega-se há outra questão pertinente à população: até que ponto são verídicas as alegações do hacker, sendo ele um criminoso ou não.  Afinal, os fragmentos de texto propagados na internet são dispersos e pouco se pode concluir, mas se há crime por de traz das ações do Presidente Temer, é necessário que haja investigação policial.', 'Por conseguinte, conclui-se que houve censura por parte da decisão para minimizar futuros constrangimentos a Temer. Mas, sendo este uma figura pública, o caso diz respeito aos brasileiros, que não podem ser vendados diante dos diversos casos de corrupção envolvendo políticos. Inegavelmente, o ato de hackear é crime, e o executor desse caso está pagando sua pena, mas deveria ser aberto um novo processo – em segredo de justiça, para que não haja a inviolabilidade da imagem da pessoa – para descobrirem se existe ou não marqueteiro(s) à trabalho para o atual Presidente da República, pois a justiça deve ter prioridade sobre qualquer direito individual.']",120,200,160,120,120,720
85,Participação popular na política,"['Os chamados projetos de iniciativa popular são projetos de lei que podem ser apresentados ao Congresso pela população, desde que haja um porcento do eleitorado nacional em assinaturas favoráveis. Esse instrumento foi instituido pela constituição  de 1988, mas foi pouco usado: apenas 4 projetos foram aprovados dessa maneira. Isso certamente é um meio muito útil para melhorar o funcionamento da máquina estatal.', 'Sem dúvida seria muito interessante a criação de um projeto de lei que sirva para reduzir e direcionar gastos do estado por meio da criação de um plano de prioridade para obras estatais. Nesse sistema obras relativas a saúde e educação seriam prioridade, apenas após atingir-se uma certa ""nota"" nessas categorias seria permitido investir em outras categorias, de modo a priorizar o desenvolvimento humano a outros investimentos menos importantes.', 'Essa divisão em categorias pode ser baseada no IDH (índice de desenvolvimento humano) visando aumentá-lo ao máximo. Isso pode ser feito estipulando prioridade aos fatores que mais interferem no resultado do índice, assim, seria possível conciliar o bem estar da população com o desenvolvimento das cidades em que se aplique o sistema.', 'Por tudo isso, é possivel a própria população civil implantar mecanismos para seu bem estar e aplicação adequada do dinheiro proveniente de seus tributos. Para isso, podem-se formar grupos de pessoas comuns e advogados empenhados em desenvolver tais projetos, assim a democracia iria alem da representatividade até a ação direta da população.']",160,200,160,160,200,880
90,,"[""Segundo os dados, os LGBT's são os públicos mais atacados no momento, pois mais da metade da população sofre para aceitar a diversificação do nosso país, pessoas transgênero sofrem para conseguir um emprego, sofrem para usar um banheiro. Grande parte do público LGBT tem um certo receio em se demonstrar publicamente, porque são inúmeros os casos de violência física e em casa a mesma coisa, muitos não se assumem diretamente por medo da família, por medo de perder as pessoas que amam."", 'Nosso país precisa de mais causas que lutem por esse público e pelo direito da liberdade se ser quem eles realmente são, sem medo de julgamentos e violência. São causas que realmente merecem a nossa importância e atenção.', 'Esse público merece respeito e acima de tudo igualdade para que se sintam serem quem realmente são.']",160,120,80,120,0,480
58,Cooperação universal,"['Considerada patrimônio da humanidade e candidata a umas das 7 maravilhas do mundo, a Amazônia está em perigo por causa dos desmatamentos e queimadas. Ela possui uma variedade de plantas que são importantes  econômico-farmacêuticamente , mas tem perdido cada vez mais a flora.', 'A floresta tropical presente no Amazonas é devastada em prol da pecuária. O que ocorre é que pecuaristas incendeiam e matam animais para depois formarem uma fazenda e criar bois. As consequências são perda da fauna e da flora. A floresta é responsável por grande parte do oxigênio no planeta, portanto é uma questão de saúde pública cuidar dela para não haver problemas do trato respiratório nessa e nas futuras gerações.', 'Ademais, um dos exemplos referente a flora é a planta carqueja que alivia problemas de digestão. Essa e uma infinidade de outras plantas como as que ainda nem foram descobertas estão em risco de desaparecer. O ""flora brasilienses"" uma obra de Philipp Von Martius, botânico Alemão, cataloga mais de 20 mil variedades de plantas com benefícios medicinais, alimentícios e tantos outros, essa é a importância da Amazônia para o mundo, política, econômica, estratégica e de saúde.', 'A região maznica está ameaçada pelas queimadas e o desmatamento. O Presidente Jair Messias Bolsonaro,  enviou tropas para ter um controle maior sobre o desmatamento, mas ainda é preciso de apoio internacional, pois essa responsabilidade é de todo o mundo. E por meio da conscientização, estudos e benefícios financeiros os países podem cooperar com o Brasil.']",120,120,120,160,80,600
9,Em busca dos seus direitos,"['Há alguns dias os jovens estão passando por um caso muito democrático, pois seus direitos estão sendo bastante, prejudicado bastante prejudicados.', 'Por tanto Portanto, nem todo mundo tem condições exatas para poder pagar ou entrar em uma Universidade universidade.', 'Exatamente durante o mês de maio foi onde ocorreu, varios quando ocorreram vários debates sobre o assunto, onde em que alguns são a favor e outros contra a Universidade universidade ser de gratuita gratuita. Mais Mas, se todos aparecem pra observa para observar direito, com os estudos de Universidade universidade grátis teria haveria no Brasil mais jovens, qualificados jovens qualificados trabalhando no mercado livre, livre. É através dessas decisões e atitudes que a maioria dos jovens nao não tem nem por começo o Português português atualizado, se os mais ricos paracem de se importa importar com si mesmo consigo mesmos, e observacem ao seu redor a população mais prejudicada que são a comunidade mais humilde, mais sincera e que sempre correr atrás dos seus direitos. Se pelo menos os jovens da população, mais população mais pobre podecem ser ouvidos teria haveria menos confusão e mais Jovens jovens formados em Universidade universidades e com o diploma na mão.', 'Tudo isso e só falta de diálogo e atitudes decentes!!']",40,40,40,40,0,160
58,,"['É viável esclarecer como a Amazônia teve sua exploração e degradação precocemente iniciada. Desde que as técnicas cientificas, medicinais e agropecuárias fizeram-se mais avançadas, os recursos até então renováveis desse enorme bioma tonaram-se esgotados e vários são os fatores causadores de tal problema.', 'Sendo uma das maiores concentrações de vida do mundo, abrigando milhares de ecossistemas e cadeias, a Floresta Amazônica tem de sobreviver aos processos naturais sempre lutando pelo seu equilíbrio sozinha. Não sendo o suficiente, ela tem de sobreviver a ação antrópica abusiva, onde milhares de quilômetros de sua extensão total são queimados todos os dias, sua flora – grande parte endêmica – é explorada e sua fauna erroneamente abusada, tudo isso sem que haja retribuição externa alguma . E mesmo sendo a casa de milhares de espécimes tanto vegetais quanto animais e um agente eficiente no trabalho de manter o equilíbrio ecológico mundial, ainda não há conscientização o suficiente sobre tudo o que ela de fato proporciona. Mesmo com as milhares de notícias negativas diárias que atualmente rondam seu nome, as pessoas ainda persistem na ignorante ideia de que a Floresta Amazônica dispõe de recursos inesgotáveis. Talvez por ser mais fácil fingir não perceber, ou por ser mais conveniente já que, por trás de tantas queimadas e desmatamentos há um ambicioso objetivo: o lucro. Entre outros muitos problemas que assolam esse tão importante bioma como o tráfico de animais, o contrabandeio de plantas para uso em remédios e substâncias ilícitas, o desmatamento excessivo de matéria-prima, e as queimadas ilegais que prejudicam não só o clima, mas também a produtividade de seu solo, muitas são as desvantagens e poucas são as providências.', 'Com extrema importância para as bacias hidrográficas que percorrem por entre suas matas, os animais que ali residem e as variações vegetais que apenas ali existem, é urgente a tomada de medidas mais extremas. Por parte dos governantes o recomendado seria tornar leis ambientais até então apenas informativas em leis penais;  que levem o indivíduo que as pratica a uma consequência mais rigorosa, também propor acordos ambientais com empresas que utilizam-se dos recursos para que se estabeleça um consumo produtivo, onde os bens utilizados possam ser devolvidos sem grandes prejuízos. Além de que tratando-se da população a utilização deveria fazer-se mais cuidadosa e consciente, com metas diárias e reaproveitamentos. E por fim ressaltando que, o mais rápido que essas medidas forem tomadas, mais rápido podemos evitar o colapso ecológico que vem se tornando uma realidade cada vez mais próxima.']",120,80,40,80,40,360
72,,"['As redes sociais são as maiores fontes de informação no Brasil e no mundo. No entanto, nem tudo que elas circulam é verdadeiro, edificando a problemática das fake news, que prejudicam o pensamento coletivo visando a democracia.', 'No século atual, as notícias falsas causam impacto amplo. Tendo em vista que as mídias sociais são usadas como formadoras de opinião e como meio de difusão informacional por jornalistas, o número de fake news tem subido intensamente e dificultam a busca da razão e da verdade dos fatos. Em defesa de tal assertiva, está o comportamento dos usuários que não filtram o conteúdo da informação recebida, não a interpretam corretamente e acabam por se desviar da veracidade, criando uma bolha de notícias inventadas.', 'Paralelamente, o incessante sensacionalismo assola a sociedade brasileira. Para muitos, os fatos têm de ser repercutidos e não comprovados, isto é, não enxergam a necessidade de que sejam fatos verdadeiros e sim que sejam condizentes com seu ponto de vista. Com isso, mal-intencionados elaboram notícias sensacionalistas com título e conteúdo persuasivo e que se aplicam a ideologia do público-alvo e por conseguinte, atingindo a finalidade de expansão de notícias falsas em escala global.', 'Destarte, urge a necessidade da aprovação da lei que criminaliza a difusão desses embustes, privando a sociedade de informações prejudiciais e punindo as fontes enganosas, com embasamento jurídico. Aliado a isso, cabe às redes sociais aplicarem mecanismos técnicos que controlem a disseminação de notícias, reconhecendo-as  e as que se mostrarem desprovidas de veracidade, sejam excluídas e a plataforma divulgadora, banida. Visto que as redes sociais são os locais de troca de conhecimento e de extração de informação, tais medidas facilitariam a supracitada implantação da democracia  e troca de conhecimento.']",120,120,120,120,160,640
77,Liberdade e respeito a homossexualidadel,"['A homofobia é criticada na sociedade contemporanea. Os homofobicos se torna, alvo e criticas das  pessoas ao seu redor. Como acaba,  e vencer de vez o preconceito? E de que maneira devemos não prejudicar eles?', 'A homofobia é como outras formas de repulsão, e que devemos aceitar e respeitar o sexo e a escolha de cada um , que seja, lésbica, bissexuais e transsexuais. Para a humanidade, pois não é norma é uma inferioridade, pecado mortal e aberração .', 'Até nas salas de aula eles se sente afastados por seus colegas cada olhar,gestos .Nas ruas são chingados com palavrões ,violentados e assasinados.', 'Por exemplo, por muitos anos acreditous-se que a AIDS, só contaminavam  principalmente,os homossexuais. Pois as pessoas podiam se sentir protegidas ,ou seja que doença não chegaria até os heteros e contamina-los .', 'Além disso, os homossexuais vivem a vida completamente comum, eles podem trabalhar como professor, médico, enfermeiro ,se divertem como quaquer um de nós.', 'Por tanto, a midia deve-se divulgar sobre o assunto , televisão, rádio, internet, e levar a informação a populaçaõ . Debater nas escolas o preconceito homofobico, e também a elaborações de leis pra ser legalizados e ter seus direitos e liberdade.']",80,40,40,40,80,280
55,"Redação Dissertativa,A importância de valorizar e garantir os direitos dos povos indígenas no Brasil","['A importância de valorizar e garantir os direitos dos povos indígenas no Brasil', 'Os povos indígenas são os que se importam com a natureza, o bem-estar do próprio lar ou seja a floresta que no entanto é a casa deles, onde vão passar o resto de suas vidas cuidando e cultivando. “Se a floresta, ou a natureza de maneira geral, é nosso passaporte, enquanto país, para algum futuro, os povos que vivem nela são seus verdadeiros guardiões”, André Villas-Bôas.', 'As principais causas do restrito número de índios no Brasil são basicamente a expropriação de suas terras para ceder à ocupação rural e urbana, grande quantidade de índios mortos em lutas contra brancos e, principalmente, por doenças que até então eram desconhecidas por eles. Nos telejornais vemos que o homem branco vem desmanchando mais e mais a natureza para seus bens matérias, para que o desenvolvimento de uma cidade seja maior, diante disso o mundo vai se descaracterizando não tendo mais árvores como principal fonte de oxigênio entre outros.', 'Posso concluir que ,  o homem banco pensa em si próprio e em nada mais e nada menos que bens matérias como no caso que a demarcação das terras dos povos indígenas seja afetada por áreas de construções civis  ou seja mais uma vez a floresta é desfavorecida pelo homem, e cada dia mais, ela demonstra que futuramente não haverá mais animais, árvores, plantas e outros. O homem branco deve reconhecer a importância do Índio na floresta na preservação de terras e Natureza.']",120,120,80,80,40,440
45,Abuso século XXI,"['O abuso de autoridade, está presente deis da antiguidade, quando era comum a nobreza  que possuía muito poder, cometer diversos abusos com escravos, e as demais pessoas inferiores na época. Na série """"Vis a Vis"""" , é retratado diretamente abusos, onde polícias cometem crueldades absurdas com as detentas; Na politica também onde não todos, mas alguns funcionários públicos tendo comportamentos abusivos.', 'Assim como na antiguidade, funcionários públicos que obtem cargos importantes e de poder, tendo comportamentos totalmente duvidosos , impondo suas idéias , opiniões e do cargo que tem, para mudar regras, muitos acabam passando até por cima das leis, pros seus próprios beneficio.', 'Ultimamente nos noticiários televisivos, há relatos de policiais agindo de maneira completamente inadequada, onde acabam sendo violentos, intolerantes e abusivos, recentemente tem visualizado um vídeo na """"globo news"""" , e outros jornais, onde certo PM está pisando no pescoço de uma senhora negra para imobilizá-la.', 'É preciso questionar, e não se calar, quando houver abuso de autoridade, uma das ferramentas que acaba tendo grande visualização e uma repercussão enorme é internet, onde podemos publicar e compartilhar atitudes abusivas das autoridades, Portanto é preciso não só conhecer seus direitos e sim cobra-los também, pra que a humanidade possa crescer e se desenvolver.']",120,120,120,120,120,600
56,,"['No Brasil,infelizmente,o número de detentos cresceu de forma expressiva. Mas, é notável que, o governo não estava preparado com tal intercrescimento forma,é preciso reverter este caso,já que, a superlotação e a desordem, são problemas na qual, devem ser resolvidos.', 'Os presídios brasileiros, não dão o suporte humanitário necessário para os presos. Uma vez que, há celas onde cabem 8, e dentro delas estão 16 pessoas por exemplo, já que,  a falta de estrutura, e sem mais presídios,dão como desumano, a situação dos presos . Assim,não é efeito jus ao art. 40 da constituição federal, em que, diz respeito à integridade física e moral dos condenados.', 'Além disso,a desordem nas prisões, mostra a precariedade do sistema. Um caso no Brasil, foi a rebelião no presídio de alcaçuz no RN  em 2017,na qual, duas facções criminosas brigavam entre si,disputando o ""poder"" na prisão. O final foi com 27 mortos, mostrando a ineficácia da segurança.', 'Portanto,é preciso que o governo libere verbas para o ministério da segurança pública, e que ele construa novos presídios,e coloque mais agentes penitenciários neles,com o objetivo de tornar mais humanitário a vida dos presos, e evitar novas rebeliões.']",120,80,80,120,120,520
93,O parto como forma de poder,"['Na antiguidade, o parto era realizado de diversas formas: com a mulher em pé, de cócoras, ajoelhada. Nos dias de hoje, os métodos se tornaram mais sofisticados, como a cesárea, entretanto, não preservam a autonomia da gestante e, consequentemente, tornam o momento que antecede o nascimento menos humanizado. Assim, vale analisar os fatores que favorecem esse quadro.', 'Em primeiro plano, o Estado negligencia a aplicação de leis que beneficiam os partos humanizados. Em seu livro “O Cidadão de Papel”, o escritor Gilberto Dimenstein afirma que, no Brasil, a legislação não funciona, mesmo aparentando ser bem construída, é ineficaz na prática. Basta observar que, em todo o país, existem apenas 18 casas de parto normal . Com isso, na maioria das vezes, as mães precisam recorrer ao procedimento por cesárea.', 'Outrossim, a sociedade patriarcal é peça fundamental para entender essa problemática. A filósofa francesa Simone de Beauvoir afirmava que a mulher, por questões histórico-sociais, era vista como objeto. Na contemporaneidade, esse comportamento se repete na forma de violência obstétrica e perda de autonomia na hora do parto, pois,  como parte da sociedade entende que a mulher é um objeto e, portanto, não possui emoções, pode realizar procedimentos invasivos. Assim, um momento que já é estressante se torna ainda mais difícil.', 'Evidencia-se, portanto, a necessidade de criar medidas que diminuam esse desrespeito contra as gestantes na hora do parto. Para tanto, é dever do Ministério da Saúde elaborar planos para aumentar o número de casas de parto normal e clínicas psicológicas para o acompanhamento pós-parto da mulher . Além disso, a criação de cursos sobre igualdade de gêneros, nas escolas, contribuirá para uma maior conscientização da população em relação ao respeito à mulher.']",200,160,120,200,120,800
61,O suicídio no setor de segurança no Brasil,"['O suicídio é um problema muito grave que ocorre em todo mundo e nestes últimos anos ocorreu um grande aumento de pessoas que tiraram sua própria vida. O suicídio é considerado por muitos estudiosos uma maneira da pessoa que lida com um ou mais problemas que atinge intensamente seu psicológico e tentam escapar através da morte . Vários são os fatores que fazem uma pessoa cometer suicídio, ainda mais em casos de pessoas que em sua profissão estão expostas a situações perigosas e que possam impressionar seu psicológico. Este é o caso dos policiais.', 'Ser policial no Brasil não é fácil, pois está sujeito a vários riscos que podem ser fatais e também precisam lidar com diversos casos que trazem uma série de problemas mentais como estresse, depressão, ansiedade, síndrome do pânico, ente outras. E além de tudo isso, a vida pessoal e familiar destes profissionais pode estar conturbada, ajudando a agravar o processo.', 'No ano passado, houve um grande aumento no número de policiais que cometeram suicídio, sendo até maior do que os casos de policiais que morreram em confronto segundo uma revista de grande circulação nacional. Este processo se dá por causa da falta de interesse destes órgãos militares em realizar assistência psicológica a estes policiais e também são causadas por um acúmulo de tempo que precisam se dedicar a suas funções. São horas e horas dedicadas a um trabalho que na maioria das vezes não são bem remunerados e além do mais são muito cobrados pelos seus superiores.', 'Esse mal que afeta o setor de segurança no Brasil precisa ser urgentemente corrigido, pois a polícia é um órgão de suma importância para a nação. Diante do problema, ele pode começar a ser combatido com a iniciativa destes órgãos militares a prestarem mais assistência mental aos policiais com a contratação de mais psicólogos na polícia, ocorrer maiores divisões de escalas, melhor remuneração, incentivos e também ocorrer uma melhor capacitação psicológica em seus treinamentos.']",120,120,80,120,120,560
25,A terapia de reversão da orientação sexual,"['Deve ser permitida a terapia de reversão da orientação sexual. Tal ação não irá impor aos homossexuais que façam o tratamento, ou que sejam feitas palestras sobre o assunto. Mas deve haver estudos e terapias, desde que a pessoa que deseja realizar, prontifique-se.', 'Uma pessoa que deseja realizar a terapia não significa que está doente, homossexualismo não é uma doença, contudo, há quem opte por tais sessões até mesmo para ter certeza de sua orientação sexual ou conhecer a si mesmo. O papel do psicólogo não é convencer seus pacientes, mas permitir que eles se conheçam a ponto deles mesmos fazerem suas próprias decisões e estarem seguros disso.', 'Em contrapartida, há possibilidade de gerar uma maior intolerância para com aqueles que se negarem a participar da terapia de reversão da orientação sexual, ou sejam até mesmo forçados, ou induzidos por amigos e familiares a realizarem as sessões.', 'A terapia de reversão de orientação sexual deve ser uma opção para aqueles que desejem fazê-la, contudo, não devem haver programas, publicidades ou propagandas que induzam a pessoa a realizá-lo , e deve ser efetuado somente em casos que sejam propostos pela pessoa, e não por amigos e familiares. Não podendo também realizar tal terapia em menores de idade.']",80,80,80,80,80,400
118,Abusados pela razão,"['Desde muito tempo, os animais têm sido                 explorados                em testes de laboratório pelo homem. E recentemente essa questão foi integrada         a         onda de protestos que         acontecem         no Brasil.', 'Quando submetidos a esses testes, os animais sofrem                 mais do que uma simples exploração                . São inúmeros                casos em que se observam intensas                 lesões                nos bichos,                 desde ferimentos profundos à incapacidade de se locomover e, até a morte.', 'O maior problema é que muitos desses procedimentos são promovidos por empresas de cosméticos ou perfumes, que são                 produtos superficiais                . E essa atitude         demostra         o desleixo que se tem com a vida animal                 em nome do capitalismo                .', 'Visto ser essa situação injusta, algumas manifestações no Brasil                 defenderam a causa                . O problema é a parte radical do protesto, nesse caso representado pelos ""black blocs"" de cunho anarquista. Esse grupo atacou                 setores de pesquisa                que utilizam animais e levaram os bichos, colocando-os em situação duvidosa, pois não se sabe o que acontecerá com eles.', 'Os animais só estarão livres dessa                 exploração                abusiva e de                 possíveis consequentes                riscos, quando a maioria da polução se conscientizar sobre a questão, o que pode ser motivado pelas                 manifestações passivas                e uma abertura ao diálogo por parte dos radicais.']",120,120,80,80,80,480
84,,"['No mês de abril de 2011, ocorreu um dos crimes mais bárbaros no Brasil: a chacina escolar de Realengo, no Rio de Janeiro. O criminoso - portado de arma e extensa munição -, assassinou onze crianças e deixou tantas outras feridas. No entanto, como se pode antepor a tragédias de tal porte e preveni-las?', 'Na Alemanha nazista, Hitler desarmou os judeus para depois dizimá-los. Com o objetivo de dar uma resposta rápida e mais cômoda, os políticos brasileiros levantaram a bandeira do desarmamento. Buscam, com isso, transportar a responsabilidade para a sociedade. Contudo, com a tônica da violência do dia em qualquer lugar, pequeno ou grande, rico ou pobre, deixam claros os índices cada vez mais alarmantes sobre a criminalidade. A população se sente frágil e desprotegida diante da aparente incapacidade do Poder Público em combater a onda crescente de violência.', 'Mais armas não significam mais violência. Estima-se que a Suíça tenha mais de 3 milhões de armas nas mãos dos civis. Mesmo assim, o país tem 45 vezes menos homícidios que o Brasil. Persistindo com a proibição, os brasileiros, que contribuem com o desenvolvimento do país, pagando seus impostos e cumprindo com a lei, ficam à mercê de criminosos, - que vão continuar comprando armamento e munições no mercado negro -.  Provando assim que o desarmamento só beneficiará um lado da moeda.', 'Portanto, permitir o armamento de civis, deve ser encarado como uma necessidade, uma vez que, sua liberação seja agregada com um treinamento especial. O que mata um indivíduo é outro indivíduo, por isso, são com as pessoas que as políticas de segurança pública devem se preocupar, e não com as armas.']",160,160,120,120,160,720
74,Somente por ser mulher,"['Criada em 2015, a lei 13.104 (Feminicídio) foi criada para defender  crimes ocorrentes somente por se ser mulher. Podemos afirmar que segundo o mapa da violência, no Brasil acontece cerca de 13 homicídios por dia, sendo isso equivalente a mais de 4 mil mulheres mortas por ano. Cabe ressaltar também que violência contra a mulher não é apenas física, mais também oral. Pois ainda hoje existe diferença salarial entre os sexos masculino e feminino.', 'Em razão disso, podemos citar o caso Eloá Pimentel, uma jovem que foi assacinada em 2008 pelo exnamorado Lindemberg Alves. A moça, junto com uma amiga passou quatro dias em cárcere privado sofrendo agressão física e psicológica.', 'Ademais, um ponto diferente  mas também válido sobre a violência, é que ela também pode vim por palavras ou desigualdades que enxergamos todos os dias . Os cargos mais altos são ocupados por homens, seus salários são maiores mesmo a mulher fazendo as mesmas tarefas.', 'Portando, maduras precisam ser tomadas pelo nosso governo para que os índices de feminicídio em nosso país diminua o quanto antes. Uma solução seria reformular leis mais severas para os acusados de tal crime, pois muitas vezes é preciso que sejam denunciados mais de três vezes para que possam ser presos, mostrando assim o descaso com as vítimas. Em consequência, a impossibilidade da retirada da queixa é bastante válida pois muitas mulheres acreditando em um falso arrependimento voltam atrás.']",120,120,80,120,80,520
47,A aceitação do EAD,"['Com a ascensão da internet no século XXI, houve uma globalização cultural que promoveu uma maior difusão de conhecimento no mundo. Nesse viés, a educação a distância no Brasil passou a ser vista através de uma nova perspectiva. No entanto, entraves como a falta de acesso para todos e o preconceito em relação a qualidade do ensino, ainda são alguns dos desafios que essa modalidade enfrenta.', 'É indubitável, de fato, que alguns problemas relacionados à aula virtual, têm sua origem porque uma parte da população não possui acesso internet em casa . Nesse contexto, conforme prevê a Constituição Federal de 88, “todo cidadão tem direito a educação”. Todavia, esse direito não é executado quando a população encontra-se sem meios para obter essa educação, seja por não ter condições financeiras de contratar internet privada, ou não saber utilizar os aparelhos que possui. Dessa forma, o ensino que ganhou destaque por sua flexibilidade e facilidade deixa alguns indivíduos carentes das possibilidades oferecidas e impossibilitados de manter o acesso, consequentemente incapazes de aderir o “EAD”.', 'Ademais, existem outros fatores que prejudicam o ensino através do ambiente virtual, como o preconceito em relação a qualidade dos cursos . Nesse cenário, segundo o escritor alemão Goethe “Nada no mundo é mais assustador do que a ignorância em ação”. Em vista disso, muitos alunos são julgados por sua formação com ensino a distância, e passa a existir uma desconfiança no mercado de trabalho que subentende que o aluno que opta por “EAD” é preguiçoso ou indisciplinado . Por conseguinte, encontrar um emprego torna-se mais difícil e o indivíduo fica com desvantagem em relação aquele que tem acesso à educação presencial.', 'Portanto, faz-se necessário que medidas sejam tomadas. Desse modo, o Governo Federal em parceria com as empresas de telefonia devem disponibilizar pacotes de internet como bolsas de estudos para alunos que precisam do “EAD” mas não possuem acesso à internet. Além disso, por meio do Ministério da Educação, deve investir nesse modelo educacional, aumentar a capacitação de seus profissionais e com reuniões presenciais no mínimo três vezes ao mês, a fim de avaliar o desempenho dos alunos e formar indivíduos mais capacitados, e consequentemente desfazer o preconceito existente no mercado. Para que assim, seja minimizado os desafios do ensino a distância no Brasil.']",160,160,120,160,160,760
80,Educar é preciso,"['Vivemos em uma época em que nunca se falou tanto sobre liberdade de expressão e direitos humanos, nunca se combateu tanto a injúria racial e suas respectivas formas de racismo. Mas, em contrapartida, cresce o número de atos racistas, que fogem totalmente desse contexto pregado pelos direitos humanos.', 'Sim, temos um histórico extremamente racista dentro do cenário brasileiro que pode, de certa forma, explicar tais atitudes. Mas não podemos, em hipótese alguma, usar esse fato como suporte para agirmos dessa forma. Numa  sociedade tão evoluída  todo e qualquer ato racista deve ser tratado como ignorância, e todo tipo de ignorância deve ser combatida  com educação.', 'As leis e punições são importantes dentro desse contexto, porém são ações paliativas que não vão ter efeito a longo prazo. Deve-se, sim, aliar isso à educação, que começa lá na infância, com os pais mostrando e educando seus filhos sobre como ser pessoas inteligentes, íntegras e melhores.', 'Caminhamos a todo vapor do ponto de vista tecnológico, mas regredimos a passos rápidos do ponto de vista intelectual. A única forma de acabarmos de vez com o racismo no Brasil é investir em uma política de longo prazo, investindo nas futuras gerações e criando pessoas humanamente melhores. Por isso, e para que isso aconteça, educar é preciso!']",160,160,120,200,120,760
121,Exercendo Cidadania,"['Horário reservado a propaganda eleitoral gratuita. Esta frase que aparece na TV é                 o ""terror""                para muitos cidadãos. As famosas expressões como: ""Todo político é igual!”, ""Interromperam minha novela!"" são as mais ditas.                 Ao invés de reclamações, por que não aproveitar          deste          recurso abrangente?', 'Através das         propagandas eleitorais realizadas na televisão e no rádio é possível conhecer um pouco das ideias dos candidatos. Outros meios como internet, jornais, revistas também auxiliam para ter esclarecimentos                 melhores de devidos.', 'Com o pensamento já                 ""instalado"" na mente                de muitos, que tudo sempre vai ficar do mesmo jeito, o comodismo prevalece. Ver, ouvir, ler e pesquisar com os recursos oferecidos hoje                 tornaram as coisas mais fáceis                . No entanto,         tais, já         foram restristas um dia         a         população. Na época da ditadura, as pessoas não tinham o direito de saber toda a         ""verdade"".', 'Em suma, as propagandas feitas no horário político deveriam ser vistas com mais atenção pelos eleitores. Ser cidadão é participar, apoiar, cumprir com seus direitos e deveres, fazer a diferença.""(...)a diferença não         esta         na ação, mas nos que a realizam.""(Spinoza)']",80,120,80,120,80,480
78,"O médio-técnico, um plano a longo prazo","['O ensino médio técnico é uma proposta com o objetivo de trazer os jovens de volta à escola e para os que já estão, de oferecer maior contato e aprendizado na profissão escolhida. O método promete profissionalizá-los para que saiam da escola e partam para a vida adulta com uma profissão. O novo ensino traz vantagens e desvantagens.', 'As vantagens, além da profissionalização do jovem, é a nova oportunidade , agregando conhecimentos práticos aos seus gostos e abrindo espaço para outras áreas. Sendo assim não deixando-os as derivas do mercado, possibilitando-os uma nova opção .', 'As desvantagens são assuntos relevantes a serem questionados , considerando a atual situação educacional do Brasil . A carga horária das disciplinas-padrão terá de ser reduzida, o que já é curta, dificultando e limitando o aprendizado básico. O aumento da carga também não é viável, pois muitos jovens necessitam trabalhar para ajudar ou até mesmo para sustentar suas famílias, o que acarretaria em um maior abandono escolar.', 'O médio-técnico  é uma ação boa, porém precipitada  , a qual ainda precisa ser analisada e discutida com cautela. Este método é um planejamento a longo prazo, onde  o ensino brasileiro consiga adequar-se a tal, fazendo com que não seja necessário aumentar a carga horária, e manter ou melhorar a quantidade e qualidade das disciplinas base.']",80,120,120,80,80,480
88,Transtornos psiquiátricos precisam ser entendidos,"['Regido pela Constituição federal, o direito à saúde é um fator primordial para o bemestar geral da população. No entanto, tem sido afetado por distúrbios mentais cada vez mais comuns na vida do brasileiro, como a ansiedade e a depressão . Nesse contexto, o preconceito e a falta de visibilidade tornam-se agravantes importantes para superar o problema.', 'A princípio, cabe ressaltar a discriminação sofrida por quem passa por algum problema psiquiátrico. A cerca disso, um notório personagem, o Corcunda de Notridame, ilustra bem a problemática  pois sua condição física o levava a segregação e ao julgamento da sociedade ao seu redor. Do mesmo modo, pacientes com a saúde mental afetada estão sujeitos ao descaso, consequência de uma visão preconceituosa que, em decorrência, dificulta o tratamento mais adequado.', 'Além disso, a falta de informação adequada, inclusive dos afetados pela doença, contribui para o agravamento desse cenário pois dificulta a busca por ajuda mais adequada. Nesse sentido e segundo a Declaração de Direitos do Homem e do Cidadão de 1789, a falta de conhecimento como um princípio básico afeta diretamente a preservação saudável da sociedade dentro de sua integralidade.', 'Portanto, para que o estigma de doenças mentais seja superado, urge a necessidade de amenizar a visão preconceituosa e a falta de conhecimento sobre um problema de saúde pública nacional. Assim, o governo federal, por meio do Ministério da Saúde, deve ampliar as campanhas de aprendizagem através de todos os meios de comunicação, com a finalidade de mostrar que transtornos psiquiátricos precisam ser entendidos e aceitos por toda a comunidade brasileira e, com isso, consagrar o direito constitucional da saúde devido a todos.']",160,160,120,200,160,800
73,"Brasil, um país de todos","['De acordo com o sociólogo alemão Émile Durkheim, a sociedade pode ser comparada a um ""corpo biológico"", por ser, assim como esse, composta por partes que interagem entre si. Desse modo, para que esse organismo seja igualitário e coeso, é necessário que o direito de todos os cidadãos sejam garantidos. No entanto, isso, no Brasil, não ocorre, pois a população negra ainda, mesmo diante de avanços sociais no país, é alvo de preconceito e discriminação.', 'O Brasil se caracteriza por uma colonização exploratória, monocultora e latifundiária . Nesse contexto de domínio europeu, milhares de africanos foram tragos compulsoriamente ao Brasil para comporem o sistema escravista. A população de africanos foi exposta à doutrinação religiosa, ao trabalho desumano e a discriminação social, ou seja, sua história foi marcada por ausência de direitos necessários a um condição digna de vida.', 'Tal conjuntura de exclusão social , mesmo depois de séculos d abolição da escravatura em terras tupiniquins, ainda persegue os afrobrasileiros . Segundo a Pesquisa Nacional por Amostra de Domicílio (PNAD) - organizada pelo Instituto Brasileiro de Geografia e Estatística (IBGE)  entre 2011 e 2015 - os negros representam 55% da população brasileira e que essa maioria tem menores salários, pouca escolaridade e alta mortalidade.', 'Assim, diante desse cenário de exclusão histórico-social, o Governo Brasileiro toma medidas que ajudam a diminuir as disparidades que marcam o país. As ações afirmativas, por exemplo, permitem jovens negros -majoritariamente pobres no Brasil - a competirem de forma mais justa aos exames de acesso às principais universidades públicas brasileiras. O acesso a uma educação superior é uma das maiores ferramentas de ascensão social que esses jovens possuem.', 'Em decorrência disso, cabe ao Governo Federal e ao terceiro setor  a tarefa de reverter esse cenário. O terceiro setor - composto por associações que buscam se agrupar para conseguir melhorias na sociedade - deve, através de mais palestras, grupos de discussão e a mídia, conscientizar as famílias de todo o Brasil sobre a cultura plural que compõe o país e mitigar a discriminação racial desde a educação infantil. O Governo Federal, por fim, deve intensificar a expansão de mais direitos sociais à população afrobrasileira. Dessa forma, o Brasil será, de fato, um Estado Democrático de Direito.']",160,160,120,160,120,720
56,,"['Durante a Segunda Guerra Mundial Hitler mandou construir diversos campos de concentração para tentar controlar a quantidade de judeus no país, o acúmulo de pessoas foi tão grande que acabou gerando a morte de milhares dos que ali se encontravam por viver em condições precárias e desumanas. Hodiernamente, a situação carcerária no Brasil com a superlotação de celas tem em vista vários problemas recorrentes, incluindo a falta de infraestrutura para com os detentos originando: fugas, mortes por condições escassas e doenças.', 'Em primeiro lugar, convém ressaltar o erro do Judiciário e da sociedade ao levar o assunto para o escanteio. As deficiências são gritantes no sistema carcerário em que, como exemplo, uma cela que serve para comportar 10 presidiários são comportados 25, totalmente inumano. Na realidade em que se vive numa proliferação de doenças contamináveis e muitas vezes de risco, igual em 1945, um retrocesso as condições de vida da Segunda Guerra Mundial.', 'Outrossim, a sociedade  por ter firme a ideia de que a justiça esteja sendo feita acaba esquecendo de que uma “disciplina”  desse modo dificilmente irá causar arrependimento, mas sim,  um derivado de coisas ruins, pois, as más influencias são maiores lá e a perspectiva de uma luz no fim do túnel é quase nula . Um bom espelho disso é a Noruega em que investem na educação presidiria, no artesanato e em grupos religiosos para ajudar a guiar, rever os conceitos e da um caminho diferente para os que lá entraram  diminuindo assim 20% da população prisional dada para o crime.', ""Impende, portanto, medidas necessárias para reverter o atual cenário assustador que há no Brasil. Investindo na educação dos jovens, crianças e adolescentes para que se evitem problemas futuros mostrando desde cedo onde se pode chegar e que caminho não se deve chegar. O poder Judiciário deveria revigorar nas leis como um meio de assustar e mobilizar os que tem a mente para o crime , a sociedade junto com escolas e parcerias com ong's poderiam organizar projetos e palestras sobre a criminalidade e suas consequências para que dessa forma sistema hitlerista não seja um exemplo, mas sim um repúdio.""]",120,80,80,120,120,520
68,Valorize seu patrimônio histórico enquanto há tempo,"['O patrimônio histórico de um país representa a identidade social de seu povo, suas origens e costumes, entre outros bens inestimáveis, que devem ser protegidos e apreciados por todos. O acesso a esse acervo de tesouros é muito importante educação e a formação de cidadãos, pois promove o autoconhecimento à nação, reflete os movimentos sociais e culturais de nosso  país, bem como desperta o patriotismo na população.', 'Sua importância não abarca apenas o nível cultural e educacional já que as ações voltadas à sua preservação e exposição geram também o aquecimento da economia. O público interessado em visitar atrações históricas de uma região trará consigo o aumento do consumo nas imediações desse lugar que, por consequência, implicará em mais vendas, em maior procura a hotéis, e em demanda extra ao sistema de transportes e outros serviços de diversão e necessidade. Em resumo, haverá um crescimento da receita dos empresários, dos postos de trabalho e de investimentos na região.', 'Mesmo com todas as vantagens resultantes de nossa herança histórica e cultural, não há em nosso país um correto uso e preservação desses bens,  que necessitam de cuidados especiais para que possam continuar a existir e ser apreciados no futuro. Vide o museu nacional da Quinta da Boa Vista que, nos seus 200 anos de criação, sofreu um incêndio de grandes proporções perdendo a maior parte de seu acervo por falta de manutenção preventiva contra sinistros desse tipo.', 'Com isso, é clara a necessidade de conscientizar a população e o próprio governo sobre a importância de seus patrimônios históricos para que assim sejam tomadas  o mais rápido possível ações preventivas que assegurem a preservação, a valorização e o correto uso desses tesouros, que direta ou indiretamente trazem tantos benefícios à sociedade.']",120,160,120,160,120,680
64,Educação sexual,"['Quando se fala em educação sexual na escola, as pessoas geralmente já possuem uma opinião pronta sobre o assunto . No Brasil, educação sexual ainda é tabu, gera polêmica e mesmo após diversas pesquisas e estudos reconhecerem a sua importância, nenhuma política é empregada para mudar o atual quadro.', 'As famílias brasileiras, principalmente as mais conservadoras  enxergam como algo maléfico o ensino sobre sexo, aborto, direitos sexuais, dentre outros no ambiente escolar. Mas será que esse posicionamento não gera problemas e mostra uma incapacidade de tentar entender melhor o que é educação sexual e os benefícios que ela pode trazer?', 'Crianças e adolescentes são muito curiosos. E isso é absolutamente normal. O problema todo surge quando a família não trata a questão da sexualidade com naturalidade, formando assim um bloqueio entre pais e filhos. Quando ocorre a tentativa de quebrar esse bloqueio, a família não obtem sucesso e o jovem acaba iniciando sua vida sexual sem nenhum conhecimento, entendimento nem embasamento sobre o assunto.', 'O Brasil hoje é um país no qual 1 a cada 5 brasileiros nasceu de uma mãe adolescente. O mesmo país apresenta, a cada ano, níveis de avanço de doenças sexualmente transmissíveis . Uma educação planejada e bem estruturada sobre riscos, DSTs, direitos sexuais, métodos contraceptivos  mudaria, a longo prazo, o atual quadro.', 'É urgente a necessidade de criar políticas e promover debates entre pais e educadores para poder trazer um olhar mais aberto sobre a questão da educação sexual. É preciso entender que a informação, quando estruturada e bem passada pode evitar os problemas como os que temos  hoje em nosso país.']",120,160,120,120,80,600
120,Sobre a liberdade de expressão,"['A redação de um jornal satírico chamado “Charlie Hebdo” foi atacada por um grupo de terroristas         no qual         queriam                 se vingar da charge em que o Deus deles                foi estampado.                 Esse grupo de terroristas segue uma religião          no qual são muito rigorosos          quando se trata do Deus em que eles têm fé.', 'A liberdade de expressão não agrada a todos e isso chega a causar problemas, como esse fato que aconteceu na França.                 Em determinados momentos, falam sobre algo          em que          determinadas pessoas não aceitam, mas é algo que deveria ser aceito por todos, já que se chama liberdade de expressão. O que aconteceu na França deveria ser aceito pelo grupo Islâmico, já que eles têm o direito de falar sobre o que quiser e quando quiser, mas claro que tudo tem o seu limite.                  Esse limite                é julgado de acordo com o         assunto, no         caso         citado         o assunto era         religião, no         momento em que se extrapola                 esse limite                , algo deve ser feito para que não haja tragédias         e consequentemente evitando         uma sessão de carnificina. Óbvio que o que os terroristas fizeram não era certo, mas o que a redação         deste         jornal fez também não foi certo.', 'Portanto a liberdade de expressão tem de ser aceita, já que é fundamental para a sociedade                 se expressar do jeito que quiser, seja de forma escrita, oral ou através de desenhos                . Pode até não ser aceita por determinado grupo de pessoas, mas deve ser respeitada                 para que quando chegue a sua vez de expressar os seus sentimentos, ou algo relacionado a isto, seja respeitado.']",80,80,80,80,80,400
74,,"['O Brasil é um país democrático baseado nos direitos da constituição de 1988, onde passou a considerar a mulher um sujeito político . Antes desta data a mulher não tinha qualquer participação no cenário sociopolítico, ou seja, um avanço. De 1988 até 2018 trinta anos se passaram e nem por isso o Estado se tornou igualitário pelo contrário assumiu uma postura cada vez mais machista e sexista.', 'O machismo e o sexismo não são matérias reclusas apenas aos homens, mas também a muitas mulheres, pois ambos foram ensinados que quando uma mulher fora espancada é porque ela fez algo que cunhou na agressão  ou quando é estuprada foi porque a mesma estava usando roupas curtas o que motivou o comportamento animalesco . É necessário ensinar á sociedade que a culpabilização da vítima está errada  uma vez que a mesma nunca é culpada, mas que políticas mal planejadas cunham em um Estado cada vez mais violento e desigual.', 'Segundo o apa de violência 2015 o Brasil está entre os países com maior índice de feminicídio, ocupando a quinta colocação deixando para trás países extremistas como a Síria. E o mais alarmante desses dados é que  segundo o Instituto de Pesquisa Economia Aplicada (IPEA) 4.621 desses feminicídios são de mulheres negras, associando a misoginia a um quadro de racismo. Tais dados são frutos de uma política fraca e defasada sem qualquer tipo de suporte as mulheres que somam aproximadamente 105 milhões da população total do país.', 'É necessário punir os agressores mais severamente, nos flagrantes a prisão  ser decretada e tida como inafiançável, capacitar os profissionais para lidar com as vitimas de violência sexual e de agressão, tipificar a Lei Maria da Penha o que daria a ela maior suporte e abrangência contra a violência  a mulher, além de disponibilizar a vitima uma escolta por setenta e duas horas para qualquer possível retaliação do agressor.', 'Ademais é necessário que o Estado propicie mais empregos em todos os cargos para as mulheres, criando leis que obrigue as empresas e o próprio Estado o direito às mulheres a mutabilidade de seus cargos, pois com a valorização das mulheres dentro do mercado de trabalho levara ao empoderamento feminino desmistificando a subserviência da mulher em relação ao homem . Com isso haveria um decréscimo nas taxas de homicídios, pois os homens teriam que aprender que o Estado passou a assegurar os mesmos direitos a homens e mulheres descartando o papel inferiorizado da mulher na sociedade e que a partir do momento que um homem agredisse uma mulher ele não mais seria punido com pagamentos de cestas básicas ou serviços comunitários, mas punidos por uma lei justa e rigorosa.', 'Por fim  nas escolas  acrescentar como carga curricular aulas de direitos cívicos e políticos para ensinar aos jovens que são o futuro da nação que todos têm os mesmos direitos e deveres desmistificando o sexismo, o misoginismo e o machismo, pois como disse Paulo Freire “Se a educação sozinha não transforma a sociedade, sem ela tampouco a sociedade muda”.']",120,120,120,120,120,600
84,Porte de arma pela população civil,"['Em virtude do massacre ocorrido em julho numa boate, em Orlando, nos EUA, considerado o maior atentado com armas de fogo em número de vítimas, 51 mortos e 49 feridos, o debate em torno da restrição ou permissão do porte de armas pela sociedade civil, ganhou ênfase principalmente na corrida presidencial norte americana. No Brasil foi criado em 2012, o PL 3722/2012 denominado, Estatuto do Controle de Armas que autoriza o uso de armas pela população civil. Tendo em vista que há uma Lei de Desarmamento em vigor, qual a motivação para a aprovação do do Estatuto?', 'Um dos principais argumentos de defesa para a aprovação do texto do PL 3722/2012 é a garantia do direito de legítima defesa pelo cidadão de bem, nos casos em que a polícia não se faça presente para a garantia da integridade física, psicológica e moral desse. Outra questão é a liberdade de produção de armas de fogo pelo mercado paralelo, e a posse e porte ilícita por parte dos bandidos. O Estatuto do desarmamento não tem controle sobre essas armas que são adquiridas ilegalmente, o que favorece a atuação e legitimação do poder dos criminosos  no contexto de violência em que o Brasil se encontra.', 'Muitos temem a aprovação do Estatuto, acreditando que esse aumentaria o índice de criminalidade por mais pessoas portarem armas, porém a aquisição delas depende de algumas exigências como: idade maior que 21 anos; não condenação por crime doloso, em que houve a intenção para a prática desse; capacidade técnica e psicológica para o manuseio e uso; entre outros. O texto em tramito no Congresso abre espaço para aqueles que necessitam se autoproteger, nos casos em que a segurança pública não seja capaz de evitar a violação da integridade física dos cidadãos de bem.', 'Portanto, é de suma importãncia que o Congresso reveja a possibilidade de implementação do Estatuto do Controle de Armas, considerando o domínio tanto das armas adquiridas legalmente ou não, com isso minimizando o poder do mercado paralelo e dos criminosos, além (de) garantir o direito de legítima defesa para aqueles que possam se encontrar em situações de violência, em que não se faça presente a atuação da polícia.']",160,160,120,160,160,760
55,Nada mudou.,"['Desde o descobrimento do rasil, os primeiros habitantes do país, o índio vem sendo explorado ou reprimido . Apesar isso, hoje, percebe-se a importância da valorização da cultura indígena para o país. Com relação a importância da cultura, pode-se dizer que os povos indígenas deixaram uma herança cultural para os brasileiros. Entre essas tradições deixadas está a culinária. O alimento de origem indígena mais utilizado em todo o território é a mandioca e suas variações. Além disso, há a influência cultural, também, nas escolas. Por exemplo, os contos, que as crianças aprendem, como a lenda do Curupira.', 'É necessário levar em conta, também, que a atual característica da língua portuguesa falada no país, é diferente do idioma de Portugal, porque sofreu influência da língua Tupi-guarani. Além do mais, o nativo é o guardião da Amazônia, pois com o seu conhecimento natural ele contribui para a preservação da floresta em função das mudanças naturais quanto as provocadas pelo ser humano.', 'Diante disso, nota-se que o índio tem um papel fundamental no país, pois a cultura dele está enraizada no povo. Com isso, as ações governamentais, como a Funai, devem garantir seus direitos e o governo deve aplicar campanhas na sociedade para mostrar a importância do índio na formação que o brasileiro é hoje.']",120,120,80,120,80,520
6,Corrigindo erros,"['Em uma primeira análise, ressalva-se ressalte-se a importância dos laços internacionais para a preservação dos interesses brasileiros, no brasileiros. No mundo globalizado sobra pouco espaço para individualismos, pois pois, mais do que nunca, questões quanto a à preservação ambiental se tornaram mundiais, devendo as nações trabalharem juntas para se alcançar alcançar meios eficazes de proteção das diversas áreas florestais.', 'Considerando a prévia colocação esses aspectos, é de interesse brasileiro que esses laços internacionais sejam fortalecidos, pois planos de proteção como o acordo de Paris são de amplo interesse brasileiro, já que nosso país possui algumas das maiores reservas florestais do mundo. A manutenção desses laços significa reconhecer a gravidade do problema e aceitar incentivos direcionados a sua solução.', 'Levando isso em conta, a questão da soberania que foi posta na balança se torna irrelevante, já que o interesse da preservação é tanto nosso quanto dos demais países, e os incentivos fortalecem também a economia pois o país sustentável se torna turisticamente atraente para a população mundial.', 'Em uma última análise, reforça-se que não é a soberania nacional que está em jogo, mas a imagem do Brasil como país capaz de tomar decisões racionais. É necessário que a população demonstre sua postura e influencie nas decisões dos nossos representantes para uma boa manutenção de laços internacionais com consequências benéficas a longo prazo mundial e nacionalmente, pois afinal pois, afinal, como refletia disse Confúcio, ""não corrigir os erros do passado é o mesmo que cometer novos erros"".']",120,120,120,120,120,600
45,AA - ABUSO DE AUTORIDADE -,"['No livro “Memórias de um sargento de milícias”, de Manuel Antônio de Almeida, com publicação de 1853, já é possível ver que o abuso de autoridade no país não é uma coisa vivida somente nos dias atuais, seja na realidade ou na literatura, no passado ou no presente, tal excesso sempre existiu e persiste. A obra conta a história de Leonardo, que é obrigado a servir o exército pela polícia do Rio de Janeiro. Ao longo da trama, uma série de abusos são sofridos pelos personagens.', 'Primeiramente, é válido lembrar que pessoas morrem todos os dias pela abundância de polícias que exercem o controle de forma demasiada, especialmente negros e periféricos. Entre 2017 e 2018, segundo o Fórum Brasileiro de Segurança Pública, dos 6.220 registros de mortes por intervenções, 74,4% eram pessoas negras, e segundo o IBGE , os negros representam 55% da população . Há abuso por nada. Há morte por nada. São violências que custam vidas.', 'Outrossim, não só entre alguns policiais que o abuso acontece, a escola é um bom exemplo de lugar para tal feito. Na interação docente/discente, o primeiro tem autoridade sobre o segundo, o problema ocorre quando o professor faz uso inadequado dessa condição – o que não é difícil de acontecer nas escolas . Alguns exemplos absurdos são: piadas discriminatórias, de cunho sexista ou racista, quando um professor coloca apelido humilhante no aluno, etc.', 'Em resumo, é mister que o Estado tome providências para resolver o impasse. Para que pessoas de cargos mais altos não usem de autoridade excessiva para com a sociedade, urge que os Poderes Legislativo e Executivo por meio da criação e aplicação de leis mais severas, punições mais rígidas, como penas de no mínimo 5 anos e multa, além da exoneração do cargo exercido. Somente assim, a violência de superioridade não virá mais cercar a população. Ninguém mais será obrigado a sofrer por tal poder excessivo como Leonardo ou alguns dos outros personagens da literatura e da vida real e haverá respeito e equidade.']",160,120,120,160,120,680
47,As dificuldades na concretização do Ensino a Distância,"['Em uma das primeiras cenas do filme sul-coreano “Parasita”, Ki-Taek e sua família procuram maneira de ter acesso ao wi-fi do vizinho . De maneira análoga, a realidade brasileira se mostra isenta de tais ferramentas. Dessa forma, a Educação a Distância (EAD) apresenta impasses a serem solucionados, uma vez que a população está à margem da ausência de recursos e de problemas emocionais.', 'Constata-se, a priori, que a inexistência de utensílios básicos para a prática dessa modalidade, como por exemplo, computador e internet, afeta cerca de um quarto de brasileiros. Além disso, muitas escolas públicas sequer adotaram esse tipo de programação, quer seja pelo não conhecimento das tecnologias da informação, quer seja pela escassez de investimento. Logo, as instituições privadas saem à frente, e o direito à educação, garantido no artigo 205 da Constituição Federal, torna-se limitado.', 'Ademais, a presença de distúrbios emocionais, como a ansiedade, decorre em razão da dificuldade de criar uma rotina consistente, à falta de concentração e até a falta de alimentos, visto que a escola é, para muitos, a principal fonte para inibir a fome. Soma-se a isso, a necessidade de lidar com um cenário pandêmico, de óbitos diários em escala global. Nesse sentido, isso compromete a saúde das pessoas e a eficácia da aprendizagem.', 'Portanto, são necessárias medidas que resolvam a problemática. Por conseguinte, cabe ao Ministério da Educação (MEC) disponibilizar verbas s prefeituras que, por meio das secretarias de educação devem comprar e elaborar livros, materiais didáticos, cronogramas e orientações afim de que todos os alunos possam ter acesso ao ensino. Deve-se, ainda, que os governadores de cada estado monte espaços de conexão de rede aberta em espaços públicos como praças, colégios e bibliotecas, para quem se encontre em situação de vulnerabilidade socioeconômica. Assim, o país será mais igualitário e o cidadão se beneficiará dos seus direitos.']",160,160,160,200,160,840
72,Disseminação em massa de notícias falsas,"['Nem tudo que circula pelas redes sociais é verdadeiro, embora atualmente seja um dos principais veículos de informação. Com efeito, ocorre o problema da disseminação em massa de notícias falsas que, muitas vezes, prejudicam a cobertura profissional da imprensa, principalmente em ano de eleições presidenciais.', 'Sabe-se que o uso e o impacto das notícias falsas tornaram-se amplos neste século. Não é incomum, diariamente, receber informações inverídicas via redes sociais, apesar de as mídias socias serem usadas como ferramenta de trabalho de jornalistas . Assim, na maiorias das vezes, nem todos filtram o conteúdo que recebem  nem mesmo interpretam a notícia sobre o candidato ou leem até o final, compartilhando informações falsas e criando uma enorme cadeia de mentiras no sistema global de redes de computadores.', 'Ademais, em uma realidade política ""pós-verdade"", a relevância das notícias falsas aumentou. Quando não patrocinadas por pessoas envolvidas por adversários políticos, são financiadas pela ""indústria de cliques"", criada pelas grandes plataformas de propaganda digital. Elas reforçam algum ideal político ajudando a fortalecer crenças que são geralmente apelativas emocionalmente, por isso, os usuários compartilham e comentam, amplamente, antes mesmo de checar as fontes verdadeiras. Dessa forma, a partir de um dos conceitos filosóficos de Francis Bacon que o comportamento do homem é contagioso, vê-se a aplicação na distribuição deliberada de conteúdos falsos e boatos pela ""internet"", não levando em conta a veracidade dos fatos publicados, de maneira que esse comportamento torna-se enraizado e frequente.', 'Portanto, a criação de ações que auxiliem a população a identificar notícias falsas faz-se necessária, pois elas só ganham visibilidade e destaque quando compartilhadas por um grande número de pessoas. O Estado, por meio da criação de um comitê para checar informações falsas veiculadas na internet, pode informar à empresa responsável pela hospedagem do site, e, como consequência, bloquear a fonte de renda dos indivíduos que fazem este tipo de ação. A sociedade deve colaborar capacitando os cidadãos, através de oficinas e cursos gratuitos, a identificar e filtrar conteúdos falsos na ""web"". Cabe as mídias sociais auxiliarem seus usuários, conscientizando quanto ao compartilhamento de boatos e mentiras na rede, denunciando essas notícias falsas como spam e punindo os autores com o bloqueio de suas contas nas respectivas redes sociais, para, assim, sustar o fluxo de notícias não verdadeiras na ""internet"", visando o bem-estar da sociedade como um todo.']",160,160,160,200,160,840
63,,"['Com o recente acontecimento em Brumadinho-MG, podemos perceber como o descaso de corporações para com questões ambientais,  é grande. Além da fauna e flora, rios e construções, vidas foram perdidas. Vidas essas que independente de esforços, nunca voltarão . Os estragos causados pela queda da barragem dificilmente serão reparados. Animais, plantas e pessoas foram afogadas em meio a lama e rejeitos.', 'Essa tragédia, assim como outras, não pode ser prevista. Embora houvessem conhecimentos sobre os riscos, não foi possível prever o dia e horário com exatidão . Se essas informações existissem, as pessoas poderiam ter se preparado para lutar pela sobrevivência.', 'Esse não foi o único impacto ambiental causado por grandes corporações. Há um pouco mais de três anos, a barragem de Mariana também se rompeu, vitimando dezenas de pessoas.', 'O Estado deveria investir em uma política rígida de fiscalização e punição às empresas que representassem algum perigo a sociedade e ao meio ambiente. Pois assim, os empresários e diretores destas teriam uma postura mais responsável e correta com a natureza  e os seres humanos que dela precisam para viver.']",120,120,80,120,120,560
83,,"['Em agosto de 2016, o mundo assistiu ao maior evento esportivo do planeta, os Jogos Olímpicos, sediados no Rio de Janeiro. Nessa perspectiva, é evidente a importância que o esporte tem diante da sociedade, tornando-se um instrumento de aprendizado e lazer.', 'Pesquisas informam que o esporte é fundamental no ciclo de crescimento dos jovens, além de ser recomendado a todos os cidadãos, independente de idade, sexo ou etnia. Assim sendo, a prática esportiva ajuda a desenvolver várias capacidades físico-mentais do ser humano, como, por exemplo: a socialização; o trabalho em equipe; a autoestima; a disciplina e vários outros benefícios.', 'No entanto, segundo as estatísticas de uma pesquisa da Universidade da Pensilvânia, atletas de esportes de contato, como lutas e futebol americano, têm 40% a mais de chances de entrar em brigas e conflitos. Analisando os dados, pode-se salientar que o esporte, dependendo do indivíduo, influência no comportamento agressivo e de rivalidade de seus praticantes, sendo uma grande problemática.', 'Portanto, nos casos de agressividade no meio esportivo, os atletas devem ter um acompanhamento pedagógico e psíco-terapeuta , para evitar futuras tensões. Ademais, a Secretária do Esporte deve sempre incentivar a população a praticar esportes, por intermédio de campeonatos, torneios e centros interativos. Dessa maneira, a sociedade poderá usufruir ainda mais desse excelente instrumento de lazer, saúde, e aprendizado, que é o esporte.']",160,160,200,120,200,840
93,Dificuldades sofridas no parto,"['O sonho de diversas pessoas e casais é ter filhos e construir uma família, com todos seus direitos sendo respeitados e cumpridos. Porém, no Brasil, muitas famílias sofrem com a infraestrutura e atendimento insuficiente em hospitais públicos, e o sonho que tinham em ter um filho, se torna cada vez mais difícil de ser alcançado,  por conta da falta de investimento em maternidades no país.', 'Como dito acima, é um direito de todas as pessoas que estejam grávidas, que elas tenham acompanhamento médico digno, durante toda sua gestação, e principalmente, que tenham segurança de um parto humanizado. Tanto a mulher quanto o bebê, devem estar seguros durante todo o parto, e a autonomia da mulher deve ser levada em conta, além de um acompanhamento antes e depois, para que tenham o devido amparo e se recuperem da melhor forma.', 'Assim, no hospital público - que esteja próximo à residência da paciente, a mulher deverá ter todo o atendimento necessário, sem que lhe seja cobrado a mais, e levando em consideração suas necessidades, para que, por exemplo, caso haja escolha, a mulher possa optar por qual parto ela se sentirá mais confortável- normal, cesárea ou fórceps, mas que também o hospital esteja preparado para quaisquer imprevistos no parto, sempre garantindo o parto humanizado e o melhor atendimento à mulher e a seu bebê.', 'Portanto, o parto humanizado é uma questão de saúde pública que deve ser assegurada pelo governo de todos os estados a todas as mulheres que engravidarem, além de um fácil acesso a um hospital público ou Sistema Único de Saúde (SUS) . E a gratuidade desse atendimento,  deve ser mantida pelo governo federal, por meio dos impostos pagos pela população, previamente destinados á saúde pública. Tudo isso, em conjunto com uma maior importância dada aos partos, resultará em melhores atendimentos voltados saúde da população em uma das horas mais felizes de suas vidas, o nascimento de seu bebê: o parto..']",160,120,80,160,120,640
46,A privatização do saneamento básico brasileiro,"['O Neoliberalismo é um modelo econômico que defende a não intervenção do Estado na economia. Nesse sentido, em 1989, foi aprovado o Consenso de Washington, o qual incentivava a privatização de empresas, para que assim, a atuação do Estado seja minimizada nesse setor. Com isso, muitas empresas brasileiras foram privatizadas e na hodiernidade, é discutido se o setor de saneamento básico deve ser privatizado ou não.', 'Dessa maneira, é importante ressaltar que, o Estado, muitas vezes não consegue manter tantas empresas pertencentes a ele. Assim, setores que são essenciais para a população, como o saneamento básico, e que não estão sendo mantidos por falta de investimentos, devem ser privatizados com urgência.', 'No entanto, antes de privatizar, é necessário observar o histórico de investimentos desse setor, pois muitas vezes, o Estado diminui os investimentos para que assim, o serviço não seja bem feito . Desse modo, a população, insatisfeita, exige a privatização, com o pensamento de que assim o serviço será melhor. Contudo, é apenas uma estratégia política.', 'Portanto, cabe ao Estado melhorar as gestões dos setores estatais, por meio de fiscalizações, com o intuito de empresas não correrem o rico de falirem e a privatização torna-se uma opção para que isso não aconteça. Dessa forma, menos empresas e setores serão privatizados no Brasil e assim, menos estratégias políticas acontecerão.']",160,160,120,160,120,720
137,Diversos benefícios dos transgênicos,"['É notório que o uso de organismos transgênicos aumentou muito no Brasil nos últimos anos, principalmente no setor de agronegócio. Dentre                 tantos fatores                destacam-se: a resistência e                 durabilidade das plantações como elemento marcante e o seu rápido crescimento.', 'Sabe-         se, que         a resistência e durabilidade         é         de fundamental importância nas frutas e verduras, pelo fato de serem em sua maioria frágeis e de rápida         oxidação;         ocorrendo assim a perda de nutrientes e sua danificação antes, durante e depois do transporte.', 'Além disso, o seu                 rápido desenvolvimento auxilia na crescente demanda do mercado consumidor por alimentos de alto valor nutricional                ; com isso, o aumento nas vendas acaba por promover                 uma elevação                na economia brasileira.', 'Diante disso, faz-se         necessário         uma maior divulgação dos diversos benefícios dos produtos transgênicos,         onde         não apenas         trás         soluções para vários problemas, como         também, a         melhora da qualidade de vida para a população brasileira.']",120,80,80,80,120,480
4,"Em caso de dúvida, liberdade ou prisão?","['A condenação em segunda instância está causando muitas discussões no meio jurídico. Após a decisão de liberar alguns presos condenados em segunda instância, dentre eles o ex-presidente Lula, o assunto está presente diariamente na imprensa e nas mídias sociais.', 'Trata-se de um assunto muito delicado, pois envolvem envolve crimes que prejudicaram uma outra parte e que causaram danos irreparáveis para alguns. A justiça brasileira precisará analisar com muita cautela qual decisão será tomada, visto que não agradará parte da população independente independentemente da decisão que for tomada.', 'Deve-se levar em conta que está sendo analisado apenas o lado do suposto criminoso e pouco se fala ou se faz para que a justiça seja feita de uma maneira que o(s) prejudicado(s) os prejudicados fiquem satisfeitos com as decisões proferidas. A justiça brasileira precisa fazer algumas modificações nas leis para que os acusados tenham a punição adequada e para demonstrar para a à população que a justiça ela funciona, minimizando ao máximo a sensação de impunidade e fortalecendo a credibilidade jurídica sua credibilidade perante a população.', 'Portanto, os condenados em segunda instância devem aguardar presos por seus julgamentos enquanto a justiça faz a parte dela apurando todos os fatos e recursos que forem necessários para que seja sentenciada a decisão correta.']",80,120,120,80,80,480
82,Automedicação – devemos realmente combatê-la?,"['O século XXI iniciou com transformações em diversos setores da sociedade, buscando aprimorar e desenvolver tecnologias que possibilitasse  a descoberta de novos conhecimentos,  os Cientistas investiram maciçamente em pesquisas, os resultados desses investimentos podem ser analisados nas áreas das Ciências Médicas   que desenvolveram medicamentos para o combate de algumas patologias que antes eram fatais. Porém   com os avanços tecnológicos e o conjunto de informações que a sociedade dispõe hoje, os cidadãos desenvolveram práticas de se automedicar sem um diagnóstico preciso.', 'Segundo o ministério da saúde , essa prática acomete 20 mil vitimas fatais por ano, e outras ficam em situações de riscos e acaba  desenvolvendo novas doenças,  em um levantamento realizado pelo Instituto de Ciências   Tecnologia e Qualidade, diz que é comum entre os brasileiros a automedicação, cerca de 76% da população admitem  tomar medicamentos por conta própria.    Haja vista que,   o sistema de saúde no Brasil é precário, faltam profissionais e postos de atendimento para suprir a demanda de toda população   deixando uma parcela desta desassistida, e esse problema é o que leva muitas pessoas a não procurar um profissional especializado para realizar os procedimentos corretos.', 'É importante frisar também que,    a maioria dos que praticam esse hábito,  s não tem consciência dos danos que podem gerar a  saúde, mesmo após as diversas campanhas de conscientização sobre os perigos do uso irracional dos medicamentos, muita gente ainda insisti  no erro, a maior parte dos casos está entre jovens de 15 a 25 anos de localidades desenvolvida  e que não ver  problema nesse método, os medicamentos mais consumidos sem a prescrição médica são os Descongestionantes Nasais; Anticoncepcionais e Relaxantes musculares nessa ordem.', 'É notório observar que, se todas as pessoas procurasse  um hospital quando notasse  algo de estanho no seu corpo, podendo ser uma simples febre ou uma dor de cabeça, os hospitais ficariam lotados   dificultando ainda mais o atendimento de casos mais graves, mesmo assim essa precariedade no sistema de saúde não justifica o hábito. Contudo    o governo necessita investir em campanhas de conscientização, na saúde e aumentar o número de profissionais,    só assim o cidadão se sentira  seguro.']",120,160,160,120,120,680
94,O autismo e suas barreiras na educação,"['Sancionada em 2012, a lei Berenice Piana, reconhece o autismo como deficiência, garantindo seus direitos, dentre eles a integração escolar. Essa inserção traz desafios em sua implementação como a necessidade de diagnóstico precoce, apoio multidisciplinar e a sensibilização dentro das escolas.', 'O diagnóstico precoce facilita na intervenção de medidas a serem aplicadas com a criança. Cada uma possui sua individualidade dentro do espectro; alguns com graus maiores ou menores de dificuldade de interação com o meio. Sendo assim, quanto mais cedo ocorrer o diagnóstico, melhor e mais rápido será o processo de desenvolvimento.', 'Vale ressaltar a importância do apoio da família juntamente com os médicos que acompanham o autista. Também se faz necessário a comunicação contínua com a escola e professores. Por conseguinte, será possível proporcionar maior bem-estar tanto na sua vida escolar e fora dela.', 'Nota-se, portanto, que o ambiente escolar deve não somente estar aberto ao aluno, contudo tornar o aprendizado efetivo. Cabe ao governo capacitar professores para melhor atendê-los. Até mesmo promover campanhas para esclarecer e trazer debates sobre.  Onde a colaboração de todos os envolvidos ocorra de forma a diminuir o estigma sobre o autismo.']",160,120,80,120,80,560
63,A indenização é uma punição ou não?,"['No ano de 2015, houve um rompimento da barragem da mineradora Samarco localizada na cidade de Mariana-MG. Na época, o crime foi considerado o maior desastre ambiental registrado no Brasil segundo o jornal O Globo. No entanto, após a tragédia em Mariana, outro crime ambiental aconteceria no país: o rompimento da barragem de Brumadinho-MG, e desta vez, ocasionada pela empresa Vale. Ambos os crimes foram cometidos por renomadas empresas, o que nos  fazem questionar sobre a funcionalidade da justiça para crimes ambientais no Brasil.', 'As duas empresas, Vale e Samarco, apenas pagaram a indenização, isso porque no artigo 25, a lei decreta ou o afastamento do cargo e a prisão para o responsável, ou a indenização para os danos causados. E dada a condenação, o processo sai de cena, ou seja, fica a mercê da justiça escolher entre as duas punições, e quando uma é escolhida, o crime é considerado pago. Porém, as duas empresas por serem grandes corporações, lucram muito, e apesar do prejuízo devido aos danos  causados pelo rompimento da barragem, elas se restabelecem com o tempo. Contudo, a indenização não é uma punição, pois essas empresas têm dinheiro para arcar com o prejuízo. E a medida de indenizar, subtende-se que o dinheiro vale mais do que as vidas de animais e pessoas, sendo um total desrespeito  ao meio ambiente e aos familiares das vítimas da tragédia do rompimento das barragens em Mariana e Brumadinho.', 'Entretanto, a indenização poderia servir com uma nova lei: constatada uma irregularidade na empresa, o empresário teria um prazo para amparar o erro. Caso o empresário não resolvesse o problema dentro de um prazo estabelecido, o mesmo teria que pagar uma multa por suma irresponsabilidade. E se mesmo após a multa o empresário não tomasse a devida providência diante da irregularidade que há em sua empresa, o mesmo  deveria ser preso por estar ciente ao risco que sua empresa pode causar ao meio ambiente, aos animais e as pessoas que vivem e moram próximas da corporação.']",120,160,120,160,120,680
52,A eficácia de algumas medidas preventivas no combate a gravidez precoce,"['A gravidez precoce é considerada um problema de saúde pública, pois provoca riscos a saúde da gestante e do bebê. Além disso, tem alto impacto socioeconômico, uma vez que pode causar a evasão escolar das mães adolescentes.', 'Recentemente, no Brasil, a ministra Damares Alves tem defendido a abstinência sexual entre os adolescentes como método para prevenção da gravidez precoce, baseado no modelo de políticas adotado pelos Estados Unidos, por volta dos anos de 1980, durante a emergência do contágio pelo vírus da AIDS, no governo de Ronald Reagan, que estava sendo cobrado por medidas preventivas de combate a transmissão de doenças sexualmente transmissíveis e gravidez precoce.', 'Contudo, pesquisas científicas , que investigaram o comportamento sexual das pessoas em diversos países, não observaram relação entre o investimento em programas de abstinência sexual e a redução dos riscos de gravidez precoce, bem como para a incidência de doenças sexualmente transmissíveis.', 'Dessa forma, a abstinência sexual não pode ser compreendida como uma medida absoluta de prevenção a gravidez precoce e a transmissão de doenças, a educação sexual, principalmente, em ambiente escolar ainda apresenta principal relevância para a quebra de tabus e conscientização dos adolescentes sobre o início da vida sexual.']",120,80,80,120,40,440
43,Monitoras de conduta,"['Com advento da globalização, em 1970, pelo mundo, as redes sociais universalizaram-se. Nelas florescem novas ideias, pelas quais os interesses coletivos são reforçados. Todavia, os meios tecnológicos passam a incorporar normas de condutas já idealizadas socialmente, mas que agora se afirmam como monitoras das ações de indivíduos frente ao compartilhamento de conteúdos que, segundo elas devem ou não serem aceitos pelos internautas. Esse questionamento tem propagado a cultura do cancelamento nas redes sociais que, por um lado está pautada numa ética coletiva histórica, por outro desvia o propósito de um diálogo construtivo na comunicação.', 'Em primeira análise, toda comunidade partilha valores e normas que a identificam e constitui sua cultura, portanto, o cancelamento na rede está fundamentado em uma ética social. Isso porque segundo a filosofia, em seu conceito sobre liberdade e responsabilidade, o indivíduo é livre para agir, no entanto, sua ação está sujeita ao julgamento coletivo, pelas regras morais. Nessa lógica, a sociedade é como um corpo jurídico, uma vez que analisa a postura do sujeito com base em valores transcendentes, até nos meios de comunicação, pois o que é propagado por celebridades, por exemplo, exerce influência sobre a opinião e comportamento de muitos seguidores, então tais publicações devem ser respeitosas e transparente, e não abusivas.', ""Em segunda análise, a cultura do cancelamento nas redes sociais tem implicações e impede o dialogo igualitário nesse local. Em síntese, o julgamento social, muitas vezes, é injusto e ofensivo, pois operam com agressões verbais que deixam marcas profundas na consciência da vítima, isso pode prejudicar por longo prazo suas relações pessoais e interpessoais, e até mesmo causar instabilidade emocional, tornando-se um mecanismo de humilhação na mídia. Dessarte, tal ação social impossibilita a comunicação igualitária, a qual, de acordo com a socióloga Djamila Ribeiro, em sua teoria sobre ''lugar de fala'', para haver diálogo construtivo é necessário que ambos os lados sejam ouvidos. No entanto ,o ostracismo social não corrobora para a construção de uma rede mais humanizada, pelo contrário a transforma em um ambiente repressivo e hostil."", 'Diante do exposto é premente que influencers ativistas e escolas- instituições que ajudam a formar a consciência coletiva- busquem combater as práticas de repressão na internet e construir diálogos humanitários, por meio de uma educação e reeducação que cure a ignorância dos sujeitos, com debates, aulas de sociologia e filosofia no contexto em questão, e informações sobre as consequências negativas do cancelamento, na mídia. Assim, será possível que o espaço online seja mais respeitoso e menos opressivo.']",160,200,160,200,160,880
2,A repentina visibilidade do STF,"['Supremo tribunal federal Tribunal Federal é o nome que se da dá para a mais alta instância do poder judiciário Poder Judiciário. Sendo o maior grau, é responsavel pela lei maxima do Brasil, garantindo que a constituição Constituição federal seja respeitada.', 'Nos ultimos anos, presenciamos assuntos polêmicos que o STF julgaria, dando uma enorme evidência ao mesmo que antes não o possuía Nos últimos anos, o STF julgou vários casos polêmicos, o que deu a esse órgão uma grande evidência, não possuída anteriormente. Podemos citar casos como o acesso a medicamentos de alto custo financiados pelo governo e a descriminalização do uso de drogas. Com a grande evidência que o supremo adquiriu nos ultimos últimos anos, começaram os julgamentos populares em que 39% reprovam o mesmo. Isto se deve por inumeros motivos, sendo o principal deles por os julgamentos de casos com envolvendo figuras públicas que dividem opiniões populares.', 'Um exemplo disso seria o julgamento do ex presidente ex-presidente Luiz Inacio  Lula da Silva, que foi condenado por lavagem de dinheiro e corrupção passiva em 2017. Lula Lula, enquanto presidente presidente, se tornou uma figura publica pública muito popular e e, após seu mandato mandato, dividiu opiniões quanto o seu governo, fazendo com que depois de declarar sua prisão muitos reprovassem o julgamento.', 'Sendo o principal orgão de poder judiciario Sendo o principal órgão do Poder Judiciário e tendo os principais profissionais da área, o STF deve respeitar e servir de forma justa e imparcial toda a sociedade brasileira, julgando os casos da melhor forma forma, mesmo quando contra a opinião do povo.']",80,40,80,80,40,320
138,Medo do quê?,"['Cada pessoa tem suas manias, preferências e medos. O que deixa mais claro o                 traço                de cada uma são evidentemente suas                 atitudes                . Por meio delas distinguimos o herói do covarde.                 Não aqueles heróis                de filmes                que estamos acostumados, mas sim aqueles que são em                maioria anônimos. Desde o bombeiro que realiza um parto por telefone até o                 réu                que confessa seu crime voluntariamente. Esses são exemplos de coragem.', 'Denomina-se covarde                 também                aquele que não luta por seus direitos. Um homem         independente do que seja         não abandonaria um navio deixando mais de 4000 vidas à deriva no mar, a menos que         este         seja mais um do                 time daqueles que não cumprem seus papéis como pessoa                . Um ato de         exrema         covardia.', 'De encontro ao         pensamento popular, prefiro um herói morto, mas que executou seu dever como homem, do que centenas de                 egoístas perambulando com seus próprios interesses ao redor do mundo                .']",80,80,0,0,0,160
51,A luta pela educação prevalece,"['O Analfabetismo funcional é um dos assuntos que mais foram discutidos na geração atual . Além de tratar da dificuldade e incapacidade de indivíduos interpretar textos e realizar exercícios básicos propostos durante a escolarização, ele abrange pessoas formadas e não alfabetizadas. Não obstante a redução das estatísticas, é preocupante o índice da sociedade que compartilha essa condição.', 'Em princípio, é importante esclarecer que para os brasileiros alcançarem a oportunidade de estudar foi uma luta e continua até nos dias atuais . Embora,  o Estado ao longo dos anos tem se dedicado na criação de novos métodos de ensino e projetos para que todos tenham acesso a educação básica e superior - tais como investimentos em politica de transportes, materiais, alimentação ,vestibulares e bolsas de estudos- novas medidas devem serem tomadas para que a taxa de analfabetos diminuam e vidas sejam transformadas.', 'Segundo a PNAD( Pesquisa Nacional por Amostra de Domicílio), de 2004 a 2012 houve uma redução de 2,8 a porcentagem de jovens e adultos analfabetos, tendo o reajuste de 11,5% para 8,7%. Isso significa que aproximadamente 17.400.000,00(dezessete milhões e quatrocentos mil) pessoas ainda necessitam serem alcançadas pela educação, vemos o resultado no nosso cotidiano de como a sociedade tem sofrido devido a sua falta, a baixa escolaridade impede novas oportunidades de emprego, dificuldade na comunicação e consequentemente rouba os sonhos que não puderam nem serem escritos no papel.', 'Cabe a nós continuarmos lutando para a alfabetização de todos e os motivando a almeja-lá. E ao Governo investir nos projetos já criados  e reforçar com novas oportunidades para aqueles que não são beneficiados com as já existentes ou muitas vezes nem são informados sobre as mesmas. Políticas de propaganda devem serem aplicadas para melhor proveito dos direitos e chances de se alfabetizar!']",120,120,120,120,120,600
73,A busca pela sociedade igualitária,"['Desde o período colonial, em meados do século XIX , essa má cultura pelo favorecimento de determinadas camadas da sociedade em detrimento de outras incidem nos direitos pelo uso do pré-conceito por determinada classe social e vem demonstrando contornos de desigualdades mesmo que no Artigo 5º da Constituição Federal de 1988 assegure a inviolabilidade do direito à vida, à liberdade, à igualdade, à segurança e à propriedade, na busca da construção de uma sociedade justa e igualitária.', 'Os colonos portugueses através de sua autossuficiência aquisitiva e financeira e detendo assim a liderança  criou o monopólio do mercado trabalhista e impunham a seus subordinados, regimes duros e desumanos  que denotava a busca da manutenção do poder e ganância, vivenciado nas chefias da mão-de-obra escrava, antes da Lei aurea sancionada em 1888 pela princesa regente do Brasil Dona Isabel .', 'Hoje o que vemos é a continuidade de modelos discriminatórios apenas nesta classe social (Reestruture) configurando o racismo em pleno século XXI que na maioria das vezes é de maneira incomum (Vírgula) criando desafios para a maior parte destes brasileiros como o ocorrido no Supermercado Zaffari em Porto Alegre/RS em 2013, no qual foi indenizado depois que três estudantes ao pagarem pela mercadoria foram abordados de maneira abusiva por cinco seguranças tendo os chamados de “neguinhos” .', 'No combate da criminalidade há registros segundo fontes do Mapa da Violência  que um rapaz negro comparado ao branco pode potencializar em até doze vezes as chances de ser vitima de homicídio, isso quer dizer que a inserção de igualdade de direitos não predomina no Brasil e a busca da desconstrução da inferioridade racial adquirida tende a aumentar, pondo em cheque um jovem negro, a cada vinte e três minutos no país.', 'Esse destonamento incide nos dados da ONU que apontou os homicídios entre as duas classes  mostrando que os negros lideram, isso porque a falta de oportunidades de emprego e renda bem como o acesso educação integral demanda do governo medidas que garante o alcance desses jovens.', 'Nos tribunais os juízes devem asseverar as punições a classe ativa ante estes atos de preconceitos raciais não sendo admitido o pagamento de fiança contando com a ajuda do poder legislativo e de parlamentares para esse fato.', 'As diversas Entidades e ONGs também devem convocar toda a população conscientizando a sociedade por meio de palestras para divulgação da necessidade de melhora e aprimoramento das leis vigentes  para o combate desta realidade socioeconômica, garantindo empregos e renda para os brasileiros.']",80,80,80,80,0,320
145,Qual a contribuição da Copa do Mundo para o nosso país?,"['A realização da         copa do mundo         no Brasil vem trazer-nos diferentes reflexões a respeito do         “legado da copa”         , pois atualmente                 demonstra um prejuízo                diante da falta de investimentos públicos na educação e na saúde, principalmente. As autoridades apostam em que tal evento         vem         a ser uma grande ferramenta para acelerar o         crescimento e necessário para         o desenvolvimento do nosso país.', 'Porém,         diante das         manifestações, a população brasileira não vê esse evento como uma oportunidade de crescimento econômico do país, pelo contrário, diante de tantos gastos         neste         evento mundial para         “impulsionar”         a economia                 surgi as dificuldade                , como as condições precárias da educação pública e         ao          atendimento                nos hospitais.', 'Em vista disso, a                 participação do Brasil         copa do mundo         não contribui com o desenvolvimento do nosso país, já         que, o         governo está investindo mais         para a         realização         deste mundial         ,         em vez de priorizar         as demais áreas essenciais para a formação de uma nação desenvolvida.', 'Constata-se, assim, que sediar a         copa do mundo nãos         traz nenhum legado econômico e         quão         é importante investir cada vez mais na educação pública, na saúde e         dentre         outras áreas fundamentais.']",120,120,80,80,120,520
49,"Influenciadores digitais, uma discussão social","['Nas sociedades contemporâneas a difusão da internet permitiu maior acessibilidade à informação e dinamizou uma forma mais instantânea de comunicação e influência. E nessa perspectiva globalizada, plataformas de vídeos e redes sociais passaram a configurar a realidade atual, seja por intermédio de youtubers com suas temáticas e opiniões, seja por outros influenciadores digitais nas diversas opções midiáticas onlines (Twitter, Instagram, Facebook e etc.). Dessa forma, é notório observar o impacto desses repertórios influenciáveis na vida comum das pessoas, porque muitos buscam formas de emagrecer, vestir-se ou procuram por respostas às suas dúvidas pessoais, por exemplo. Então, qualquer informação ou atitude deve ser repassada de forma saudável, clara e verdadeira, pois pode ajudar aquém precisa, mas também pode prejudicar se forem repassadas erroneamente.', 'Nesse contexto, nota-se a importância da veracidade conteudista repassada por eles, pois as fake news – notícias falsas já equacionam malefícios à população diante da Pandemia do Covid-19; um fato dessa negativa é a informação de que chás, certas ervas e vitamina C combatem o coronavírus. E, como finaliza o filósofo e escritor Umberto Eco: “a internet deu voz aos ignorantes”. Por isso, influenciadores digitais são cidadãos responsáveis pelo que transmitem e precisam operacionalizar cuidado acerca dos conteúdos e, assim, perpetuar conhecimento digno e justo.', 'Por conseguinte, infere-se a democraticidade  a qualquer plataforma digital, e a procura pela notoriedade em tornar-se um “digital influencer” ganhou cada vez mais espaço. No entanto, não é uma questão de ser, mas o que será repassado, porque diversos públicos procuram por dicas, tutorias, receitas e tantos outros, e num ambiente digital, sem a presença dos pais para inspecionar, certas atitudes e informações distorcidas por pessoas despreparadas, podem prejudicar um adolescente com pensamentos suicidas ou provocar incêndios por tutoriais errados e sem proteção indicada . Dessa maneira, numa sociedade fortemente impactada por esses produtores de conteúdos digitais, a consideração precisa ser empatia, humanismo e respeito pelas pessoas que assistem.', 'Por último, falar em influenciadores digitais é falar em internet, portanto, problemáticas ainda necessitam de resoluções. Cabe ao Ministério da Cidadania  protocolar por iniciativa de uma Proposta de Emenda Constitucional – PEC, a precisão para fiscalizar canais de interatividades, tais como youtube e verificar se as informações fornecidas por “digital influencer” estão certos e seguros . Isto posto, asseguraria aos pais uma preocupação a menos diante de tantos malefícios. Contudo, tal resolução deve perpetuar um ambiente protegido e um Brasil mais instruído.']",160,160,160,160,160,800
82,Consultar para se medicar,"['O comum ato de automedicar-se é um problema para a saúde dos brasileiros,  a causa desse ato é a opção de somente buscar cuidados médicos quando de fato não há alternativa, ou seja, já sendo caracterizada uma emergência. A consequência da automedicação é o agravamento da doença e o possível surgimento de novos problemas de saúde.', 'Menos da metade da população faz consultas medicas  periodicamente, seja por medo,  pela falta de tempo ou por não possuírem plano de saúde, dependendo do sistema público de saúde, incapaz de suprir as necessidades de toda a população. Consequentemente, a primeira ação dessa porcentagem grande da população é buscar uma solução mais prática, rápida, que é usar remédios indicados por familiares ou amigos, ou ainda encontrada por meio de pesquisas na internet. Entretanto, cada organismo reage de uma forma a certa substancia ,  ao mercar-se  por conta própria  uma pessoa pode sofre  com os efeitos colaterais do medicamento, normalmente indicados na bula do remédio, que não é clara e de difícil compreensão.', 'No caso de enfermidade  cujos sintomas são equivalentes a de outras, como a Dengue  que pode ser inicialmente confundida com um resfriado comum, normalmente tratado com antigripais e analgésicos. Todavia, a automedicação em casos como esse,  está colocando a vida em risco, já que muitos medicamentos são contra indicados , como a aspirina  que aumenta as chances de hemorragias, agravando a doença.', 'Conclui-se que  para melhorar os cuidados com a saúde  campanhas deveriam ser criadas para deixar explicito  os danos da automedicação, leis poderiam ser criadas para que as informações nas bulas fossem mais claras e uma nova organização do sistema público de saúde deveria ser elaborada, de forma a acompanhar o paciente e marcar checapes regulares.']",120,160,160,120,160,720
149,"Terra ou Marte, deixar o certo pelo duvidoso?","['Parece loucura, mas é a pura realidade, viajar para Marte, colonizar o planeta vermelho dar adeus ao planeta         terra         , a todos e a tudo que se ama por aqui.', 'Quando pensamos que já se viu de tudo, vem alguém nos surpreender com essa ideia         impressionante,          o primeiro                  passo se deu          á anos atrás em 1969          quando o homem pisou pela primeira vez na lua parecia surreal, e daí por diante não se parou mais as pesquisas e viagens espaciais e agora colonizar um planeta onde não se tem vida humana? Mas os apaixonados pela          inovação da história          estão confiantes que tudo vai dar certo, e foram milhares os inscritos, sem falar da vida que vão deixar para trás definitivamente, virar a          pagina          dessa          historia          e começar de novo.                  Basta ter coragem para se inscrever, porque deixar esse planeta maravilhoso e tudo          á          sua volta para encarar o incerto.']",0,80,0,0,0,80
82,Automedicação problema de saúde pública,"['Tomar medicamento sem prescrição médica,    pode trazer consequências graves e   em alguns casos, a pessoa pode chegar ao óbito. De acordo com a Associação Brasileira das Indústrias Farmacêuticas (Abifarma), cerca de 20 mil pessoas morrem todo ano no País , vítimas da automedicação. Dessa maneira, o crescimento no número de pessoas se automedicando  no Brasil torna-se um problema de saúde pública que deve ser combatido.', 'O uso indiscriminado de medicamento, deve-se, a  facilidade de aquisição sem receita médica, falta de informação, indicação de terceiros e dificuldade de acesso a  assistência médica,  este ultimo  problema citado é a causa maior da automedicação, pois todo cidadão que busca o posto de saúde para seu atendimento, ao chegar   encontra o posto lotado de pacientes, com pouco ou nenhum médico, assim desistindo  do atendimento e buscando de formar  errada à automedicação.', 'Outrossim, o Governo não tem combatido o uso da automedicação de maneira satisfatória, não há propagandas diárias nos veículos de comunicação, não há campanhas permanentes nas cidades para trazer pessoalmente ao cidadão informação do perigo da automedicação. Dessa maneira veremos o aumento no número de mortos pelo uso indiscriminado de medicamento sem prescrição médica.']",120,120,120,120,40,520
84,"Porte de armas, um mal sem necessidade","['A insatisfação dos indivíduos para com a segurança, principalmente no Brasil, tende a ser um dos grandes problemas que precisa ser melhorado, nos quais setores das instituições governamentais tentam melhorar esse quadro . O porte de armas é uma das polêmicas  que há controvérsias ou para alguns, (mas para outros) pode ser a solução da violência.', 'A falta de um bom ensino, normalmente no público  do país é uma justificativa para a violência. Muitos estudantes, dentre esses crianças e adolescentes, abandonam as escolas por falta de apoio e incentivo. Assim, eles obtêm outras formas de sobrevivência, ao sair dos estudos, os jovens são “jogados” diretamente aos trabalhos ilegais. O porte de armas de fogo é uma das suas formas de se manterem, roubando ou até matando, mesmo que seja ou não, para sobreviver.', 'A falta de preparo policial também é um fator que faz crescer o aumento da violência, pois a distribuição de seus oficiais é heterogênea, no centro de uma cidade há mais segurança, e em periferias ou lugares mais carentes, são mais que deixados de lado, pela falta de apoio e a violência acaba se disseminando.', 'Uma população armada pode acarretar em uma disputa por expandir armas de grande porte, para alguns acharem que estão mais seguros,  ao ser assaltado, mesmo que estejamos preparados para a legítima defesa, a grande chance de sermos mortos do que se ficássemos apenas calados, então uma das formas para acabar com os homicídios, é fortalecer os diversos lugares homogeneamente e com policiais preparados.', 'Portanto, o governo precisa investir na educação, dando condições aos jovens que moram em condições mais carentes e que eles possam concluir um ensino de qualidade, impedindo estes de conviver com armas, roubos ou mortes, podendo salvar diversas vidas que no futuro poderiam estar condenadas.']",120,120,120,120,120,600
86,As redes e seus ríscos para a saúde mental,"['Nos dias atuais, estar conectado às redes sociais é a realidade de mais de 60% da população brasileira, segundo o IBGE . Por consequência dessa grande popularidade, surge um grave entrave: a falta de punição aos atos ilegais nesse meio e a pouca informatividade social têm dado margem a impactos negativos na saúde mental dos usuários.', 'Em primeira análise, os crimes de ciberbullying lamentavelmente têm ficado muitas vezes na impunidade. Dessa forma, o Estado brasileiro desrespeita seu papel de garantir o bem-estar social e a justiça aos cidadões, delegado a ele pela filosofia contratualista . Nesse sentido, casos em que pessoas criam perfis falsos para proferir, por exemplo, discursos homofóbicos e racistas, afetando a saúde psicológica das vítimas, ainda são pleiteados com a impunidade.', 'Além disso, a pouca informação sobre o uso correto das redes socias corrobora o entrave. Nesse aspecto, segundo o filósofo Imannuel Kant, o homem é o resultado da educação que recebe. Desse modo, a falta de campanhas mediáticas que instruam a população a denunciar os abusos nas redes ou até mesmo como lidar com as pressões para estar adequado ao perfil que a internet exige, facilita o surgimento de problemas psicológicos como a depressão.', 'Por tanto, medidas são necessárias para resolução desse problema. Para isso o Poder Judiciário - como representante do Estado brasileiro- deve analisar e punir os casos de ciberbullying, por meio de uma comissão, formada por juízos especializados em crimes cibernéticos, para assim tornar essa prática cada vez menos frequentes e fazer valer no país o pensamento contratualista. Além disso, o MEC deve criar campanhas publicitárias divulgadas na tevê e redes socias, nas quais psicólogos e especialistas em segurança online ensinem como os usuários denunciarem atos ilegais e lidarem com a toxicidade dessa rede. Assim, os internautas brasileiros terão sua saúde psíquica preservada.']",160,160,160,200,200,880
47,....,"['A educação a distancia no Brasil est em alta nos últimos anos, isso deve-se, ao avanço tecnológico que se modifica cada vez mais. Nesse sentido,o desafio ainda é enorme, pois a edução virtual não possui a mesma qualidade comparada a educação presencial.', 'Segundo, dados no instituto nacional de pesquisas educacionais Anísio Teixeira a edução a distancia cresceu cerda de 17,6% de 2016 a 2017. Sob essa ótica, é evidente que esse crescimento deve-se aos alunos procurarem uma maneira mais acessível de estudar. Contudo, a educação a distancia enfrenta muitos desafios no Brasil , pelo fato de muitas pessoas não possuírem acesso internet ou preferem o ensino tradicional.', 'Outrossim, os desafios que os professores sofrem graças esse novo modelo de educação é eminente . Ademais, muitos professores ainda concordam que o método de ensino tradicional, pelo fato de alguns não possuírem domínio na tecnologia. Com isso, é necessário a adaptação dos profissionais nesse novo método de ensino.', 'Em resumo, é evidente que a educação a distancia será o principal modelo de ensino no país,  é necessário que a população se adapte ao ensino a distancia. , o Ministério da Ciencia e Tecnologia invista em institutos tecnológicos, para que pessoas de baixa renda e professores que não possuem domínio a tecnologia podem se acostumar a esse novo método de ensino, assim o Brasil seguirá em frente.']",160,160,120,160,120,720
91,redação 2,"['Observando o cenário de 1999, na África do Sul, é notório que o surto da aids deu-se, primordialmente, pela negação de seu presidente, Thabo Mbeki. No século XXI, essa realidade não é diferente, visto que no Brasil, a taxa de vacinação contra a poliomielite não foi atingida. Torna-se conhecimento diante desses fatos  que o aumento da taxa de óbitos e de noticias falsas são aspectos do negativismo cientifico.', 'Ao analisar alguns sites e seus conteúdos, é evidente que varias das milhões de noticias são de cunho duvidoso e completamente inapropriadas. Além disso, uma porção dessas noticias falsas ocorrem por interferência linha religiosa que, em grande parte, desqualificam as grandes vacinações e os seus efeitos.', 'Outro ponto importante é o grande aumento de óbitos no mundo, consequência direta da ideologia mal declarada. Convém lembrar que a direção de um Estado pode afetar diretamente no aumento e redução dessas taxas, sabendo-se afora a sociedade é o espelho da organização.', 'Portanto, é inegável a existência das consequências do negativismo e, para haver uma melhora nesse âmbito, o Estado deve  investir na educação e na verificações de noticias, visando sempre o melhor para a população. ""A educação é a arma mais poderosa que vice pode usar para mudar o mundo"", de Nelson Mandela.']",160,160,120,200,120,760
81,Intolerância Religiosa,"['A intolerância religiosa descreve bem a situação atual na sociedade. A falta de respeitar  as diferenças e crenças de outros constrói um conceito do   qual não há liberdade de religião.', 'Em relação as  manifestações de pensamentos diante as  doutrinas, é algo que abrange diversos aspectos tantos  na organização religiosa, já que diz respeito à viabilidade de conciliamento entre igreja e estado , quanto na escolha da crença, visto que a autonomia de seleção da doutrina é um direito pessoal e está garantido por lei.', 'Várias pessoas revolucionaram o mundo com as tendências igualitárias, em razão de que há anos as perciguições  religiosas acontecem. O aumento de variedades de crenças causam  um caos e violência entre os indivíduos, já que leva o ser humano à incorfomidade.', 'Logo, embora o direito de criticar os dogmas sejam considerados  liberdade de expressão, muitos exercem atitudes agressivas com outros. Dessa forma, todos merecem respeito, independentemente de sua religião.']",120,120,120,120,0,480
82,Controle,"['A atitude de automedicação,   contraria a sugestão médica de buscar ajuda, todavia, tal atitude -com determinado controle- é nescessária na atualidade. Atualmente vivenciamos um mundo dinâmico e cada vez mais rápido. A consequência é o surgimento de problemas de saúde, uns de alta gravidade -como obesidade- e outros mais simplificados, porém mais constantes- como dores nas costas. Dores nas costas pode  ser consequência de má postura, muitas vezes ocasionada pela postura apresentada durante um dia de trabalho no escritório. Uma simples dose de rémedio para dor e o problema em questão está aliviado, no entanto, não solucionado. A acessibilidade ao medicamento,   permite manter e facilitar a participação humana nesse mundo dinâmico. Com a rede mundial de comunicação, mútiplas informações são transmitidas, mas a carência de fontes gera mobilizações por proximidade afetual. Muitas pessoas preferem receber dicas de amigos que tiveram casos semelhantes do que  de pessoas especializadas, em contrapartida, em muitos casos, pessoas especializadas não se encontram nas proximidades ou disponível . Ocorre também a inexistência do serviço público de saúde na região   favorecendo a automedicação. O custo para instalação de determinados postos de antedimentos em regiões isoladas é alto, além das dificuldades de transporte e construção que diminuem o favorecimento da instalação. O constante acréscimo de problemas de saúde rotineiros,    favorece o processo de automedicação,  tal processo deve-se ser controlado e educado. Para que isso ocorra   é nescessário  devem ser estabelecidas nos ambientes de trabalho, evitando futuros problemas derivados da rotina.']",160,120,120,120,160,680
84,"Mais armas, Menos Crimes","['Discute-se nas comissões parlamentares do Brasil o Estatuto do Controle de Armas,no todos os cidadãos que cumprirem os requisitos mínimos exigidos pela lei terão o direito de possuir e portar armas de fogo para legítima defesa ou proteção do próprio patrimônio. Com isso, percebe-se que tal parecer vem para fazer cumprir a lei brasileira, ou seja, dar liberdade aos habitantes, já que, de acordo com a constituição, todos têm o direito de se defenderem para salvar suas vidas e uma vez que o Estado, que deveria garantir segurança a população os deixam a da bandidagem, a única forma de manterem a integridade de sua existência é a utilização de armas.', 'Neste sentido, segundo o especialista e PhD John Lott, através do livro “Mais armas, Menos Crimes”, há um total equívoco em se tentar reduzir a criminalidade urbana por meio do desarmamento. Deste modo, entende-se que o governo falhou na tentativa de acabar com a violência tirando as armas de fogo de circulação, uma vez que o desmantelamento atingiu apenas os cidadãos honestos e cumpridores da lei e não o “público” como um todo, isto é, os bandidos continuaram assombrando as pessoas com seus imensos arsenais de armas.', 'Desta forma, o Estatuto deve ser aplicado com o objetivo de minimizar o medo e a insegurança da população, que além de ser alvo do descaso dos órgãos governamentais ainda é manipulada pela mídia- que por meio de programas policiais sensacionalistas ou reportagens de baixa qualidade contribui para o sentimento de impotência, ódio e vingança. Logo, segundo o ex-presidente dos Estados Unidos, George Washington, “Um povo livre precisa estar armado”, ou seja, os indivíduos não podem estar indefesos diante da marginalidade e da violência, eles devem ser livres para lutar por suas vidas.', 'Portanto, em primeiro lugar o Estado deve reformular suas políticas de segurança pública, além de reforçar o policiamento nas ruas, principalmente em lugares propícios ao crime, para transmitir maior segurança aos moradores. Em segundo lugar, a mídia, como maior veiculador de notícias do país, deve desencadear campanhas voltadas a sensibilização das pessoas, para que, ao ser liberado o porte de armas, elas tenham consciência do poder que têm nas mãos e, assim, não ousem irresponsavelmente. Por fim, para que um povo seja livre por completo há a necessidade do reconhecimento da liberdade alheia, deste modo cabe a cada cidadão a visão de que o armamento não acabará com a violência, mas apenas trará um sentimento se segurança, sendo necessário para isso o respeito e o amor ao próximo.']",160,160,160,200,160,840
126,Meia-entrada,"['Dois projetos de lei em tramitação no Congresso reacenderam uma antiga         polêmica         com o objetivo de regulamentar e limitar a concessão da meia-entrada para estudantes, jovens de baixa renda, portadores de necessidades especiais e idosos a 40% do total de ingressos disponíveis para cada evento cultural e esportivo.', 'Produtores e empresários da área argumentam que são forçados a aumentar o preço dos ingressos para arcar com os custos do benefício, tornando esses eventos muitas vezes inacessíveis para a maioria da população que não conta com a meia-entrada. Regulamentar seria                 um passo a mais                no sentido de tornar os eventos culturais e esportivos acessíveis a toda a população sem deixar de conceder o benefício da meia-entrada para alguns.', 'Abolir a meia-entrada não é o que propõem os projetos em tramitação, apenas regulamentá-la, e esta é uma medida fundamental                 já que se trata de uma ingerência do Estado na economia. ""Você não pode fazer um espetáculo em que, se aparecer 100% de público com carteirinha, você obtém metade da bilheteria. Se você levar essas carteirinhas no supermercado, o açúcar não sai pela metade do preço, não é verdade?"" pontua a atriz Fernanda Montenegro.']",160,160,120,160,80,680
36,Liberdade! Liberdade! Abre as asas sobre nós,"['“Eu tenho um sonho”, disse Martin Luther King na luta pelos diretos civis para os negros cem anos após a abolição da escravidão estadunidense.', 'Continuamos a sonhar que essa atrocidade tão antiga não afete ainda mais a sociedade atual e que principalmente deixe de existir. Atualmente grande parte da escravidão se encontra camuflada em um sistema muito semelhante ao processo de escravização indígena na América espanhola, onde estes recebiam “algo” pelo trabalho realizado, ou seja, era estabelecido um regime de semi-escravidão.', 'Nesse sentido, as regiões mais populosas do globo são mais afetadas, no atual mundo capitalista, a procura por alta produtividade e baixos custos faz com que os escrúpulos de alguns empresários inexistam, nesta relação capital e todo homem nasce livre e igual perante a lei, a cobiça esta vencendo.', 'Portanto, a luta pelo fim da escravidão é árdua, a ONU (organização das nações unidas) deve juntamente com a OIT (organização internacional do trabalho ), pressionar órgãos financeiros de destaque como o Banco Mundial e O FMI (fundo monetário internacional ) a não financiar escravidão pelo mundo.', 'No Brasil cabe ao ministério do trabalho informar, principalmente os mais humildes, de seus direitos realizando ações, com escolta da polícia federal em regiões mais propensas a tal abuso, pois como disse Abraham Lincoln “se a escravidão não é crime, não há crimes”.']",120,80,80,0,80,360
93,O parto humanizado e o direito de escolha das mulheres,"['O parto humanizado consiste em um movimento que teve forte crescimento a partir do século XXI, onde seu objetivo é designar um nascimento que ocorre de acordo com preceitos da humanização, com o mínimo de intervenções médicas.', 'Desse modo, as escolhas das mulheres serão protagonistas, considerando o momento não como um evento médico, mas social, emocional, familiar e espiritual, caracterizando-o como um acontecimento natural, sem a necessidade de interferências injustificadas. Além disso, o parto humanizado ressalta também os benefícios emocionais, positivos tanto para a saúde física quanto mental.', 'De acordo com o Ministério da Saúde, um parto humanizado requer a criação de um ambiente acolhedor e a inclusão de procedimentos que rompam o ""tradicional"", dando s mulheres mais autonomia diante do acontecimento delicado. Não se trata de seguir sempre o ""comum"", e sim de um direito de escolha de cada mulher, devendo ser respeitada cada decisão e conscientizada sobre as vantagens e desvantagens do procedimento escolhido.']",200,80,80,160,0,520
51,Modelo Educacional Brasileiro,"['No livro ""O Código da Inteligência"", o filósofo Augusto Cury faz crítica ao modo que a educação cognitiva se sobressaia não cognitiva nas escolas, ou seja, as matérias tradicionais são desenvolvidas mas o pensamento questionador e reflexivo, não. Analogamente com a obra, é evidente que a persistência do analfabetismo funcional no Brasil é reflexo de um modelo educacional ultrapassado e sem inovações, que impedem tal ensinamento de ocorrer .', 'De acordo com o filósofo Immanuel Kant, o homem é aquilo que a educação faz dele. Logo, se os moldes vigentes de ensino não adotam mudanças e não alteram seus métodos, acabam formando cidadãos sem levar em consideração se possuem habilidades de interpretar, debater ou questionar determinados assuntos. Sendo assim, essa falha educacional acarreta prejuízos na formação individual e social dos estudantes, visto que não possuem incentivo para o desenvolvimento de um pensamento indagador.', 'Além disso, é válido ressaltar que essa lacuna na educação reflete diretamente na visão crítica dos indivíduos. Isto é, segundo Cristine Bragale, vice-presidente de comunicação do The News Literacy Project, um dos problemas do baixo nível de alfabetismo é que essas pessoas ficam vulneráveis a desinformação, especialmente quando se trata de memes e imagens falsas . Ou seja, acabam ficando suscetíveis a alienação e manipulação.', 'Diante do exposto, antes que a situação se agrave, é preciso intervir. Logo, cabe ao Ministério da Educação promover um novo modelo de ensino que mantenha as matérias básicas mas que também estimule o pensamento reflexivo dos alunos. Essa medida deve ser feita através de eventos culturais que promovam debates sobre temas sociais e tragam tona figuras que discorreram sobre a educação, como por exemplo o filósofo Paulo Freire, incentivando assim o raciocínio crítico dos estudantes. Além disso, deve disponibilizar bibliotecas e livros com assuntos variados para que possa ocorrer leituras e debates construtivos acerca dos mesmos, tendo como resultado não apenas a formação intelectual dos cidadãos mas também a capacidade de obter uma visão de mundo ampla e uma posição crítica.']",120,160,120,160,120,680
143,Uma fronteira cultural,"['Violência. Humilhação. Morte                . Muitas são as                 consequências                dos trotes universitários de que se ouve falar por meio da mídia. Nesse contexto, uma pergunta deve ser feita: qual é o limite entre o trote e o crime?', 'De um lado, nota-se que o trote é uma boa oportunidade de os calouros conhecerem os veteranos e a universidade em que vão estudar. Nesse sentido, trata-se de um verdadeiro ritual, que marca o início de uma nova etapa da vida, mais séria e responsável.', 'De outro lado, vê-se que o trote é desviado de sua finalidade por muitos dos seus aplicadores, convertendo-se em atos de violência - tanto física, quanto moral. Essa prática repugnante se deve, em grande parte, ao sentimento de impunidade dos seus autores. Tal sentimento, por sua vez, é baseado no fato de que muitos dos seus veteranos agiram do mesmo modo e não foram reprimidos.', 'A fim de que o problema seja mitigado, órgãos estatais de fiscalização da lei, como o Ministério Público e as Polícias, devem estar presentes nesses eventos. Destarte, aqueles que ainda assim cometerem crimes durante os trotes serão mais facilmente investigados e punidos pelo Estado.']",200,200,120,120,120,760
48,Saúde,"['A revolta da vacina foi um movimento organizado pelo sanitarista Oswaldo Cruz no Rio de Janeiro, no ano de 1904, o qual apresentou o descaso existente no tratamento da doença da época. Nesse contexto, percebe-se que os desafios enfrentados pelo sistema público de saúde no Brasil ainda são perceptíveis, e mesmo com a institucionalização do Sistema Único de Saúde (SUS)  em 1988 pela Constituição Federativa, a falta de recursos e o ma atendimento continuam sendo o grande impasse para resolução dessa temática.', 'Deve-se pontuar, de início, que a falta de recursos é um grave empecilho para persistência do problema, um reflexo do déficit orçamentário de estados e municípios . Segundo o blog Doutores da alegria  em 2018,  o Brasil investe apenas 10% do Orçamento da União para a saúde enquanto que em outros países os investimentos aumentam com os anos, o nosso permanece estagnado . Diante disso, a escassez de recursos influencia diretamente na falta de hospitais, medicamentos e médicos, proporcionando que nenhum município (com 10 mil habitantes) consiga disponibilizar todos os serviços de saúde e atender corretamente os seus cidadãos.', 'Ademais, um descaso crônico do SUS é o ma atendimento decorrente da dificuldade para agendar consultas, exames e cirurgias. Nesse viés, de acordo com a entrevista realizada pelo Datafolha com 2 mil pessoas das cinco regiões do país, em que pelo menos 80% classificam como o maior fator negativo o tempo de espera desses procedimentos . Assim, gera-se um aumento na lista de espera dos processos e de insatisfação na população que faz com que a maioria recorra ao setor privado motivados pela necessidade de ser atendido, já que o atendimento básico do SUS ainda é falho.', 'Portanto, conclui-se que, é necessário que o algo seja feito com urgência sobre a questão. Logo, o governo em conjunto com o Ministério da Saúde, deve promover por meio de um financiamento maior de verbas governamentais aos estados, para que seja ampliado o números de hospitais e especialistas nas capitais e demais regiões assumindo a responsabilidade de promover uma atendimento de qualidade a população.']",160,160,120,200,120,760
46,Violação aos direitos humanos,"['Muitas cidades brasileiras , sofrem com a falta de saneamento básico ,no que deveria ser obrigação dos governantes, oferecer um serviço de qualidade á população .Caso a privatização ocorra certamente não haverá melhora no serviço ,pois o interesse financeiro impedirá investimentos na área', 'A privatização do saneamento básico será uma forma de aumentar os lucros das partes interessadas e diminuir investimentos em melhora da qualidade do serviço. Por outro lado pessoas menos favorecidas ficam  mercê do capitalismo.', 'Para que haja garantia que haverá benefícios população, seria necessário que as discussões sobre o assunto fossem ampliada a todos,. No entanto as únicas partes a serem ouvidas são as do capitalismo ,que tem interesse em ganhar cada vez mais sem oferecer benefícios. Dessa forma OS direitos humanos , ficam em segundo planos e o vencedor será o capitalismo.']",120,120,120,120,80,560
85,A soberania popular e o poder legislativo,"['A democracia é conceituada como o governo do povo, porém no Brasil ela é exercida através da representatividade já que a população elege a partir do voto seus representantes, contudo existem mecanismos que possibilitam a participação direta da população, sendo a lei de iniciativa popular a principal delas , entretanto é necessário que haja maior participação direta do povo na elaboração de leis.', 'É evidente a escassa participação popular na elaboração de projetos de lei, uma vez que no Brasil desde a promulgação da Constituição Federal de 1988 apenas quatro leis oriundas da iniciativa popular foram aprovadas, além disso, até 2013 havia apenas cinco propostas provenientes da iniciativa popular esperando para serem analisadas. Um dos fatores apontados para a pouca ocorrência de leis procedentes de iniciativa popular é a difícil aferição da autenticidade das assinaturas de abaixo assinados.', 'É fundamental pontuar que a soberania popular ainda é refém da Constituição Federal, uma vez que o artigo 49 diz- ser competência exclusiva do Congresso Nacional resolver definitivamente sobre tratados e afins, ou seja a população é impedida de definir o que que decidir.', 'Dessa forma, medidas devem ser tomadas para aumentar a soberania do povo sendo a principal delas a elaboração de um projeto de lei de iniciativa popular que vise o aumento da soberania do povo mediante todos os assuntos relacionados à nação, além disso, novos mecanismos como utilização da tecnologia para confecção de abaixo assinados assegurando a autenticidade dos mesmos, assim a soberania popular mediante processo legislativo será satisfatória.']",160,160,120,160,200,800
38,Ciência vs. Politica ,"['Na ultima década, o pesquisador Gilberto chierice desenvolveu uma substancia chamada fosfoetanolamina sintética, mais conhecida como: Pílula do câncer . Segundo ele, ela promete atuar contra vários tipos de câncer. Mas, será que essa substancia é realmente eficaz? Foram comprovados a eficácia dessa pílula? Tem relatos que mostram melhoras nos pacientes?', 'Alguns relatos nas redes sócias e na mídia mostram que diversas pessoas tiveram uma melhora, ou ate que se curaram após o tratamento com uso dessa substancia . Os testes realizados, foram feito em camundongos, após a aplicação, eles apresentaram uma melhora significativa em diversos tipos de cânceres.', 'Não se fez teste em humanos que comprovaram a sua eficácia, portanto, cientificamente não se pode confiar nela. Por que cada câncer é diferente do outro, ou seja, para combater cada um deles, é necessário a aplicação de diversas drogas. Como por exemplo o câncer de mama, ele não é simplesmente uma substância, mas sim uma série delas localizadas na região do seio.', 'Somos levado a acreditar que realmente é uma droga que promete muito pro futuro, mas, por enquanto não sabemos sua real capacidade de cura e de efeitos colaterais. Não podemos simplesmente ingerir uma droga sem antes ser testada e comprovada pela ciência. A mídia pode ajudar, mostrando depoimentos e debates com especialistas da área. As instituições de ensino também podem dar uma força, conscientizando os jovens do mal que o uso de substancias sem uma comprovação confiável pode nós trazer.']",120,80,80,120,120,520
67,,"['Os indígenas foram os primeiros povoadores do território brasileiro, ou seja, antes mesmo do “descobrimento” do Brasil já estavam por aqui . Os indígenas foram figuras muito importantes durante a construção histórica do país, sendo escolhidos como símbolo do Brasil,  durante à época colonial. Porém com o passar do tempo essa população começou a sofrer devido a inúmeros desafios,  que influenciam no modo de vida dos mesmos, como o desmatamento das áreas indígenas e a falta de educação escolar de qualidade.', 'Sendo assim, é necessário olhar com cuidado e preocupação para o desmatamento das áreas indígenas. ois essas áreas são por lei dos índios e tem como objetivo,  cultivar a cultura indígena brasileira, além de preserva o espaço vital deles. Mas mesmo com leis que protejam essas áreas, muitos casos de desmatamento podem ser vistos, e tm como principal causa a exploração para extração de madeira de forma ilegal. Essas explorações causam como consequência o desmatamento das florestas, deslocamento dos índios e a poluição ambiental.', 'Ademais, a precarização na educação desses povos é outro problema que deve ser avaliado . Segundo Nelson Mandela,  “A educação é a melhor arma para mudar o mundo.”, ou seja, a educação dos indígenas é muito importante, pois uma vez adquirida, tm o poder de causar transformações na vida das pessoas através do conhecimento. Essa falta de educação, faz com que os índios acabem se calando por meio de ameaças de madeireiros, por exemplo, devido a falta do conhecimento das leis que a leitura pode oferecer .', 'Visto isso, é necessário que medidas para mudar essas situações sejam tomadas. Primeiramente  o Governo Federal por meio do Ministério do Meio Ambiente, deve efetuar fiscalizações de forma mais rígida,  através de ações de investigações e explorações dessas áreas, para evitar que casos de desmatamento continuem ocorrendo. Outrossim, o Ministério de Educação ,  precisa investir na educação desses povos,  por meio de construções de escolas bem estruturadas e na qualificação de professores especializados, com o intuito de levar educação de qualidade aos indígenas.']",120,160,120,160,120,680
133,Paradigmas sociais e governamentais,"['Desde a         idade média         ,                 o conceito de Estado passou a se revigorar como um poder          central         cujo objetivo seria uma                 relação                benéfica entre         este         e o indivíduo.                 Tal ação deveria ser recíproca, mas o ideal de privatização governamental e o esquerdismo exacerbado contribuem para          esta          discrepância de pensamentos em que se vive hoje.', 'De fato, os cidadãos se         ateem         mais à remediação do que à prevenção. Paradoxalmente, a sociedade exige um Estado em que suas necessidades sejam atendidas, porém a maioria         se abstém desse problema quando escolherá         seus representantes,         nesse sentido de hipocrisia          , tal máquina estatal tem mais liberdade de deter-se, quase exclusivamente, aos seus deleites.', 'Por sua vez, nada justifica ao Estado                 usufruir benefícios de uma sociedade alienada. Nesse ínterim, um esquerdismo exacerbado, ou genericamente, uma ""cubanização"" pode estar próxima                . Ater-se à direita, nessas condições, seria uma prévia solução, pois essa         ""pseudo democracia""         , inerente                 a vários países                , é a responsável por         esta         discussão, já que                 a mesma se tornaria supérflua                se houvesse uma relação benéfica e recíproca entre o Estado e o indivíduo. O que nos dias de hoje constitui uma utopia.', 'Fica claro, dessa         forma          que a menor participação populacional no Estado é inegavelmente uma mera consequência da hipocrisia do indivíduo. Em suma, far-se-ia necessário que o governo não usufruísse de um problema de proporções mundiais para alimentar suas prioridades e seu egocentrismo.']",120,80,80,120,0,400
71,Não tenho nada a perder,"['Nos últimos tempos, temos nos deparados com uma situação nada comum, jovens com uma vida aparentemente saudável que por motivos desconhecidos de amigos e parentes tiram a própria vida. Dois casos chamam atenção em cidades diferentes em que uma era cheia de vida e outra estudante, que por conta própria resolveram sumir do mundo.', 'primeiro caso inexplicável; uma jovem mãe cheia de vida com dois belos filhos e que vivia a sorrir como se não acontecesse nada, todos ao redor dela desconhecia qualquer tipo de sofrimento, e em uma noite sozinha na cidade saiu e pegou um táxi até Natal ,mais precisamente a ponte Nilton Navarro e cometeu o suicídio, deixando a todos surpresos e com uma enorme interrogação. O segundo caso; uma adolescente entre os 18 e 20 anos  era estudante da faculdade UFRN e estava as vésperas de se formar, essa tinha sim um problema para quem esta fora era insignificante, mas para ela a perfeição tinha que acontecer e essa busca não se sabe o real é que a fez tomar tal decisão, vivia muito bem com os familiares e amigos eram religiosos e frequentadores da igreja católica, ela estava sempre com eles, era noiva estava com planos para o futuro após o término da faculdade, é claro que a família procurou ajuda quanto a isso mas não tiveram sucesso, em uma noite as vésperas da apresentação do TCC na faculdade , se despediu do noivo e foi aparentemente dormir, esperou que todos estivessem em seus lugares e sem que ninguém percebesse abriu a porta e saiu pela madrugada em direção a ponte Nilton Navarro e praticou o suicídio .', 'Como ajudar essas pessoas? quase que impossível, não se sabe o que eles pensam e principalmente se estão passando por algo, a única coisa a se fazer quanto a isso é organizar campanhas de alerta a quem est por perto e para eles mesmos a ter amor por si próprio.']",120,40,40,40,0,240
54,Muitas variáveis,"['No início do século XX, a população do Rio de Janeiro absteve-se de aceitar a campanha de vacinação desenvolvida pelo médico e sanitarista Oswaldo Cruz, sobretudo pelo desconhecimento acerca do funcionamento das vacinas. Em tal contexto, o Brasil era afligido por diversas enfermidades, suscitando a necessidade de políticas públicas para erradicá-las peremptoriamente, pois a estabilidade da sociedade dependia disso. A imprescindibilidade de campanhas do tipo em território brasileiro perdura, oriunda tanto de sua importância para a garantia de um direito constitucional quanto para a manutenção da estabilidade produtiva das empresas estabelecidas em território brasileiro.', 'A Constituição Federal de 1988 afirma a garantia do direito à saúde aos brasileiros. A vacinação, dessa forma, é fundamental para a égide de tal princípio constitucional pelos órgãos do Estado, à medida que a observação empírica constata que essa auxilia na atenuação da incidência de doenças nas diversas regiões do país, propiciando proteção da população contra enfermidades e, consequentemente, do direito constitucional no que tange à saúde. Sendo assim, a vacinação é de suma importância para a melhoria da qualidade de vida brasileira e preservação de um direito social.', 'Além disso, a economia brasileira pode ser beneficiada, direta e indiretamente, com campanhas de vacinação. A existência destas, por exemplo, pode eventualmente diminuir o número de trabalhadores que têm de se ausentar do trabalho devido a enfermidades, mantendo estáveis os níveis de produtividade das empresas. Soma-se a isso, a atenuação dos gastos públicos com tratamento para determinadas patologias, que impacta positivivamente a economia. Logo, a necessidade da vacinação de majoritária parcela da sociedade é respaldada também pelo impacto de tal atitude no setor econômico.', 'A vacinação da população é, indubitavelmente, fundamental para a manutenção de uma sociedade com saúde populacional e economia estáveis. As secretarias municipais de saúde devem, portanto, realizar campanhas de vacinação, tencionando ampliar o número de pessoas imunizadas a doenças que atingem o território brasileiro, e palestras que mitiguem crenças errôneas acerca do funcionamento e consequências das vacinas. Concomitantemente a isso, as empresas devem se engajar em campanhas que visem auxiliar na ampliação do número de trabalhadores vacinados, diminuido a possibilidade de eventuais prejuízos. Com essas medidas,  será possível evitar a ascensão de doenças até então erradicas, impedir o aumento dos gastos públicos com tratamento dessas enfermidades,  e, ao combatê-las, proteger a economia do Brasil.']",160,160,160,160,160,800
74,Feminicidio no Brasil,"['O feminicídio é o assassinato de uma mulher, a maioria das vezes esse desejo é causado por ódio, desprezo,..., e quando perdem o dominio sobre a mulher, como é comum nos casos brasileiros.', 'Isso ocorre quando o homem se sente em uma hierarquia. Onde ele é quem manda e a mulher tem que obedecer, por muitas das vezes praticando agressão contra a mulher, fazendo a mulher se alto mutilar.', 'Para coibir o feminicidio no Brasil, teria que haver palestras e acompanhamento para as mulheres que já foram agredidas, pois por muitas das vezes as mulheres tem medo de denunciar, pois podem morrer . Atualmente esses tipos de casos tem tido um grande crescimento no Brasil.']",80,80,80,80,80,400
125,Vende-se maconha,"['A legalização da maconha traria sérios problemas         sociais, entre         eles, o aumento da prostituição e dos gastos com a saúde pública         seriam         uma consequência imediata. Mas, ao contrário, no tratamento de doenças teria uma grande utilidade.', 'Esse espírito de liberdade que envolve a descriminalização da maconha não mede as consequências                 dessas legalizações nefastas                , pois incentivaria ,""in pari passu"", a                 perversão do turismo sexual no Brasil                , assim como foi observado no bairro da Luz Vermelha na Holanda.                 Dessa maneira a prostituição se tornaria uma opção fácil e rápida para conseguir dinheiro e alimentar o vício de drogas.', 'Além do risco de dependência,                 esta                pode provocar os mesmos problemas das drogas consideradas lícitas. Hoje os maiores gastos com a saúde pública         são em         decorrência do consumo do álcool e do tabaco.                 Apesar dos efeitos medicinais comprovados em algumas doenças, o uso indiscriminado da maconha traz grandes riscos à saúde do usuário.', 'Portanto, a sua proibição                 seria                uma alternativa para evitar vários problemas de cunho social. Sendo assim, a sua utilização ficaria restrita apenas         para         uso medicinal                 em hospitais                , livrando a sociedade do uso indiscriminado.']",120,120,80,120,80,520
86,impactos na vida presencial (G),"['Hoje em dia vive-se em um mundo super conectado, onde a todo momento as pessoas estão postando suas localizações, o que estão fazendo,e com quem estão. Postar tornou-se algo comum e rotineiro,pois a todo instante os “status” de cada um são publicados na internet, ficando assim expostos para qualquer um ver. As pessoas se importam tanto em publicar tudo o que está acontecendo ao seu redor, para não ficar “offline” que infelizmente esquecem e deixam de viver a realidade da vida.', 'Como um meio de comunicação muito rápido e eficaz, as redes sociais influenciam cada vez mais as pessoas, não só a postar  mas também a mudar seus hábitos, como o modo de se vestir, o corpo, a alimentação, tudo para se enquadrar no padrão que as redes sociais exigem, e qual padrão é esse? Já sabe-se qual é, são pessoas brancas, magras, e bonitas, pois com base no que se vê no “feed” das mídias sociais, percebe-se que é exatamente isso o que as pessoas que as utilizam querem ser.', 'É notório que o surgimento da internet e das redes sociais facilitou muito a comunicação entre todos, pois faz com que as pessoas consigam se falar em segundos, porém junto com a vantagem vem a desvantagem, pois segundo uma pesquisa feita pelo Instituto Psiquiatra Paulista, as redes sociais são o mal do século, porque dentre 90% das pessoas que as utilizam 35% sofrem de depressão,ansiedade e possuem tendências a piorar cada vez mais seus estados mentais por navegarem na internet, porque de tanto tentarem se enquadrar nesse padrão social, acabam desencadeando entre si um sentimento enorme de insuficiência, gerando então a vontade de cometer suicidio. Devido a esse fato presencia -se um alto índice de suicídios presentes no mundo atual.', 'Para combater esse padrão de vida e de aparência que a mídia social exige é preciso que as pessoas reflitam e se aceitem como são, não é errado querer mudar, mas é errado tentar se encaixar em um padrão que os outros definem que deve-se seguir. Apenas assim se amando, respeitando, e vivendo mais a vida real que as pessoas irão conseguir não ser afetadas pelas mídias sociais, sabe-se que realmente não é fácil ser o que cada um é, mas nunca é tarde para tentar mudar isso, se as pessoas presentes na nossa sociedade deixarem de tentar se encaixar em padrões exigidos para seguir, e começarem a ser o que são de verdade o mundo será mais feliz.']",160,160,120,120,160,720
59,Crise Econômica e Corrupção,"['De acordo com o relatório internacional divulgado pela Organização das Nações Unidas (ONU) no ano de 2018, o número de brasileiros que passam fome chegou a 5,2 milhões de habitantes, um número maior que a população de nosso  país vizinho Uruguai. As regiões mais afetadas pela fome são o Nordeste e Norte do país. São reflexos desse número a crise econômica enfrentada pelo país nos últimos anos, que culminou com a alta do desemprego e o congelamento em investimentos, e a corrupção envolvendo políticos e empresários.', 'Com a crise econômica que se alastrou pelo país nos últimos anos, o desemprego atingiu valores alarmantes, segundo dados do Instituto Brasileiro de Geografia e Estatística (IBGE), esse número chegou 13,2 milhões de habitantes. Em consequência desses números ouvi um aumento na taxa da pobreza, o que consequentemente contribuiu para o aumento da fome no país.', 'Ainda, devido a corrupção envolvendo políticos e empresários, ao qual deixou um rombo de bilhões aos cofres públicos e quebrou dezenas de empresas, o país acumulou uma dívida altíssima, que culminou com uma plano de congelamento dos investimentos, a fim de controlar os gastos públicos e assim reduzir a dívida. Isso prejudicou os programas sociais, de desenvolvimento econômico e tecnológico, afetando diretamente os mais pobres, que já carecem de necessidades básicas, tais como, saneamento básico.', 'Por outro lado, os planos de governos anteriores já haviam conseguido reduzir de forma significativa a fome no país, através de programas sociais, como, por exemplo, o bolsa escola . Entretanto, como exposto pelo compositor Flávio Leandro em uma de suas músicas, ""não, eu não quero enchentes de caridade, só quero chuva de honestidade"", é possível entender que apesar dos programas sociais a corrupção afetou diretamente a vida das pessoas, em geral os mais pobres, e o reflexo dela é a real situação em que vive-se hoje.', 'Os programas sociais já foram um grande passo na resolução do problema da fome, porém se faz necessário outras abordagens. Assim, faz-se necessário que os Ministérios da Economia e da Agricultura destinem maiores investimentos em tecnologia para a agricultura familiar, principalmente para a população da zona rural, com objetivo de fornecer o sustento próprio dessa população, através do consumo e comércio dos alimentos fabricados. Ainda, é necessário, por meio do Ministério do Trabalho o incentivo ao empreendedorismo, através de investimentos financeiros e educacional, a fim de reduzir o desemprego, a pobreza e melhorar a economia do país. Por fim, cabe a população a escolha de representantes que trabalhem para o povo e não em benefício próprio. Dessa forma, será possível reduzir os índices da fome,  e garantir a dignidade da pessoa humana, como descrito na Constituição Federal.']",120,160,120,160,120,680
85,Prova do restabelecimento democrático,"['O Brasil passou por 21 anos de ditadura militar, onde a democracia não era plena. Em 1988 foi promulgada a Constituição Nacional, que entre as suas leis está presente o projeto de lei de iniciativa popular, que dá autonomia para o cidadão construir leis, seguindo as regras para tal construção. Porém esse projeto tem seus aspectos negativos e positivos.', 'O projeto de lei de iniciativa popular precisa de assinaturas de 1% dos eleitores se a lei for nacional ou do estado, e 5% para o município, sendo que o país tem mais de 200 milhões de habitantes, segundo o IBGE em 2013. Tais dados deveriam ser positivos para a aprovação desses projetos, mas até os dias atuais existem apenas 4 leis que vinheram de iniciativas populares. Essa situação é explicada pela burocracia existente para a aprovação de leis por iniciativas populares. Para elas serem aprovadas precisam primeiramente ter apreciações no Congresso, ou seja, deputados que as defendam, (;) e possuírem as assinaturas necessárias e votados pelos deputados, senadores e o (a) presidente da república.', 'O projeto de iniciativa popular, já citado, também tem suas vertentes positivas. A primeira delas é o respeito ao poder democrático, no Brasil a democracia é representativa, mas nem só por isso a população deixa de participar dela diretamente, um exemplo disso é o referido projeto. No contexto atual a internet contribui significativamente para a propagação da democracia, contribuindo assim, para o aumento do número de integrantes de um movimento e consequentemente maiores arrecadações de assinaturas.', 'É evidente; portanto, que após anos de ditadura o Brasil conseguiu restabelecer a sua democracia, prova disso é o projeto de lei de iniciativa popular. Contudo tal lei ainda possui muita burocracia, sendo necessárias mudanças. O Estado deve retirar a exigência de apreciação do Congresso antes do projeto recolher as assinaturas. O Estado e a escola devem ensinar para as crianças sobre a importância da iniciativa popular na formulação de leis em uma democracia que mesmo sendo representativa tem a participação direta dos indivíduos.']",120,80,120,120,160,600
84,"Arma na mão, tiro no pé.*","['Ás vésperas das Olimpíadas do Rio, o país enfrenta índices de criminalidade extremamente elevados, o clima de insegurança tomou conta. Segundo reportagem publicada na revista Veja, o número de óbitos diários por homicídio no Brasil é maior que o de vítimas do conflito entre Israel e Palestina. E é neste cenário que ressurge o debate sobre o porte de arma de fogo pela população civil.', 'Como mostram inúmeros protestos recentes nos EUA, o porte de armas é uma questão que suscita discussões não só no Brasil, mas em vários países. Se por um lado temos os que temem que com um maior número de armas nas ruas a violência só aumente, por outro, temos aqueles que usam a própria violência urbana como argumento para o porte. E é nessa direção que apontam a maioria dos estudos relacionados, (;) estar em posse arma de fogo é um fator que pode alterar completamente o rumo de situações cotidianas, brigas de trânsito, desentendimentos entre vizinhos e a clássica rivalidade entre torcedores seriam ainda mais perigosas.', 'O Estatuto do Desarmamento foi um marco importante na luta contra o crime, sua revogação pode trazer sérias consequências para a população. As armas têm como única função a violência, seja na mão do bandido, para causar o mal, seja nas mãos da polícia, como forma de coerção. E como disse o filósofo francês Jean-Paul Sarte, a violência, seja qual for a maneira em que se manifesta, é sempre uma derrota.', 'Sendo assim, é preciso deixar claro que armas nas mãos de civis tendem a tornar nossas cidades ainda mais perigosas. A educação é sempre a melhor saída, jovens e adultos devem ser instruídos sobre os riscos de andar armado, e para isso, o MEC pode fazer uso de campanhas educativas nas mídias e nas escolas. Também é necessário que a sociedade civil organizada pressione os legisladores para que mantenham o Estatuto, garantindo assim uma sociedade mais segura.']",160,200,160,200,200,920
72,A mentira sendo cão guia,"['O combate s pseudo-informações é extremamente necessário para o acontecimento de eleições justas. É indubitavelmente indiscutível  a força de manipulação das grandes massas contidas nesse tipo de material; isso é evidente ao acessar a internet, onde milhares de informações circulam livremente sem a menor fiscalização a respeito da sua veracidade.', 'No que se refere às grandes massas de manobras, encontra-se a maior parte da população, vítima dessa prática, que acaba sendo influenciada, muitas vezes por não questionar a vericidade dos fatos afirmados em determinada fonte; pode-se citar o exemplo do Dr. Enéas Carneiro, presidenciável em meados de 1990, o qual era taxado de louco em meios de comunicações, por ter ideias consideradas extremas, acarretando o enfraquecimento de sua candidatura e tendo sua credibilidade reduzida.', 'Além disso, o avanço tecnológico permite o acesso a um mundo virtual que é, sem dúvidas  muito vantajoso, mas ao mesmo tempo,  pode ser agudamente prejudicial; qualquer pessoa possuindo acesso a essa dimensão,consegue criar notícias e apontar o fato desejado, verídico ou não, seja ele para denegrir ou mesmo favorecer algum candidato injustamente. Portanto a manipulação é real; bota-se ao acessar o navegador de internet, onde se tem diversas páginas midiáticas com notícias e resultados tendenciosos e fontes muitas vezes não confiáveis.', 'Logo, o combate a esses meios ilegais é de suma importância, visto que o futuro está diretamente ligado à internet. O que pode e deve ser feito é a conscientização das pessoas na hora de pesquisas a respeito dos candidatos, procurando meios diferenciados, não se deixando levar por uma única informação aleatória vista; também deve ocorrer no meio cibernético,  o investimento em uma maneira de policiar informações falsas; por fim, tornar esse tipo de propagação difamatória, uma atitude ilícita.']",120,120,120,120,120,600
57,,"['Ao fazer uma análise do cenário atual no brasil, percebe-se que o acesso ao cinema é problema, enfrentado por boa parte da população, principalmente por aqueles que moram em regiões periféricas ou interioranas. Contudo uma das principais causas é a urbanização acelerada, a falta de investimento e a desigualdade social.', 'A princípio é importante frisar que os grandes centros urbanos, são áreas privilgiadas já que são onde a maioria da população está concentrada. Deste modo o investimento em cinemas nas grandes idades é maior, pois a renda recebida é mais alta. Vale ressaltar que com o avanço descontrolado da globalização o acesso a essas tecnologias foi facilitado. No entanto o Brasil é marcado pela desigualdade social que afeta diretamente os cidadãos que moram longe das cidades grandes e são privados do acesso a essas tecnologias e consequentemente aos cinemas.', 'Em contrapartida, com o acesso dificultado, com a falta de informação e com avanço das tecnologias a população prefere assistir filmes na televisão ou na internet. Entretanto, é importante salientar que todo cidadão deveria frequentar os cinemas, pois eles são uma forma de enriquecimento cultural e convívio social.', 'Logo, com os dados expostos, percebe-se a necessidade da democratização dos cinemas. Portanto, cabe ao Governo juntamente das empresas exibidoras, investir na construção de mais cinemas, principalmente em áreas periféricas e em regiões afastadas dos centros urbanos. Cabe a mídia promover propagandas e campanhas enfatizando a importância de visitar cinemas. Deste modo a população não ser excluída do meio, e assim, ser um fator a menos para contribuição da desigualdade social.']",120,120,80,120,80,520
83,Esporte,"['Recentemente, o Rio de Janeiro foi sede do maior evento esportivo do mundo. Este acontecimento trouxe de volta à tona assuntos acerca da importância da atividade física e dos malefícios que a falta dela em nossas vidas pode causar. É inegável afirmar que o esporte deve fazer parte da vida de toda  a população, mas afinal, de quais formas a prática esportiva, seja ela competitivamente ou não, é incentivada e valorizada no nosso âmbito social?', 'Naturalmente, o ser humano precisa ir em busca de formas de exercitar-se fisicamente. Principalmente durante a infância, pois nessa fase desenvolvem-se diversos fatores cognitivos, e as atividades físicas podem e devem ser grandes aliadas nesse quesito. Além da questão do benefício na saúde e no desenvolvimento dos mais novos, a prática esportiva também é muito importante no aprendizado e convívio social dessa criança, uma vez que a criança pode buscar no esporte uma forma de inclusão social.', 'Além disso, mesmo sabendo de todos os benefícios que a prática esportiva pode trazer, em muitos lugares, o esporte acaba sendo negligenciado. Onde, por exemplo, em favelas, onde muitos jovens não veem nos esportes uma forma de mudar de vida, devido muitas vezes a dificuldade da prática profissional do mesmo e da falta de incentivos, e acabam sendo levados para o caminho do tráfico.', 'Portanto, para tornar mais atrativo e interessante a atividade esportiva no Brasil, os governos devem assumir a responsabilidade da criação de iniciativas e projetos que estimulem e deem suporte para o desenvolvimento esportivo no país. Não só no objetivo de descobrir novos talentos para representar a nação, mas também valorizar o esporte como um grande colaborador para o desenvolvimento social que ele é.']",120,160,120,160,200,760
82,Automedicação,"['Em partes sim, pois a quantidade de pessoas que tomam remédios perigosos para sua saúde, sem receita ou sem ao menos o cuidado de tomá-los de maneira correta,   é alarmante. E muitas pessoas morrem por conta disso, por isso que é imprescindível o trabalho de combate, pois são enormes e infelizmente muitos não têm a consciência que alguns possuem.', 'Contudo, se fosse combater todo tipo de automedicação, rigorosamente, os hospitais ficariam lotados de pessoas com sintomas como dor de cabeça, que poderia ser usado um remédio sem necessariamente passar por uma consulta. Isso não quer dizer que deve-se  esquecer os médicos, de maneira alguma, se a dor de cabeça persistir   ir ao médico é extremamente necessário; o caso é que nem sempre é essencial, e a automedicação pode auxiliar nesses casos.', 'A automedicação surgiu como uma alternativa de solucionar os problemas por conta própria, é muito perigoso, mas não deixa de ser preciso em alguns casos simples. A falta de médicos especializados, demora nos atendimentos e prescrição errada colabora  para a expansão desse método.', 'Porém   essa prática não deve ser incentivada de maneira alguma, pois as conseqüências são muito graves, pode acelerar a doença a ser curada, esconder sintomas e também causar dependência química.', 'Portanto   a melhor forma de lidar seria não focar somente em querer exterminar a prática em si, pois levaria muito mais tempo e poderia nem conseguir totalmente e sim tentar guiar as pessoas a fazerem isso de uma forma um pouco mais segura, lhe dando palestras e cursos ensinando quais medicamentos poderiam ser tomados sem receita e quais não, quais remédios nunca deveriam ser misturados. Um ensinamento básico sobre medicamentos em geral, claro que o combate continuaria, mas teria uma opção para os que não seguirem as normas ou conheçam pessoas que continuariam tomando e avisaria, assim evitaria muitas mortes por falta de informação.']",120,120,120,120,120,600
54,O conhecimento como impulsionador do aumento na taxa de vacinação,"['A vacinação é fundamental para a população, visto que é responsável por erradicar doenças graves e evitar a volta de doenças já erradicadas. No entanto, a procura pela vacinação diminuiu nos últimos anos, sendo um dos fatores agravantes para tal fato a falta de informação disponibilizada para a população em geral sobre o funcionamento das vacinas, fator este que também contribuiu para a ocorrência, em 1904, da Revolta da Vacina.', 'A comprovação da queda na cobertura vacinal é dada pelo Fundo das Nações Unidas pela Infância (Unicef), que garante que de 2014 a 2017 a taxa de vacinação caiu de forma preocupante. Com base nesses dados, é possível apontar a carência na divulgação de informação à comunidade como uma das razões para o decaimento dos números de vacinas aplicadas, já que as pessoas sentem medo do desconhecido e não saber como uma substância age de fato em seus corpos se torna um motivo para que elas evitem a vacinação.', 'Ademais, a existência de “fake news” dificultam a assimilação da verdade sobre a atuação das vacinas no organismo, uma vez que passam informações erradas, fazendo com que mesmo quem possui acesso ao conhecimento nas mídias sociais desconfie dos efeitos causados por elas . Essas falhas na comunicação levam s pessoas a não se vacinarem, podendo contrair doenças que necessitam de tratamento, o que afeta até mesmo a economia do país, pois os gastos com a saúde pública começam a crescer.', 'Dessa forma, ações precisam ser tomadas para garantir uma divulgação correta das informações necessárias e um aumento na taxa de vacinação. Assim, cabe ao Ministério da Saúde implantar um sistema nos postos de saúde que aponte quais indivíduos de determinada região não foram vacinados, para que um assistente social possa entrar em contato e ajudá-los, seja esclarecendo dúvidas, explicando de forma simples como as vacinas funcionam ou organizando um melhor horário para o atendimento. Além disso, campanhas nas redes sociais também se tornam indispensáveis para uma melhor divulgação de conhecimentos sobre a vacinação. Com essas medidas, uma das principais causas da Revolta da Vacina , a falta de informação sobre as substâncias injetadas na população, não se fará mais presente na atualidade.']",120,160,120,120,120,640
37,O grande medo das mulheres no século XXI,"['O estrupo crime que vem alcançando índices cada vez maiores ao longo dos tempos, ocorre desde a segunda guerra mundial, quando russos estupravam mulheres alemãs e comunistas. Tal ato sexual afeta diretamente a vida da vítima, seja ela mulher ou criança, deixando marcas a vida inteira, como problemas psicológicos e afetando seu modo de viver. E poucas são as denúncias registradas no Brasil.', 'Apenas 35% dos casos de estrupo são registrados no país, esse número tão pequeno deve-se ao fato de que muitas das mulheres são ameaçadas pelos homens que ás violentam, outras por vergonha e medo de como a sociedade possa julgá-la. Aquelas que denunciam, passam por tratamentos psicológicos para conseguir viver normalmente. O medo de voltar a caminhar sozinha, de sair para trabalhar, e até mesmo de ter um relacionamento amoroso com outro homem, são as consequências causadas por tal crueldade.', 'O número desse crime contra crianças abaixo de 12 anos também são altos. essa violência pode vim de dentro de casa. Tios, cunhados irmãos, são os principais acusados nas denúncias. Já existe uma lei em vigor contra o estrupo , o acusado pode ter uma pena de até dez anos de prisão, mas muitos ainda ficam impunes, outro fator que leva a vitíma a não querer denunciar.', 'Esse é um problema que deve ser bastante discutido pela sociedade e por as autoridades responsáveis juntamente com o governo, investindo na educação da população,  levando informações em escolas e na televisão, com a ajuda de profissionais como professores, médicos e psicólogos. A família também tem que participar da vida da criança ensinando valores morais desde pequenos . Essa é uma questão de moral e também de saúde pública.']",120,80,80,80,120,480
86,Saúde mental e Redes Sociais,"['Tecnologia e comunicação são fundamentais. A invenção da emprensa  por Gutenberg, por exemplo, proporcionou um avanço sem precedentes ao agilizar-se o processo de cópia de textos. Tendo tal progresso em vista, observa-se indispensável a análise dos impactos do uso das redes sociais na saúde mental.', 'É de valorosa importância, assim sendo, a compreensão dos males que essas acarretam à vida pessoal. De acordo com o Hospital Santa Mônica, o medo de estar desconectado das mídias sociais gera uma constante busca por estar atualizado, o que vicia os usuários dessas plataformas. Percebe-se, nesse sentido, a existência de um fenômeno que, indubitavelmente, ocasiona severas psicopatologias que se equiparam em certos aspectos ao vício em drogas.', 'Sendo assim, a educação mostra-se uma ferramenta essencial, visto que o uso indiscriminado das redes é prejudicial à sociedade, principalmente os jovens – devido ao alto índice crianças e adolescentes conectados aos espaços virtuais . Segundo Kant, filósofo alemão do século XVIII, o ser é aquilo que a educação o faz. Portanto, a elaboração de medidas educativas  visando amenizar tal empecilho é imprescindível para que haja, de fato, transformação social.', 'Em resumo, conclui-se que as redes sociais são fruto do progresso da tecnologia e da comunicação, ou seja, são inegavelmente fundamentais ao convívio coletivo. Salienta-se, contudo, a urgência de medidas que minimizem os seus impactos negativos na questão da saúde mental. Por isso cabe ao Ministério da Saúde  por meio do SUS (Sistema Único de Saúde) disponibilizar às UBS (Unidade Básica de Saúde) psicólogos especializados a fim de que pessoas portadoras desses males sejam tratadas com maior efetividade.']",160,160,120,160,160,760
60,,"['Desde o mandato do ex-presidente Michel Temer, tem se falado e discutido  muito sobre a polêmica Reforma da Previdência, uma reforma que é justificada, segundo os governantes, com o aumento da expectativa de vida , e assim, um aumento considerável nos gastos com a previdência. Porém do jeito que está sendo encaminhada, prejudicaria diretamente as mulheres, a população mais pobre,  e os idosos, acarretando mudanças drásticas em suas vidas.', 'Caso seja aprovada, os trabalhadores terão que ter no mínimo 65 anos de idade, e 25 anos de contribuição para ambos os sexos, e para ter a aposentadoria integral,  o indivíduo teria que contribuir por 49 anos, o que complica a vida de muitas mulheres, por exemplo, que por conta de um machismo enraizado em nossa sociedade, teriam jornada dupla de trabalho, tendo que trabalhar fora e fazer os afazeres de casa, tornando injusta essa condição em relação aos homens.', 'Na questão da pensão de morte, a mudança também seria bastante significativa, principalmente aos menos favorecidos socialmente, onde estes, conforme a reforma, receberiam somente 60% do valor total do benefício, mais um adicional de 10% para cada dependente. Sendo assim, um (a) viúvo (a) sem filhos ou com filhos acima dos 21 anos,  receberia um valor equivalente à R$ 598,80 reais, o que pesaria consideravelmente para quem vive em situações precárias e que, muitas vezes, tenta sobreviver com menos de um salário mínimo e a ajuda dessa pensão.', 'A idade mínima de 65 anos também é muito alta, pois se uma pessoa com idade, por exemplo, de 55 anos, já ter cumprido o tempo de 25 anos de contribuição, teria que esperar mais 10 anos até conseguir se aposentar, e como se sabe, o mercado de trabalho não é tão amigável com os idosos , sempre preferindo pessoas mais jovens e mais qualificadas. Sendo assim, um idoso na faixa de 60 anos teria bem menos chances de arrumar um emprego, fazendo com que consequentemente o desemprego aumentasse.', 'Conclui-se então, que a atual reforma proposta é um erro, pois gera mais malefícios do que benefícios para o cidadão brasileiro. Para ser algo justo todos, deveria se repensar as mudanças oferecidas, e organizar uma reforma onde todos sejam beneficiados, analisando com cuidado cada situação e seus fatores.']",120,120,120,120,120,600
62,,"['O discurso de ódio se caracteriza por incitar a discriminação, hostilidade e violência contra um indivíduo ou grupo, neste último, geralmente minorias . Ele busca perseguir, coagir e até mesmo a segregação. Dentre muitos de seus fundamentos, destaca-se a privação dos direitos.', 'Com a popularização da informática e a criação das redes sociais as ideologias passaram a ser discutidas num âmbito global. Como consequência desse avanço, o fluxo das informações, tanto inofensivas quanto maléficas , tornou-se intenso. Analogamente, vivenciamos  Eros e Tânatos no mundo virtual.', 'Assim como uma onda emerge e amplifica-se ao colidir uma pequena pedra sobre o espelho d’água, os discursos de ódio assumem proporções inimagináveis no emaranhado cibernético  rompendo barreiras geográficas. As informações são compartilhadas velozmente pelo grande público, muitas sob a forma de um conteúdo superficial e sensacionalista.', 'Neste cenário caótico, a célebre frase “Penso, logo existo” de Descartes  não se aplica. O pensamento individual está sobre influência do contexto e ideologias do meio coletivo. Grupos sob o respaldo da impessoalidade e da falsa sensação de anonimato, visto que hoje a tecnologia permite o rastreio cibernético, fornecido pela internet  influenciam os diversos espectros de indivíduos disseminando, assim, o ódio.', 'Responsabilizar unicamente as empresas de tecnologia por tal problemática seria se não uma ingenuidade, uma hipocrisia. Como discutir a intolerância nas redes sociais quando, no presente, muitos governantes compõem essa grande massa que vocifera o ódio nas redes? Dessa forma, os poderes legislativo e jurídico devem estar fortalecidos e atualizados para lidarem com os crimes em meio virtual. Além disso, sua atuação deve ocorrer de forma autônoma do poder executivo  de forma a garantir uma atuação energética visando punir e coibir tais atos.']",120,160,120,120,120,640
50,A sociedade e a ciência em si,"['No entanto , o Covid-19 foi um vírus que trouxe grande ""suspense"" e medo na sociedade. Mas, para a Ciência , foi como uma nova brecha de descobertas.', 'Sobre tudo, podemos  dizer que a ciência pode nos mostrar à cura para algo tão espantoso.', 'Logo, posso lhe dizer, que uma pandemia tão rigorosa pode se obter uma cura, descoberta por: cientistas,  e equipamentos de alto porte. Através, de estudantes, livros, pesquisas frequêntes e equipamentos. Sendo assim, acredito que pode-se obter ,dessa forma ,resultados para cura de tal pandemia.']",120,80,40,80,0,320
91,,"['O mito da caverna, de Platão, descreve a situação de pessoas que se recusavam a observar a verdade em virtude do medo de sair da sua zona de conforto. Fora da ficção, o Brasil hodierno sofre as mesmas conotações no que se refere à persistência do negacionismo. Nesse contexto, percebe-se a configuração de um grave problema de contornos específicos, tanto em virtude da má influência midiática, quanto do silenciamento social . Logo, faz-se imperiosa a análise dessa conjuntura, no intuito de mitigar essa perversidade brasileira.', 'É indubitável, nesse contexto, que a questão da má influência midiática influi decisivamente na consolidação do problema. Segundo o filósofo Pierre Bordieu, o que foi criado para ser instrumento de democracia, não deve ser convertido em mecanismo de opressão. Nessa perspectiva, pode-se afirmar que a mídia tem o dever de desenvolver debates a fim de elucidar a população com informações verídicas, porém negligencia essa ação, o que reforça, desse modo, a intensificação de falsas notícias.', 'Ademais, ressalte-se que o silenciamento social também configura-se como um entrave no que tange a questão do negacionismo. A filósofa Hannah Arendt em “Banalidade do mal” refletiu sobre o resultado do processo de massificação da sociedade, o qual forma os indivíduos incapazes de realizar julgamentos morais, tornando-se alienados e aceitando as situações impostas sem questionar. O pensamento da filosofia está relacionado ao contexto de alienação da sociedade brasileira, n qual os sujeitos se calam em situações que os prejudicam, desconsiderando a importância do Art.218° da Constituição federal, que garante, em tese, o desenvolvimento nacional, por meio da capacitação cientifica e incentivo a pesquisas, para o comprimento de direitos sociais.', 'Torna-se evidente, portanto, que os caminhos para o combate à recorrência do negacionismo no Brasil, apresentam entraves que precisam ser revertidos. Para este fim, a Secretaria especial de comunicação social (Secom) juntamente com o MEC , devem realizar a liberação de verba para a produção de propagandas e campanhas educativas, que terão como desígnio a desmitificação de informações que não conferem com as pesquisas e estudos pré-estabelecidos pela ciência. Além da explanação de estudos e artigos, que serão divulgados nas redes sociais dos órgãos, de forma interativa, a fim de expandir o conhecimento fundamentado. Talvez, assim, seja possível construir um país que Platão pudesse se orgulhar.']",160,200,160,200,200,920
73,Onde está a segurança para todos?,"['Os desafios enfrentados pelos negros no Brasil não é uma invenção atual, tendo  que desde o regime escravista brasileiro, o negro foi marginalizado, criando como consequência uma dívida histórica com a qual convivemos até os dias atuais.', 'O art 5º da Constituição nacional diz que todos os brasileiros ""são iguais perante a lei"" e possuem direito ""à igualdade, à segurança"", entre outros. Porém, as estatísticas se contrapõem a isto. Segundo o Mapa da Violência, a cada 23 minutos um jovem de pele negra é morto em nosso país, o que expressa até 12 vezes mais comparado aos índices de assassinatos de jovens brancos. Então onde está a igualdade e segurança para todos?', 'A principal causa para estes números exorbitantes é a desigualdade social que atravessa gerações, além da falta de policiamento e controle absoluto do Estado em comunidades e periferias, muitas vezes orquestradas pelo tráfico.', 'Confúcio, insigne filósofo, dizia que ""não corrigir nossas falhas é o mesmo que cometer novos erros"", portanto medidas são necessárias para combater a falta de segurança para com os negros. O ministério de segurança pública juntamente com a polícia deveria aumentar o policiamento em regiões com maior incidência de assassinatos, evitando assim novos crimes. Ademais, o ministério da educação  do governo federal deveria investir em métodos de inclusão de jovens negros e de periferia nas escolas e universidades, pois ""só a educação liberta"".']",120,120,80,120,80,520
144,"O passado, o presente e o futuro da mulher no Brasil","['Se no início da formação da sociedade brasileira as mulheres eram vistas apenas como donas de casa, esposas e mães, o que         a mulher da sociedade         atual nos permite         vivenciar         é a ascensão         da mulher         em todos os aspectos da vida.', 'Atualmente, o Brasil vive o fantástico episódio, talvez, nunca imaginado por alguns, mas sonhado por outros: uma mulher na presidência!', 'Depois de ocupar cargos importantíssimos nos governos, em grandes empresas e até no futebol, uma mulher consegue chegar ao ápice, ao mais alto dos cargos dentro de uma nação.', 'As mulheres                 lutaram                por direitos iguais, lutaram para ter “voz”, para ter um lugar num círculo social outrora dominado pelos homens.', 'As mudanças de poder observadas na sociedade brasileira atual são reflexos das                 grandes empreitadas, desafios e lutas das mulheres de anos atrás.          Esta análise me leva a uma interrogação: Prosseguir          acreditando que pode quebrar tabus e regras impostas por uma sociedade antes alienada ao julgo masculino, é um indício do papel da mulher brasileira que sabe dos seus limites, mas consegue superá-los?', 'A atual mulher da sociedade brasileira não pode ser rotulada a um único papel, visto que a         liberdade de expressão e escolha não modificou         seu         papel de dona de casa, mãe e esposa, mas                 somou papéis a esta mulher que também precisa de formação para se dar bem profissionalmente                .', 'Estar por dentro de todos os assuntos, sejam políticos, econômicos, científicos, conhecer a realidade do seu país e colaborar para o desenvolvimento e fortalecimento de uma sociedade mais justa para as gerações futuras,                 este é um dos muitos papéis                da atual mulher brasileira.']",160,120,120,120,120,640
84,,"['A questão do Porte de armas de fogo pela população civil se intensificou e vem sendo debatido as sociedade brasileira. Diante disso,um projeto de lei pretende tornar mais leves as restrições para o acesso às armas,uma vez que o Brasil é o primeiro colocado no ranking de violência do mundo* garantindo de alguma forma,maior proteção individual a cada cidadão.', 'O fácil acesso a armas de fogo provoca tragédias não só no Brasil, mas também em países desenvolvidos, como os Estados Unidos. Os americanos voltam à discussão sobre o porte de arma depois de mais um massacre,que ocorreu em Orlando deixando 49 mortos e cerca de 50 feridos. Esse atentado reascendeu o debate sobre o porte de armas,no qual  correntes se divergem quanto a sua legalização. Segundo o  Mapa da Violência, no  Brasil a arma de fogo mata 116 pessoas por dia revelando o alto índice de criminalidade  e  a ineficiência dos serviços de segurança pública, assombrando cada vez mais os brasileiros.', 'Todavia,muitas pessoas tornam-se reféns de suas próprias casas, assustadas com o crescente número de assaltos a mão armada e de homicídios. Em decorrência disso, foi aprovado o Estatuto de Controle de Armas de Fogo que segue para o Plenário,assegurando  aos cidadãos que cumprirem os requisitos previstos em lei o direito de possuir e portar armas de fogo,tornando mais  brandas as restrições ,assegurando o direito natural de defesa de cada indivíduo.', 'Tendo em vista os aspectos observados, percebe-se a importância da  aprovação  do referido Projeto,onde a  legalização do porte de armas assegurará maior segurança às famílias, uma vez que bandidos estão bem mais armados do que os próprios agentes de segurança. Como dizia o filósofo Immanuel Kant ‘’ O ser humano é aquilo que a educação faz dele’’. Dessa forma, o Governo em parceria com o MEC deve instituir nas escolas palestras que visam a formação efetiva dos jovens no combate a violência,com o apoio dos meios de comunicação para a realização de campanhas que envolvam governo e comunidade.']",160,120,120,160,160,720
70,Doenças sexualmente transmissiveis(DSTS),"['Doenças sexualmente transmissíveis (DSTS): Como evita-las?', 'As doenças sexualmente transmissíveis  são muito encontradas no meio da sociedade atual, geralmente elas transmitem-se através do ato sexual sem uso de preservativo, seringas contaminadas, contato com sangue e secreções expostas ou através do parto na gravidez. Infelizmente, algumas dessas doenças são irreversíveis, ou seja, não há cura para elas, como a AIDS. Até os dias de hoje não se foi encontrado a cura para tal doença, mas,  há vários tipos de tratamento que podem retardar o vírus e devolver pessoa contaminada uma vida normal como a de todas as outras pessoas. Nos últimos anos  no Brasil, doenças desse tipo tiveram um crescimento instantâneo na população, principalmente entre jovens e adolescentes, de acordo com dados informativos, a grande maioria se encontra em lugares mais humildes e de população carente.', 'Pode-se dizer que em variados casos entre jovens e adolescentes, o relacionamento afetivo com outras pessoas podem ser um “refugio” de problemas familiares, maus tratos e abusos . Sem o devido conhecimento ou sendo induzidos ao ato sexual sem preservativo, acabam obtendo uma doença que pode levar a morte. A falta de comunicação familiar também pode agravar tal situação, os jovens precisam de um acompanhamento do lar durante essa fase de mudanças que cada um passa, mas  infelizmente  muitos tm pais ausentes e irresponsáveis que acabam não dando a devida orientação de como lidar e se prevenir dessas doenças . Em muitos casos há um certo descuido da prevenção da doença durante o ato, ocorrendo então a contaminação. O governo diante esses acontecidos , parece não demonstrar tanta preocupação como deveria, assim esse caso importante diversas vezes acaba ficando de lado.', 'Para haver uma orientação maior sobre doenças sexualmente transmissíveis, tende haver mais palestras e estudos sobre sexo e cuidados com a saúde nas escolas, nas cidades para a população se conscientizar e cuidar do corpo com mais cautela. A mídia pode ser usada para alertas já que é uma grande influenciadora nos lares da sociedade atual, assim diminuindo a chance de doenças severas como a se espalhem sem nenhum tipo de conhecimento sobre elas . Contudo, a sociedade pode ser mais cuidadosa com a saúde do corpo e privilegiar o bem estar físico.']",120,120,120,120,120,600
45,O beneficio que não beneficia ninguém.,"['Sem gerar nenhum benefício,a não ser para aquele individuo que está se prevalecendo diante da situação,o abuso de autoridade é considerado até mesmo letal,visto os inúmeros óbitos causados desnecessariamente por forças policiais no país .Ademais o Brasil enfrenta pessoas que utilizam também de sua posição profissional para desrespeitar as leis.', 'Em primeiro plano, segundo um relatório feito pela Anistia Internacional publicado em 2015, a Policia Militar do Brasil é a que mais mata no mundo, que em geral são homicídios de pessoas já rendidas, feridas,alvejadas ou confundidas sem qualquer aviso prévio . Entre as mortes estão principalmente de jovens negros periféricos. Perfil de João Pedro,de 14 anos,assassinado dentro de sua própria residência com mais de 70 disparos de fuzil,dados pelas suas costas. Vidas como está são perdidas com apenas desculpas de que foi ""sem querer\' ou \'confundimos ele com o traficante\' , mas que não são o suficiente.', 'Em segundo plano, visto que, posição nenhuma o faz estar acima das leis do seu país,isso jamais deve ser utilizado como forma de descumpri-las. Cenas como a do Desembargador que humilhou um Guarda Municipal por efetuar uma multa, da qual foi aplicada por estar descumprindo um decreto de sua cidade, deve ser extintas, já que independente de sua profissão, cargo público ou condição financeira ainda continua sendo um cidadão. Além que no Brasil o abuso de autoridade é crime.', 'Destarte,é necessário que os orgãos de justiça sejam atuantes e firmes nos julgamentos de casos onde crimes de abuso de autoridade ocorram, com o intuito de punir aqueles que os cometeram, e demonstrar que tals atos não serão tolerados.. O governo deve promover dentro das forças policiais do país, formações mais efetivas a esses profissionais a fim de prevenir novos casos de abusos e consequentemente mortes desnecessárias. Além de também levar auxilio à aqueles familiares que perderam entes, como políticas públicas com ajuda psicológica . A morte por descuido jamais deve ser banalizada no Brasil e nem em país nenhum do mundo.']",160,160,160,200,120,800
6,Amazônia deve ser preocupação da população brasileira,"['Bom, como podemos observar, os brasileiros estão sofrendo com as queimadas e possíveis desmatamentos que acontecem na floresta, porém esse status atual é decorrente de ações que já são feitas a tempos atrás praticadas há muito tempo.', 'É de conhecimento geral que a exploração dessa região é feita geralmente para termos papéis, móveis, construções de estruturas, entre outras coisas que são importantes no nosso dia a dia. Cabe salientar que o oxigênio que é oferecido por essa floresta não é só o Brasil que o recebe, porém se a França se preocupasse realmente com essa causa, não estaria sofrendo a há décadas com garimpos ilegais que são feitos em sua parte da floresta, no território da Guiana.', 'Todavia é possível prevê prever que o Brasil Brasil, ao aceitar essa união união, passará a sofrer pelos mesmos motivos. Então, nessa situação, o cabível seria a conscientização da população em para não degradar ainda mais essa área, porque sempre tivemos queimadas queimadas, já que resultam de tempo seco e muito quente, mas esse ano a preocupação não é só de com queimadas ou de com explorações e sim de com desmatamento ou até mesmo crime ambiental.', 'Portanto, como o Presidente do Brasil já providenciou ajudas específicas das autoridades cabíveis cabíveis, seria sublime agora a ajuda da população, pois mantendo o país saudável estaremos também ajudando essa floresta.']",80,80,80,80,80,400
122,"O Brasil é laico, o brasileiro não","['No Brasil se defende a         ideologia         de que o povo brasileiro é desprovido de preconceito e intolerância, contudo as ações praticadas por alguns membros desse povo derruba essa         ideologia         .', 'Dentre os diversos tipos de preconceito encontrados na         sociedade          o mais notório é o preconceito religioso                .         Infelizmente         pessoas que se dizem praticantes de uma determinada religião muitas vezes não         aceita, que         outras possuam uma crença diferente da sua, chegando a hostilizar aqueles não fazem parte do seu meio religioso.', 'A maioria dos casos de intolerância religiosa ocorre em locais onde o nível socioeconômico é mais baixo. Isso pode ocorrer porque as pessoas que vivem nessa condição são mais susceptíveis a acreditarem no que          lhe          dizem sem fazer nenhum questionamento, e muitas vezes são iludidas por líderes religiosos, mal preparados, que apregoam quase o fanatismo.                  As religiões que          tem a sua origem as matrizes africanas, são          , dentre todas as diversas formas de cultos existentes no Brasil, as que mais sofrem esse tipo de preconceito, pois, como a escravidão no Brasil ainda faz parte de um passado recente, essas          religiões  por estarem ligadas ao negro ao pobre e a uma cultura que é pouco propagada          causam medo e a tendência a ser hostilizada,          tornando-as          tabus religiosos.', 'Para diminuir essa intolerância camuflada que se encontra enraizada na         sociedade         é necessário educar e informar o povo brasileiro, para que com mais cultura não haja espaço para o preconceito e a intolerância no Brasil.']",160,200,120,160,160,800
118,Os beagles sem saída,"['Por esses dias a sociedade          esta vivênciando          um dilema                , que         é o          testes de animais,          ápos          a conturbada ação dos black blocs.', 'Primeiramente eles tentaram tirar os beagles daquela situação         que encontraram         , mas não pensaram em um         porém         que essas pesquisas são importantes para         nós         seres humanos, apesar de ser dolorosa a         idéia         de ver seres vivos em uma         situção         como aquela.', 'Outra questão levantada foi a violência         em que         os black blocs         usaram, será         que a depredação do         institudo         foi necessária?         Para o meu parecer  não, com         violência não se mostra que a         idéia         ou         opnião         que a pessoa defende é a melhor, pelo contrário mostra que a pessoa não         e         madura e informada o suficiente para         tomar lado de uma posição         ou defender uma         idéia          séria como          está         .', 'E o pior de toda essa         ação, foi         eles terem abandonado os beagles nas ruas de São Roque         (SP), como         eles afirmam salvar, se depois abandonam? É tão dificil entender o que se passava na cabeça dessas         pessoas.', 'E em toda essa         histórias         os beagle sofrem de todas as maneiras e se         vêem         sem         saída, por          um lado foram soltos daquela situação mas abandonados          depois,  sentimos         dó pela situação         em que esse         cachorros enfrentam mas precisamos deles.', 'Esse é um dilema que pelo visto não terá um fim tão cedo!']",80,120,80,80,0,360
90,Como combater a transfobia no Brasil,"['Os transgêneros enfrentam diversos obstáculos para se inserirem na sociedade brasileira, visto que, conforme dados da Associação Nacional de Travestis e Transexuais (ANTRA), cerca de 90% das travestis e transexuais usam a prostituição como fonte de renda. Nesse contexto, a falta de acolhimento da família e o preconceito nas instituições de ensino dificultam a ascensão dessa população e a sua representatividade nos diferentes espaços e, por conseguinte, acarretam a permanência da transfobia e da marginalização desses indivíduos. Logo, medidas devem ser tomadas, a fim de combater esse preconceito e facilitar a inclusão dessa comunidade.', 'Nesse âmbito, diversas vezes, a discriminação começa a aparecer no ambiente familiar que deveria ser um espaço de acolhimento. Como resultado, várias pessoas que possuem uma identidade de gênero diferente do sexo atribuído são expulsas de casa e encaram bastantes desafios para a sua sobrevivência. Prova disso é a ovem Patrícia Borges que foi banida da residência da sua família aos 13 anos, em razão de ser trans. Nesse sentido, é necessário desenvolver uma maior tolerância dentro desse meio.', 'Além disso, em virtude do enorme preconceito nas escolas, inúmeros transgêneros abandonam os estudos e, por consequência, encaram várias barreiras para ingressarem no mercado de trabalho e acabam na prostituição, tendo sua imagem marginalizada. Segundo dados da Rede Nacional de Pessoas Trans do Brasil (RedeTrans) 82% das mulheres transexuais e travestis abandonam o ensino médio, devido à discriminação . Nesse contexto, devem-se criar condições para a permanência desses cidadãos no meio acadêmico.', 'Portanto, embora não haja soluções imediatas para esse problema, torna-se indubitável que a transfobia precisa ser combatida. Nesse sentido, cabe ao governo, em parceira com o Ministério da Educação, diminuir esse impasse. Para isso, esses agentes devem contratar psicólogos para fornecer palestras sobre esse tema e oferecer auxílio aos transgêneros, com o intuito de diminuir o preconceito na família e nas instituições de ensino e amparar as vítimas, além de ofertar bolsas para esses indivíduos, com o intuito de diminuir a evasão escolar. Assim, a transfobia será um mal cada vez menor na sociedade.']",200,200,160,200,160,920
55,A importância da valorização dos direitos,"['No inicio do século XVI quando os europeus chegaram na América se depararam com pessoas diferentes, tanto em cultura, quanto em seu idioma, dentro dessa visão eles se autodenominaram ""civilizados"" . A partir desse termo encontraram uma espécie de ""direito"" que dava a eles poder sobre o povo que ali encontraram, passaram a tomar as terras para si e tentaram desestruturar uma cultura instituída séculos antes de chegarem.', 'Depois de um longo período finalmente conseguiram uma constituição que zelava por seus direitos. Os territórios pertencentes a esses povos atualmente estão sendo ameaçados por possíveis ações que possam violar a Constituição, os povos nativos são como ""guardiões"" de nossa  natureza como a conhecemos  hoje, com o cuidado que exercem sobre a fauna e a flora ao tirar apenas o que precisam. Com a retirada das terras desses povos a natureza restante no país estaria basicamente condenada, levando em consideração a extinção de diversas partes do ambiente natural do país por meio das terras exploradas, além da perda cultural desses povos.', ""Por fim é preciso que por meio de ONG's e mídias sejam criadas campanhas para conscientização sobre a valorização dos direitos e sobre a importância ambiental e cultural da preservação dos territórios e direitos indígenas, também é preciso que diante dessas campanhas a sociedade se una para defender os direitos desses povos, que precisam ser preservados. Assim o governo poderá ver a importância de preservar os direitos e garantir que os povos indígenas possam ter seus direitos preservados para que não ocorra a privação e nem a suspensão de seus direitos .""]",120,120,120,120,120,600
78,,"['A reforma do ensino médio no país, visa de maneira geral  o melhoramento do desempenho do estudante nas matérias a quais ele mais se identifica, visando assim obter melhores índices educacionais no país, garantindo maiores propensões à  inserção de jovens e adultos no mercado de trabalho tendo uma formação mais direcionada e especializada.', 'Ressaltando que a reforma do ensino médio é um conjunto de novas diretrizes, que terão a função de altera a distribuição das treze disciplinas, antigamente obrigatórias, ofertará em mais abundancia o ensino técnico e incentiva o crescimento de instituições de ensino integral. Com essas medidas o aluno poderá focar seus estudos nas matérias que são realmente necessárias para sua aprovação e estadia no curso superior desejado por ele .', 'Vale-se destacar que a nova reforma do ensino médio não excluirá filosofia, sociologia, artes, educação física, português e matemática. Sessenta por cento da grade curricular do aluno será composta por tais matérias. Os outros quarenta por cento restantes serão definidos por matérias extracurriculares escolhidas pelos alunos. O inglês também recebeu sua devida importância sendo considerado obrigatório nas escolas desde o sexto ano do fundamental.', 'Tendo como base todas essas informações se faz necessário que o Governo, com a criação de palestras e cartilhas informativas, mostre a população todos os pontos positivos que a nova medida trará. A mídia se faz importante com a função da divulgação da reforma do ensino médio, deixando os brasileiros a par das novas mudanças. No âmbito escolar deve-se começar a mudança de forma stil, acostumando os alunos as novas regras assim que essas forem impostas. Com essas medidas podemos relembrar de Paulo Freire quando ele diz: “não há saber mais ou saber menos; há saberes diferentes”.']",120,120,120,120,120,600
83,Esporte,"['Na Grécia Antiga, as olimpíadas eram um símbolo religioso, político e cultural, e proporcionavam um armistício entre as cidades-estado. Nos dias atuais, o esporte deve ser visto como um poderoso instrumento de inclusão e interação, além de proporcionar hábitos saudáveis e de bem-estar. Porém, para que esses efeitos sejam atingidos, é necessário práticas educativas eficazes e resolutivas em suas propostas.', 'As olimpíadas e paraolimpíadas, assim como a copa do mundo, mostram às pessoas que, de fato, o esporte pode incluir e fazer com que haja relação entre povos e culturas universais, oferecendo, sobretudo, o respeito às diferenças, a união, a paz e a harmonia com a diversidade.', 'As práticas educativas colaboram fortemente na comunicação das pessoas, efetivando o respeito aos diferentes pensamentos e ideologias, no entanto, não é raro casos de discriminação nos jogos. Algumas pessoas acabam se tronando alvos de xingamento, racismo e preconceitos atrelados ao pré-julgamento estereotipado de que algumas pessoas não são capazes de participar de determinado esporte ou ao fato da distinção destas práticas, exclusivamente à diferenciação de sexo.', 'Portanto, para que o esporte cumpra com o seu papel na sociedade, é preciso incentivo e investimentos que desenvolvam os talentos pessoais, sem distinção de gênero. O Governo, por meio do Ministério do Esporte, deve incrementar as politicas públicas esportivas criando práticas pedagógicas eficientes, também como providencie infraestrutura necessária e disponibilize instrumentos para as atividades. Só assim, pode-se educar e construir uma sociedade melhor, por meio do esporte.']",120,160,160,160,200,800
43,As causas do cancelamento na democracia,"['São Tomás de Aquino defendeu que todas as pessoas precisam ser tratadas com a mesma importância. Porém, no decorrer do século XXI, vem ocorrendo um novo impasse nomeado como a ‘’cultura do cancelamento’’, que por certo contraria o ponto de vista do filósofo, por conta de que muitas pessoas são vítimas de discurso de ódio por terem visões diferentes da sociedade brasileira, assim, sendo expostas nas redes sociais, e como consequência disso, muitos indivíduos têm a saúde mental prejudicada, e até mesmo recebem ameaças de morte. Nessa perspectiva, percebe-se a configuração de um grave problema de contornos específicos, em virtude da falta de debates e da impunidade.', 'Em primeira análise, a ausência de discussão sobre as consequências do ‘’cancelamento’’ é um fator que tem dificultado a resolução do problema. Nesse sentido, Habermas traz uma contribuição relevante ao defender que a linguagem é uma verdadeira forma de ação. Dessa forma, para que um problema como a cultura cancelamento seja resolvido, faz-se necessário debater sobre. No entanto, percebe-se uma lacuna no que se refere a essa questão, que ainda é muito silenciada . Assim, trazer à pauta esse tema e debatê-lo ampliadamente aumentaria as chances de atuação nele e as consequências do problema como saúde mental prejudicada será amenizada.', 'Outro ponto relevante, nessa temática, é que a impunidade perpetua o problema, multiplicando os casos de discursos de ódio sobre as pessoas nas redes sociais. Nesse panorama, para Aristóteles, a base da sociedade é a justiça. Entretanto, em redes sociais não há penalidade sobre o assunto e, por conta disso, não há um receio em ‘’cancelar’’ as pessoas, assim, são livres para expor os erros e as opiniões dsse melhantes do comum na sociedade brasileira, por meio de redes socias, como o Twitter, Facebook e Instagram.', 'Portanto, uma intervenção faz-se necessária. Para isso, cabe ao Ministério da Educação em parceria com as escolas estaduais e em suas redes sociais – local onde a população brasileira está cada vez mais presente –  promover campanhas publicitárias, mostrando as decorrências do ato de ‘’cancelar’’ as pessoas no ambiente virtual, salientando como é prejudicial ter uma saúde mental fragilizada, com a finalidade de conscientização do problema e um melhor conhecimento sobre o tema.']",160,160,160,200,160,840
27,De acordo com Immanuel Kant,"['De acordo com Immanuel Kant;  “O ser humano não é nada além daquilo que a educação faz dele”. Seguindo a essa lógica, podemos perceber que', 'Quando se pensa em debate, vem a imagem de uma pessoa argumentando certo assunto ou dando uma justificativa sólida , no entanto, tiveram episódios nas votações do plenário, que virou noticia na internet, como as justificativas, em que o debutado saia', 'Entretanto podemos notar esse problema nos jovens de hoje, pois querem debater certos assuntos, e infelizmente não tem um conhecimento prévio sobre aquela situação em que se foi posto porque simplesmente não tem a curiosidade em pesquisar certos acontecimentos que ocorreram na sociedade atual. E isso será um grave problema, pois teremos uma população que não saberá justificar suas opiniões.', 'Diante disso, o MEC juntamente com a Secretaria da Educação deveria incentivar as escolas públicas e privadas a fazerem debates, entre seus alunos, e ainda promoverem fontes de pesquisas, para que tenham uma base e a aprimore , fazendo assim com que os alunos aumentem seus horizontes.']",120,80,120,120,120,560
88,,"['A informação e apoio psicológico deveria constituir um exercício fundamental de cidadania para o desenvolvimento de uma sociedade pautada no bem-estar coletivo. No entanto, os estigmas associados às doenças mentais na sociedade brasileira demonstram a fragilidade e ineficácia em exercer esse fundamento no Brasil. Tal ineficácia ocorre tanto pela negligência estatal acerca da saúde mental como também pela falta de uma visão socioemocional na educação.', 'Diante desse cenário, é importante ressaltar a ignorância estatal nos aspectos psicológicos dos seus cidadãos. Conforme o artigo 6° da Constituição federal, documento jurídico mais importante do país, todo cidadão tem direito saúde. Entretanto, é inegável a ausência de ação promotora desse direito constituicional por parte do governo nacional. Tal quadro é constatado no precário apoio psicológico oferecido pela saúde pública e, consequentemente, a garantia da situação de subcidadania de diversos indivíduos afligidos por psicopatologias.', 'Outrossim, somado a esse comportamento estatal pouco empático, há ainda, a absência de modelos educacionais que desconstruam os preconceitos ligados aos problemas de saúde mental no Brasil. Compreender essa assertiva é considerar que o modelo educacional vigente perpetua o pensamento atroz e rotulador acerca das particularidades psicológicas de cada sujeito. Em vista disso, é lamentável a ausência de uma perspectiva humanista, como evidenciada pelo filósofo brasileiro, Augusto Cury, reforçando uma cultura de ignorância e desrespeito às dificuldades socioemocionais, psicólogicas e mentais do próximo, sendo imprescindível a dissolução do senso-comum acerca das doenças mentais na realidade tupiniquim.', 'Portanto, conclui-se que a excludente realidade acerca das doenças mentais está intrinsecamente ligada à problemática ação estatal e à apatia educacional. Por isso, medidas devem ser realizadas para reverter esse cenário. Posto isso, cabe ao Ministério da Saúde, instância reguladora das garantias sociais no eixo da saúde pública,  criar um Programa Nacional de Amparo Psicológico, o qual divulgará informações e fornecerá atendimento de forma gratuita e efetiva- como apoio psicocliníco e psiquiátrico-, por meio de investimentos que fomentem uma educação socioemocional de qualidade, para que essa sociedade estigmatizadora seja transformada em uma comunidade democrática, como elucida Cury, baseada compreensão humana e bem-estar social.']",160,200,160,200,200,920
48,SUS e sua importância.,"['O SUS  é referência mundial por ser um sistema universal de saúde que atende toda a população brasileira, que possui proporções continentais. É evidente sua importância para a saúde pública no Brasil, mas também pode-se apontar diversos desafios a serem enfrentados pelo mesmo , para melhorar sua qualidade.', 'Em primeira análise, percebe-se que a importância do SUS está ligada diretamente ao fato de grande parte da população depender exclusivamente dele para ter atendimento médico, sendo que até mesmo quem possui planos particulares utiliza o SUS em algum momento , seja em campanhas de vacinação ou atendimento móvel de urgência, como mostram as pesquisas.', 'Em segunda análise, observa-se que esse sistema possui defeitos, sendo os mais evidentes, a burocracia em excesso, no sentindo de haver muita demora para serem feitas cirurgias ou exames, e o sucateamento do sistema, provocado muitas vezes pelo desvio de verbas, visto que em muitas localidade faltam leitos, materiais básicos de higiene e infraestrutura debilitada em alguns hospitais.', 'De acordo com o apresentado, é necessário que o ministério da saúde , em parceria com os estados e municípios, atuem em conjunto com o sistema judiciário, para promover a melhoria do SUS, por meio de investimentos maiores em infraestrutura e equipamentos , sendo o judiciário responsável por combater possíveis desvios de verba, tendo como finalidade melhorar a saúde pública no Brasil .']",160,160,120,200,160,800
84,Causas e consequências do porte de armas pela população civil,"['Nos dias atuais,a população convive com a insegurança em sua vida. Seja em casa ou na rua,nunca sabemos se iremos ficar vivos no dia seguinte devido ao aumento de assaltos a mão armada no país.', 'Pensando nisso,um deputado elaborou um projeto que possibilita que todos os cidadãos* tenham posse de arma permitido em suas casas. Isso vai servir para que o cidadão de bem ande nas ruas com segurança e tranquilidade.', 'O cidadão de bem deve primeiramente registrar a arma em seu nome para que ela seja aprovada e principalmente deve tomar cuidado,pois, está mexendo com coisa séria.', 'Um exemplo de cuidado é com as crianças,pois elas têm muita curiosidade e podem achar que a arma é um brinquedo e sendo assim,as consequências podem ser muito graves,provocando acidentes e até uma morte.', 'O Governo também deve fazer a sua parte,colocando mais viaturas rondando a cidade. Fazer um acordo com as Polícias Militar e Cívil para aumentar o número de viaturas para garantir ainda mais a segurança do povo.', 'Todos nós devemos lutar para acabar com essa insegurança que vivemos atualmente!Devemos dar um BASTA nessa insegurança.']",160,120,120,120,120,640
82,automedicação,"['Uma das principais discussões no cotidiano do brasileiro é automedicação. Praticamente todo mundo tem um remédio para uma doença. Porem  deve-se ter cuidado com o uso desenfreado desses medicamentos, que podem ocasionar inúmeros outros problemas para a saúde.', 'Como diz um ditado, que de  médico todo mundo tem um pouco,  no cotidiano esta  frase é comprovada, basta observar que a grande maioria já fez uso da automedicação, seja por incentivo de um amigo ou  por conta própria. Os defensores dessa pratica  argumentam que doenças como gripe, resfriados e dores de cabeça podem ser resolvidas com os remédios de uso comum. Além de que  isso minimiza os gastos do já deficitário sistema público de saúde.', 'Embora a pratica da automedicação traz facilidades no momento, no futuro o uso inadequado de medicamentos pode desencadear inúmeras doenças. Pesquisas relacionadas à organização mundial da saúde  apontam que o uso errado de antibiótico causa o desenvolvimento de superbactérias  que se tornam mais resistentes às dosagens inseridas. Dados mostram que doenças como hepatites e problemas estomacais estão aumentando devido ao consumo exagerado das medicações.', 'Dessa forma, é necessário o debate sobre a automedicação pela sociedade. Pois  em alguns casos  como um dor nas costas ou de cabeça  o uso de remédios por conta própria pode ajudar, mas deve-se ter cuidado e entender a importância dos profissionais da saúde no combate as doenças.']",120,120,120,120,80,560
55,Índios,"['Pero Vaz de Caminha, com sua pena entrelaçado entre seus dedos e olhar fitado descreveu em um primeiro contado  que os índios eram de feição agradável, em particular, as índias que tinham curvas sinuosas e andavam nuas com muita inocência, na aldeia, eles caçavam, plantavam e colhiam, e assim, viviam despreocupadamente . Passados séculos, essa realidade mudou drasticamente e a medida em que o progresso foi se elevando, gradativamente a população indígena foi se dizimando da existência por vários fatores, entre tais a invasão de suas terras que é fundamental para sua sobrevivência e consequentemente, as doenças transmitidas pelo contato com o homem branco . É por conta disso que é indispensável que se faça as políticas públicas que valorizem os indígenas de um modo geral, respeitando-os como primeiros cidadãos brasileiros.', 'Não por menos, eles têm um papel importantíssimo no equilíbrio ecológico, e é por conta dessa importância que a empresa de mineração Vale, em Carajás – Parauapebas/Pa., dar todo o apoio social com diversificados profissionais à uma tribo, os Xicrim, entre os mais importantes estão o acompanhamento médico com várias especialidades e a alfabetização para que possam se socializar no mundo contemporâneo respeitando sua identidade.', 'É recorrente ouvirmos , principalmente nos jornais e telejornais, os confrontos com ruralistas, esses que em nome da sua ambição por terras para virar pastos ou mesmo para plantar, invadem áreas demarcadas dos nativos ciente de um possível confronto e que na maioria das vezes acontecem, saindo bem-sucedidos pelo arsenal de armas pesadas que usam nestes embates.', 'Portanto, se faz necessário que a FUNAI (Fundação Nacional dos índios), seja mais presente para defender os reais interesses dos índios fiscalizando com mais rigor, na medida do possível  suas áreas demarcadas e fazendo campanhas em salas de aulas e universidades (...) com o objetivo de combater a discriminação e dar os devidos valores com sentimento de gratidão por ser a origem do povo brasileiro.']",120,120,80,120,40,480
56,,"['Na obra “Memórias Cárceres”,do autor Graciliano Ramos,preso durante a ditadura do Estado Novo,ele relata os maus tratos,as péssimas condições de higiene e a falta de humanidade vivenciadas na rotina carcerária. Apesar de não vivermos  mais um regime totalitário no Brasil,a situação atual dos presídios brasileiros não se difere muito daquela época. Isso porque, o nosso  sistema penitenciário porta diversos problemas que vão desde a infraestrutura à superlotação. Por conseguinte,reverter a situação social a qual o penitenciário está submetido é indispensável para avaliar seus efeitos na contemporaneidade.', 'Em primeira análise,é lícito postular, de que forma as más situações de infraestrutura dos grandes presídios brasileiros afetam a vivência dos presidiários no decorrer de suas penas. Pode-se dizer que em grande parte, essa problemática é frutos das superlotações. Dados do Ministério Da Justiça apontam que o Brasil possui 622 mil detentos,mas apenas 371 mil vagas; sendo a quarta maior população carcerária do mundo. Em meio a esse cenário,uma significativa parcela dos presos ainda aguardam por seus julgamentos. Especialistas ouvidos pela BBC Brasil acreditam que a solução dessa questão estaria na combinação de penas mais curtas_dependendo do crime cometido_com julgamentos mais rápidos. Além disso,outra consequência da superlotação é a saúde precária,já que essas pessoas estão mais sujeitas não só a contraírem doenças (relacionadas às péssimas situações de higiene),mas também à dependência de drogas.', 'Além do mais,ressalta-se que a reincidência no Brasil, tem dimensão  muito maiores. Segundo estatísticas oficiais,70% dos que deixam a prisão acabam cometendo cromes novamente. Isso transcorre porque a maioria das penitenciárias brasileiras carecem ou até mesmo negligenciam programas sociais socioeducativos e de reabilitação para os detentos; sendo que esses tipos de programas são primordiais para a reintegração dos presos à sociedade.', 'Infere-se portanto,que medidas visando a mudança do atual cenário carcerário do Brasil precisam ser projetadas. Nesse sentido,cabe ao Governo criar políticas públicas que objetivem a obrigatoriedade de todos os presídios de oferecem projetos que possibilitem a reinserção dos presos à sociedade,quando estes cumprirem suas penas. Ademais,faz-se necessário a reconfiguração de das penas impostas no sentido de diminuí-las para quem cometer infrações de menor gravidade no intuito de diminuir a sobrelotação.']",120,120,120,120,120,600
54,,"['Sarampo, caxumba e rubéola são algumas doenças que podem ser evitadas mantendo o calendário de vacinação em dia. Diante disso é inegável a importância da vacina para prevenção de doenças perigosas como essas. Entretanto, segundo dados divulgados pela UNICEF a cobertura da vacina tríplice viral está caindo, foi de quase 100% em 2014 para apenas 85% em 2017. Desse modo, convem analisar os empecilhos que fazem que  esses dados não permaneçam estável.', 'Inicialmente, a Constituição Federal promulgada com base nos direitos humanos, prevê como garantia fundamental o direito saúde. Contudo o próprio poder estatal fere esse preceito. Isso porque , o Ministério da Saúde não promove políticas públicas para amenizar a hostilidade de alguns postos de saúde e hospitais , comprometendo assim a ineficácia de imunização em escala nacional.', 'Ademais, a desinformação corrobora para que os mitos que foram criados em torno da vacinação persista em nossa sociedade. As campanhas publicitárias para a prevenção não são frequentes, fazendo com que o movimento antivacina que acredita que a vacinação só trás problemas , cresçam ainda mais nas redes sociais, consequentemente a população fica com medo de se vacinarem . Portanto, é preciso desfazer esses mitos e informar a população os benefícios para a saúde.', 'Infere-se, portanto, que medidas são necessárias para solucionar o impasse. Cabe ao governo, responsável por organizar e administrar a sociedade, por intermédio do MEC financiar projetos nas escolas, por meio da utilização de recursos públicos, para fomentar debates com os pais, alunos e professores a respeito da vacina. Ademais, é necessário que sejam investigados por meio do Poder Judiciário caso de desvio de verbas e haja uma eficaz fiscalização no comprimento de leis, para que sejam destinadas de maneira correta. Dessa forma, os direitos serão respeitados e a população irá se prevenir.']",120,160,80,120,120,600
149,Segundo grande passo para a humanidade,"['Primeiro a Lua e agora Marte. O homem nunca deixará de                 sonhar                , e não deve, mas desbravar o planeta vermelho é um empreendimento, no mínimo,                 utópico                .', 'A         ousada viagem foi idealizada pela empresa holandesa Mars One, do empresário alemão Bas Lansdoorp, que pretende         enviar         com passagens apenas de         ida         quatro corajosos colonizadores para Marte em 2023. E a julgar pela quantidade de inscritos dispostos a abandonar tudo para essa aventura, mais de 160 mil pessoas até agora, habitar esse planeta         inospito         é o sonho de muita gente.', 'Entretanto, colonizar o planeta vermelho é ainda                 um sonho          utopico         . As condições         atmosfericas         não são favoráveis         a         vida e a temperatura média é de -63ºC, admite o próprio Lansdoorp. Além disso, essa empreitada terá um custo         astronomico         , 15 bilhões segundo o jornal Agora São Paulo, recursos estes                que dificilmente uma empresa privada         disponha         .', 'A NASA (Agência Espacial Americana), responsável por levar o homem         a         Lua nos         anos 60 anda         não tem planos para pisar                 em                Marte. Parece mesmo que a conquista de                 Ares                está distante do alcance humano.', 'Por fim, mediante         a tantos empecilhos         a ida do homem ao nosso vizinho rubro ainda deverá demorar algumas decádas para se concretizar. Talvez sejamos surpreendidos em 2023, mas as chances são remotas.']",160,120,120,120,0,520
37,Reflexos do Patriarcado,"['O crime de estupro é um crime que apresenta uma característica muito peculiar em relação aos demais: a culpabilização da vítima. Atribui-se a causa ao comportamento, à roupa usada no momento do ato e aos locais que costuma frequentar. Tais fatores podem ser facilmente refutados quando se põe em evidência dados disponibilizados pelo IPEA (Instituto de Pesquisa Econômica Aplicada) que demonstram que mais da metade dos casos são cometidos contra meninas menores de treze anos.', 'Um ponto importante a se analisar é que esse ato é o reflexo de uma sociedade machista, produto de um longo processo de socialização entre gerações. Como herança cultural, o meio mais eficaz de se eliminar tal problema é justamente a conscientização da população e a criação de leis que garantam a liberdade sexual e a propriedade sobre o próprio corpo, desde que estes não infiram na liberdade do próximo, de modo a eliminar essa cultura da educação que as crianças recebem em casa e na escola, tendo em vista que estas são o futuro da nação e carregarão consigo os valores que lhes foram passados.', 'Desse modo, o primeiro passo é conscientizar a população para que estas possam passar as informações obtidas também em suas casas. Ainda mais importante, focar o ensino escolar, em especial o fundamental, na formação de caráter dos estudantes, debatendo assuntos como educação sexual, participação do pai na gravidez, identidade de gênero e o papel da denúncia na redução do número de casos. Por último, garantir a penalização dos praticantes de atos libidinosos e de agressão à liberdade pessoal é também fator primordial. Em frente às propostas apresentadas, é interessante ressaltar que a solução é ampla e demanda tempo, mas que não poderia deixar de ser , tendo em vista que não diz respeito somente à vítima e ao agressor, mas à cultura de toda uma sociedade.']",160,200,160,160,200,880
46,PRIVATIZAÇÃO NÃO É A SOLUÇÃO,"['No início de 2010, a Organização das Nações Unidas reconheceu o acesso à água e ao esgotamento sanitário como um direito humano fundamental. Entretanto, o Estado brasileiro não tem conseguido atender s necessidades básicas de toda a população de maneira uniforme e eficiente. Muito embora haja sérias dificuldades na implementação dessa política pública, a privatização do setor poderá agravar ainda mais a situação e dificultar a prestação desses serviços à população mais vulnerável.', 'A transferência de obrigações que são do Estado, como o esgoto e saneamento, por se tratar de serviços públicos sensíveis e indispensáveis à população está sendo revista em várias localidades mundo afora. No Brasil, pode-se observar o que ocorreu no estado do Tocantins, que privatizou o saneamento no ano de 2000 e depois de 14 anos a concessionária declinou de sua competência para operar o sistema e restituiu essa tarefa para o Estado, porém apenas daquelas regiões que não eram rentáveis para ela . Logo, percebe-se que as regiões desprovidas de predicados econômicos continuariam sendo um pária em questões sanitárias e o Brasil trilharia o caminho oposto ao que tem acontecido em parte dos países desenvolvidos – a exemplo de França e alguns países europeus – que é a devolução desses serviços para o poder público.', 'Um outro aspecto de relevância a ser lembrado é a questão das tarifas. A privatização poderá recrudescer ainda mais as desigualdades sociais, tendo em vista que parcela da população com menos poder aquisitivo poderá ficar refém de um aumento excessivo das taxas e comprometer significativamente seus rendimentos, o que já tem ocorrido devido à pandemia da covid-19 . O grande problema da privatização é que os investidores/financiadores não estão interessados em oferecer serviços de água e esgoto, estão interessados, sim, em multiplicarem seus capitais . Dessa forma, o saneamento perde completamente sua função social, que visa garantir o direito humano ao acesso a esse serviço básico para que o indivíduo tenha o mínimo de dignidade em sua vida cotidiana.', 'À luz dessas ponderações, nota-se que, apenas privatizar o saneamento não seria a melhor opção para resolver essa questão. Faz-se imperioso, portanto, que haja integração dos governos municipais, estaduais e federal,  a fim de que o governo local, que é o conhecedor das necessidades de sua região, aponte quais pontos carecem prioritariamente desses serviços e a União, que é a detentora da maior quantidade de verba pública, disponha dos recursos necessários para efetivar as políticas públicas em conjunto aos demais entes envolvidos. Assim, com uma fiscalização do próprio poder público e da sociedade civil, o serviço sanitário poderá alcançar o maior número de brasileiros e construir uma sociedade mais igualitária e fraterna.']",160,200,160,160,160,840
29,Cracolândia,"['Desde a origem do crack na década de 1970, muitos países já sofreram uma epidemia com essa droga. O Brasil não é diferente e está passando por problemas com as chamadas cracolândias. Tentando mascarar o problema, a prefeitura de São Paulo aposta na internação compulsória para as cracolandias desaparecerem do mapa. Apesar da iniciativa, o verdadeiro problema tem raizes profundas na sociedade brasileira.', 'O Brasil é um dos países que mais consome crack no mundo, e essa fuga da realidade descende dos problemas sociais enraizados nesse país . Segundo o neurocientista Carl Hart, a desigualdade social é um dos principais motivos para o consumo da droga, fato que concorda com a pesquisa da Fiocruz onde afirma que 80% da população na Cracolândia tem pele escura.', 'A internação compulsória não soluciona o problema, sendo apenas uma forma de exclusão social onde se elimina o indesejável tentando apontar o problema apenas no vicio . Alguém com dependência química não deve ser excluido , mas reajustado na sociedade com uma nova proposta de vida, algo que o faça trocar o crack, como uma carreira, família ou uma paixão.', 'A violência e repressão da internação compulsória, mesmo que justificada, não tem poder para acabar com a Cracolândia , programas de reinstalação social com psicólogos para usuários seriam eficazes nos casos menos agressivos. Nos casos de dependência critica , com probabilidade de suicídio a internação é justificada. Em todos os casos a família é importante como uma forma de apoio. Controle do tráfico e anúncios sobre os riscos do vício podem refrear novos casos. Além de tudo, a construção de uma sociedade com menos desigualdades podem levar o retrato da pobreza a diminuir gradualmente, contribuindo para um Brasil melhor no futuro.']",160,200,160,160,120,800
86,Redes sociais x Redes de saúde mental,"['O filme ""A rede Social"", lançado em 2010, retrata a criação do Facebook pelo jovem Mark Zuckemberg como uma tentativa de promover um espaço virtual para unir pessoas através da interação social. Contudo, diferente desse contexto, as redes sociais tem servido nos últimos anos como instrumentos de divisão e impactado negativamente a saúde mental de diversos usuários. Diante disso, é importante destacar que a imagem estereotipada de sucesso exibida nas redes e a falta de maturidade emocional dos indivíduos, em decorrência de uma rede de saúde mental fragilizada, são fatores relevantes que fazem dessa problemática das redes sociais uma realidade no mundo contemporâneo.', 'Em primeiro lugar, cabe ressaltar que é inegável a contribuição das redes sociais para a difusão de conteúdos e criação de vínculos através das interações virtuais. Entretanto, o que se observa hoje é que esses vínculos estão frequentemente associados a um padrão idealista de estilo de vida relacionados a bens materiais ou à aparência física, uma vez que esse padrão exibido nas redes, na fantasia de muitos usuários, é o que representa o sucesso. Nesse sentido, ao não se reconhecerem nos padrões idealistas das redes sociais, muitas pessoas acabam sendo tomadas por um sentimento de frustração que prejudica significativamente a homeostase da saúde mental e impacta de maneira negativa a qualidade de vida dos indivíduos.', 'Além disso, um outro desafio a ser superado é o fato de que uma ampla parcela dos usuários ainda não possui a inteligência emocional necessária para lidar com as frustrações e problemas decorrentes do uso das mídias sociais. Nessa perspectiva, é importante reconhecer que embora a Política Nacional de Saúde Mental, promulgada em 2001, tenha proporcionado avanços na oferta da integralidade do cuidado em saúde, grande parte da população, devido à carência da rede de saúde e ineficiência do poder público, ainda se encontra distante do acesso aos serviços de apoio à saúde mental previstos na legislação. Nesse cenário, ao não encontrar o apoio estrutural das redes de atenção psicossociais previstas no sistema de saúde os usuários que apresentam dificuldades emocionais por influência das redes sociais ficam mais vulneráveis aos impactos dos efeitos deletérios das mídias e deixam de amadurecer emocionalmente.', 'Torna-se evidente, portanto, a necessidade de que o Ministério da Saúde , aproveitando-se da elevada conectividade da população, implemente uma campanha de apoio à saúde mental dos usuários, por meio da criação de um aplicativo que ofereça orientações e suporte especializado com profissionais de saúde mental para que os usuários possam encontrar acesso facilitado aos serviços de saúde e assistência para lidar com problemas emocionais decorrentes do uso das redes sociais. Dessa forma, a saúde mental da população que utiliza a internet como meio de interação poderá ser mais preservada e os impactos negativos das redes sociais minimizados.']",160,200,160,200,160,880
47,Educação a distancia no brasil e os seus desafios,"['A educação no brasil est vivendo no momento muitos problemas um dos motivos é que as escolas estão paralisadas, melhor não estamos tendo aula presenciais por qualsa da pandemia que estamos nós enfrentando .', 'A pandemia começou no incio do ano trazendo doença para a população e por isso tivemos que muda a educação presencial para a educação a distancia  mais enfrentamos muitos desafios com o ensino a distancia por exemplo :', 'Os alunos para da continuidade nos ensino precisa esta assistindo aulas de todas as matérias seja ela pelo computador, televisão, internet e outros meios de comunicação  porém isso é um grande desafio na educação a distancia boa parte da população não tem acesso a isso .', 'Também os aluno precisão de material didático , material escolar como , livros e apostilha para fazer seus exercicio para da continuidade nos estudos, mais isso se torna um grande desafio porque não temos muitos recurso .', 'Umas das maneiras que podemos resolver isso na educação a distancia é ajudando os alunos e os estudante  brasileiro fornecendo internet gratuita para os alunos poderem assistir as aulas seja pelo o computador , telefone celular ou qualquer outro meio de comunicação e os alunos que não tm acesso a isso podemos contrata os professores para da aula na televisão, para ensinalos aqueles que não tm acesso a esse recurso e também podemos distribuir livros e apostilha para os alunos estudarem em casa e com isso a educação a distancia se torna mais produtivo , eficiente e obtemos melhores resultado no ensino a distancia no nosso país .']",120,120,80,120,80,520
71,,"['Na ""Obra os sofrimentos do jovem Werther"", o protagonista encontra no suicídio uma forma de livrar-se das dores de um amor não correspondido. Hoje, os jovens encontram no suicídio uma forma de libertar-se do sofrimento. Esse problema de saúde pública vem se alastrando no decorrer dos séculos e torna-se necessário a urgência desse problema .', 'O suicídio é consequência da depressão que é gerada pela tristeza, baixo autoestima, perdas, decepções e entre outros fatores que induzem o jovem a isso como por exemplo, o bullyng, que na maioria dos casos acontece nas escolas. Há também casos de homofobia àqueles que se reconhecem como gays. Por isso os mesmos se sentem rejeitados e entram em estado de depressão.', 'O grande problema é que não há percepção familiar. Por conta disso os jovens entram numa profunda melancolia e se isolam do mundo e de todos . Também, há pessoas de má fé que usam da internet para se aproveitar da vulnerabilidade dessas pessoas, como acontece no jogo: ""Balela Azul"". Isso tornou-se um caso de sade pública e faz-se necessário medidas urgentes para amenizar esse problema.', 'Em primeiro lugar os pais devem prestar mais atenção aos seus filhos usando também de bons diálogos frequentemente. Cabe ao ministério da saúde em parceria com as escolas  promoverem um bom treinamento aos profissionais da área educativa, a mídia também contribuir com mais campanhas publicitárias que envolvam esse assunto, para que usando desses recursos os jovens portadores dessa doença não busquem no suicídio essa libertação que tanto procuram.']",120,160,120,120,120,640
22,Segundo a Constituição brasileira,"['Segundo a constituição brasileira todos são iguais perante a lei. No entanto, cidadões comuns brasileiros são julgados por instâncias inferiores enquanto pessoas que ocupam cargos públicos privilegiados são julgados por instâncias superiores. Essa separação, também chamada de foro privilegiado, vem ganhando repercussão, uma vez que, esses privilégios tem levado a impunidade de algumas figuras políticas. Além disso, o condenado possue menos instâncias para recorrer e somente pode pedir a reavaliação de provas em casos específicos.', 'Segundo Marx, o alienado é aquele que não tem consciência ou perde o controle sobre os meios de produção e o processo produtivo. No âmbito político, alguns poderes judiciários, por serem independentes perdem a capacidade de julgar autoridades publicas, desse. modo, ao invés de serem julgados pelas quatro instâncias acabam, por direito, julgados por apenas uma. esse fato diminui as possibilidades de um criminoso ser condenado, visto que, a sentença final é dada por apenas um juiz, sem se quer recorrer as outras instâncias. Ademais, é notório que desde a monarquia, alguns desses ocupantes de cargos jurídicos foram escolhidos pelas próprias autoridades condenadas, sendo assim favorecidos quando acusados.', 'Por conseguinte, é negado que outros juízes reavaliem provas, o que ocasiona uma grande injustiça aos que são condenados inocentemente. Dessa forma, esse sistema favorece a corrupção e aumenta ainda mais a injustiça social. O filósofo confúncio suscitou que não corrigir as falhas é o mesmo que cometer novos erros. Desse modo, faz-se altamente necessários medidas para solucionar o impasse.', 'Para isso, cabe ao povo promover manifestações pacificas ou por meio de redes socias a respeito das injustiças do sistema de foro privilegiado. Por outro lado, é dever do estado garantir o direito de igualdade previsto na constituição,  e não favorecer as minorias. Por fim a mídia deve abordar mais o tema em programas de televisão para que a sociedade esteja ciente das regalias existentes.']",80,120,80,80,120,480
60,"NECESSÁRIA, PORÉM DESIGUAL","['A Reforma da Previdência, da forma como é apresentada é prejudicial. Embora ela realmente seja necessária, somente o trabalhador arcará com os prejuízos.', 'Para começar deveria ser considerada em um país de extensão continental como o Brasil a expectativa de vida em uma dimensão regional, no mínimo. Estabelecer a mesma regra para todas as regiões trata alguns com desigualdade.', 'Outro ponto é a maneira em que se encontra a economia. Não é fácil se manter em um único emprego devido a crise. Demissões em massa ocorrem e entre um emprego e outro o cidadão ficará sem ter renda para contribuir. Assim, posterga-se ainda mais sua aposentadoria que agora exigirá um tempo maior de contribuição.', 'E por fim, tais alterações legislativas retiram ou protelam direitos. Viúvas dependendo da idade receberão a pensão apenas por um período menor. Idosos, que embora viverão realmente mais terão que trabalhar doentes (nem em todos os casos poderão se afastar) na esperança de um dia alcançar o seu direito. É o lado social da previdência sendo abandonado.', 'Portanto, embora não se questione que é preciso se aprovar uma reforma, dever-se-ia buscar alternativas para que não apenas o trabalhador fosse onerado com estas medidas. Enquanto empresas tem dívidas perdoadas com o governo em casos de desoneração fiscal, o trabalhador terá que se submeter a um regime que não o desonerará.']",120,80,80,120,80,480
77,Love is Love,"['Segundo informações fornecidas pelo Grupo Gay da Bahia (GGB), a cada 25 horas uma pessoa LGBT (sigla para designar lésbicas, gays, bissexuais e transgêneros) é assassinada no Brasil, também contabilizaram um total de 343 mortes por homofobia em 2016, quase 1 morte por dia nesse ano.', 'Essas estimativas só marcam a falta de empatia e até mesmo de bom senso de nossa sociedade . Todo tipo de amor é bemvindo, sendo de homem e mulher, homem e homem ou mulher e mulher. Essa falta de compreenção mobilizou a internet, e assim criaram a hashtag “Love is Love”, que significa, “Amor é Amor”, independente de raça, religião ou sexo, é uma questão de escolha, e não cabe a ninguém julgar.', ""Levando em conta essa crescente taxa de LGBT's no Brasil, a Comissão de Constituição e Justiça (CCJ) do Senado aprovou o projeto de lei para reconhecer a união estável de duas pessoas do mesmo sexo, mudando assim o Código Civil onde reconhece a entidade familiar como “união estável entre homem e mulher” para “união estável entre duas pessoas”, o que já garantiu um grande avanço contra a sociedade homofóbica, sendo que essa união já está contemplada em nossa lei."", 'Outras medidas também podem ser tomadas para essa conscientização, como o ator Paulo Autran disse: “Todo preconceito é fruto da burrice, da ignorância, e qualquer atividade cultural contra preconceitos é válida”, sendo assim campanhas publicitárias, palestras sobre o assunto e também a própria educação em casa podem contribuir para um país sem preconceitos.']",160,120,120,160,120,680
74,,"['Apesar da implantação da Lei Maria da Penha em 2006, o feminicídio vem crescendo de maneira contínua. Destarte, urge a necessidade de ampliar o rigor das leis que amparam a população feminina de modo que haja a reversão dessa situação estarrecedora.', 'O assassinato é o ponto extremo da violência contra a mulher e indubitavelmente, o maior problema enfrentado pela sociedade feminina é a impunidade ao agressor. A Lei Maria da Penha pouco se faz presente nesses casos e em uma sociedade em que a mulher não é respeitada, como é a brasileira, requer maior severidade de aplicação dessa e outras leis adjacentes, já que com tamanha impunidade, o agressor se sente livre para agredir, ser detido e solto rapidamente ou ainda, sequer ser preso.', 'Outrossim, o feminicídio permanece em tempos hodiernos devido à inferiorização sofrida pela mulher no país. Assassinatos por ciúmes, separação não aceita, por exemplo, são vistos com frequência na mídia e mesmo assim, a mulher é culpabilizada no ato da denúncia, acusada por exemplo , de provocar o homem e por conseguinte, conferindo à mulher uma imagem submissa , causando tortura física e psicológica à vítima, que se sente inferiorizada.', 'Logo, é necessário que o Estado aplique corretamente as leis nesse sentido, amparando a vítima e principalmente, punindo o agressor. Cabe a mídia e a sociedade civil, se unirem para erradicar o machismo e a misoginia, com a primeira promovendo campanhas de conscientização em escolas, pela televisão e a internet  e a segunda, protegendo e defendendo a mulher e seus respectivos direitos, através de manifestações em prol de um Brasil igualitário entre gêneros.']",160,120,120,160,120,680
85,Retrocesso da participação popular,"[""A Grécia Antiga tinha como modelo politico à democracia plena, em que os próprios cidadãos opinavam projetos em praça pública, sendo mulheres, escravos e indivíduos não nascidos nesse país europeu considerados ''não cidadãos''. Analogicamente, todo mundo pode votar no Brasil na era moderna se completado a idade mínima que é 18 anos, mas diferentementea do período clássico, os cidadãos não têm mais o exercício da iniciativa popular. Decerto, a fraqueza desse setor deve ser considerado um retrocesso, que com ele culmina (em) um país menos justo e mais desigual."", 'Ademais, após a Constituição Cidadã criada em 1988 só consolidou quatro leis oriundas de inciativa popular. O maior exemplo do êxito dessas leis oriundas da população é a Lei da Ficha Limpa, em que políticos que são considerados corruptos não podem se candidatar para o póstumo cargo público. Assim, para ampliar a democracia, a iniciativa popular não deve só ser estabelecida como base, mas também utilizada pela população como voz desta.', ""Consequentemente, ''a democracia é o governo do povo, pelo o povo, para o povo'', segundo o político estadunidense Abraham Lincoln. Para efetivar a ideologia de Lincoln, os projetos de iniciativa popular devem ser tratados como um poder oriundo das massas e ser mais explorado pela população brasileira, haja vista, que ninguém menos do que os cidadãos brasileiros compreendem os problemas que a sociedade está enfrentando, já que convivem com tais diariamente."", 'Portanto, o Governo deve dar mais incentivo a esses projetos, seja ele por meios  de veículos de divulgação em massa, como rádios e televisão, mas também aprimorando n o Congresso de modo a se tornar mais acessível a população. As Organizações Não Governamentais (ONGs) devem conscientizar a população por meio da internet, dando um grande passo rumo a democracia plena, pois, utilizando a publicidade presente nesse meio e criando sites para que a população exponha suas ideias, atingiria um grupo mais de pessoas seria atingido. Por fim, cabe as escolas, como formadores de ideologias, fomentar o debate nos ginásios ou auditório para os alunos do ensino médio, com o foco em projetos que supostamente deveriam ser criados para ajudar a população brasileira, para que assim, a soberania popular seja exercitada.']",120,80,160,160,200,720
84,Arma* que matam,"['É notório que a permissão ou restrição do porte de armas traz divergências de opiniões. Dentre tantos fatores relevantes, destacam-se; o aumento da criminalização e mortes principalmente nos grandes centros urbanos.', 'Sabe-se que o uso indiscriminado de armas de fogo utilizadas pela população civil, gera um aumento na violência no país. (Um exemplo é o que) como aconteceu na tarde de sexta-feira (22/07/2016) em Munique, na Alemanha, onde um jovem matou 10 pessoas em um centro urbano comercial.', 'Ainda convém lembrar que as mortes também são ocasionadas por incidentes com armas de fogo. Algum membro da família, o qual possui esse instrumento, acidentalmente ao manuseá-la atira em outra pessoa ou a si mesma , até uma criança que pega a arma guardada, que é de autoridade do seu responsável, pensa que é um brinquedo e acaba matando um amigo de escola ou um colega do bairro.', 'Portanto, deveria ser proibida a comercialização de armas de fogo, pois as pessoas têm fácil acesso à elas. O Estatuto do Desarmamento é importantíssimo na proteção da vida, o qual tem que ser mais rigoroso para o uso e comercialização das mesmas,ele tem que contribuir pra dificultar a compra e venda de armas, pois este instrumento é o que mais mata em todo o país.']",120,160,120,160,200,760
59,Inimigos do prato cheio,"['O cortiço de Aluízio Azevedo é uma obra que além de cômica remete as desigualdades sociais no Brasil vividas no tempo do Império . A imagem da face dualística entre o cortiço, pobre, e a corte farta, o é . Assim como no livro da época, hoje, o Brasil possui maior desigualdade, é ainda maior o retrato da fome, provenientes do sistema econômico capitalista e também da ambição megalomaníaca do homem, que independe dos sistemas econômicos, exceto o capitalismo, que o é ambiciosoor essência.', 'Na Europa do século XVI foram tomadas algumas medidas pelos reis para alavancar a economia, como o mercantilismo, onde os países acumulavam metais e pedras preciosas. Pode-se dizer que foi a primeira fase do Capitalismo segundo o filósofo e sociólogo Karl Marx. O objetivo era o domínio e o poder através do desenvolvimento do capital. E embora os reis possuissem o banquete, a população já morria de fome. Com o tempo o mercantilismo desenvolveu na Inglaterra o que ficou conhecido como a segunda revolução industrial  e é justamente nela que pode-se perceber a pior face do capitalismo, pois mesmo com a coroa e os industriais anglo por transbordar lucros, a população estava também ainda a padecer de fome.', 'E com a evolução extraordinária e massiva do sistema capital por intermédio das segundas e terceiras revoluções industriais e técnico-científica, então, ""chegou o cavaleiro amarelo da fome do sexto capítulo do Apocalipse"", pois nos dias hodiernos o que pode-se observar é a imensa multidão a mendigar e pedir comida pelos estados do Brasil e sofrer e falecer de fome. Evidente que a maior culpa do problema da fome é o capitalismo, porque é uma máquina que concentra toda a riqueza do país nas mãos de poucos e por isso a supremacia humilde fica sem poder de investir e sem poder de comprar inclusive a própria comida.', 'Por outro lado e outrossim, convicto de que a ideologia inglesa que se espalhou pelos países, causou o colapso da dignidade da pessoa humana, pode-se deixar conspícuo, ao não se limitar a esse fato, que a ambicão megalomaníaca do homem é outro fator preponderante para tantas barrigas vazias e verdadeiros óbtos por inanição, dado que o mal do sistema dos ideais de Adam Smith pode-se encontrar até mesmo nas práticas do sistema comunista. Por exemplo, a Venezuela que possui mais de 70 por cento da população na extrema miséria e todos os dias morrem uma grande quantidade de crianças com fome, consequências da ambição e autoritarismo de um homem, o atual presidente Nicolás Maduro. As nações até se reuniram para conceder ajuda humanitária, mas foi negado aos caminhões repletos de comida ultrapassarem a fronteira para não ferir a supremacia do ego humano, destarte no Brasil o faminto também não consegue transpassar as fronteiras impostas pela ambição política que oprime, ambições industriais que exploram e empresariais que sonegam bilhões ao governo. Ou seja, nem todo socialismo ou comunismo gera fome, depende do seu representante, mas com certeza todo capitalismo gera, pois sua finalidade é acumular o lucro nas mão de poucos, contudo a ambição humana é idescutivelmente  a raíz dos males e seus ramos são capitalismo.', 'Portanto  visto que o capitalismo que se espalhou pelo mundo é a base da desigualdade social e que além disso a ambição desinfreada do homem pelo poder são as fontes pelas quais levam os individuos até a falecer de fome, é preciso inibir a ideologia individualista pregada pelo capitalismo e frear o poder presente nos sistemas político-economicos socialistas. Isso ocorre por meio da manifestação dos cidadãos pelos seus direitos, a criar e requerir pelos seus representantes, as leis necessárias que possam aniquilar a tenebrosa força das trevas da fome. Além disso  pode-se cobrar os impostos sonegados de tantas empresas  pelo Ministério da Fazenda e redistribuir esse recurso para o povo como medidas urgentes, afinal, fome não é brincadeira, fome mata . Outro modo é estimular a educação  pois a criança educada de hoje é o cidadão bem alimentado de amanhã.']",120,160,80,120,120,600
75,O livre porte de armas no Brasil,"['Nos tempos de hoje no século XXI , retrocedeu muito o porte de armas principalmente no Brasil , pois as condições de os dicadões de bem terem armas para sua proteção e de sua família é mais complicada.', 'Uma família não tem como se proteger além da proteção Divina pois esta tudo muito complicado , vimos na televisão os policiais com mandao de prisão para invadir as casas dos marginais e encontrar armas de vários calibres  mas com numeração raspada, hoje em dia se a pessoa física que passar por varias etapas e já os assaltantes não passam por nada disso.', 'Os cidadãos de bem  temos que reverter essa situação para proteger as nossas famílias se tem armas para o crime também tem que ter armas para as pessoas de bem .']",120,40,40,40,40,280
94,Autismo na sociedade atual,"['O mito da caverna, de Platão, relata a situação de pessoas que se recusavam a observar a realidade sua volta em virtude do medo de sair de sua zona de conforto. Fora da ficção, o Brasil atual sofre as mesmas conotações em relação dificuldade de inclusão de pessoas autistas. Nessa lógica, percebe-se a configuração de dois fatores que não podem ser negligenciados, tanto em virtude da má influência midiática, quanto do gerenciamento estatal ineficiente.', 'É incontestável, nesse contexto, que a questão da má influência midiática influi decisivamente na consolidação do problema . Segundo o filósofo alemão, Theodor Adorno, as estratégias midiáticas manipulam o comportamento das pessoas. Desse modo, os veículos de informação ao não promoverem debates, a fim de elucidar a população sobre os diversos desafios que autistas sofrem na sociedade atual, ajudam a atravancar o modo indiferente que os cidadãos enxergam a situação. Assim, tornando comum a reprodução de entendimentos e comportamentos que generalizam a comunidade com TEA de forma preconceituosa.', 'Além disso, ressalta-se que o silenciamento do Estado também configura-se como outro empecilho. De acordo com o filósofo inglês, John Locke, o Estado deve garantir direitos naturais, como a vida, a liberdade e a propriedade. Nessa perspectiva, pode-se afirmar que o governo federal, ao invés de rechaçar os atos de discriminação — muitas vezes velada — contra pessoas do espectro autista, favorece-os ainda mais por meio de condutas negligentes em relação aos artigos da Constituição de 1988, os quais afirmam que todos os cidadãos têm direito a uma vida plena . Desse modo, a exclusão dos indivíduos que vivem nessa situação deve ser combatida para que não fira mais os artigos constitucionais.', 'Torna-se evidente, portanto, que os caminhos para que os desafios à inclusão de pessoas com autismo apresentam entraves que precisam ser revertidos. Sendo assim, cabe ao Ministério da Educação, em conjunto com a mídia, criar projetos para serem desenvolvidos nos principais veículos de massa , através de propagandas em horário acessível para todos — visto que muitas pessoas adquirem informações através deses —, a fim de conscientizar a população sobre os males da negligência em relação aos cidadãos que sofrem com o autismo . Assim, o Brasil, finalmente, poderá afastar-se da realidade vivida pelos indivíduos do mito da caverna.']",160,200,120,200,200,880
85,,"['Ultimamente a Lei de Iniciativa Popular é um dos assuntos mais dominantes na imprensa nacional. Tal discussão se refere ao instrumento mais importante de participação dos cidadãos na vida política, e é através dele que podemos atuar publicamente na criação das normas que nos regem , um exemplo disso pode ser a criação de  uma proposta de lei que vise melhorar a situação dos presídios, como solução para minimizar os gastos públicos .', 'No tocante à Lei de Iniciativa Popular , a população pode participar da elaboração, ela consiste na apresentação de um abaixo-assinado à câmara dos deputados, subscrito por, no mínimo , 1% do eleitorado nacional, distribuídos por, pelo menos, cinco Estados , com não menos de três décimos por cento dos eleitores de cada um deles. Além disso, um protocolo será atribuído a esta demanda, o qual possibilitará aos cidadãos seguirem, à distância , o trâmite de sua proposta.', 'Projeto de Lei do Senador Waldemir Moka (que) prevê que (o) preso pague as despesas durante o cumprimento de sua pena é uma ideia interessante para uma proposta de Lei Popular , uma vez que a sociedade paga pelas despesas dos apenados, através de impostos. Pelo texto da Lei , o detento que tiver condições financeiras deve ressarcir ao Estado os gastos com a sua manutenção no Sistema Prisional enquanto os detentos hipossuficientes, devem pagar com trabalho. Para mais, esse projeto sendo aprovado diminuirá os gastos do governo e melhorará o Sistema Penitenciário brasileiro.', ""Portanto, para que se encontre uma solução adequada ou pelo menos se amenize o problema, a população deve usar dos meios que possui para pressionar os deputados a exigir a aprovação dos projetos de Lei que realmente atendam à necessidade do povo. Ademais, é criar mecanismo através de ONG'S com o uso de palestras para falar sobre a Democracia e os direitos dos cidadãos para assim conscientizar a sociedade a respeito do assunto discutido.""]",160,120,160,160,120,720
78,A educação para todos os brasileiros,"['Muita polêmica e debate vem surgindo por meio do assunto sobre a reforma do ensino médio . Muitas pessoas acreditam que isso vem sendo um problema e outras acreditam que seja uma solução para a educação do nosso país.', 'Hoje em dia, muitos jovens se encontram fora de suas escolas , principalmente mais de 1 milhão de alunos com 17 anos, que já estariam cursando seu último ano de ensino médio e quase 2 milhões de jovens não estudam e nem trabalham, o Ideb também mostra a atual defasagem do ensino médio brasileiro que realmente se encontra estagnado . O Ministério da Educação (MEC) propôs vigorar algumas disciplinas para o próximo ano, que abrange quatro grandes áreas do conhecimento que serão integradas em ciências humanas, ciências da natureza, linguagens e matemática. A proposta dessas mudanças também tem em vista algumas escolhas dos próprios alunos, pois assim poderão ser escolhidas disciplinas que pretendem adquirir mais aperfeiçoamento para poder desfrutar diretamente em sua futura carreira profissional.', 'Muitos especialistas criticam a proposta e sugerem a criação de um debate na sociedade para aperfeiçoar o projeto  e discutirem sobre a precariedade que vem sendo a educação em nosso país e assim pretendem chegar à  um acordo com a sociedade sobre o melhor ensino a ser escolhido  para que os índices de brasileiros sem escolaridade ou com esta mas, incompleta venha à  decrescer nos próximos anos  tendo em vista as novas propostas sendo colocadas em prática ou não.', 'A Reforma do ensino médio também é uma grande geradora de oportunidades para os brasileiros , e principalmente para os mais pobres, pois a inserção no mercado de trabalho seria maior, tendo assim também outro ponto positivo que é a escolha do estudante para sua trajetória de ensino, tendo em vista uma tentativa para melhorar o ensino médio, tudo isso pode se descrever como aspectos positivos em nossa sociedade e que trariam cada vez mais possibilidades para a educação, pois, como diria o filósofo brasileiro Paulo Freire,  ""Se a educação sozinha não transforma a sociedade, sem ela, tampouco, a sociedade muda"".']",80,120,120,120,120,560
55,Fazendeiros maquiavélicos,"['O índio é uma etnia fundamental quanto a construção da cultura brasileira, principalmente seus conhecimentos que foram adquiridos . Porém desde o colonialismo até a atulidade sua presença não é respeitada como deveria, isso se deve ao fato de que a sociedade desconhece seu valor somado a interferência de latifundiários no seu espaço', 'Apesar do patrimônio indígena, a população pouco se ouve sobre eles, alguns não sabem por exemplo que a origem de objetos como: rede, peteca, canoa e etc... vem desses. Tais ignorâncias levam o indivíduo a dicriminalizar o índio como inferior, assim ferindo seus direitos sociais que devem ser protegidos pelo governo.', 'Junto a este problema, observa-se abusos cometidos por fazendeiros no momento que desejam expandir suas terras, dessa forma interferindo no território indígena, nesse contexto a citação "" Os fins justificam os meios"" derivada de Maquiavel se aplica perfeitamente , ou seja, em virtude do lucro os fazendeiros usam da violência para expulsar os índios de suas terras.', 'Nesse cenário, uma ação deve ser tomada pelo Ministério da Educação e da Cultura que vise concientizar a socidade através das escolas, da mídia e de campanhas. Ademais, a legislação deve garantir penalidade por via de multas, aos donos de terra que causarem danos aos índios.']",120,120,80,120,40,480
79,,"['O sistema carcerário brasileiro está enfrentando uma das piores crises com várias rebeliões e inúmeras mortes e é uma questão a ser discutida,  será que os presídios brasileiros dão condições de ressocialização  . São diversos os problemas que atualmente o sistema penal passa, como a superlotação, má  condições sanitárias, precariedade e falta de treinamento para os agentes penitenciário .', 'O sistema prisional brasileiro já está ultrapassado, necessitando se modernizar e dá  condições dignas aos penados, pois essa superlotação com falta de higiene faz com que esses prisioneiros se revoltem ainda mais, saindo seres humanos muito mais violentos.', 'É necessário transformar esses detentos,  em um ser capaz de voltar para sociedade como pessoas melhores, mas na situação que hoje os presídios passam será muito difícil que isso ocorra. Criar novos presídios e diminuir o contingente de presos, separar por crimes,  os mais perigosos daquele que tem a real chance de ressocialização, agilizar e antecipar processos que duram anos sem o devido julgamento  diminuindo a população carcerária  são algumas das soluções para melhorar o sistema penal brasileiro. Outro caminho para resolver a problemática dos presídios é ocupar o tempo deles, com trabalho, estudo, é pensar que um dia esses detento saíram  das cadeias e iram  conviver com cidadãos do bem, para isso eles têm que estar ressocializado.']",80,80,80,80,120,440
65,,"['A educação desempenha um papel fundamental para a formação dos jovens e, consequentemente, do país. Isso ocorre com a formação de profissionais de nível técnico, engenheiros, médicos e professores. Mas quando a educação não vai bem os indicies mostram os reflexos , aumento de criminalidade, desemprego e desordem no pa[s.', 'As escolas públicas brasileiras, que atendem maior parte da população, sofrem com a evasão, s motivos vão desde uma falta de atitude por parte dos professores em como lidar com uma situação de bullying e passar o conteúdo para os alunos até problemas estruturais da família do aluno , onde os pais o matem na escola para que se alimente ou para receber algum benefício governamental . Com essas dificuldades os alunos abandonam as escolas e vão para o mundo do crime, desse modo conseguem suprir as necessidades arriscando a própria vida.', 'Alguns querem resolver esse problema, causado pela ineficiência escolar, reduzindo a maior idade penal .Essa medida de curto prazo, sendo pouco eficiente porque não ataca o problema central e acarretaria mais custos no futuro, custos com construção de mais presídios e para manter cada detento.', 'Ciente do que foi exposto, precisamos de políticas eficientes para a educação. Valorizar a carreira do professor e sua formação, já que parte dele o papel de formar os jovens e por meio de visita de assistentes sociais, auxiliar familiares e alunos em vulnerabilidade social.']",120,120,80,120,120,560
63,"Tragédias ambientais, como evitá-las?","['Ao se pensar a respeito dos impactos ambientais resultantes da ação das grandes corporações, é possível afirmar que o poder público tem que fiscalizar de forma efetiva os trabalhos das empresas exploradoras. Isso aponta para a necessidade de um acompanhamento rigoroso e constante por parte dos órgãos responsáveis.', 'O primeiro fator que deve ser analisado em relação à situação em questão é a prevenção.', 'O poder público, ao constatar que as corporações extrapolaram ou abusaram do que lhes é permitido, deve aplicar multas severas e interditar os trabalhos, se for o caso. Com isso, as empresas terão mais cautela e preocupação quanto à exploração, pois certamente não desejam sofrer multas pesadas ou terem seus trabalhos interrompidos.', 'A multa deve ter o papel de “assustar” essas empresas, almejando, assim, a preservação de vidas e do meio ambiente.', 'O segundo fator importante para a reflexão é que se porventura ocorrerem “acidentes ambientais” , suas causas devem ser apuradas . O que levou ao acidente? Omissão por parte do poder público que não fiscalizou, vistas grossas por parte de algum agente público, ordem da empresa para dar um passo a mais do que o prudencial etc. Não se deve aceitar a continuidade dos serviços sem antes exigir reparos aos estragos e principalmente prisão aos culpados, caso seja apurado que um eventual crime ambiental aconteceu por omissão ou conivência .', 'Para que tragédias ambientais não se repitam ou sejam mínimas possíveis, é fundamental a atuação do poder público que deve continuamente fiscalizar, aplicar penalidades rigorosas em caso de não obediência às normas , bem como a execução das multas, pois só assim as empresas se preocuparão em evitar tragédias como as de Mariana e Brumadinho, que ceifaram vidas e causaram destruição ambiental incomensurável.']",160,120,80,120,80,560
95,Debate sobre o marco temporal - BXA,"['A Constituição Federativa Brasileira de 1988, no artigo 237, declara que, é direito dos indígenas o usufruto permanente das terras que originalmente ocupam na forma desta lei. Nesse sentido, é perceptível que a prerrogativa n qual, o interesse pelo marco temporal por vezes é embargada principalmente, no que tange a demarcação das terras dos originários no Brasil . Dessa forma, torna-se imperiosas ações efetivas para diminuir a precariedade nas políticas públicas do país, tendo em vista, a falta de reconhecimento vindo das bancadas ruralistas e a delimitação honesta e imparcial das terras.', 'Em primeiro plano, é importante pontuar que enquanto se mantiver a contestação histórica dos ruralistas sobre os índios, parte dos indivíduos serão prejudicados em seus direitos básicos. Nesse viés, de acordo com o filósofo John Locke, é dever do Estado assegurar os direitos imprescindíveis da população, todavia, essa não é a realidade brasileira. Dessa forma, ocorre que, o descaso com as invasões nos terrenos indígenas corrobora com os riscos perpetuação do problema, de modo que acarreta conflitos árduos entre as partes. Isso é bastante paradigmático,  em um país que se autodenomina “desenvolvido”, a permanência deste obstáculo.', 'Em segundo plano, é valido ressaltar também que a falta de uma nova delimitação justa traz dificuldades para os grupos em suas singularidades. Nessa linha de raciocínio, pode-se observar que há uma discrepância mútua de ideias sobre o assunto, o que contraria o pensamento de Thomas More, na bra “Utopia”, que retrata uma sociedade perfeita e ideal; contraposta pelos embates das associações atuais. Dessa maneira, sucede-se que,  a omissão estatal diante da situação, potencializa as inconformidades da problemática, de sorte que gera insatisfação entre ambos. Tal consequência soma com os atritos já existentes entre os membros, fazendo, assim, desafiador a finalização do impasse.', 'Portanto, cabe ao Supremo Tribunal Federal, pleitear leis que assegurem ambos os grupos de seus direitos, isso por intermédio de debates e votações na Câmara dos Senadores, de modo a estabelecer os reais limites entre as terras de direito indígena, para o seu uso próprio, além das terras de direito dos proletariados, para usufruir com o objetivo econômico, respeitando as dívidas históricas por parte das comunidades. Assim, o debate sobre o marco temporal seria uma mazela passada no histórico brasileiro.']",120,200,160,200,160,840
55,Mudança de Mentalidade,"['De acordo com os conhecimentos adquiridos ao longo da nossa trajetória escolar , sabemos que os índios eram os verdadeiros donos das terras brasileiras. Nessa perspectiva, os portugueses não descobriram o Brasil, mas apenas o encontrou. E encontraram aqui,  um povo com seus costumes, suas crenças e culturas já internalizadas.', 'No entanto, as pessoas que aqui chegaram não souberam ou simplesmente não quiseram respeitar os povos que aqui viviam . Obrigando-os a tentarem se adequar aos costumes dos povos brancos. Infelizmente, de acordo com o que nos conta  a história esse embate de culturas e costumes, esse embate de culturas levou a um extermínio de uma grande parte da população indígena que vivia no litoral brasileiro.', 'Ademais, isso também levou a uma grande mudança no modo de vida dos indígenas, algo que não deveria e não podemos permitir hoje que continue acontecendo . Uma vez que, esses povos detinham e ainda detêm um grande conhecimento acerca da natureza que os cercam. Sendo esses conhecimentos de grande importância para encaminhar pesquisas científicas que levaram e ainda levam à descoberta de inúmeras doenças.', 'Portanto, não podemos permitir que as culturas e direitos desses povos sejam negligenciados . Pois, invadir e obrigar um povo a viver de forma diferente dos seus costumes,  é uma grave infração dos Direitos Humanos, onde se diz que, cada ser humano tem o direito de viver da forma que melhor lhe convier. Que saibamos respeitar, valorizar e garantir a esses povos, seus direitos tantas vezes negado, para que fatos iguais aos ocorridos no passado não voltem a acontecer.']",120,120,80,120,80,520
82,Auto-anamnese,"['A saúde deve começar na escola porque são poucos os profissionais da saúde para atender todo tipo de sintoma.    Para se formar em medicina   há uma grande batalha com longos anos de estudo e dedicação com poucas vagas em universidades publica  e   nas particulares   as mensalidades são estratosféricas.    Ensinando a auto-anamnese nas escolas   o sistema não entraria em colapso de atendimento.', 'Cada um sabe onde sua ferida dói!  A anamnese é uma técnica médica de investigação da situação atual do paciente.   Adaptar esta  técnica na escola trará muitos benefícios porque a pessoa terá consciência qual a finalidade de cada unidade de medida como: pressão, batimentos cardíacos, pulso, cor dos olhos, do rosto e sintomas. Com a auto-anamnese respondida, a pergunta final é “preciso procurar um médico?  Em caso negativo: posso comprar remédio?”.', 'As farmácias já atendem  uma determinação da ANVISA que é vender medicamento controlado mediante retenção de receita médica.   O governo regula de maneira excelente o mercado farmacêutico  impedindo a automedicação e direcionando os casos mais complexos para os médicos que são competentes para diagnosticar, prescrever medicamentos e realizar cirurgias.', 'O sistema de saúde tem poucos profissionais para atender a população, a qualificação para se tornar um médico requer muitos anos de estudo e recursos financeiros.   A auto-anamnese adaptada trará maior consciência de quando usar ou não medicamento, ainda destinando apenas os casos mais importantes para os médicos.']",120,120,120,120,120,600
45,Por um mundo de liberdade,"['No filme ""Star Wars"" (1977), o vilão Dath Vader, representa uma figura de autoridade - sendo uma espécie de ditador - de um gigantesco império. Ao longo desta liderança e seu abuso de autoridade levam à práticas violentas; escravidão, massacres, extorsão, entre outros. Elementos estes, que, também, causaram uma ferida marcada pra sempre na história brasileira, e se mostrou uma brutalidade a ser combatida.', 'Acima de tudo, a questão do autoritarismo no Brasil, em sua história, esbanjar momentos deste abuso, com seu ápice na ditatura militar; onde por 22 anos o governo cometeu este hediondo crime contra o povo. Além disso, em 1986, mesmo com uma anistia, permaneceu o sentimento autoritário perdido.', 'Visto que, apenas em 2019, foi posto em prática, uma norma que expande o que a legislação anterior entendia como condutas excessivas por parte de servidores públicos e autoridades. Entretanto, não se mostrou eficiente, pelo contrário, segundo o relatório anual da Ouvidoria das Polícias, 2020, as denúncias de abusos cometidos por policiais no ano passado, 84% deles apontaram envolvidos de PMs.', 'Em suma, fica exposto que, m caminho seria reestruturar a polícia brasileira, pensando, talvez, numa desmilitarização. Dar mais importância à polícia civil e incorporá-la na segurança que, hoje, é exercida pela PM. Oferecer treinamento digno aos policiais, uma vez que estamos falando de pessoas que andarão armadas pelas ruas.']",120,120,120,120,80,560
52,A conscientização da gravidez na adolescência.,"['A gravidez entre adolescentes de 10 a 19 anos vem aumentando a cada ano. Muitas delas acontecem por falta de informações sobre métodos contraceptivos, já algumas por simplesmente nao levarem sérios suas responsabilidades sexuais e trocarem-nas por uma noite de prazer momentâneo.', 'Muitos problemas acabam sendo ocasionados por uma gravidez precoce; várias mães acabam deixando os estudos para trabalharem e manterem seus filhos o que acarreta grandes problemas socioeconômicos, além disso há também doenças sexualmente transmissíveis que acabam se espalhando por pessoas que se relacionam com companheiros que mal conhecem, a sociedade patriarca acaba também jogando toda a culpa da gravidez na mulher que na maioria das vezes é abandonada pelo pai do bebê e cuida dele sozinha quando ambos fizeram o filho e a responsabilidade é igual para os dois.', 'Para diminuirmos a quantidade de gravidez na adolescência  este tema deve ser abordado naruralmente ente país e filhos, professores e alunos e governo com populações através do diálogo, devemos ter em mente que campanhas como as camisinhas entregues para adolescentes no carnaval não os incentivam a terem relações sexuais  e sim a se no caso tiverem se previnam de DSTs e da gravidez precoce.']",120,160,120,120,120,640
127,Escola,"['A vida do         típico adolescente         se divide entre os amigos e os estudos. Com os amigos,                busca a diversão e, nos estudos, busca conquistar a, por muitas vezes difícil, vaga em uma boa universidade. Em cada         lado         , o adolescente         precisa de adaptar-se         para conseguir os seus objetivos, e                 se misturar as duas normas diferentes usadas em tais ambientes, sendo que com os amigos utilizará uma linguagem impessoal e nos estudos deverá utilizar a norma culta, o resultado poderá ser desastroso.', 'Há sempre de analisar o percurso para alcançar os objetivos dos diferentes                 espectros                da vida do adolescente;         As         universidades usam como critério de seleção para suas vagas de ensino o domínio da norma culta, e as escolas mostram-nos o melhor caminho para conquistar os nossos objetivos acadêmicos, por isso seria         contra produtivo         as escolas ensinarem uma variante linguística senão a norma culta. Com os amigos, o adolescente adaptar-se-á ao grupo e, se utilizar a norma culta durante uma conversa neste ambiente,         corre         o risco de ser excluído. Se invertêssemos os papéis, e as escolas tivessem como objetivo ensinar os alunos a fazer amigos, daí então a escola teria de ensinar a                 norma não culta                .', 'Deve-se repudiar uma escola que não ensine a norma culta ou que apoie o uso de linguagem informal dentro da sala de aula, pois fora dela poucos adolescentes conseguiriam aprendê-la.                E se um dia, as universidades mudarem seus critérios de avaliação, e passarem a analisar o domínio da linguagem informal, o que esperamos que não aconteça, daí sim as escolas poderão a passar a permitir o uso da linguagem informal.']",120,120,120,120,120,600
132,MMA versus as artes marciais,"['O MMA - acrônimo para ""mistura de artes marciais"", em inglês - tem ganhado cada vez mais espaço na cultura brasileira. Alavancada pelo UFC, seu campeonato, a modalidade conquistou a preferência de pessoas de todas as idades e estratos sociais. Tal disseminação tem prós e contras: como esporte, o MMA condiciona fisicamente; como modo de vida, deixa muito a desejar.', 'É inegável que a luta é uma excelente forma de fortalecer o corpo. O preparo físico do MMA, como o de qualquer arte marcial, é exigente; suas técnicas são valiosas em situações de autodefesa, ou até mesmo cotidianas.', 'Contudo, esse esporte também cria pessoas como o                 estudante que, ao ser          perguntado porque escolheu         MMA, respondeu: ""Gosto de bater mesmo, quero ver sangue"". A causa disso é que, apesar de, como o nome sugere, misturar outras artes marciais, o MMA deixa de lado as filosofias de modalidades como caratê, judô e outras que guiam suas técnicas com o respeito ao próximo.', 'O resultado disso tudo são lutadores desprovidos de uma filosofia que os guie - o bushido (caminho do guerreiro) das artes marciais orientais         - :         centenas de pessoas que ""querem ver sangue"" e um campeonato de ""artes"" marciais sensacionalista e capitalista para atendê-las.']",200,200,160,200,160,920
64,Pedagogia Oprimida,"[""A educação sexual, a atribuição do ensino de cárater sexual, é um assunto pedagógico pouco abordado nas instituições sociais, da família, escola e Estado, que muito frequentemente se esbarra com preceitos religiosos, mitos e tabus sociais que acarretam a uma série de consequência àqueles que lidaram com o assunto tardiamente, tal como gravidez precoce, Dst's e aborto. Por ser um assunto pouco trabalho e ensinado, várias gerações aprender o tema com má interpretações, informações erradas e debates morais sobre a sua própria sexualidade, dos limites de seu corpo e do ato que supostamente deveria ser bom e saudável."", 'A metodologia atualmente empregada é evitar o assunto, assim como as questões morais, religiosas e suas implicações, o que de fato é abordado é o ato sexual de cárater biológico e fisiológico, mas pouo ou não explicado outros temas relacionados, como as consequências da gravidez e de doenças sexuais, o funcionamento dos mecanismos de prevenção e a moralidade do ato. No entanto, não cabe apenas a Escola a educação sexual, a Família é imprescindível para o amadurecimento dos jovens, tratar sua fisiologia e dúvidas de forma natural e não romantizada, mas esclarecer numa linguagem e com conhecimentos prévidos, de acordo com sua maturidade e idade, que compreenda. Pois quando o assunto for aprofundado posteriormente, esse indíviduo o trabalhará com naturalidade, interrompendo o ciclo vicioso de preconceitos de uma cultura retrógrada, guiando com informações corretas as próximas gerações.', 'A chava para tirar o Brasil dos péssimos índices que o seguem, como um em cada cinco crianças de mães adolecescente e a 7ª maior taxa de gravidez precoce (na América do Sul), de acordo com a ONU e o Ipea, é a educação . Ela deve ser abordada como uma questão de saúde pública cabível aos Estados da União, para com as famílias e escolas, trazendo um plano integrado a legislatura brasileira de como abordar o tema, com informações verídicas ao meio familiar e escolar, do ato sexual e tudo que o contempla, com enfâse no comportamento e respeito ao próximo e aos seus limites, para tirar-se os tabus que cercam o tema e criar-se indíviduos responsáveis e conscientes, pois esta medida pode trazer ainda melhores resultados, como a queda significativa de estupros e feminiciídios e das questões socio-culturais, como a LGBTfobia.']",120,160,80,120,160,640
84,Na mira da culatra,"['Sendo um dos principais personagens de Hollywood, o agente secreto James Bond ficou conhecido por ter salvado o mundo várias vezes. Na trama, o espião utiliza diversos acessórios e, dentre eles, uma pistola, que acabou se tornando a icônica marca do herói. Se na ficção o uso da arma foi tão importante, na vida real surge uma dúvida: a legalização do porte de arma para a população civil é a solução para combater a violência?*', 'Há quem diga que sim, afirmando que, historicamente, a força bélica se fez necessária, como, por exemplo, na segunda grande guerra do Século XX, onde as armas nas mãos dos soldados fizeram valer a liberdade democrática dos países vencedores sobre as ideologias ditatoriais de Hitler, Mussolini e afins. Com isso, na concepção de muitos, os revólveres se tornaram sinônimo de segurança e integridade física. Assim, o armamento civil no Brasil traz consigo a promessa de diminuir a violência, já que o bandido pensará duas vezes antes de agir contra um cidadão possivelmente armado.', 'Todavia, se por um lado há aqueles que defendem, por outro há aqueles que discordem da arma particular. Na ótica dessa parcela da sociedade brasileira, tomando como exemplo os Estados Unidos, o armamento pode acarretar o efeito inverso daquilo que se espera, promovendo a verticalização do número de homicídios, pois pessoas sem instruções de uso e habilitação psicológica comprovada por especialistas podem portar uma arma. Sendo assim, segundo dados do Instituto Sou da Paz, uma pequena discussão de bar, por exemplo, tem duas vezes mais possibilidades de acabar em morte caso o cidadão disponha de uma arma de fogo no momento de fúria.', 'Fica claro , portanto, a necessidade de medidas que resolvam a questão. Cabe ao Governo Federal reforçar o efetivo da Policia Militar em todo o pais, aumentando a segurança e mostrando ao cidadão que vale mais confiar na polícia do que na posse de uma arma. A Polícia Federal, por sua vez, deve firmar parceria com o núcleo de inteligência investigativa da Policia Civil, para traçar os mapas da violência e combater o mal pela raiz. Escolas e universidades devem ministrar palestras para seus alunos, mostrando os benefícios e os malefícios do armamento e despertando o senso crítico dos jovens e adolescentes. Com esses pequenos passos, o Brasil poderá fazer uma grande caminhada.']",160,160,160,200,200,880
120,(Sem título 070),"['Liberdade de expressão é poder se expressar         dos         mais variados assuntos sem ser oprimido. Mas até que ponto podemos nos expressar?         Tem         um limite?', 'Vivemos em um mundo com os mais diversos tipos de culturas, religiões e         politicas O.         que acaba tornando difícil                 o modo de como se          expressar  , por exemplo me expressar         sobre um religião é válido, desde que não ofenda os         seguidores da mesma         .', 'Tudo na vida tem um         limite já         pensou se pudéssemos fazer o que         quiséssemos o         mundo seria um verdadeiro         caos, por         esse e                 outros motivos                a opinião também         tem         .', 'Podemos nos manifestar sobre todos         assuntos         contanto que não nos         exaltemos, não         precisamos ofender ninguém para         se expressar         . O certo seria que todos pensássemos antes de falar, para         que não cause         problemas.']",120,80,80,120,80,480
63,INDENIZANDO O MEIO AMBIENTE,"['Precisamos de alternativas para restaurar os impactos ambientais resultante da ação antrópica, que devasta todo o ecossistema necessário para o bom funcionamento do planeta.', 'A principal causa deste desgaste , é o imenso descaso das grandes empresas, que pensam que podem fazer tudo que desejam, por serem portadores de grande poder aquisitivo.', 'Portanto  uma maneira de restituir a natureza, seria implantar como punição para cada desastre ocasionado, a obrigação de patrocinar ações em prol do meio ambiente, como exemplo se tornar mantenedor de entidades que já fazem esse tipo de trabalho.']",120,80,80,80,80,440
110,Pensar como um estuprador,"['O estupro – assim como qualquer outro crime que infrinja os Direitos Humanos – prejudica a dignidade do         cidadão. Além         de afetar o direito à         propriedade do corpo         e, principalmente, a autoestima da vítima, que                 se sente                violada e exposta.', 'Segundo estudos do Ipea (Instituto de Pesquisa Econômica Aplicada), 89% das vítimas são do sexo feminino e isso pode ser explicado         no         fato         do         papel da mulher na sociedade ser visto historicamente como inferior.         Desde os         primórdios da humanidade, o homem saía para caçar e realizar tarefas pesadas, enquanto elas encarregavam-se das mais amenas. No decorrer do tempo, a         imagem         de submissão feminina acentuou-se, tornando-se regra que moças deveriam dedicar suas vidas à família e a casa. Na Índia, por exemplo, até pouco tempo                , a mulher deveria morrer junto ao         marido caso         ele falecesse.', 'Além disso,                 pessoas que praticam violência sexual podem          possuir          graves distúrbios psíquicos, pois subjugam as vítimas que, muitas vezes, não          possuem          sequer conhecimento do ato                – como em casos de bebês e crianças. É ignorância atribuir a culpa a uma pessoa violentada, visto que o agressor é antiético, por desrespeitar os Direitos Humanos, não         possui         bom senso em prol do bem comum e é sádico, já que sente prazer com o sofrimento alheio.', 'O ser humano          possui          uma visão machista perante a imagem da mulher na sociedade                , contudo isso não pode servir como justificativa para o estupro, assim como nada que prejudique os direitos do cidadão o         podem         . Ter         uma ideologia         que algo         explique         o porquê de um ato ilícito tão         cruel, é         pensar como um estuprador, já que ele também         possui         motivos para tal, mentalmente         conturbado         ou não.']",160,200,200,120,0,680
84,,"['Está sendo discutido na Câmara dos Deputados um projeto de lei que libera o porte de armas no Brasil. Na antiguidade,as armas eram feitas e usadas para guerra e profissões capacitadas ,e hoje propagam a violência na sociedade. Nesse viés, ‘’o mundo nada nas águas da violência ‘’ , o que poderia trazer a cada indivíduo uma reflexão sobre o armamento civil.', 'O porte de arma garante segurança em um assalta , porém a sociedade pensa que a usará somente para essa situação, esquecendo que a mídia mostra frequentemente acidentes causados por crianças e adolescentes  que ao brincarem com a arma acabam por matar sem a intenção. De acordo com o Sociólogo Zygmunt Bauman , ‘’o mundo tecnológico trouxe a diluição dos sentimentos humanos’’ , o que mostra claramente que diversas pessoas iriam adquirir armas com a intenção de matar e roubar facilmente.', 'Nessa perspectiva, possuir arma também causaria o aumento de homicídios ,pois de acordo com a OMS , 71% da população brasileira* comete esse ato com armas de fogo, mostrando outro ponto negativo .É preciso considerar ,antes de mais nada , que diversos fatores seriam considerados a obter uma arma, como ser maior de 21 anos , não responder a processos e não possuir antecedentes criminais. Ainda foi constatado estatisticamente por um estudo do ‘’American Journal of Health’’ , que há mais relações entre possuir arma e o risco me matar uma pessoa conhecida  do que possuir arma e matar um desconhecido - certamente a violência aumentaria - evidenciando o quão distante estaria a população na relação de respeito ao próximo.', 'Um dos projetos de lei discutidos na Câmara é o de armamento civil. Portanto, é necessário a ação da mídia através de comerciais, novelas e documentários, tentando trazer na sociedade a reflexão das consequências do armamento . Instituições de Ensino devem juntamente com a família monitorar as crianças e adolescentes investindo em consultas psicológicas, objetivando o pensamento da paz e o bem estar entre os alunos nas escolas evitando sempre a violência.']",160,160,120,120,160,720
39,(Sem título 095),"['A intensa crise econômica que assola o Brasil é aprofundada pelo caos político, que pode culminar na deposição da presidente Dilma Rousseff (PT). Apesar dos argumentos dos pró-governo, favoráveis à sua permanência no cargo, o impeachment se apresenta como única solução viável para reverter a crítica situação do país.', 'Os que se opõem ao interrompimento do mandato tomam como base argumentativa principalmente as conquistas sociais obtidas no governo petista e a natureza do processo. Eles propagam a ideia de que não há crimes de responsabilidade por parte da presidente, o que torna o impeachment um golpe contra a democracia; além de quê, em vez de solucionar os problemas econômicos, pode agravá-los ainda mais. De fato, na última década os programas sociais promoveram uma redução na extrema pobreza no país, além da inserção de grande parcela da população na classe média.', 'No entanto, esses feitos não alteram o fato de que caminhamos para a maior recessão econômica de nossa história. O desemprego chega aos 9,8%, segundo dados do IBGE, e a inflação é a maior desde a criação do Plano Real, nos anos 90. Observamos que a instabilidade política é o principal agravante da crise econômica, uma vez que o país deixa de ser alvo de investimento das grandes empresas multi e transnacionais. Assim, resta como única opção a alternância de poder por base legal.', 'Então se recorre ao impeachment, que, diferente do que apontam os defensores do atual governo, está previsto na Constituição de 1988, logo não configura golpe de Estado. Quanto às denúncias contra a presidente Dilma, constam as pedaladas fiscais, que aumentaram expressivamente o rombo nos cofres públicos, além dos diversos escândalos de corrupção nos quais seu partido se encontra envolvido.', 'Diante disso, cabe ao Congresso e ao Supremo Tribunal Federal (STF) o devido julgamento do processo, tomando-se sempre pelo que determina a lei, o que pode resolver a crise política e, por consequência, a econômica. Independentemente da sustentação ou não do impeachment, o governo deve tomar como prioridade a criação de pacotes para a captação de investimentos estrangeiros, com a redução de impostos e o incentivo à livre concorrência, bem como o combate à inflação. Desse modo, o Brasil evitará passar por outra década perdida.']",160,200,160,160,120,800
46,Privatização do saneamento básico_,"['É inegável dizer que ao longo da histria humana houve constantes problemas relacionados a política, economia, educação, etc. Assim como os demais, a saúde está encarnada ainda com desavenças nos dias atuais, em especifico o saneamento, onde sem uma diminuição ou eliminação completa de seus problemas, pode futuramente ocasionar ainda mais infecções, pragas e poluições de atmosféricas e hídricas afetando não só as comunidades carentes onde o problema é altamente notável como também a população inteira da nação e até mesmo a diversidade animal.', 'No brasil, o problema com a falta do saneamento atinge por volta de 17% da sociedade de acordo com dados do ""BKR Ambiental""Tais consequências provocadas pela não atenção ao caso podem ser relacionas com a ""Peste Negra"", uma pandemia ocorrida em meados do século XIV, causada pelo transporte de ratos junto com suas pulgas, trazidos pelo oriente a Europa, onde o principal motivo de se alastrar foi devido a falta de higiene local, como o acúmulo de lixo nas ruas e esgotos céu aberto, relacionados com a falta de saneamento na época.', 'Uma das medidas para a diminuição desse problema atualmente é a privatização do saneamento básico, tal medida foi proposta pelo senado dependente da sanção do Presidente Bolsonaro de acordo com informações do site ""UOL"". É correto afirmar que a privatização poderá aumentar a qualidade do saneamento junto a integração a diversas localidades, também com a colocação de multìplas empresas a concorrência poderá aumentar gerando possivelmente uma diminuição ao preço do serviços.', 'Em complemento, á medidas em que o governo, mais especificamente prefeituras das cidades, terão que proporcionar as localidades carentes como comunidades, onde seria ideal a coleta e a limpeza gratuita por parte dos agentes públicos, onde a população tem o direito a condições minímas de sobrevivencia de acordo com a constituição brasileira, promovendo assim uma melhora as condições mundiais da humanidade, em generalização, da vida terrestre.']",160,160,120,120,80,640
8,Pensamento científico em perigo,"['A ciência contribuiu, ao longo dos séculos, para o desenvolvimento da sociedade tal como a conhecemos. Graças à a ela, diversas comodidades, como meios de comunicação, internet e medicamentos, estão disponíveis. Entretanto, seu prestigio prestígio vem diminuindo entre a população. Este Esse fenômeno está bastante associado às novas formas de consumo de informações e pode trazer grandes prejuízos ao povo.', 'Atualmente, a disseminação de informações tornou-se mais dinâmica. Entretanto, isto isso favoreceu as chamadas ""fake news"", caracterizadas por apresentarem inverdades, muitas vezes convenientes para alguns segmentos da sociedade. Ainda Além disso, o impacto destas dessas notícias é favorecido pela chamada era da pós-verdade, que, como explica o filósofo Paulo Ghiraldelli, caracteriza-se por uma situação em que fatores pessoais pesam mais no momento de analisar uma informação do que qualquer outro. Com isto isso, tanto o pensamento crítico, como o científico são postos para escanteio.', 'Além disso, a descrença na ciência traz consequências negativas para a população, sendo um claro exemplo desta relação desse fato o caso da vacinação. Tal ligação se dá pelo fato de o Brasil, nos últimos anos, ter passado de país modelo na pauta de imunização à a figurante entre os principais países com aumento na incidência de sarampo. Neste Nesse processo, o disseminado movimento anti-vacinas antivacinas, carente de base técnica científica, teve importante contribuição. Associado à a ele, também contribui a falta de criticidade relativa às informações.', 'Dado o exposto, faz-se necessário trabalhar pela valorização da ciência. Neste Nesse processo, as instituições educacionais são fundamentais e devem contribuir para a formação de cidadãos críticos. Além disso, devem estimular o primeiro contato com a ciência e sua compreensão, por meio de atividades práticas contextualizadas com o dia a dia. Além disso, é de suma importância que as empresas ligadas à comunicação desenvolvam mecanismos de combate às ""fake news"", a fim de evitar a disseminação de informações prejudiciais à população. Desta Dessa forma, contribuir-se-á para o melhor uso do conhecimento.']",160,200,200,200,200,960
62,Cadê a humanidade que estava aqui?,"['O avanço da internet, e mais especificamente das redes sociais, escancara um terrível mal tem corroído a democracia mundo afora: o ódio humano exacerbado que provém de desigualdades alarmantes sob diversas ordens – política, social, econômica etc. Afinal, até quando a humanidade suportará essa forma radical de pensar, ver e viver a vida?', 'Tornou-se indiscutível que a profusão de discursos de ódio na internet, sobretudo contra minorias étnicas, sexuais e religiosas, e, de maneira geral, avesso aos direitos humanos, é um perigo ao sistema Democrático de Direito. Tal massa constitui um público que é, em si, ignorante quanto à própria história, desinformada, portanto, da evolução das leis, normas e regras de convivência – como, a exemplo, da própria noção universal de direitos humanos. Há, no bojo de tais discursos, uma alarmante desigualdade de diversas ordens, a qual se manifesta em posturas radicais e odiosas em relação a si mesmo, a sua história e a seu semelhante. No tocante à questão, estudos recentes indicam que cerca de 1% da população detém renda maior que 99% do restante do mundo. A reação a esta brutal estatística vem sob radicalismos múltiplos, manifestando-se no discurso político em negar o outro,  e, por consequente, a si mesmo, como ser humano detendo de direitos.', 'Isso explica, em partes, a tese do pesquisador e autor inglês Jamie Barrelete de que os “grupos radicais chegaram antes à internet por estarem fora dos jornais e do mainstream”. Excluídos da sociedade, encontram formas outras de expressar o descontentamento com a situação desigual de suas vidas através dos discursos de ódio. Nesse sentido, há de se observar ainda a profusão de notícias a que diversas pessoas mundo afora veem todos os dias. Para o autor,  “estar envolvido em tanta informação assim é mais preocupante que as próprias notícias falsas”, haja vista que tais informações circulam em “bolhas”; em círculos de pensamento único, em que indivíduos já excluídos se isolam mais e criam espaços próprios capazes de, conjuntamente, negar ou dissimular fatos. Na dúvida, outros tantos preferem se guiar pelo sentimento, do que lhes parece melhor ser verídico ou não. A isto, alguns pesquisadores deram o nome de “pós-verdade"".', 'Dessa forma, é premente uma resposta conjunta de toda comunidade internacional no entendimento de tais questões bem como em ações, globais e também conjuntas, contra discursos do tipo, a começar pelo combate à desigualdade socioeconômica que tem brutalizado a humanidade de muitos, investindo, para tanto, na correta distribuição de riqueza e na adoção de políticas educacionais que preparem os diferentes sujeitos para vida num mundo cada vez mais diverso em opiniões e possibilidades -- de pensar, ver e viver a vida em comunidade.']",120,160,120,160,120,680
93,A humanização do nascimento e suas consequências,"['Com a era da informatividade, a medicina e a tecnologia se aproximaram, o que condicionou utilização de novas técnicas para o tratamento e promoção da saúde. Diante disso, no Brasil contemporâneo, convém citar o parto humanizado, como uma questão de saúde pública, pois a sua frequência está gradativamente maior. No entanto, há entraves que impossibilitam a sua adesão, tais como, a falta de informação e a carência de investimentos na saúde da mulher.', 'Diante do exposto, a falta de informação colabora para a não aceitação desse tipo de parto, uma vez que as mulheres desconhecem a prática e optam por seguir os métodos tradicionais. Consoante a isso, ressalta-se a evolução da medicina no que tange o tratamento a enfermidades, visto que a descoberta da penicilina ampliou as possibilidades de cura. Sendo assim, nota-se que apesar do progresso da ciência, a ausência de informação persiste na sociedade, o que leva à falta de adesão ao parto humanizado. Dessa forma, o conhecimento e o acesso à educação são fundamentais para a promoção da saúde, pois estimula às futuras mães a buscarem formas menos invasivas no momento de dar à luz. Assim, percebe-se que a humanização do nascimento é um aliado para a manutenção da autonomia da paciente, o que confere maior respeito à parturiente.', 'Ademais, a carência de investimentos na saúde da mulher também interfere na realização do parto humanizado, já que, a ocorrência de locais específicos para essa prática, no SUS, é limitada. Paralelamente a isso, destaca-se a figura dos boticários e curandeiros, que na era colonial, devido à inexistência de hospitais e centros de saúde, eram os responsáveis por todos os tratamentos e diagnósticos. Nesse contexto, a medicina progrediu e adotou novos modelos terapêuticos, porém ainda se observa um descompasso, pois enquanto novos conhecimentos médicos surgem, o acesso a eles ainda é restrito . Diante disso, cabe ressaltar que a negligência governamental contribui para esse cenário, visto que não ocorrem investimentos maciços para a maternidade. Logo, isso contribui para a perpetuação de partos hospitalares, que necessitam de intervenções médicas.', 'Portanto, diante dessa realidade, é necessário aplicar medidas para mitigar esses entraves. Para tanto, o governo federal em parceria com o Ministério da Saúde deve realizar investimentos em programas de assistência mulher , por meio do aperfeiçoamento de profissionais , que devem ser capacitados continuamente, e também a ampliação das casas de parto, que devem estar inseridas no SUS. Além disso, médicos e especialistas em saúde precisam promover palestras e mesas-redondas, direcionadas ao público gestante, a fim de instruir e orientar as futuras mães sobre os benefícios do parto humanizado, e como este mantém a autonomia da mulher.']",160,160,160,160,160,800
50,"Coronavírus e ciência, uma discussão social","['O cientista e físico Isaac Newton descobriu a teoria da gravidade durante a quarentena da peste bubônica do século 17 . Tal fato pode expressar grande significado frente a pandemia do Coronavírus na atualidade, seja pela realidade do isolamento social enfrentada pela população, seja diante da nova rotina de vida diária . Dessa forma, o cientificismo passa a agregar informação sobre o Covid-19, instruindo  e esclarecendo dúvidas sobre o vírus. Além disso, abre caminho para propor novas abordagens educacionais, econômicas e políticas, pelas quais a cotidiano vem se adequando.', 'Nesse contexto, percebe-se a necessidade em protagonizar ao mundo questões importantes, tais como: a origem do vírus e como age no organismo humano e porquê medidas isolativas são cruciais para conter o avanço da doença . Logo, em uma sociedade globalizada, cuja mobilidade é grande e frenética  falar em coronavírus, isolamento social e quarentena,  possibilita dimensionar o problema e desenvolve medidas eficazes para anular a propagação da moléstia. Assim, a mídia vem noticiando informações por intermédio de especialistas em imunologia, cientistas em genética e parasitologia para ajudar a sociedade e evitar fake news – notícias falsas que só atrasam soluções.', 'Por conseguinte, infere-se uma discussão imprescindível acerca dessa realidade, porque tal como a pandemia da gripe espanhola em 1918 e a Peste Bubônica do século 17 permitiu o surgimento de novas descobertas à ciência na área da matemática e da medicina, também, em tempos atuais o cientificismo vem realizando suas pesquisas e a população busca adequar-se em suas  casas. Então, apesar das dificuldades geradas pela pandemia, resoluções são intercaladas para vencer a monotonia, pela internet e variantes ;  ausência de aula, pelas plataformas digitais e outras mudanças.', 'Com base nessas considerações, constata-se uma questão de segurança pública a qual impera a necessidade pelo cuidado e medidas cautelosas para combater o coronavírus. Sendo assim, o Ministério da Saúde, por intermédio da mídia brasileira, deve criar um canal específico em horário nobre , do qual seria exibido em intervalos em todas as emissoras informações sobre os últimos avanços da ciência, medidas de cuidado e proteção, além de proporcionar conhecimento verdadeiro, vai mudar a percepção da população sobre a ciência e sua importância ao mundo.']",160,160,120,160,120,720
89,O dilema dos mais vulneráveis,"['Com a advinda do capitalismo a desigualdade social e econômica acentuou-se no Brasil. Nesse contexto, é possível destacar a impariedade existente no cenário atual de pandemia, onde a população pobre entra em um dilema: isolamento social ou subsistência?.  Isso é preocupante em pleno século XXI.', 'A princípio, é possível analisar que o isolamento social é cientificamente comprovado ser eficaz no combate a pandemia do novo coronavírus. Contudo, o turismo, por exemplo, foi um dos setores mais prejudicados com essa medida. Desse modo, isso contribuiu para o agravamento da crise econômica no país, fazendo com que a parcela mais vulnerável da população ficasse mercê do vírus e da miséria.', 'Além disso, é possível observar que a instabilidade política, a inflação, a recessão, entre outros fatores foram também responsáveis pela crise econômica. Nesse sentido, perce-se que a dispariedade que existe entre a população influencia na maneira com que que as pessoas lidam com o isolamento social. Dessa maneira, constata-se que não existe estratégia que dê certo sem políticas públicas que a englobe.', 'Portanto, medidas são imprescindíveis para mitigar essa problemática. Logo, cabe ao governo federal aumentar a tributação sobre os mais ricos por meio da criação do ""Imposto sobre grandes fortunas"", afim de arrecadar recursos que possam ser usados para auxiliar pessoas em vulnerabilidade econômica. Ademais, é imprescindível dar continuidade em programas como o auxílio emergencial para que assim o trabalhador sem carteira assinada possa sobreviver respeitando o isolamento social e sem ter que passar fome para isso.']",160,120,120,200,160,760
143,Tolerância zero,"['O trote universitário, para os muitos adeptos         à esse         ato deplorável, é uma espécie de ritual ou tradição, que tem como intuito marcar a passagem                 da vida estudantil para a vida universitária                . Porém, essa explicação                 é totalmente inválida                , visto que o trote         leva a tona         sentimentos de superioridade e poder dos veteranos perante os calouros, assim desencadeando violência moral e física, desrespeito e humilhação.', 'O tempo compreendido entre a criação do trote universitário, na          idade média          , e os dias atuais conta com uma infinidade de barbaridades ocorridas por causa dos mesmos                , entre elas estão a morte de dois estudantes de universidades públicas dos estados de São Paulo e Rio de Janeiro e o caso de um estudante de uma universidade também de São Paulo, que teve seu nariz e rosto quebrados.', 'O ato citado anteriormente                não deve ser admitido nem aceitado                 só por causa do seu valor simbólico                , nem levado         com         esportiva e como brincadeira pelos que sofrem com ele,                 principalmente devido ao fato de que ele toma proporções inimagináveis, visto que ele é diretamente ligado ao          bullyng          , que causa diversos problemas psicológicos.', 'Levando em consideração os fatos acima, é notório que é chegada a hora de o         poder legislativo         federal promulgar uma lei específica para combater tal atrocidade ou mesmo implantar em todo o Brasil a                 lei já existente                no estado de São Paulo, que proíbe o trote em que há ataque à integridade física e moral do calouro.']",120,120,80,80,80,480
14,Sonho imigrante,"['O escritor brasileiro, Milton Nascimento em sua música “Sonho Imigrante”, expressa o sentimento de saudade e anseio de retorno à pátria amada. Em decorrência da grave crise política, econômica e social que assusta países em todo o mundo, milhares de pessoas recorrem ao Brasil como refugio em meio ao caos que vivem.', 'Em primeira análise, é importante ressaltar sobre a crise que assola a Venezuela, o que fez com que muitos vissem o Brasil como uma grande porta de recomeço. Segundo dados do Governo Brasileiro , foram emitidas aproximadamente cinco mil carteiras de trabalho dos imigrantes Venezuelanos , o que faz com que trabalhadores que exercem serviços de baixa escolaridade, se sintam ameaçados com a nova concorrência. Outrossim mesmo que a sociedade civil se sinta ameaçada, o Governo Brasileiro não pode omitir ajuda aos estrangeiros, pois a Constituição brasileira prevê igualdade entre nacionais e estrangeiros.', 'Alem do mais, ressalte-se que o Brasil também vive uma crise econômica, com universidades, escolas e hospitais em estado de calamidade. Com a crescente onda de imigrações as autoridades deverão aumentar o repasse de recursos aos municípios, a fim de atender as necessidades básicas dos moradores, sejam eles nacionais ou estrangeiros.', 'Fica clara, portanto a necessidade de ações por parte do Ministério da Justiça juntamente como Departamento de Migrações (DEMIG), como a solução dos “Campos fechados” uma proposta feita pela França e Espanha. É de extrema importância que o Ministério da Saúde intensifique campanhas de vacinação, para que doenças já erradicadas não se tornem novamente um alarde á saúde pública.']",160,120,80,120,80,560
94,,"['Ainda que houve um grande avanço nos últimos anos a respeito do transtorno do espectro do autismo (TEA), existe um longo caminho para entendê-lo melhor e para alcançar melhores resultados no acolhimento e tratamento das pessoas acometidas por esse transtorno, para que essas sejam integradas na sociedade e sejam indivíduos ativos e funcionais.', 'Há características notórias que ajudam a identificar indivíduos com TEA, a ver: dificuldade na fala, comportamentos repetitivos, isolamento social, déficit de atenção etc. Com isso, pais e profissionais da educação podem atentar-se para essas características afim de identificar crianças com potenciais de terem o transtorno, pois o mesmo manifesta-se cedo na infância.', 'No Brasil há diversas escolas especializadas que conseguem oferecer um tratamento melhor às crianças com TEA, por meio de ambientes que itensificam o contato social e uma melhor atenção dada pelos profissionais devidamente preparados, por exemplo. Isso ajuda a integrá-los melhor na sociedade, pois quanto mais cedo o transtorno for identificado e tratado, o indivíduo terá mais chances de ter uma vida normal devido drástica redução dos traços comportamentais e cognitivos característicos do TEA.', 'Além do que foi dito, há muitos estudos sendo realizados afim de desvendar a origem do TEA, isso garantirá um melhor entendimento sobre esse transtorno e consequentemente tratamentos mais eficazes. Também é importante ressaltar a conscientização da sociedade a respeito do TEA, o que vem sido muito bem desenvolvido por meio das crescentes representações artístico-culturais de autistas em filmes, séries televisivas, livros etc. Continuar investindo em estudos e escolas especializadas, manter ou reforçar os níveis de conscientização são um excelente caminho para alcançar níveis aceitáveis de integração.']",160,160,120,120,80,640
50,Corona vírus,"['Recentemente, o mundo tomou conhecimento de um novo vírus que espalhou-se rapidamente pelo mundo, o corona vírus, desafiando  governantes, mostrando  a fragilidade dos sistemas públicos de saúde e a essencialidade da ciência no combate à doença.', 'No Brasil, a falta de recursos no sistema de saúde pública tem dificultado a luta contra o vírus, que se alastra pelo país, fazendo o número de infectados crescer a cada dia  abarrotando  o limitado sistema, causando  um colapso na saúde pública.', 'Estudos estão sendo feitos no intuito de se conhecer melhor sobre o corona vírus apesar da falta de investimentos, durante anos . Cientistas não medem esforços a cada dia, e utilizam de todos os recursos disponíveis para fornecerem todas as informações necessárias no desenvolvimento de vacinas , a única maneira eficientemente conhecida no contingenciamento de contágio.', 'Em suma, mostra-se de extrema importância a organização dos governos no sentido de investirem no desenvolvimento de pesquisas científicas para existam vacinas , prevenindo  as populações de alastramento de doenças, facilitando , assim, o funcionamento do sistema de saúde pública.']",120,160,120,120,120,640
39,(Sem título 094),"['O Impeachment da atual presidente do Brasil passou a ser senso comum, devido ao elevado número de pessoas que apoiam o movimento e os argumentos desenvolvidos, entre eles, estão a atual situação do Brasil que encontra-se em crise e a sua participação, através de um vínculo de amizade entre os seus integrantes, na operação lava-jato .', 'A crise passou a ser uma consequência da situação da política brasileira devido aos países terem desistido de investir pela falta de estabilidade, não permitindo que alguma empresa pudesse vigorar em um sistema instável.', 'Enquanto a causa dessa consequência pode ser apresentada através da na operação lava-jato que revelou a participação de políticos em uma renomada corrupção.', 'Os fatores mencionados entre causa e consequência são mínimos para consolidar a perda do mandato da presidente do Brasil, que dará ao país a chance de recomeçar por um outro ponto de vista, que talvez não seja o vigente lema “Um país rico é um país sem pobreza”, mas que poderá auxiliar em áreas esquecidas pela própria dirigente.', 'Para que isso aconteça, a participação do povo deve ser cada vez mais efetivada através das manifestações que revelam a sua insatisfação e a busca por um país melhor, partindo da percepção de que a corrupção existe, sim. E que pode ser posto um fim nela.']",120,0,0,0,120,240
93,"Mais humanização, menos cesáreas","['Parto humanizado é o termo utilizado para se referir aos partos realizados com pouca intervenção médica e com autonomia da mulher, ou seja, da maneira que ela preferir: cesárea, normal ou fórceps, hospitalar ou domiciliar, etc. Este é um tema muito discutido no Brasil desde os anos 2000, embora muitas pessoas ainda não o compreendam muito bem. Os principais movimentos a favor surgiram por conta do elevado número de cesáreas e visam garantir maior conforto às gestantes.', 'Atualmente, o Brasil realiza cerca de quatro vezes mais cesáreas do que a quantidade recomendada pela OMS (Organização Mundial da Saúde). O procedimento só deveria ser realizado em casos realmente necessários, visto que o parto normal costuma ser mais benéfico à mãe e ao bebê (por exemplo para a imunidade do recém-nascido). Diversos fatores podem ter contribuído para o aumento das cesarianas, entre eles o medo do parto normal.', 'Por isso, é importante que, antes da mulher tomar sua decisão, seu médico obstetra explique os prós e contras de cada opção e lhe deixe confortável e sem medo para se decidir. Como afirmou uma vez o Papa Francisco, “o gênio feminino é necessário nos lugares em que se tomam as decisões importantes”. Sem dúvidas, um parto é extremamente importante e a mãe deve ser respeitada.', 'Portanto, faz-se necessária a redução de cesarianas e o incentivo aos partos humanizados. Cabe ao Ministério da Saúde  promover, através do SUS (Sistema Único de Saúde), a divulgação de informações, a contratação e disponibilização de profissionais capacitados e maior oportunidade de partos normais (como mais casas de parto normal - atualmente, o país possui apenas 18 em funcionamento) . Assim, a gestante se sentirá mais confiante e segura para tomar sua decisão, evitando maiores complicações e frustrações.']",160,160,120,160,120,720
71,O suicídio como uma forma de autodefesa,"['Desde o inicio do século XXI, os casos de suicídio aumentaram de maneira significativa no Brasil. Segundo o levantamento feito pelo sociólogo Júlio Jacobo, entre 2000 e 2015, os casos de suicídio de jovens entre 15 e 19 anos cresceram 45%.', 'É de conhecimento geral que, na maioria das vezes, o suicídio tenha sido causado pela depressão. Entretanto, a série s 13 porquês, lançada pela Netflix em março do ano passado e inspirada no livro de Jay Asher, mostra que essa atitude extrema também pode ter seus fundamentos no bullying. Esses casos apenas dão razão á frase de Sêneca,  viver significa lutar . Mas,  ainda sim é possível tornar essa luta um pouco mais justa e igualitária.', 'A internet, como uma das principais formas e comunicação do mundo globalizado, dispõe de muitos serviços de atendimentos gratuitos para pessoas que pensam em cometer suicídio. É importante lembrar que o Centro de Valorização da Vida, CVV, atende pelo número 188 e pode ajudar significativamente alguém que pensa em tirar sua própria vida. Esse tipo de iniciativa deve ser incentivada e valorizada, tendo em vista que muitas vezes a pessoa com pensamentos suicidas se sente constrangida em se abrir com amigos e familiares.', 'Logo, podemos  concluir que não há maneira mais efetiva de diminuir os números alarmantes de suicídio do que saber identificar os sinais que uma pessoa depressiva e com pensamentos suicidas dá . Para isso, o Ministério da saúde em conjunto com a mídia, deve promover campanhas que falem sobre esse assunto que ainda é considerado tabu . As instituições escolares também podem participar desse processo incentivando os pais e responsáveis a participarem e observarem ativamente o comportamento dos filhos.']",120,160,120,160,120,680
94,,"['Em Esparta, era comum as exterminação de recém-nascidos, a qual apresentavam qualquer tipo de deficiência ou transtorno. Entretanto, diferentemente do passado  ainda há vestígios da falta de inclusão, entre eles pessoas com TEA . Nesse sentido, no Brasil há desafios na inclusão de autistas na contemporaneidade, não permitindo o progresso social. Dessa forma, nota-se a omissão do Estado em mudar esse cenário.', 'Diante desse cenário, é válido ressaltar as dificuldades que os autistas possuem de ter uma ""vida normal"". Destarte, ao Artigo 5 da Constituição federal de 1988  assegura-se ""Todos somos iguais perante a lei"". Contudo, há entraves uma vez que há desafios na inclusão de pessoas TEA , como no comprimento de serviços essenciais como educação e saúde. Sendo assim, observa-se a negligência do governo em cumprir um direito garantido pela Constituição.', 'Somado a isso, na obra cinematográfica ""O Extraordinário"" nota-se as dificuldades de inclusão de Arthie no ambiente escolar simplesmente por ter deformação facial. Nesse sentido, não Diferentemente de ""O Extraordinário"" observa-se na sociedade brasileira o preconceito enraizado em incluir pessoas com transtorno ou deficiência, endo assim pessoas com TEA são facilmente alvos de discriminação. Assim sendo, faz-se necessário desenvolver estratégias para combater o estigma relacionado aos autistas.', 'Dessa forma, é essencial adotar medidas para mitigar os desafios para a inclusão de autistas. Logo, cabe ao Ministério da Educação (MEC), promover palestras realizadas por psicólogos que abordem as maneiras para inclusão de pessoas com TEA, visando uma preparação profissional para receber alunos autistas e promover a igualdade, respeitando as diferenças, no território nacional.  A fim de, promover a inclusão social de autistas na sociedade brasileira.']",120,160,120,160,120,680
72,,"['Com o advento da internet as informações circulam com grande velocidade. Porém, junto com as notícias que circulam na rede, surgem, também, as chamadas feke news – notícias falsas. A enxurrada de notícias inverídicas podem impactar nas eleições, por isso é necessário identificá-las e combatê-las.', 'Atualmente as redes sociais é a forma mais usada para transmitir informações, visto que os usuários estão conectados a todo o momento. Logo, percebe-se que essas mídias são formadoras de opinião. O grande problema é que maior parte dos usuários não filtram o conteúdo disponível. Logo, muitos compartilham as notícias sem saber se o relatado é ou não verdade. Ao compartilhar notícias sem cuidado corre-se o risco de propagar feke news, criando com isso uma rede de mentiras. Essas notícias mentirosas podem ter um impacto imensurável nas eleições , pois o leitor pode fazer julgamentos errados dos candidatos e consequentemente cometer um erro no momento de votar.', 'É notório que em ano de eleições presidenciais a enxurrada de fake news nas redes sociais precisam ser combatidas para que prevaleça a verdade e a própria democracia. Para isso, é necessário algumas iniciativas por parte do governo e por parte da sociedade. O governo precisa criar mecanismos que puna quem fabrica e quem compartilha as fke news, precisa alertar a sociedade das noticias falsas. Paralelo às ações governamentais a sociedade tem que aprender a verificar a veracidade da informação antes de compartilhar. Medidas simples podem ajudar o cidadão a ver se a notícia é falsa, tais como: checar a fonte, vendo se é confiável, verificar a data da publicação, pois as vezes a notícia não é falsa, mas é velha, ler a matéria por completo e não apenas o título e ter a consciência de que outras pessoas irão ler a notícia compartilhada e por isso ter cuidado para não compartilhar mentiras.', 'Destarte, é inegável que a internet é um meio eficiente de transmitir informação e que junto com as notícias encontram-se, também, as feke news, por isso é preciso ter cuidado ao se compartilhar as notícias encontradas na rede, principalmente em ano de eleição, para que os eleitores não façam julgamentos baseados em mentiras e com isso façam uma escolha errada na hora de votar. Assim, será possível evitar que o futuro da nação fique nas mão de governantes que não representarão o povo brasileiro.']",120,120,80,120,120,560
67,Dificuldade de uma minoria,"['O Brasil por ser um território grande é muito miscigenado muitos povos juntos pra formar um país com culturas, línguas, culinárias, religião diferentes por uma parte  bom mais agregação para uma sociedade por outro lado existem as pessoas que discordam com as diferenças,  tem preconceitos  dificuldades em abraçar o que não igual a si, precisam a aceitar e respeitar para terem uma convivência adequada', 'Uns dos primeiros que sofrem por terem ""essa condição"" imposta são os povos indígenas, que ficam limitado ao seu espaço por possuírem características próprias de uma etnia que é desrespeitada convivendo em conflitos constantes com uma parcela da sociedade que não respeita o lugar onde vivem, querendo extrair o máximo qualquer recurso de tenha na amazônia, como os madeireiros destruindo as arvores e solo onde elas permanecem para exportar para fora do país na fabricação de móveis entre outros pra lucrarem em cima da infelicidade deles, outro exemplo o garimpo feito de forma ilegal através da mineração extrair pedras preciosas usando o mercúrio que é extremamente contaminante destrói as águas e qualquer forma de vida lá, que por consequentemente atinge os índios delimitando a usarem a qualquer recurso da terra. Pessoas precisam compreender a gravidade do problema afeta todos sem exceção de ninguém, somos  filhos da terra devemos proteger e cuidar de forma consciente', 'Uma das maneiras de combater esses problemas inserir palestra na população conscientizando a preservação da mata e flora e de sobrevivem lá, debater com esses povos sobre o que pesam e que fazer para melhorarem seu ponto de vista e possivelmente implantar politica que aumenta os direitos deles é saber como pode usar os recursos de maneira sustentável a exploração sem precisar de destruir . Apesar que com o Estatuto dos Povos Indígenas foi feito mas até hoje está parado na justiça esperando a votação se pode ser implantada o que minimizam muito qualquer esperança de uma povo reprimido sedento de atenção voltada ao seu problema esperando uma resposta prudente do governantes']",120,80,80,120,120,520
89,,"['Atualmente o assunto mais comentado entre a população de todas as idades, é sobre o vírus da covid-19 (conhecido também como coronavírus). Desde que chegou ao Brasil, tem gerado uma grande quantidade de mortes tanto por dia, quanto por horas. Várias medidas já foram tomadas para tentar solucionar esse grande problema que atormenta todos nós.', 'A primeira decisão que tiveram foram fechar todos os comércios das cidades como bares, restaurantes, lanchonetes, lojas de roupas, calçados, acessórios, entre outros incluindo também supermercados, bancos, etc... Porém não foi o suficiente para diminuir a quantidade de pessoas contaminadas por este vírus tão letal, até porque a maioria dos jovens na faixa de 17 a 29 anos,  não estavam cumprindo com as medidas dadas pelos agentes da saúde não estavam obedecendo o distanciamento social, muitos furaram a tão temida quarentena para se juntarem, e acabarem sendo contaminados, e aumentando cada vez mais o número de óbitos.', 'Apesar de todas essas perdas, de todos os sufocos que estamos enfrentando, seguimos com a esperança de que tudo isso acabe um dia, e tudo volte a ser como antes !']",160,120,80,120,0,480
50,A Ciência Contra as Epidemias,"['A ciência proporcionou, historicamente, avanços gigantescos nos mais variados setores da sociedade, a qual nos tempos atuais não apenas usa o conhecimento científico  como é dependente dele para o desenvolvimento (no sentido mais amplo da palavra) de toda a sua estrutura. Notoriamente, a saúde, como uma parte importante da organização humana, é profundamente atingida pelas realizações científicas ou pela ausência delas. Nos últimos anos, porém, têm se tornado populares ideias propagadoras de um anti-cientificismo que, principalmente em momentos de crise global, se revela ameaçador para a toda a conjuntura social . É necessário reforçar o papel que a ciência tem na saúde mundial e que ela é a chave para erradicar o coronavírus, a mais alarmante pandemia do século XXI..', 'Epidemias não são algo novo no mundo. Temos registros de crises epidêmicas desde as mais arcaicas sociedades  e por diversas vezes na história tais crises tiveram um papel protagonista no desencadeamento de eventos que modificariam o mundo . É o caso da peste negra, da gripe espanhola, de epidemias de malária e da febre amarela. A rápida propagação de cada uma dessas doenças deveu-se à ausência de conhecimento científico que a humanidade tinha, gerando  uma dificuldade na prevenção, no tratamento e no controle das enfermidades. Afortunadamente, o surgimento do método científico no século XVII e seu desenvolvimento e popularização nos seguintes séculos foram capazes de determinar as causas das doenças e combatê-las. Como consequência disso, a humanidade conseguiu erradicar doenças com um enorme potencial letal, a exemplo da varíola.', 'Ademais, percebe-se que têm ganhado força convicções de que a religião ou determinado pensamento filosófico devem substituir o método científico para o combate à doenças . Esse pensamento é perigoso, pois pode aumentar drasticamente as vítimas e o alcance das epidemias. Uma exemplificação disso foi o recente impacto que o COVID-19 teve na Coréia do Sul, onde foi descoberto que membros de um grupo religioso que defendia o tratamento espiritual em detrimento do científico foram os principais propagadores da doença . Inclusive, o vírus em indivíduos que não faziam parte do grupo foi por diversas vezes traçado sendo originário dos praticantes religiosos .', 'Tendo em vista esses pontos, devemos  defender o estudo científico da saúde. Cabe também ao Estado financiar a pesquisa científica, pois o setor privado utiliza-se dela na maioria das vezes como forma de lucro e não visando a saúde de todos os indivíduos da sociedade . Além disso, é necessário coibir manifestações religiosas  anti-cientificas que possam disseminar ideologias inverídicas que prejudiquem a saúde pública. Para tal, é necessário haver uma conscientização popular sobre a importância da ciência, e esta conscientização deve começar pela educação.']",160,200,160,160,120,800
104,Sustenta Trânsito,"['As ciclovias contribuem com a qualidade de vida dos ciclistas,         que         por sua vez, melhoram                 o aspecto de vida no trânsito                ; ato que resulta em                 um melhor funcionamento do meio ambiente.', 'Além de ser um estilo de vida ecológico, a bicicleta é uma alternativa saudável, para fugir do trânsito excessivo das cidades.', 'Contribuindo-se                a isso, as ciclofaixas possibilitam mais segurança aos ciclistas, fazendo com         que, outros         motoristas sintam-se         confortáveis  , em         aderir à         ideia.  Contribuindo          para um trânsito menos caótico, e elevando a sustentabilidade do país.', 'A iniciativa das ciclofaixas é benéfica, contudo, apenas                 o ato                não basta. É preciso que nossos representantes elaborem campanhas e programas, tais como:                 bolsas          à          ciclistas                propagandas de incentivos         em rádios e televisores, é preciso          triplicar as ciclofaixas                , fazer com que haja em todas as ruas um acesso exclusivo         ao         ciclista e                 estacionamento obrigatório                para bicicletas. Assim, podemos usufruir de um         transito         menos estressante e poluído.']",80,80,0,0,80,240
47,A educação em tempos de pandemia,"['Com o isolamento social , as escolas estão fechadas, os alunos em casa e o material didático esta sendo atrasado diante a pandemia, como consequência prejudica aprendizagem de alunos e dificulta os professores de ensinar além de enfrentar a realidade das desigualdades de recursos tecnológicos de alunos e professores em escolas públicas.,  e desafios na experiência de ensinar a distância., existem ademas diferentes possibilidades de continuar ensinando sendo a tecnologia apenas um caminho.', 'De todos os âmbitos impactados pela pandemia, a educação foi um dos mais afetados, devido que para as escolas que começaram a dar aulas a distância adaptar-se e uma dificuldade para ambas partes, e com as escolas públicas sem recursos e equipamentos, isso gera oportunidades desiguais e problemas no futuro.', 'Ademais das visíveis consequências existem outras dificultades resultado de não ter aulas presenciais e que são fundamentais para os alunos, como atendimento psicológico, apoio para aprendizagem, merenda escolar, etc.', 'Percebe-se, por tanto, que a pandemia trouxe muitos desafíos na educação no Brasil, sendo assim, é necessário que as escolas  como o apoio do Ministerio d Educação, se ocupem de proporcionar a currícula por outros meios como a televisão e rádio, particularmente em áreas que não possuem internet, como assim também retirar o conteúdo impresso da escola com apuntes atividades e livros didáticos. As pessoas com as ferramentas digitais que possuem baixas habilidades tecnológicas e dificultades para ensinar e aprender a distância, brindar tutoriais com mentores para orientar tanto a alunos como professores. e conferir a previsibilidade a retomada gradual aproveitando o recesso escolar do verão. com todas as precauções de saúde em compasso com as diretrizes de enfrentamento a pandemia para os alunos']",120,120,120,120,120,600
63,Quais as soluções para os impactos ambiemtais resultantes da ação  de grandes corporações,"['Os impactos ambientais são desastres causados por várias corporações, a qual causa grandes danos ao meio ambiente, as pessoas e aos animais. Esses desastres afetam direto ou indiretamente a saúde e a segurança da população.', 'Nota-se que os impactos causados pelas corporações  tem afetado diretamente as pessoas como  na cidade de Mariana no estado de MG em 2015 quando a barragem da Samarco rompeu deixando vários  mortos e diversas famílias sem lares além de desvastar toda  a cidade.', 'A tragédia ocorrida em Mariana volta a ser lembrada na cidade de Brumadinho como mais um desastre industrial deixando mais de duzentas pessoas mortas e mais de 70 desaparecidos devido a grande massa de lama que atingiu a cidade.', 'Para evitar estragos ambientais e poupar vidas é necessário a colaboração de casa um, estabelecendo projetos como a despoluição de rios e o reflorestamento das áreas desmatadas ,a qual as pessoas usam somente recursos naturais.']",120,120,120,120,80,560
48,Avaliação do SUS,"['Avaliação do SUS', 'O Sistema Único de Saúde é um órgão de grande importância para o atendimento público em relação à saúde. Todavia, não há crenças de que este programa auxilie no enfrentamento de novos desafios, como o coronavírus, por conta do cumprimento severo da burocracia e da falta de recursos medicinais.', 'Primeiramente, vale ressaltar que a burocracia, responsável pelo estabelecimento de regras, é essencial para o controle da gestão em qualquer local de trabalho . Porém, ela se torna um terrível problema quando a seguimos de maneira exagerada. É muito comum nas mídias casos de pessoas, que necessitavam de ajuda imediata, morrendo por conta da longa espera na fila do SUS.', 'Além disso, mesmo aqueles que conseguem ser atendidos, por muitas vezes não são tratados adequadamente pela presença de poucos recursos no estabelecimento. Isso é o principal motivo da maioria das pessoas terem preferência em hospitais particulares, o que prejudica pessoas sem ou com poucas condições financeiras.', 'Portanto, apesar do SUS ser um sistema criado para cuidar de quaisquer indivíduos, independentemente de suas condições financeiras e sociais, não apresenta recursos e nem organização necessários para a execução dessa função . Para a melhor resolução desse problema, cabe ao Ministério de Saúde investir nos recursos públicos desse programa e conscientizá-lo sobre uma maneira mais organizada de atender sociedade. Dessa forma, haverá maior confiança nos serviços prestados pelo órgão e mais pessoas terão acesso a uma saúde de qualidade.']",160,160,120,200,120,760
40,A verdade por trás das cirurgias plásticas,"['Em cada ano que se passa, mais de 23 milhões de cirurgias plásticas são realizadas ao redor do mundo. E o brasil, tem ocupado a segunda posição no ranking mundial. E as mulheres, por sua vez, representam mais de 80% das pessoas que realizaram cirurgias plásticas, que entre elas, em destaque foram:  a lipoaspiração e a prótese mamária. Contudo, nota-se que a busca pelo corpo perfeito e a insatisfação da beleza natural, está presente em grande parte do mundo conteporâneo. As revistas e a mídia tem grande impacto no índice das cirurgias, devido a criação de estereótipo tanto femininos, quanto masculinos. A modelo Andressa Urach, é um grande exemplo: a brasileira passou semanas internadas devido a grande doses injetadas de hidrogel nas coxas. Outro caso é o de Célsio Santebañes, mais conhecido como Ken humano; ele fez várias modificações cirurgicas em busca do rosto perfeito, parecido com o do boneco, ken .A busca pela perfeição ou o estereótipo imposto pela sociedade, nem sempre dá certo, havendo grandes complicações e até mortes. Devido a grande consumição das cirurgias, muitas pessoas que não tem condicão financeira, buscam por procedimentos mais baratos, sendo assim,  mais perigosos. Em virtudes dos fatos mencionados, conclui-se que, cirurgias plásticas está ocupando grande espaço atualmente, tornando-se já uma obsessão entre a população. Dificilmente o auto bem estar consigo mesma é suficiente para não realização de procedimentos médicos. Tendendo a cada vez mais aumentar o consumismo na forma física e anatomica.']",120,160,160,160,0,600
53,A Influencia dos Meios de Comunicação na Sociedade Brasileira,"['Desde os anos 80 a tecnologia vem crescendo de maneira rápida, afinal quem hoje em dia não tem um celular? Ou um computador? E mesmo se não tiverem, ainda existem lugares para que as pessoas que não possuem computador em casa possam ter acesso a eles. Além disso, as empresas de telefonia e as próprias industrias de celulares tem tornado possível a compra de aparelhos de celular para que todos possam utilizar dos serviços dessas empresas. O numero de jovens como celular cresceu muito desde o inicio dos anos 2000, foram mais de 20 anos de evolução até aqui para que hoje em dia com apenas um toque tenhamos noticias do mundo todo, desde um evento cultural que aconteceu em nossa cidade até um assalto no Japão.', 'Com esse avanço drástico na indústria de comunicação, ter um meio de comunicação digital passou a ser de suma importância, afinal, quem não quer falar com os parentes ou amigos distantes? Ou até postar uma foto legal que tirou nas férias para que os outros vejam? Grande maioria hoje em dia utilizam das redes sociais para saber do mundo, e existe um grande exemplo disso que foi quando o presidente dos Estados Unidos, Donald Trump, enviou um bombardeio para o Ir o que acarretou a morte de Qassem Soleimani, um poderoso general do iraniano, o que provocou uma duvida mundial se haveria ou não uma 3ª Guerra Mundial, e o medo de que o Brasil estaria envolvido, muitos brasileiros passaram a fazer piadas, inclusive uma das piadas comentadas foi que as pessoas estavam sabendo mais da guerra por piadas do que pelos próprios jornais digitais, impressos e televisivos, onde se concentra o maior numero de noticias mundiais. Isso pode ser um problema, assim como pode ser uma boa coisa, afinal, ficamos sabendo de coisas importantes que mudaram nossas vidas em questão de segundos, já pelo jornal televisivo existem horários específicos para isso, o que atrasa o conhecimento.', 'Não podemos considerar o uso das mídias no dia-a-dia como um problema, afinal, todos temos o direito de saber sobre as coisas que acontecem no mundo a hora que quisermos, sem a pressão de ter de esperar o noticiário passar na tv ou ele ser impresso, e a melhor evolução foi a dos jornais impressos para digitais, podendo manter as noticias de forma rápida e acessível para todos. O mundo tecnológico está evoluindo cada dia mais e é necessário que nós usuários também evoluamos para podermos usufruir de tudo que é ofertado para nós no mundo da tecnologia.']",120,80,40,80,40,360
46,.,"['Após todos esses anos, é notório que o serviço de saneamento básico no Brasil é extremamente desigual e negligente em alguns casos, colocando a pauta a privatização desse serviço. Estando o Estado inchado e sobrecarregado, a privatização de um serviço básico de tanta importância tende a aliviá-lo e oferecer uma melhor infraestrutura de serviço à população. Todavia, é imprescindível a regulamentação desse processo.', 'Inicialmente, notamos que a distribuição do saneamento no país é desigual e precário, apresentando constantes problemas de infraestrutura e falta de controle de qualidade do produto final. Isso ocorre por conta do baixo investimento destinado ao serviço. Com a sua privatização, o dinheiro para o setor tenderia a aumentar, visto que a empresa se dedicaria exclusivamente em atender a demanda necessária para os moradores da região, aumentando também a qualidade do produto final que se destina às casas dessas pessoas.', 'Finalmente, lembramos da importância de uma regulamentação para as privatizações . Essas, ocorrendo, precisam ser constantemente vigiadas e implicadas regras como, por exemplo, a empresa ser responsável por 100% do abastecimento daquele local, no caso de um cobertura menor que 75%,  o contrato se encerra e a empresa perde a prioridade em futuras negociações com o Governo Federal. Essa medida ajudaria na fiscalização e garantiria uma distribuição mais uniforme do serviço.', 'Portanto, tira-se a responsabilidade do Governo na distribuição e fornecimento do serviço, mas não de fiscalizá-lo. Com as privatizações, seria mister aos órgãos responsáveis pela área ,  uma fiscalização e regulamentação criteriosa, para assim se obter resultados positivos com condições melhores trazendo segurança e certeza a população do recebimento do saneamento básico de qualidade.']",160,160,120,160,120,720
82,A questão da automedicação,"['Muito se tem discutido, recentemente, acerca da automedicação. No momento presente ele pode ate  ser a melhor opção  mas  futuramente, pode trazer consequências. Será abordado o fator que geralmente leva a automedicação, juntamente da desvantagem.', 'Este  cenário tornou-se real,  porque é inviável para as pessoas irem ao médico todas as vezes que apresentarem um mal-estar,  devido a isso recorrem a prática da automedicação, visto que momentaneamente e geralmente resolve seus problemas e também é um meio mais acessível, porque o custo financeiro é menor e mais prático, pois demanda menos tempo.', 'Alguns argumentam que o uso de medicamento sem prescrição médica pode levar ao agravamento da doença, dado que o uso inadequado pode esconder certos sintomas. Caso o remédio seja um antibiótico  a situação fica ainda pior, pois a utilização abusiva deste  produto facilita a resistência de microorganismos   prejudicando a eficacia  do remédio.', 'Diante dos fatos mencionados, percebe-se a necessidade de alertar a população sobre os efeitos de tomar remédios sem a prescrição de um médico. O governo pode ajudar realizando ações sociais que visem a   conscientização da população como propagandas de televisão ou palestras.']",80,120,120,80,120,520
46,Privatização do saneamento básico,"['No Brasil, o saneamento básico é um direito assegurado pela Constituição Federal de 1988 e que tem não só direito ao saneamento básico, mas também direito a infraestrutura, ao abastecimento de água, ao esgoto sanitário entre outros. Apesar de um direito, à uma grande parcela da população, principalmente moradores de áreas mais afastadas e com menos investimentos do Estado que não possuem acessos a esses serviços.', 'O sistema divide ideias quanto ao saneamento básico ser para todos e privado . De um lado, o saneamento levaria as pessoas de baixa renda a ter uma qualidade de vida melhor e mais duradoura, inclusive, as mesmas  teriam menos chances de contrair doenças resultantes da falta desses serviços. No Brasil, 35 milhões de brasileiros não tem acesso a água tratada, segundo o presidente do Instituto Trata Brasil  o que revela um grande descaso do governo a não atender a parte mais carente da população.', 'Por outro lado, é necessário observar também que um dos argumentos utilizados pelo sistema é que se houvesse investimento nessa área para todos, o resultado seria o aumento do valor pago pela população . Vale citar ainda que um dos principais argumentos contra a nova lei aprovada pelo Senado no dia 24 de junho de 2020, é que os pequenos e mais pobres municípios não traz interesse das empresas privadas e por isso ficarão sem saneamento básico.', 'Dito isto, torna se necessário que o Ministério da saúde  tome medidas para garantir a igualdade para todos. Observando isto, o governo deve liberar verbas para a construção de tratamento de esgoto em áreas mais afastadas e no interior do país, visando que também deve haver atendimento em postos de saúde e tratamentos oferecidos aos infectados por doenças causadas pela mesma , que torna assim uma sociedade com mais igualdade.']",160,160,160,160,160,800
84,Porte para a morte,"['A liberação do porte de armas para a população civil é uma questão delicada no Brasil. Existe um descontrole da entrada de armas ilegais nas fronteiras do país, e mais de 70 % dos homicídios no país estão associados ao uso de armas de fogo. Contudo, em países como os Estados Unidos que tem o uso de armas legalizado, houve redução dos homicídios. Mas, é necessário analisar cuidadosamente este tema, pois a comparação com outros países deve levar em consideração ser analisada n aspectos históricos e socioeconômicos.', 'No Brasil foi feito um plebiscito sobre o desarmamento da população no ano de 2003, e a maioria da população aprovou o desarmamento. Entretanto, alguns setores da sociedade não concordam, e afirmam que armar a população seria uma maneira de evitar a criminalidade. Pois a falta de segurança assombra os brasileiros, que se estivessem armados se defenderiam dos bandidos. Mas, a maior dúvida é saber se realmente a população está preparada psicologicamente para o uso de armas de fogo, e se realmente na prática seria benéfico para os cidadãos e para a sociedade.', 'O certo é que logo após a aprovação do estatuto, no ano seguinte houve uma queda do número de homicídios depois de dez anos. Trata-se de uma questão lógica, já que diminuindo o fluxo de armas consequentemente diminui o número de mortes. Contudo, as armas ilegais continuam a entrar ilegalmente no país contribuindo cada vez mais para a criminalidade, (.) onde recentemente houve um assalto a uma transportadora de valores no estado de são Paulo, onde os bandidos portavam uma arma de uso restrito capaz de derrubar até um helicóptero.', 'Cabe, portanto, ao governo o controle rígido das fronteiras do país, com o uso de uma polícia especializada no combate ao tráfico de armas e que atue de forma organizada. Além da criação de um estatuto de controle de armas, onde apenas civis capacitados e bem treinados e em trabalhos específicos como na área de segurança socioeducativos possam usar o armamento. Mas o bom mesmo seria se a sociedade não precisasse usar armas que foram feitas exclusivamente para matar outros seres humanos.']",120,120,160,120,200,720
87,,"['O filme de origem francesa estreado pela NETFLIX ""Lindinhas"" que retrata a preocupante situação da erotização infantil . Esse tema é bastante discutido e preocupante principalmente entre os pais, professores e,  todos aqueles que zelam pelo bem-estar da criança. Essa cultura é notada especialmente em algumas músicas escutadas pela sociedade, que apresentam letras execráveis no ponto de vista social. Essas canções estão em maior concentração nas comunidades, nos lugares com menos ação social e,  nas plataformas digitais. Tal cultura é fruto das falhas na assistência governamental, aliado ao acesso às redes sociais precocemente.', 'Primeiramente, é fulcral pontuar que as a cultura da erotização infantil deriva da baixa atuação dos setores governamentais no que concerne a criação de mecanismos que coibam tais recorrência.']",160,120,80,80,0,440
95,redacao originarios ...,"['Em 1500, com o descobrimento do brasil e ida dos europeus ao brasil , os portugueses tiveram uma uma enorme surpresa ao encontrar povos indígenas onde no imaginavam que existia vida humana. com tudo, existiram muitos conflitos com a demarcaçao territorial. Os portugueses invadiram terras indgenas e expulsaram de suas terras. Com isso, os indgenas vao a rua para lutar por seus direitos.', 'A demarcaçâo de terras de povos originarios . Assim conhecido o povo indgena. povo que protege. proteger terras. crenças, costumes e lingua. Que por muito tempo tiveram que lutar por territorios que era seu por natureza.', 'Um processo de demarcaçâo territorial, onde indgenas afirmam perder suas areàs.  stf por meio do chamado marco temporal apresenta uma lei que garante que povos indgenas permaneçam em terras que os pertemcem desde o dia 5 de outubro de 1988.', 'Sendo assim, os indgenas podem ficar em suas terras com garantia d lei. Mas o processo de demarcaçao acontece ate os dias atuais, mas agora os indgenas tem uma lei para proteger suas terras. Marco temporal a lei que garante permanencia dos indgenas em suas terras.']",120,80,80,120,0,400
54,A importância da vacina,"['Observa-se que tal cenário é maléfico, visto  que atualmente doenças erradicadas estão ressurgindo inesperavelmente. Além disso, nos últimos anos a porcentagem da cobertura vacinal vem decaindo, as pessoas estão deixando de se vacinar e existem lugares onde as vacinas não chegam.', 'O sistema imunológico recebe a vacina com os agentes patogênicos a fim de que causa uma resposta do organismo. É de fundamental importância a população ser conscientizada de forma que mantenham sua caderneta de vacinação em dia.', 'A vacina é o maior mecanismo de defesa contra as doenças, além do mais é extremamente importante estar prevenido. No Brasil, a taxa de cobertura vacinal vem caindo , bem como doenças erradicadas estão voltando.', 'No Brasil muitas pessoas estão deixando de vacinar por consequências de falsas notícias e falta de informações e também pessoas que não são vacinadas pela a falta de vacina em sua região.', 'Dessa forma é evidente a necessidade de que as campanhas de vacina passem por melhorias, em virtude de que as vacinas cheguem nas áreas mais afastadas do Brasil onde as pessoas não estão sendo vacinadas e que as campanhas conscientizem as pessoas e importância de se vacinar.']",120,120,40,80,40,400
43,cultura do cancelamento-111,"['A cultura do cancelamento pode ser definida como uma série de reações hostis e exageradas por parte dos usuários das redes sociais motivadas por atitudes ou palavras de pessoas famosas, conhecidas na internet. Esse tema tem ganhado destaque nas discussões contemporâneas por estar cada vez mais presente no cotidiano dos usuários. Desse modo, é necessário apresentar um exemplo desse tipo de comportamento, suas consequências e alternativas para a solução da problemática.', 'Primeiramente, deve-se entender que a cultura do cancelamento é um problema, pois não se trata de uma forma de justiça, ao contrário, provoca reações insensíveis e desmerecidas. Exemplo disso é o que aconteceu com o ""youtuber"" PC Siqueira, que estava sendo investigado por pedofilia. De posse de tal informação, diversos internautas ""cancelaram"" o influenciador digital, desferindo ofensas e ameaças, alguns chegando a pedir para ele cometer suicídio . Um usuário, ainda, promoveu uma enquete para que seus seguidores opinassem se PC ia ou não se matar.', 'Em seguida, vale salientar que esse tipo de conduta gera diversas consequências para a pessoa atingida, podendo ter danos leves, moderados ou graves. Nesse sentido, pode-se citar: queda no número de seguidores e rompimento de parcerias e de contratos promovidos por empresas ou por outros influenciadores ou artistas, que agem assim por conta da imagem negativa atrelada à pessoa em questão. Outras consequências são as agressões verbais ou físicas e as ameaças sofridas pelo ""cancelado"".', 'Por fim, é importante apresentar algumas saídas para a resolução desse problema. Com efeito, algumas leis protegem os indivíduos lesionados por esse tipo de ataque. Assim o Código Penal descreve o crime de ameaçar alguém de causar-lhe mal injusto e grave. Além disso, o Marco Civil da Internet tem como fundamento o respeito aos direitos humanos e ao exercício da cidadania. Nessa perspectiva, é necessária a atuação do Poder Público , principalmente o Judiciário, para efetivamente fazer cumprir as leis e penalizar pessoas que se excedem no ambiente virtual.']",160,160,160,200,160,840
64,Educação sexual,"['Educação sexual é aquele espaço em que um adulto conversa com uma criança a respeito do corpo, a respeito do que é ser menino, do que é ser menina, a respeito de onde vêm os bebes da gravidez no parto . Todas essas questões que tem a ver com o ser humano e o relacionamento dos diferentes tipos de família. Com base nessa introdução , a educação sexual busca ensinar e esclarecer questões relacionadas ao sexo livre de preconceito e tabus, o objetivo principal da educação sexual é preparar as crianças e os adolescentes para a vida sexual de forma segura, chamando –os à responsabilidade de cuidar de seu próprio corpo para que não ocorram futuras situações indesejadas, como a contração de uma doença ou uma gravidez precoce e indesejada.', 'Como citado , muitos podem ser os causadores de uma doença ou uma gravidez precoce, a falta de orientação sexual nas escolas, associado ao excesso de informações eróticas apresentadas pela mídia e a falta de diálogo entre as crianças e seus pais sobre sexo. O problema principal não é o fato de crianças estarem iniciando suas vidas sexuais cada vez mais cedo, mas sim de estarem desacompanhadas das orientações de seus familiares e, muitas vezes terem relações sem consciência das consequências e de como se prevenir.', 'Entretanto, a educação sexual deve ser entendida como um processo amplo, natural e inerente ao ser humano e próprio de cada fase em seu desenvolvimento, pois a sexualidade é presente em todas as faixas etárias independente de padrões de normalidade, sejam estas físicas, mentais ou sociais, pois as crianças e jovens necessitam cada vez mais de recursos diferenciados para alcançar a compreensão esperada pelos educadores.', 'Fica evidente, portanto, que a educação sexual precisa ter mais ênfase nas escolas. Como forma de garantir isso, cabe ao Ministério da Educação, em parceria com grandes canais de educação desenvolver campanhas de ensino que estimulem o diálogo sobre a sexualidade, como forma de garantir a compreensão sobre a sexualidade. Ademais, cabe ao Ministério da Cultura  em parceria conjunto com prefeituras para um amplo alcance, o estabelecimento de aulas de sociologia, dentre outras que permitam a apresentação da sexualidade, Assim, a sociedade brasileira poderá garantir o exercício da cidadania em todos os setores sociais e, finalmente ultrapassar antigos paradigmas.']",120,160,120,120,160,680
92,As mazelas do racismo milenar,"['Segundo a Declaração Universal dos Direitos Humanos (DUDH), toda e qualquer pessoa possui direito de ser respeitada perante as leis, sem distinção de “raça” ou etnia. Nesse contexto, surge a necessidade de desenvolver meios para combater o preconceito amarelo, ou seja, a discriminação contra asiáticos, já que,  este se tornou um fenômeno social. Dessa forma, entre as causas para a ocorrência de tal problemática cita-se, a visão perpetuada do eurocentrismo e o racismo.', 'Diante do exposto, a visão perpetuada do eurocentrismo se torna um pilar que sustenta todo o sistema preconceituoso e discriminatório da sociedade, uma vez que, esse pensamento de superioridade condiciona o surgimento da xenofobia, ou seja, a aversão ao diferente. Diante disso, é relevante destacar as correntes filosóficas do século XX, como a Eugenia e Darwinismo Social, que pregavam a inferiorização do africano e de outras etnias em detrimento do europeu, assim como, a manipulação genética dos indivíduos. Dessa maneira, observa-se que o preconceito amarelo é uma herança da mentalidade arcaica e histórica, fundamentada pelas práticas imperialistas e consolidada pela dinâmica da sociedade atual, que ainda prioriza os produtos e a cultura europeia. Por conseguinte, esse cenário, é contrário aos princípios da DUDH, pois,  esse grupo social não tem assegurado os seus direitos , o que o mantém margem da população.', 'Ademais, o racismo também favorece a manutenção dessa estrutura desigual, pois, a partir do desconhecimento e do desinteresse, a população cria juízos de valor considerados absolutos e incontestáveis. Sendo assim, pode-se destacar um descompasso, pois, entre o cenário de desrespeito, existe a valorização de certos traços da cultura asiática, representada pela difusão do estilo musical K-pop, pelos animes e filmes. Nesse viés, percebe-se que o preconceito sofrido por esses povos se tornou comum em meio à pandemia devido às especulações sobre a origem do vírus causador da Covid-19, porém, esse fenômeno somente representa uma ferramenta para justificar a mentalidade alienada dos indivíduos. Logo, devido à persistência do racismo, cria-se uma realidade intolerante, e que não aceita a pluralidade, o que confere aos asiáticos,  a exclusão do convívio social por terem comportamentos diferentes dos demais.', 'Portanto, diante dessa realidade, é mister que novas medidas sejam tomadas para mitigar tal problemática. Para tanto, é necessário que o governo federal realize investimentos direcionados às escolas, por meio da promoção de palestras e projetos sociais que abordem a história dos povos asiáticos, assim como, a aceitação da pluralidade. Além disso, é preciso que debates com antropólogos e sociólogos, acerca do preconceito e da xenofobia sejam divulgados em mídias sociais, como a internet e a televisão, a fim de instruir e expor à população, a importância da diversidade étnica, bem como, do respeito ao diferente. Assim, os direitos prescritos na DUDH seriam enfim assegurados.']",120,200,160,200,200,880
42,(Sem título 085),"['A escola foi criada para trazer mais educação para as pessoas que a frequentam, mas não podemos deixar de lado que deve haver um pouco de interesse por parte dos alunos. A situação da escolaridade no Brasil não é nada animadora, há alunos que mau sabem ler e escrever e há professores que não se importam com alunos e dão qualquer atividade mesmo sem explicar nada. Alunos de escola pública que querem estudar e ter ""sucesso"" sofrem muito nos dias de hoje, pois não está fácil, é ônibus lotado, pessoas que moram em roça ou em lugares perigosos demais. O ""sucesso"" vem da luta e persistência que se deve ter, nas condições de vida de hoje, pra quem é pobre querer alcançar algo é muito lamentável .Há projeto do governo para a educação, mas falta melhorar muito ainda as estradas, merendas, professores, segurança, transporte, e também o interesse do aluno é essencial, pois não se pode chegar ao sucesso se não correr atrás, os pais devem incentivar os filhos a lerem mais, estudar em devido horário para que seja alcançado o ""sucesso"" tão desejado.']",80,80,80,80,80,400
98,Um problema evidente,"['A obesidade                é um problema que tem aumentado em todo o mundo, e atinge cada vez mais as crianças, que por sua vez,não possuem maturidade suficiente para perceber as graves consequências que uma alimentação a base de fast-food pode trazer para a sua saúde física e mental.', 'As grandes redes de lanches investem parte de seu capital em propagandas, que são encontradas nos meios de comunicação mais populares como a internet e a televisão. O objetivo desses comerciais é persuadir principalmente o público infantil a consumir o produto. Para isso,oferecem diversos brindes e criam personagens carismáticos que são muito bem aceitos pelas crianças.', 'A família, porém, é a maior culpada por esse crescente índice de obesidade infantil, pois                 além do fast-food ser uma opção cômoda para quem não dispõe de muito tempo, os pais tentam compensar a sua ausência, cedendo aos desejos dos filhos.                  Esse péssimo hábito alimentar traz sérios problemas como o sedentarismo, a diabetes e a pressão alta, além de consequências à saúde mental como a baixa auto-estima, a depressão e o bullying que os mais jovens sofrem na escola.', 'É necessária a criação de uma lei, que proíba a exibição de propagandas de fast-food nos horários de maior audiência do público infantil. O mais importante, porém, é que as famílias mudem seus hábitos alimentares, procurando ingerir cada vez mais alimentos que façam bem à saúde,para que desde cedo as crianças aprendam a ter uma vida mais saudável, e a obesidade possa ser controlada.']",160,120,120,80,160,640
26,Podemos perceber que a sociedade brasileira,"['Podemos perceber que a sociedade brasileira enfrenta um grave problema no que diz respeito a valorização do professor, visto que países com IDH (índice de desenvolvimento humano) elevado atribuem grande importância a esse tipo de profissional. É necessário que o docente seja valorizado', 'Frequentemente professores, especialmente de escolas públicas, são agredidos dentro de seu ambiente de trabalho. Segundo a OCDE (Organização para Cooperação e Desenvolvimento Econômico), a República Federativa do Brasil atingiu a marca de 12.5% no que se refere a violência contra o magistério maior porcentagem do mundo.', 'Desde o século VIII, mais precisamente na sociedade romana, a figura do docente revela-se extremamente importante. Patrícios solicitavam que seus filhos fossem educados pelos gregos antigos. Convém lembrar ainda que países com o maior número de prêmios Nobel, como Estados Unidos e Reino Unido, consideram o professor peça fundamental de seus sistemas educacionais.', 'Desse modo, é necessário que o governo proporcione valorização ao professor fornecendo maiores subsídios salariais bem como, um canal de fácil acesso para um feedback de como está o processo educacional; a mídia também deve promover campanhas de conscientização sobre a importância do docente e a sociedade deve participar ativamente sobre o desenvolvimento de um determinado cidadão atentando-se ao que o magistério tem a dizer.']",120,120,80,120,120,560
31,Caminhos para a igualdade,"['No que se refere a terceirização, é possível afirmar que, não só será uma forma de retrocesso para os trabalhadores; mas também, será um grande avanço para as empresas.', 'Relativo a mão de obra terceirizada, podemos ver os direitos dos trabalhadores cada vez menores. O Brasil passou por uma longa luta na ditadura, para que nos dias atuais suas vozes pudessem ser ouvidas. Legalizar tal lei seria como voltarmos a estaca zero, fazendo toda a nossa luta, para um Brasil mais justo, ser em vão.', 'Nesse sentido, as empresas conseguem com facilidade aumentar os lucros para suas respectivas empresas. De onde vem esse dinheiro? Muito fácil, do bolso do trabalhador. “O homem é o lobo do homem”, fazendo jus a frase de Thomas hobbies , percebemos que a humanidade se preocupa apenas com seus próprios interesses, causando assim sua própria ruína.', 'O governo, portanto, deve reconhecer que tal lei não beneficia ambos os lados, mas, sim, apenas os empresários em questão. As escolas então, precisam pregar a igualdade, fazendo projetos para os direitos iguais, para que as crianças de hoje, sejam adultos justos amanhã.']",120,80,80,120,80,480
